hnit	ক্রিয়ারযেরূপেবচন,পুরুষএবংকালসংক্রান্তকোনোপরিবর্তনহয়না,সেইক্রিয়াররূপ
hnak	কর্তৃকারককেস
hkak	দ্বিতীয়া-বিভক্তিকেস
htak	বিষয়কেস
hpap	বাবা
hmam	মা
hyat	মাতাপিতার
hcan	হ্যালো
hwik	সম্বোধনাত্মককারককেস
hsuc	পূর্বপুরুষ
htat	পিতামহী
hcac	ক্ষুধার্ত
hnik	ষষ্ঠীবিভক্তিকেস
hcit	বিশেষণ
hwan	এবং
hman	আমাকে
hnan	আপনি
hwam	আমাদের
htit	এটা
htac	গন্তব্যকেস
htik	সম্প্রদানকারকয়িকেস
hyit	বাস্তবমেজাজ
htim	deonticমেজাজ
hcut	শর্তাধীনমেজাজ
hsit	epistemicমেজাজ
hyak	যান্ত্রিককেস
htan	অভ্যন্তরপ্রসঙ্গ
hpan	ব্যক্তিপ্রসঙ্গ
htin	স্বাধীনধারা
hyan	নির্ভরশীলদফা
hfap	perfectiveদৃষ্টিভঙ্গি
hkat	অতীতক্রিয়ারকাল
hnin	পুংলিঙ্গলিঙ্গ
hmak	comitativeকেস
hnat	বর্তমানক্রিয়ারকাল
hpak	benefactiveকেস
swik	essiveকেস
htut	অস্বীকৃতিপূর্ণকোয়ান্টিফায়ার
hsan	পৃষ্ঠতলপ্রসঙ্গ
hpin	adpositionalকেস
hwin	অবস্থানকেস
hkan	স্থানপ্রসঙ্গ
hnac	উপায়কেস
hyut	প্রশ্নসূচকমেজাজ
hnam	এবংঅথবা
hkit	একচেটিয়াঅথবা
hsuk	উৎসকেস
hpik	অপাদানকেস
hcat	নৈকট্য
hmat	প্রমাণদায়ক
hkuk	দফালেজ
hlan	কিন্তু
hsut	সব
hyin	সার্বজনীনকোয়ান্টিফায়ার
hcin	নারীসংক্রান্তলিঙ্গ
hpac	বহুবচনসংখ্যা
hyik	এক
htic	তাদের
hkik	কে
tcat	ভবিষ্যৎক্রিয়ারকাল
hsin	সামাজিকপ্রসঙ্গ
hkac	কখন
hmip	imperfectiveদৃষ্টিভঙ্গি
klan	সেখানে
hlak	আপেক্ষিককেস
hlik	অন্তিমকেস
htam	নির্দেশনামেজাজ
hlat	নির্বাচককোয়ান্টিফায়ার
hkam	কি
hwat	প্রশ্নশব্দ
htap	যোজকপদ
hpat	ব্যক্তি
nyan	পুরুষ
hkas	পারা
tcan	অন্যান্য
hnuc	সংখ্যা
twit	জিদপূর্ণকোয়ান্টিফায়ার
hsak	সময়প্রসঙ্গ
htuk	সময়গতকেস
htun	কেবল
htum	উপদেশমূলকমেজাজ
hyip	ভূতাপেক্ষদৃষ্টিভঙ্গি
hlit	volitiveমেজাজ
pcic	অবশ্যই
tyut	দুই
hsat	দেখ
hkut	জানা
hcic	নিচে
hcap	পর
hpam	প্রথম
hlac	হস্তান্তরযোগ্যদখল
hkap	না
hnic	অবিচ্ছেদ্যদখল
tyat	পুরাতন
tcit	স্বেচ্ছাকৃতমেজাজ
tcin	দিন
hlam	আসা
hwak	স্বরবর্ণ
hkin	যাওয়া
lwak	perlativeকেস
hpip	প্রগতিশীলদৃষ্টিভঙ্গি
lyan	দীর্ঘ
hsac	বলা
kyan	কিভাবে
htas	আবার
hsic	এখানে
hcik	মনে
hcak	অধীনেপ্রসঙ্গ
hfan	পাওয়া
hsun	হাত
hyac	এছাড়াও
nwan	তরুণ
tyit	বিরুদ্ধে
tlan	দেবতা
twak	delativeকেস
hmin	কিছুনা
hyas	একবার
hlap	semelfactiveদৃষ্টিভঙ্গি
kcac	বাম
hyic	করাত
hcas	ঘর
hwac	বিশ্ব
tyin	তিন
hnun	নব্য
hcuk	কেন্দ্রবিন্দু
pyan	ভালবাসা
hsis	সর্বদা
hyam	রাত
hyap	রাজা
hkic	মধ্যে
hmas	মন
cyit	হৃদয়
pluc	paucalসংখ্যা
kyik	কারণ
ksak	কারণিককেস
tcun	সম্পন্ন
hnim	নাম
tsan	সঠিকবিশেষ্য
klac	দেশ
hpun	জিজ্ঞাসা
cyat	দৃশ্যমানপ্রামাণিক
pcac	উত্তম
hmac	মুহূর্ত
hnas	নাপারেন
hwic	পানি
twim	ইচ্ছার্থকমেজাজ
kwan	আলো
tlat	শব্দ
tyan	দরজা
hsas	সকাল
syat	পর্যন্ত
twik	terminativeকেস
hpit	সাদা
pcan	টাকা
hyis	দরিদ্র
mwan	মরণ
hfam	ফর্ম
nwik	inessiveকেস
kcat	একসঙ্গে
tsac	প্রায়ই
pyat	বন্ধু
psan	অর্ধেক
hpim	অনুজ্ঞাসূচকমেজাজ
hyuc	বৃত্তাকার
hfat	প্রেরিত
hcis	স্ত্রী
kcan	বিশ্বাসকরা
hsik	প্রকাশ্য
htus	অবস্থাপ্রসঙ্গ
hpas	ছেলে
clat	শিশু
tyak	এইভাবে
cwan	আশা
syin	প্রিয়
hkuc	উচ্চ
tyac	পড়া
syit	শহর
hlic	ইতিমধ্যে
hfit	factiveপ্রামাণিক
tcac	মেয়ে
hcun	শোনা
ksan	অন্তত
hyaf	সম্ভবত
kyat	প্রকৃতপক্ষে
tcic	শরীর
hwit	প্রত্যাবর্তন
cwat	বাতাস
hfaf	আইন
hput	সাহায্য
lyat	চিঠি
ksas	চার
hpic	ইচ্ছাপ্রকাশকমেজাজ
hfuk	আগুন
hcam	ঘন্টা
twat	যুদ্ধ
kyak	বিভিন্ন
tlit	দ্বিতীয়
pcin	পিছনে
hmut	নষ্ট
clan	হাজার
hfac	পরিবার
twan	আত্মা
hwas	প্রশ্ন
syan	সত্য
htis	তৈরীর
tsat	সম্ভাব্যমেজাজ
lwik	allativeকেস
nyin	মনুষ্যলিঙ্গ
hfak	পাঁচ
tcak	একইবিষয়মার্কার
htuc	বিভিন্নবিষয়
hnap	উত্তর
hmit	সমুদ্র
hcuc	ভয়
pcat	বোঝা
syas	শর্তাবলী
hcaf	সন্দেহ
twut	dubitativeমেজাজ
hkis	কালো
tlak	আনা
hyus	সুন্দর
nyit	বাছাইকরা
htip	দশ
ksis	গল্প
hpuk	বই
hlin	বৈদ্যুতিন
hkun	হিসাব
lyas	স্বার্থ
lyit	লেখা
pwat	বিছানা
hnis	বয়স
hnut	counterfactualশর্তাধীন
slas	শিল্প
hwis	vialisকেস
pyak	ভাই
lyin	লাইন
tyas	টেবিল
hyun	নদী
kyac	চোখ
tfan	হঠাৎ
kcin	গভীর
hmuc	উদ্দেশ্য
cyac	রক্ত
hmap	গোলাপ
tlin	ঠান্ডা
hyif	অগ্রবর্তী
tyam	বিলম্বে
hnaf	অনুমানকরা
hkip	প্রায়
myan	খনি
tsin	জ্ঞান
hkup	কপি
hsam	স্বামী
hlis	ছয়
cwit	জীবিত
cyan	শান্তি
myat	মনেরাখা
tyic	প্রাকৃতিক
hfut	পতন
swas	সেবা
hsap	ছাড়া
pcit	কপিরাইট
hyim	সেনা
kyas	ঘোড়া
plic	ভবিষ্যৎ
pcak	পশ্চিম
hpis	বেতন
hyuk	লাল
hwun	স্বর্ণ
twin	ইচ্ছা
plan	খেলা
hpus	অফিস
syun	সরকার
kyic	গির্জা
htaf	শক্তি
hlun	লম্বা
kyin	কোম্পানির
kyis	কাগজ
mlan	সম্ভাবনা
hcim	বিশেষত
cyas	ভালুক
twac	জানালা
nyat	সৌন্দর্য
hcus	আধুনিক
htup	দায়িত্ব
htif	দূরত্ব
pyas	পা
hlas	বন্য
ksin	সবুজ
hmaf	কষ্ট
myac	হাসি
hsim	ঘুম
kyit	উদ্ধৃত
kwik	quotativeকেস
fwan	দর্শন
slan	অনুসরণকরা
psit	উপস্থিতি
hmic	মিষ্টি
hmuf	মুখ
hfin	ধনী
tcam	শত্রু
psuk	ভাঙা
kcap	জাহাজ
pwan	অন্তর্ভুক্তব্যক্তি
hfic	প্রভাব
tcuc	প্রদর্শিত
hkim	গোপন
pyin	অনুগ্রহ
pwit	precativeমেজাজ
pyit	ভদ্রনিবন্ধন
cwak	মন্দ
myak	মার্চ
tcas	জায়গা
hlaf	থাকা
psat	পরিবর্তে
nlan	নীল
psac	অসম্ভব
kcuk	স্কুল
kcit	বিবাহিত
kcak	খাদ্য
syis	বিশ
tlac	শান্ত
hcip	প্রত্যাশিতদৃষ্টিভঙ্গি
kwin	দান
tsit	বন্ধ
pyac	ভাষা
hsus	সপ্তাহ
hcup	হল
cyap	আশ্চর্য
tfin	স্বভাবসিদ্ধ
fyat	আদালত
hnip	নীতি-বাক্র্যসংক্রান্তদৃষ্টিভঙ্গি
tsak	সম্মান
tlas	মূল্য
syuc	বৃক্ষ
plat	প্রাচীর
cyak	স্বর্গ
twip	ক্রিয়ারআরম্ভসূচকদৃষ্টিভঙ্গি
mlat	আদেশ
swit	আদেশবানির্দেশাত্মকমেজাজ
mwas	মাস
hwaf	নির্ভুল
tyap	অভিজ্ঞতা
ksac	পরিস্থিতি
syac	তাজা
hnuk	সর্দার
kwak	আবৃত
tyuk	পূর্ব
pwac	পাথর
hkif	উন্নতচরিত্র
nyac	অভিমুখ
cyis	চেয়ার
tyuc	প্রতীক্ষা
tsun	গ্রাম
tyik	একমত
hnum	অনুমতিসূচকমেজাজ
slak	সাফল্য
tsic	চেষ্টা
slat	পাহাড়
hmik	সঙ্গীত
hkus	কান্না
hsip	সাত
hpaf	বেসরকারী
nwas	খবর
tfac	দৃশ্য
fyan	বাগান
cwas	শুরুকরা
hfik	বিভাজককেস
lyac	শেখা
syik	রাজনৈতিক
clin	হেনরী
cyin	মিথ্যা
tsas	নিক্ষেপ
cyik	কর্তৃত্ব
tlap	মেঝে
cyam	গ্রীষ্ম
tcut	ধর্ম
tcap	অব্যাহতি
hlut	লেখক
pyun	বাদামী
tcuk	ব্যথা
swan	বসন্ত
hmun	নরম
kyun	কোণ
nyak	ট্রেডমার্ক
tsis	বিচারপতি
psas	উত্পাদনকরা
cyaf	হাস্য
hwut	ভুলে
hyup	ইউরোপ
hwap	আট
psak	ক্ষণস্থায়ী
kyap	ভয়ানক
pyic	প্রয়োজনীয়
hmim	মাঝারি
hsaf	শ্বাস
hmis	বিজ্ঞ
hsum	সম্বন্ধসূচকমার্কার
ksat	আরামপ্রদ
ksit	সমাধি
tsap	দ্বীপ
kyam	শিবির
tcum	স্পর্শ
cyun	ভাগ্য
psic	কূল
tyun	ডোমেইন
mwit	commissiveমেজাজ
tlut	ডিগ্রী
myit	শীতকালীন
kfan	আচার
slac	দৌড়
myin	মিনিট
tyip	নেতৃত্ব
klas	কাচ
pfat	তক্তা
cyic	নিরর্থক
swam	ব্যাপার
syam	নিরাপদ
tsut	ডাক্তার
hlip	সমাপকদৃষ্টিভঙ্গি
kcas	অন্ধকার
nyun	উষ্ণ
hpuc	পানীয়
tlam	উদাহরণ
hfun	ক্রোধ
tsik	বিদ্বেষ
tsam	সরাসরি
hmup	টুপি
klak	কুকুর
slin	রূপা
swac	দাস
kcam	গর্ব
pyik	রেলগাড়ি
myut	নৈতিক
syak	প্রবেশকরান
swat	তরবারি
kyuk	আক্রমণ
clac	স্বাস্থ্য
tyaf	অনুচ্ছেদ
swic	সামাজিক
tfit	প্রত্যর্পণ
hkaf	কর্মকর্তা
pcas	চাহনি
nyam	গরিমা
tfat	দ্বাদশ
pcut	জড়িত
pwin	ওয়াইন
mwat	স্বাদ
fyac	লোহা
syap	বিতরণকরা
myap	বাণিজ্য
hyum	ব্যবহার
fwak	বিচারক
klat	অধিনায়ক
twap	শমদৃষ্টিভঙ্গি
kcic	কৌতুহলী
kwic	বিদেশী
hnif	intensifier
myun	গুরুত্ব
tlic	পরিশেষে
cyuk	ঘাড়
syut	স্বাধীনতা
pfan	পক্ষই
kyuc	শুষ্ক
pcap	সরাইয়া
tfak	প্রামাণিক
tcik	প্রামাণিককেস
twun	দূরবর্তী
tyis	উন্নতি
nyap	সংকীর্ণ
plit	ভবন
hpif	পৃষ্ঠা
pwic	অধিষ্ঠিত
syic	দু:খিত
tsip	পাপ
syim	অসুস্থ
tcis	সত্
pcun	ব্যাংক
ksap	গ্রহণকরা
lyam	প্রবাহ
tcaf	সাবধানে
kwac	কান
hpup	রুটি
kcut	পছন্দ
nwam	পশু
hsup	জীবাশ্মপূর্ণলিঙ্গ
nwit	eventiveমেজাজ
tcim	একইঘটনামার্কার
tlik	বর্ধককেস
kyus	ক্রুশ
hmus	পুরু
kfat	সাহস
nwat	হত্তয়া
myic	বৃষ্টি
hpum	পৃষ্ঠ
swut	পবিত্র
clis	জুলাই
mwun	ফ্যাশন
hfas	ফাইল
cwac	অংস
kwat	সান্ত্বনা
nwac	কেউ
tcip	আকাঙ্ক্ষিত
kfac	ঘাস
hmuk	আঁকা
plin	উদ্বোধন
kwun	জুন
mlik	মাছ
klin	রাজধানী
pfut	স্তন
twam	দাবি
fyin	খরচ
nlit	আপনার
mlin	মিলিয়ন
pyut	প্রার্থনাকরা
hluk	ক্লান্ত
ksut	বধ
cyut	ছায়া
psin	ওজন
kcis	ধূসর
pyam	সাহসী
mwac	সন্তুষ্ট
klam	বলছে
ksam	জাতীয়
hfip	দুর্বল
klik	উপত্যকা
hkum	ফটকামূলকমেজাজ
clas	হলুদ
cyuc	তাপ
mlac	দেহাবশেষ
syip	সমানভাবে
pwak	বক্স
tcif	তীক্ষ্ন
psip	নীতি
ksik	ফল
tsim	ঋতু
flan	বিজ্ঞান
pcam	স্পষ্টত
kcun	বিঁধ
ksuk	কাকা
mlit	তালিকা
pcik	বিপজ্জনক
kwas	অগাস্ট
hluc	জনপ্রিয়
klit	অজানা
flak	পরিচিত
fyit	পরিচিতনিবন্ধন
lwat	পাঠক
plun	চলাফেরা
twas	দ্বিগুণ
pcis	পুরোহিত
fyas	আহত
nlat	প্রাসাদ
myuk	মূর্খ
pfak	আনুকূল্য
tcuf	নয়
cwap	সহানুভূতি
plac	বিস্ফোরণ
pyap	স্থাপন
lyic	পরিহিত
hcum	গোলমাল
lwit	সাহিত্য
tsuk	পদমর্যাদা
hfup	ঝড়
kcik	পকেট
nwap	নভেম্বর
tyim	ডিসেম্বর
psaf	অনুপস্থিতি
nlac	জনসংখ্যা
kyaf	ধন্যবাদ
slis	ক্রম
pyaf	পাখি
mlak	মালিক
kwut	কোট
hwuc	সম্পর্ক
pyis	দ্রুত
twuc	ধোঁয়া
nwak	জানুয়ারী
mlic	মেশিন
tlis	দাঁত
ksun	জ্বলন্ত
clam	লজ্জা
klaf	গুণ
clit	রিং
fyak	ফ্রেজ
fyam	ফ্রেজমার্কার
kwap	বর্গক্ষেত্র
hwip	রবিবার
psis	কবিতা
pwut	preordained
kyim	কিনতে
clic	ক্ষেত্র
pyip	এপ্রিল
kfap	অক্টোবর
psut	বস্তু
kcuc	তিক্ত
nlap	ক্রীতদাস
hsok	আলগা
htet	পাঠ
hbat	খারাপ
hrit	ধার
hzit	বৈশিষ্ট্য
hpet	পনের
krac	নিষ্ঠুর
hduc	ধূলিকণা
hrik	ব্যবহারিক
hron	রঙ
hnus	নাক
hric	বন্ধুত্বপূর্ণ
srik	সরবরাহ
hten	গতকাল
tlet	hesternalক্রিয়ারকাল
slap	ব্যর্থ
hban	পরা
hdat	অন্ধ
fran	মাছি
hdan	শয়তান
htec	ধীরেধীরে
hmon	মিশন
cran	বলিদান
hran	বিবেক
hmos	মন্ত্রী
nrit	শক্তি
hcet	ঘৃণা
hset	কেন্দ্র
hrin	মূলদলিঙ্গ
hcot	ভোগ
hrip	সংক্ষিপ্ত
htep	পূজা
hcif	চামড়া
hrat	ছাদ
kran	মুকুট
hkon	দুর্গ
tran	হতাশা
hmif	মাইল
trin	বৃত্ত
hgin	কারাগার
hkop	কাপ
hcen	সদস্য
swin	বেসামরিক
hrac	সর্বত্র
hris	প্রথা
hbin	মানানসই
hmot	মাংস
hdut	দুধ
hwen	জায়মানলিঙ্গ
nran	বিরল
hbac	চাচাতভাই
crut	সেতু
hsoc	স্টক
hsom	লবণ
nris	নির্দোষ
hbit	এড়াতে
crin	তারিফ
rwin	রাণী
hgut	গণনা
hdas	নাচ
hnot	হোটেল
hdin	পূরণকরা
hton	বন্দী
hdak	দোকান
hlet	সোপান
hson	ক্ষমা
hgek	গে
hras	বালি
hsep	সেপ্টেম্বর
hbic	ধ্বংস
hlen	লাইসেন্স
hcon	পর্যাপ্ত
hgit	সাক্ষী
kfon	রান্নাঘর
hbak	বিক্রিকরা
tlim	চিকিৎসা
hsot	স্পীড
kyut	কম্পিউটার
hnen	অনন্ত
htek	লাইব্রেরি
hzan	ধারণকারী
hbis	ভিত্তি
hbun	বিশৃঙ্খলা
kcus	রাঁধুনি
hgat	মরুভূমি
hwus	চুম্বন
hbif	বরফ
hbot	বল
hrut	যুক্তি
hdit	আশীর্বচনমেজাজ
hdis	দোষী
hjan	শাস্তি
plis	পুলিশ
hgan	লুকান
hsen	অভিযান
nrin	অজ্ঞ
hyen	মেঘ
frif	ফেব্রুয়ারি
hdik	রোগ
hnek	উদ্যোগকেস
hbam	চাচী
hmen	নম্র
hdip	বিলম্বিতঅনুজ্ঞাসূচক
prat	রিপোর্টপ্রামাণিক
hdet	মধ্যরাত্রি
hjit	আঙ্গুল
hmoc	কোথাও
pran	প্রেস
kcec	এলাকা
hken	ইদানীং
hloc	মনমরা
hrak	লাঠি
htes	ঠাউর
rwan	পুরষ্কার
hdon	দানকরা
htot	কপাল
hnet	ফেরেশতা
hdun	একক
croc	ভুল
hlon	ভোর
hyec	মেষ
hjin	ধৈর্য
hrec	উল্লেখ
mran	ভূট্টা
htos	সংখ্যাগুরু
hcos	ব্যবস্থা
hkoc	কদাচিৎ
hlif	মুনাফা
clak	চিনি
hjat	মানবতা
tram	ফ্রেম
hdic	ডিস্ক
hkok	নির্জন
srat	শিল্পী
crak	কবজ
hmet	ই-মেইল
hden	সিদ্ধান্ত
gran	রাজ্যপাল
crac	শাখা
hjac	উদ্যম
hdim	প্রস্তাবনামূলকমেজাজ
hcok	ত্বরা
hyet	তেল
pwap	নল
trat	ছাপা
tcot	কঠিনব্যাপার
hdoc	উহু
hren	বক্তৃতাপ্রসঙ্গ
tcon	দুপুর
krin	কেবিন
plam	বিপদাশঙ্কা
hnes	স্নায়বিক
tcen	পর্যবেক্ষণ
hsek	দৃষ্টিভঙ্গি
plik	প্রযোজ্য
slik	সিল্ক
hfen	শতাংশ
hgen	দালাল
hnon	মিলন
crik	জাহান্নাম
tcet	ত্রুটিপূর্ণ
mrat	মিশ্র
hdam	উপদেশমেজাজ
hgac	উচ্চাকাঙ্ক্ষা
htoc	একরকম
hdac	পরামর্শ
nwin	সংবিধান
srit	যন্ত্র
hret	দৃঢ়রূপে
nlin	অনলাইন
hzat	জোয়ারভাটা
klic	কলেজ
hkek	লেজ
nric	প্রজন্ম
hgic	জনাকীর্ণ
hgak	বিড়াল
trit	সরাসরিপ্রামাণিক
tyot	চুক্তি
hnok	সামগ্রী
crit	পরিত্যক্ত
slen	এগার
srin	সত্ত্ব
hpok	উপজাতি
hyot	অভিশঁকীমেজাজ
cric	আশ্রয়
hruc	অভদ্র
cwin	অশ্বচালনা
hzak	ঝাঁকি
dyit	শিল্প
hpec	পেশা
nras	নার্স
hcec	শিক্ষাদান
hbut	জুতা
hmec	অস্পষ্ট
twot	কার্যকলাপ
crat	শনিবার
hkot	ধারণক্ষমতা
hnec	রোদ
hwuf	বিধবা
cren	চালা
nrat	তারকা
hget	অতিথি
hbik	আশীর্বাদকরা
brin	ভিতরের
hpot	সহজলভ্য
trac	সহ্যকরারক্ষমতা
prac	আহরণকরা
hcoc	ফাঁপা
hpon	প্রদেশ
hwim	সভ্যতা
dwan	খাটান
cwok	অভিঘাত
hdok	পরিচালনা
crun	ধন
hzik	বীজ
hrot	সাম্প্রতিকঅতীতক্রিয়ারকাল
hket	জাগ্রত
hcek	আসবাবপত্র
hrop	দড়ি
mrac	দু:সাহসিককাজ
byit	ভোজ
trak	বার্ষিক
hzin	দক্ষিণ
sric	অনুষ্ঠান
clik	শিকার
trap	উদার
hrim	খ্রীষ্টধর্ম
hrus	রাজকুমারী
blat	বেদি
cyon	অতিক্ষুদ্র
hwep	ওয়েব
krat	কার্ডিনাল
tris	রক্তবর্ণ
kcot	সংগ্রহকরা
hben	নির্বাচন
trik	মাতাল
kfit	উত্তোলন
tcec	বিনিময়
nrik	নির্দিষ্টপ্রবন্ধ
grat	সম্রাট
dran	প্রশাসন
hpen	পূর্বে
cluk	অরুপ
nrac	নির্দোষ
ryin	প্রশিক্ষণ
hrun	রোল
nwic	ইঞ্চি
slit	অঙ্কুর
gzat	সংবাদপত্র
krot	কাটা
drit	দাড়ি
hzis	বিছিন্নকরা
hdap	আঠার
sris	ঐতিহাসিক
mrut	স্থূল
nyik	কাদা
bran	নববধূ
drat	নির্ভর
djan	দৈত্য
glat	সরলতা
hpoc	শরৎ
pras	পর্দা
hgot	জমায়েত
tret	থিয়েটার
tras	তুলনা
rwit	প্রতিদ্বন্দ্বী
hfon	বিরচন
klot	কোচ
hmum	মেজাজ
drac	বক্তৃতা
rwas	উপন্যাস
tset	প্রতিশোধ
hdot	শেষপ্রান্তপ্রমাণদায়ক
ryut	ঈর্ষান্বিত
hwon	আমন্ত্রণ
byat	দগ্ধ
flac	ফ্ল্যাশ
prot	প্রতিকৃতি
crek	সুপারিশ
htok	দ্বন্দ্ব
htop	অভিশাপ
prit	অভিসম্পাতসূচকমেজাজ
hces	অসহায়
klup	ক্লাব
hnos	বন্যা
dwin	অযত্ন
prin	দিগন্ত
mrit	ধরিয়ালত্তয়ারস্বভাববিশিষ্টমেজাজ
tcoc	খাড়া
hcom	সাদৃশ্য
grit	বজ্রধ্বনি
tlot	শৈশব
hgik	হাঁটু
hwes	অজ্ঞান
hzac	পারস্পরিক
hsec	সফটওয়্যার
tson	প্রতিষ্ঠান
ryit	প্রাপ্তি
dlin	শৃঙ্খলা
slip	চিলতা
klon	বিপ্লব
hfim	কৃষক
hpom	মাচা
cyen	ছাত্র
hgec	গুহা
hroc	ঐতিহ্য
srac	জমা
ryat	দুঃখজনকঘটনা
kcen	কুমারী
hbap	বিদায়কালীন
krik	সমালোচনা
krap	cotton
fwat	হাসপাতাল
kcet	ভাড়া
hgas	গ্যাস
pfin	অনিবার্য
dlit	পাতা
ryan	অনুবাদ
sran	অন্ত্যেষ্টিক্রিয়া
mrin	ময়দা
hram	রোমান্টিক
dlan	ডলার
hzas	ঠাট্টা
hsos	ষোল
klen	উপনিবেশ
gyin	ডানা
hsif	সিংহ
cluc	ধূর্ত
prip	প্রস্তুতি
hzut	কুয়াশা
dwat	ঔষধ
krit	প্রুফরিড
sras	নীড়
hses	চতুর্দশ
brat	আপত্তি
flat	অ্যাসিড
hjic	যথা
slic	অস্ত্র
hbuc	ব্যবহারকারী
tron	কমলা
byan	স্নান
hrif	আদিম
tlip	স্থাপনকরা
blan	ঝুড়ি
kris	সম্পাদক
hyon	ইতোমধ্যে
tren	আজ
dlat	বর্তমানসময়েঘটিতক্রিয়ারকাল
hzic	বিষ
tfic	রাইফেল
tlen	প্রতিভা
hlim	জলবায়ু
dyat	সঙ্গী
kcon	উদ্ঘাটন
dlac	ধোয়া
krak	স্বীকারোক্তি
hbas	আজেবাজেকথা
hkec	কয়লা
hrek	প্রত্যর্পণকরা
hkos	শাল্তি
hwif	ভাইস
tric	অস্থায়ী
hdep	delimitativeদৃষ্টিভঙ্গি
mwak	গাদা
ksot	হাড়
hnoc	সোমবার
nlas	মঙ্গলবার
brac	বুধবার
frap	যুক্তরাষ্ট্রীয়
pfit	প্রতিনিধি
pcoc	মেরু
lyen	লিনেন
swak	ডুবা
pcen	রাষ্ট্রপতি
brit	রক্তাক্ত
hwec	নিরোধ
hwet	পেট
hlos	উপরতলার
hbon	বিভিন্ন
pcon	পিতল
hsem	শিখর
lwac	সস্তা
tsos	প্রতিযোগিতা
kwen	একচেটিয়াব্যক্তি
trun	অবতরণ
trut	মুর্তি
hrap	কামান
hgap	গ্রেফতার
trot	তাপমাত্রা
grin	আশপাশ
hjak	আলিঙ্গন
hpek	প্যাক
hlus	হরিণ
hwos	শয়নকক্ষ
tsuc	গুল্ম
pcuc	নির্গমন
cris	উত্তরাধিকারী
clun	ত্তক্
hpes	অপ্রীতিকর
nlet	অসম্পূর্ণ
hrom	কার্যক্রম
pyon	পিয়ানো
swet	পটান
dric	অদৃশ্য
tyen	ভালপরিচিত
hruk	নিষ্ঠুরতা
frat	বরাদ্দ
hyoc	প্রলোভন
hlep	telicদৃষ্টিভঙ্গি
nrot	আন্তর্জাতিক
nret	আবেগপূর্নভাবে
hfif	দার্শনিক
pfic	প্রতিনিধিত্ব
hmek	সংবেদনশীল
hfec	কল্যাণ
myik	মাছধরা
truc	চুরিকরা
tcop	ঠোঁট
rwic	অপসৃতকরা
htom	অর্থনীতি
glan	দরদালান
pren	সমান্তরাল
hlek	atelicদৃষ্টিভঙ্গি
nrak	মহাদেশ
truk	ঠক্ঠক্
hjim	নিষেধাজ্ঞামূলকমেজাজ
rwat	টাই
hcep	কোষ
dyan	ডিম
jrat	কৃত্রিম
nren	অনুপ্রেরণা
ksic	সঙ্কট
tsoc	অনুসন্ধানের
lwan	লাঞ্চ
hpos	সরলবৃক্ষ
hcuf	ধাক্কা
tcus	আদালতেঅভিযুক্তকরা
pset	প্রসারিতকরা
hkep	তামা
swis	নাবিক
prim	সার্বভৌম
trip	চাবুক
cras	শার্ট
swap	কুড়ান
syet	স্কেচ
htof	চোর
clen	চ্যানেল
kwit	ব্যক্তিত্ব
klok	বাড়তি
hrok	সংশোধন
hguc	তৃষ্ণা
kcim	শাসানি
hpem	করতল
psik	বক্তা
frit	গোবরাট
cret	ট্রেস
mrak	বর্শা
syen	সেশন
tcup	স্যাঁতসেঁতে
hyek	পান্থ
trim	টিন
plak	অভিযোগ
hyok	কোণ
hgam	গাভী
hmok	কল
jrac	মানচিত্র
kloc	মণ্ডল
gyit	ভেবেচিন্তে
hbip	বিয়ার
mlet	মখমল
lyap	অপব্যবহার
cwen	পাল
bwan	ভাইঝি
tses	তের
jrit	ন্যায্যতাপ্রতিপাদনকরা
nlak	পাণ্ডুলিপি
sron	সৈনিক
cruc	শুক্রবার
broc	ব্রাশ
dlot	ডাউনলোড
krim	ক্রিম
pric	পিচ
prut	জুরি
hgon	হিমায়িত
sram	আক্ষরিকঅর্থে
pfot	পাত্র
hlot	পরিকল্পিত
djin	মুদ্রা
hlok	লাফ
hpep	আপেল
hwot	পাকান
dlak	আলোচনাকরা
brik	সাবস্ক্রাইব
nlis	নকলকরা
hbet	বাজি
pris	দুষ্ট
hjik	আতিথেয়তা
blit	শিশুবৎ
hjap	পোশাক
tfik	প্রতিফলিতকরা
hdaf	সাধা
hpop	অপেরা
kcaf	লুকানো
kcoc	কনুই
hrum	মেরামত
cyim	সন্দেহজনক
dyic	শিক্ষাবিষয়ক
hgoc	খন্দ
drak	ব্যাধি
plas	সাধুবাদ
byin	বাইনারি
hzap	মঠ
nlot	আনুগত্য
mrik	যান্ত্রিক
hsop	সফলভাবে
crap	ফাঁদ
kyek	পিষ্টক
nrut	পোষণকরা
syes	জনাব
hjet	সতের
hjen	নারীসংক্রান্ত
hmom	মধু
hdec	দুর্ভাগ্যবশত
lwen	কিংবদন্তী
slot	চুলা
frac	বিদ্রোহী
gwan	চিতান
mruk	উন্নতকরা
swot	জলা
zlan	আয়করা
hnem	প্রাণবন্ত
hdes	ড্রেসিং
prak	গাহা
frin	সিনারি
hfet	বিরোধিতা
cros	ধুয়া
ryon	মূলদ
tcos	ফসল
tsen	প্রক্রিয়াজাতকরণ
hwek	নেকড়ে
nlik	অস্বীকার
klap	কার্পেট
dras	অবজ্ঞাকরা
prop	উর্বর
slim	বাঁশি
hgis	পনির
krut	দান্তদিয়াফুটাকরা
srot	সহচর
bjan	চরা
nwen	নৌবাহিনী
myas	মাস্ক
kwaf	উন্নতি
twis	ট্যাক্সি
pcip	পেন্সিল
srap	শাকসবজি
sren	প্রদর্শক
tlun	ট্রাউজার্স
hrup	দুর্নীতি
nrip	মন্ত্রিসভা
srup	সুপ
jran	সার্জন
bjat	ভাতা
gyat	গুপ্তচর
hlem	উদ্দাম
srak	বিমূর্ত
kson	স্বরাঘাত
cwis	বৃহস্পতিবার
sret	অকপটভাবে
hraf	ট্রাফিক
hres	স্থাপত্য
hsuf	নিষ্পত্তি
rwak	ফাটল
twon	অলঙ্কার
hfus	উদ্ধার
hkom	কোড
djat	শিকারী
nlut	নিউজলেটার
hsef	সাপ
mris	গণতন্ত্র
bric	ব্যাটারি
mlam	মোম
zran	শেয়ারিং
cron	শিহরণ
hzen	সাঁতারকাটা
traf	ফালা
cwaf	খাম
srip	সিগারেট
mrot	মোটর
swon	স্বেচ্ছাসেবক
ryak	প্রতিক্রিয়া
pfun	আংশিকভাবে
blac	পোঁটলা
mret	মন্ত্রক
hjon	যৌন
kcok	কুঠার
dram	হীরা
kren	একান্তর
tcek	প্রতিধ্বনি
hdif	পরিচয়
tfas	রাষ্ট্রদূত
hfot	গঠিত
lwas	অলস
hmep	momentaneদৃষ্টিভঙ্গি
kfin	এনকোডিং
mwin	কল্পিত
hrem	রশ্মি
pram	আরোহণ
byac	ভুগর্ভস্থভাণ্ডার
mren	স্মরণীয়
swen	ব্যবস্থাপকসভা
kras	শবাধার
hgun	গেলা
nlok	আনুকূল্যকরা
ryic	কৃষিজাত
gwin	দোল
srut	তৃণক্ষেত্র
hkes	জটিল
hfis	পদত্যাগ
frak	পুনঃপুনঃ
hnom	চক্রান্ত
hcop	মদেরদোকান
hlec	মরিচ
mlot	সুর
zrat	প্রার্থী
proc	পৃষ্ঠপোষক
flik	শিয়াল
cyet	দুঃখপ্রকাশ
hgim	চিমনি
slet	প্রতিবন্ধক
tcok	সঠিকতা
bjit	সাবেকমৃত
brot	কুঁড়ি
bwat	কম্বল
hdus	শূকর
gwat	আইভরি
kret	নির্যাস
nwet	পর্যবেক্ষক
jwan	পথ
nwis	নখ
mwic	মৌমাছি
bzat	অভিনেতা
gyan	ঘাম
zyit	কার্যনির্বাহী
blic	বিভ্রম
pcet	অনিশ্চয়তা
tsot	ভাঁজ
bwit	সীমানা
tres	জোর
hkof	খরচ
nyen	গাঁ
hles	অনুরূপ
cyek	ছালা
hjis	সুই
gjan	প্রপঁচ
prec	আচরণকরা
drot	নিয়ন্ত্রিত
kcek	বাঁক
twic	মুরগিরমাংস
brak	পিপা
zwat	অভ্যাসগত
clap	অভ্যাসগতদৃষ্টিভঙ্গি
tsec	বিশেষজ্ঞ
bwin	ছাপ
cwet	বেষ্টিত
hbek	রূটিত্তয়ালা
zlin	জলপাই
mron	অগ্রদূত
drin	চাই
psap	প্রভাবাধীনকরা
gjin	জন্মদিন
clut	হাতুড়ি
cwun	সুগন্ধি
twaf	নগণ্য
pcot	পোষা
krok	খুলি
dlik	আইন-সভা
cwic	ভাগ্যক্রমে
srun	ভ্রূকুটি
crec	অন্তক
jlan	মার্জিন
kcip	রক্ষক
blin	বিলিয়ন
ryik	রাসায়নিক
mlas	নাড়ি
flit	চালক
hzet	গিঁট
cwik	সৌম্য
twet	স্কার্ট
mwik	সাপ্তাহিক
tfis	প্রযুক্তিগত
tlon	বাহন
cram	চাটুকার
grac	শক্তিশালী
kraf	কাক
trup	গুণ
hduk	হুক
cruk	বাঘ
nrap	বাড়িরসরকার
crot	হাইওয়ে
mlip	সৈন্যবাহিনী
hfoc	আলোকচিত্র
nres	অখণ্ডতা
plos	যোগ
tfam	স্বচ্ছ
nlic	উনিশ
hwok	যোগ্যতাসম্পন্ন
nlen	প্রবন্ধ
fyic	দক্ষতা
hwuk	অনন্য
hgok	জৈব
flic	ব্রহ্মবিদ্যা
flot	ভাসা
hboc	বাধ্যকরা
hwoc	জাদুকরী
syot	চিত্রশালা
cwip	শ্যাম্পেন
hbes	নিশান
lwic	বিবাহবিচ্ছেদ
blot	বল্টু
cwot	বন্দিদশা
cwam	শিরা
prik	নিষ্ক্রিয়
hfum	ফেনা
grik	নুড়ি
zrin	পরিচ্চদ-রক্ষকবহিরাবরণ
gren	গ্রহ
hfuc	পুনরুত্থান
claf	বালুচর
flas	ফ্যান
hjot	গ্রীষ্মপ্রধান
hbim	অবাধ
krek	পারদ
hbec	হিতৈষী
tsaf	আত্মহত্যা
pwas	ছোঁ
plot	সংবাদদাতা
kfak	ব্যয়করা
blak	অলিন্দ
hdos	দাগ
kwis	সর্বোত্তম
kcos	অভিযুক্তকরা
psen	পেনশন
kres	ক্রিয়া
hzon	বানর
srim	স্বাক্ষর
glin	অনিচ্ছা
mlut	কুখ্যাত
myot	আমদানি
fwac	প্রতিষ্ঠাতা
troc	মশাল
hgaf	ব্যাকরণ
hyop	ইয়ট
ksip	লুপ্ত
sres	প্রমোদভ্রমণ
hnup	গম্বুজ
hzun	একগুঁয়ে
mric	পেশী
gjat	বিশালতা
hros	ঘষা
zrac	অবীর
tros	টোস্ট
myus	মাউস
dwac	সংলাপ
byak	ছাগল
htef	দরজী
hfek	ঝঙ্কার
dzan	চাপান
nyon	নামবিহীন
zrit	আনুষ্ঠানিকনিবন্ধন
pcos	ক্রীড়া
hjec	দ্রবীভূতকরা
dlas	মুছেফেলা
mras	ছাতা
mram	খনিজ
cwut	সাময়িকযুদ্ধবিরতি
hbok	হাঁস
swun	সাবান
dwak	পুতুল
plif	উদ্যানবাটি
slon	সেলাই
tfut	সংবর্ধিত
djac	মিলনসাধনকরা
hjas	দমনকরা
kric	খরগোশ
kwot	কন্ডাকটর
gzan	জামিন
clot	খেলোয়াড়
ksek	পোকা
psam	অঙ্গবিন্যাস
mwut	পেঁচা
htem	স্থায়িভাবে
clon	বেহালা
dzin	বাসিন্দা
rwim	যথাক্রমে
hyof	উপকারী
dron	ঘুড়িবিশেষ
dwit	শ্রাবণপ্রামাণিক
sroc	এক্সপোর্ট
hzot	পরিসমাপ্তি
djik	গড়িমসিকরা
kfik	ঢাকনা
ryun	প্রবিধান
hmes	মেয়র
rwac	হার্ডওয়্যার
sruk	সার্কাস
sros	নাবালকত্ব
bzan	দাঙ্গা
kset	অর্কেস্ট্রা
bjon	বেকন
hjut	সীমাহীন
tfen	রক্ষার
zwac	অসুবিধা
dyin	ধীরতা
myis	সুরকার
mlis	মানসিকভাবে
pret	অপর্যাপ্ত
tsek	স্থপতি
hlom	লেবু
ksos	কাশি
crok	মাথাব্যাথা
flin	উর্বরতা
mrun	সূত্রধর
swec	এলোমেলো
syuk	চামচ
blun	বেলুন
tcep	খড়ি
fric	জলখাবার
rwik	উল্লম্ব
rwen	নিরোধক
flet	আনুমানিকপ্রামাণিক
pfac	প্রকাশক
srek	ভিনেগার
tfun	সুড়ঙ্গ
pwet	ধাঁধা
gyik	অংক
fwot	বিলীনকরা
lwin	সুষম
jwin	যকৃত
bwik	sublativeকেস
hdup	চোবান
hnop	একাধিকার
bwic	ডুবোজাহাজ
ryen	নির্বিশেষে
hcem	ভূমিকম্প
hbos	পরীক্ষাগার
nrek	কর্মী
ryim	তাল
nyic	ব্যাখ্যাকরা
dwas	দূতাবাস
rwok	ঘটান
kram	অক্ষমতা
ksim	ঘোষণামূলকমেজাজ
clok	চকলেট
pcec	সুবিধাভোগী
nyis	নির্জনবাসী
tyoc	সমাপতন
grak	আঁচড়েরদাগ
zlat	দস্তানা
hjuk	হাঁটুগাড়িয়াবসা
trif	ভূগোল
djit	নিয়মানুগ
pson	অপরাজেয়
mwis	বিনিয়োগ
cwec	মৌখিক
hdek	ধর্মনিরপেক্ষ
blik	বাজপাখি
sloc	মনোবিজ্ঞান
brap	স্ক্র্যাপ
jlat	জলদসু্য
dros	ডোজ
slam	স্যালমনমাছ
pwun	পুডিং
gwik	চৌম্বক
pcop	পাম্প
myen	একভাবে
ksen	অক্সিজেন
mrap	মোড়ল
tfot	শংসাপত্র
ksus	গুচ্ছ
trok	অলঙ্কারশাস্ত্র
tloc	মইয়েরধাপ
zyan	বৈঠা
nlun	লগইন
hlop	দূরবীন
jlin	বানান
lyut	মেঘলা
hsof	সার্ফ
fyik	হুইস্কি
klet	অপেক্ষাকৃতভাবে
hwof	ক্রিকেটখেলারব্যাট
hlum	উট
myet	অপেশাদার
klis	বিচ্ছিন্নতা
hbaf	জীবনী
gwac	গাধা
hwum	গুজব
pwik	পরিপ্রেক্ষিত
pron	স্বপক্ষে
myes	মাসিক
mwen	দিবাস্বপ্ন
kfic	অবকাশ
klek	ক্লিক
cwon	উপবৃত্তাকার
lyak	স্থিতিস্থাপক
kwon	অভিধান
hjam	হ্যাম
rwon	রামধনু
crip	এতদ্বারা
zwan	ঘটমান
srok	সম্পাদকীয়
craf	শারীরিক
tlok	ট্যাংক
brip	প্রজাপতি
tfap	তালিকা
jwat	যমজ
pros	অপারেটিং
psun	লক্ষণ
clet	হীনাবস্থা
hbus	বাঁশ
dyas	ব্যাপারী
klun	আহরণ
jlit	সর্বসম্মত
hdom	দুঃস্বপ্ন
kron	কারবন
hzam	জ্যাম
cyot	শ্রোতা
hmem	জাদুঘর
lwam	বর্ণমালা
fras	ছিটান
psoc	মুষ্ট্যাঘাত
hgum	আঠা
brek	ব্রেক
glit	স্থায়িত্ব
frun	হাজা
gris	আক্রমনাত্মক
mroc	ঘর্ষণ
bzit	মাকড়সা
plut	আলু
glac	ক্ষুধা
gzac	জমান
prun	ঘূর্ণন
jlet	পাঁজি
nyim	মনোনয়ন
tlos	দশসহস্রেরত্রিঘাত
slut	সালাদ
fwit	হাঁ-সূচকমেজাজ
pyen	অ্যাপ্লিকেশন
nlon	নামমাত্র
dren	প্রদর্শন
drun	অসন্তোষ
cyok	ঝিঁকাদেত্তয়া
hfop	ফুটবল
ryac	অংশীদারিত্ব
gzin	অগ্রগামী
hgip	বাঁধাকপি
tyet	ক্রীড়াবিষয়ক
hdof	idiophone
hwup	অমুল্য
lwek	লিভার
syec	সেনেট্সভারসভ্য
jyak	মিটমাটকরা
mlim	পিপীলিকা
fwic	কার্যকরীভাবে
gzit	গর্ভবতী
blas	নির্ভরতা
jrin	প্রতিদিন
gwak	গোড়ালি
drik	বেশভাল
prif	পরিবর্তনশীল
jwit	বৈচিত্র্য
krip	বৈষম্য
ryot	সশ্রদ্ধভয়প্রদর্শন
nwut	ফুটপাথ
kcif	সক্রিয়ভাবে
jrak	বেঙ
twek	অত্যধিককেস
psot	প্রায়শ্চিত্ত
pfon	পাঁড়মাতাল
sluk	কাঠবিড়াল
nlim	irrealisমেজাজ
ksaf	ঘাটতি
glak	আগ্নেয়গিরি
plen	সুস্থিতি
kfaf	স্কার্ফ
kyon	কাজেলাগান
jlik	ভূতাত্ত্বিক
psop	পাসপোর্ট
kfis	কর্মখালি
fyon	সম্বন্ধ
nram	ব্যভিচারী
hbuk	বিসকুট
gras	সমাধি
hyos	অভিশঁকী
flim	চলচ্চিত্র
plet	ট্যাবলেট
rwam	পরমাণু
blis	ভ্যানিলা
zlit	উপকরণ
fyut	খুঁতখুঁতে
crim	পিরামিড
hjif	বেআইনী
crif	ব্রীড়া
lwap	বাঁশির
tyon	জ্যোতির্বিদ্যা
mrim	কিংকত্র্তব্যবিমূঢ়
drut	বর্ণনামূলক
nrim	বৃত্তি
kruc	কচ্ছপ
kwam	উপদেষ্টা
jrik	ক্রিকেট
dlut	বোঝান
pyot	পায়রা
dyon	অভিযোজন
prap	অপারেটর
bzin	ব্যাজ
tyek	ত্রিভুজ
trec	কোষাধ্যক্ষ
nron	উদ্জান
pyet	মুদ্রাকর
tsok	শ্বাসরোধ
zyin	দীর্ঘকালস্থায়ী
slek	সাইকেল
jyin	প্রকৌশল
ryas	সংক্রমণ
zrak	সতেজকরা
nyas	নর্তকী
gric	অভিপ্রয়াণ
zlak	লঙ্ঘনকরা
tces	টেনিস
hjun	ঝড়ো
twen	বুনা
kyet	সংগ্রাহক
gwit	কণ্টক
kyot	জ্যা
fwin	ফ্রিকোয়েন্সি
tfuc	তাঁত
dlet	ডিরেক্টরি
pfik	ভাবুক
bjet	বাজেট
trek	কৌশল
kros	স্ফটিক
gjit	কাঁচি
gwic	সুইচ
frik	তত্ত্বীয়
tluc	গামছা
pruc	চৌকি
glic	হিমবাহ
krun	সম্পূর্ণতা
bjin	ভবিষ্যদ্বাণী
tlaf	অংশগ্রহণ
tfet	উত্পাদক
bras	পার্শ্বিক
dwik	প্রতিবাদী
clec	এক্সস্ট
cres	দাবা
tcef	চেরি
tcom	পদস্খলন
nyot	অনুবাদক
tyok	ট্রাক
cyip	সবাইকেঅতিক্রমকারী
grot	সরিষা
bris	বেতার
nlam	নিলাম
slif	চালনী
hgos	জং
swoc	অস্থির
jyat	দেউলিয়া
slum	ইসলাম
hjes	আদমশুমারি
dzat	পদাঙ্গুলিরডগায়ভরদিয়াচলা
slun	ঝুলান
nwot	ধারাবাহিকতা
gyic	গিটার
pfas	পক্ষপাত
zyik	দস্তা
blen	চকচকে
hyem	বেদারুজাতীয়বৃক্ষবিশেষ
hnep	হামাগুড়িদিয়াআরোহণ
nyut	বোনা
ryam	সর্বনামমার্কার
clim	মসলা
jret	তীব্রতা
tfon	আঁচড়ান
jwac	জাভা
hrep	প্রণালী
dyac	ভোটাধিকার
myip	মিটার
rwis	জাতিগত
hkem	ধূমকেতু
nwon	নবপ্রবর্তিতবস্তু
zwin	নিষেধাজ্ঞা
dyis	মধ্যযুগীয়
mrec	চড়ুই
fyot	পাদটীকা
mlon	মাপা
pfis	অনুসমর্থন
rwot	অক্ষিকোটর
hfok	মিতব্যয়ী
glof	গলফ
zron	শূন্য
hzip	ফ্যাস্শব্দ
hwom	গৃহহীন
bjic	চর্বণ
pcim	মেটান
hjip	চিপ
bwac	হাইতোলা
mlos	আঁচিল
mrip	মৃত্শিল্প
bron	ভ্রূণ
ksoc	সিদ্ধান্তগ্রহণ
cyum	খামির
jyan	অপভাষা
plim	বরই
mwet	কারবালা
ryet	স্নাতক
glik	সেচ
plap	পুঁজিবাদী
tsif	স্থিতিস্থাপকতা
gyak	হাঙ্গর
djon	ডিফল্ট
nwun	সময়নিষ্ঠ
cles	বাস্তববাদ
dris	ক্রমবর্ধমানভাবে
hkef	ক্যাফে
blus	অ্যাম্বুলেন্স
blap	মানিব্যাগ
bjak	ভাবাবেশকর
klim	মুখবিকৃতি
gyac	বিজ্ঞানী
jyit	মনেরস্থিরতা
dzit	বাস্তবানুগ
bwak	বহিরঙ্গন
dyot	রেডিও
bwon	শিম
fris	লৌকিকতাবর্জিত
klut	ফটকাখেলা
tfek	মাংসেরফালি
nrok	নাইট্রোজেন
zyat	ক্ষুর
bram	বিড়বিড়করা
ryis	পরিচায়ক
nlip	বিশ্লেষণকরা
nros	বিসদৃশ
hcof	সাধারণপোশাক
tfif	উদ্দীপক
kroc	খাঁজকাটা
hdum	ইহুদীধর্মমত
pses	প্রাপক
plok	পূরক
lyet	লেন্স
pwek	pegativeকেস
kfas	ক্যান্সার
pwen	গুটি
nrun	অনুস্মারক
clek	ফুটো
pcif	নজির
glas	জটিলতা
zwit	বাচাল
kces	সক্ষমতা
crem	খুচরা
grap	দখল
kwip	হস্তক্ষেপকরা
dyut	ডিসকাউন্ট
crus	যাজকতন্ত্র
gyet	মেয়েমানুষ
gram	খেঁককরা
kyip	টিকটিকি
nyet	প্যাড
crop	জলপ্রপাত
glon	পয়সেরপাঁচসের
mrok	মশা
fluc	অনর্গল
dwic	চ্যুতি
slec	অনুসন্ধানকারী
srec	মেয়াদউত্তীর্ণ
blut	মল্লযুদ্ধ
myok	বিচিত্র
tlek	প্লাগ
nruk	সংক্রামক
nwoc	অত:পর
bjut	বেঁটে
hges	গর্ভাবস্থা
twoc	মুদিখানা
kyos	সাম্যবাদী
mrek	স্তম্ভিতকরা
clip	অনুতাপ
pwok	prosecutiveকেস
dwot	একনায়ক
zyac	তন্ময়তা
jlic	উপগ্রহ
slop	উপানৎ
ryip	সমানুপাতিক
psim	আনুমানিক
byet	বেকার
cyop	শখ
rwun	নির্ণায়ক
blop	কন্দ
syok	পৃষ্ঠপোষক
klos	ক্লরিন
lwot	ক্লরিনেরযৌগিক
byic	ব্যাকটেরিয়া
lyik	আঠাল
blok	জীববিজ্ঞানসংক্রান্ত
jlac	ছলকরা
bret	সংবাদেরএকক
krif	লুকাইয়ারাখাবস্তু
blet	ব্যালে
nruc	প্রস্রাব
tsus	রসুন
dyak	মধ্যমশ্রেণী
tcem	চিমটা
cyoc	চ্যালেঞ্জিং
trep	স্ট্রবেরি
dlun	দূষণ
hlup	অ্যালবাম
hbep	আমেরিকাযুক্তরাষ্ট্রেরজাতীয়খেলা
praf	গ্রস্থস্বত্বাপহরণ
pwis	পার্টিসিপেল
grek	গ্যারেজ
kruk	খঁজেরযষ্টি
hfof	ভোরেরতারা
rwut	কাঠামোগত
myam	মাধ্যমিকবিদ্যালয়
krec	কপিকল
jras	ঠিকাদার
zrik	অবহিত
blam	নৃত্যশালা
klip	শিল্পী
hwef	অবৈতনিক
zlac	কলা
gret	উত্পাদক
lwuk	পাঁজর
nyek	নিকেলকরা
blos	বাস
sles	সমালোচক
tlif	টালি
kses	সসেজ
mwot	টমেটো
lyot	স্বয়ংক্রিয়
tsom	পটাসিয়াম
brut	ভার্চুয়াল
djap	বীজগণিত
hjok	জাতিবাচক
kfen	ধারণা
pcok	অপটিক্যাল
bzut	নাড়া
syek	বেকারি
mruc	শুঁয়াপোকা
bwas	ব্রাউজার
klif	ক্যালসিয়াম
rwet	দূরবর্তীঅতীতক্রিয়ারকাল
srif	ঐতিহাসিকক্রিয়ারকাল
hwem	বর্ণালী
syom	সোডিয়াম
tyos	অছি
jyic	জিম্মি
hguk	লাউ
dwun	বলি
swip	গজাল
tlec	টিক্টিক্শব্দ
blaf	ধর্ষণ
tsem	নিরীশ্বরবাদ
mloc	মনিটর
gyot	শর্তাধীন
trop	প্রোবের
rwap	ত্রৈমাসিক
hjep	লিঙ্গ
pyim	প্লাটিনাম
dlon	দ্বৈতসংখ্যা
pcep	ফুসফুস
twuk	মাজন
tyec	ট্যাগ
syup	সুপার
trom	ট্রলিবাস
nyip	স্থানীয়ভাবে
glis	পেট্রল
gjik	বৃক্ক
hjos	সঙ্গিহীন
hjuc	লুণ্ঠন
swek	বহুলশ্রমসাধ্য
psek	সেঁকোবিষ
twok	পরিসংখ্যানসংক্রান্ত
tsep	ফড়িং
slos	সমাজতান্ত্রিক
nwim	সংজ্ঞাবহপ্রামাণিকমেজাজ
tlop	টেবিলেরআচ্ছাদনবস্ত্র
trus	বিতর্কমূলক
pwot	শিকল
djot	পলি
nloc	তিরস্কার
mwon	ম্যান্ডারিন
hjek	জকি
crom	সহযোগিতাকরা
myon	নিউমোনিআ
twec	সংস্থাপনকরা
ryek	রকেট
dlic	ভাজ্য
kwet	স্কেইট
bwen	আবেশ
plon	বরাদ্দ
syon	হাঁফান
djis	ডিজিটাল
byut	দুশ্চরিত্রা
hyep	নেত্রপল্লব
dwon	কর্ণ
byis	অবচেতন
brec	ভুরু
cyec	হাঁচি
hwop	ত্তঅট্
clus	অত্যধিকহাসিখুশি
kfun	দখল
nwum	হিন্দুধর্ম
fyim	উদ্বাস্তু
cwos	তুরি
tfoc	টনটন্
pwon	প্রোটিন
sraf	স্বসন্তুষ্ট
hbom	বমি
gyen	জিন
drim	নবীন
trem	accoutrements
tsup	ধ্বংসকরা
slok	সমাজবিজ্ঞান
kwoc	স্কোয়াশ
bwam	ভোটার
mlok	গতিশীলতা
kyen	আঞ্চলিক
hmop	গতিকষ্টসাধ্য
rwek	ভূতাপেক্ষ
kfup	ঘনক্ষেত্র
grok	গাজর
drap	দায়গ্রস্তকরা
lwis	আণবিক
ksuc	হিসাবরক্ষক
tsop	দুর্গন্ধ
kyok	শসা
nroc	বেলেল্লাপনা
jlot	দ্রাবক
psof	ফসফেট
hgif	মুগ্ধকরা
kfim	ক্ষারীয়
psos	পালোয়ানি
pfen	প্রতিপাদন
kcom	অর্থনীতিবিদ
krom	কমা
tluk	ছলনাকরা
hyom	আইত্তডীন
nwuc	গতিউতরাই
gjac	গর্ভস্রাব
pcom	শুঁটি
dzic	ডিজাইনার
grun	আস্ফালন
dzot	দাতা
hzek	ম্যাঙ্গানীজ্
kfot	কীবোর্ড
jlas	অবিশ্বস্ত
lyim	অভিজাত
jyen	ইয়েন
pcaf	প্রথমবন্ধনী
rwip	রাগবিখেলা
blip	বাইবেল
kyoc	করণ
lyon	ঘাত
flis	রুপান্তরিত
nrif	খুঁটা
kfam	পরিমাণ
swes	সোয়েটার
lwon	অভিব্যক্তিমূলক
drec	ব্যবচ্ছেদ
gjap	স্পা
lyec	রৈখিক
tyom	রসাঁজন
pwuk	superessiveকেস
flaf	আরম্ভ
myim	অনাক্রম্য
pcek	পাচার
bjac	ভাঁটিখানা
bzac	সংক্ষেপকরা
bzak	মোজা
twes	টিভি
dwut	তথ্যচিত্র
ksom	নিসর্গ
lyis	বনপালনবিদ্যা
lwim	অ্যালুমিনিয়াম
ksok	জাতক
sruc	সুবিধাযুক্ত
dlif	শুশুক
byik	হত্যাকারী
tfec	স্টেশনারি
hjaf	স্তনপায়ীপ্রাণী
ryok	প্রোটোকল
dwis	ডাইঅক্সাইড
jlon	কোলন
brus	আমলাতন্ত্র
gjak	ছায়াপথ
lyip	রোগশয্যা
ryem	রেডিয়াম
href	তনু
prok	ফ্রিজ
slep	বনদেবতা
dret	পুনরাবৃত্তির
kluk	প্রত্নতাত্ত্বিক
dlis	মানসিকগঠন
kfip	অগ্রহণীয়
mlec	ম্যাসেজ
pfif	সবিস্তারবিবরণী
nrec	সংজ্ঞাবহ
pfet	প্রচারপত্র
hzoc	আচার-ব্যবহারকরা
dlam	আদর্শভাবে
nlec	নৃবিদ্যা
kluc	সুস্বাদু
dyet	সেদা
tyif	সকর্মক
krus	গুড়িমারা
nluc	সূর্যমুখী
lyun	স্থূলাণু
zrot	বহি:সমর্পন
ksif	মিথ্যাবর্ণনাকরা
psif	নিঃসরণ
crup	উপরেজড়ান
fret	আবিষ্কর্তা
grut	ত্তলটান
ksec	সহপাঠী
jric	ভ্রমণপথ
mrop	মাইক্রোওয়েভ
srus	উচ্ছেদকরা
gyas	নরসুন্দর
floc	লোকাচারবিদ্যা
plek	কৈশিক
nwop	নিতম্ব
nrom	নিয়ামক
twos	সন্ত্রাসবাদ
lwok	জিগির
dwet	অধিকাল
slem	উচ্চতরখাতেপ্রবাহিতকরান
grip	ভাজাভুজি
gwas	কিদারুন
kwok	নিকেলজাতীয়ধাতু
gwon	জই
hdop	গতিupriver
glam	মলদ্বার
bwot	জড়বুদ্ধি
bren	অন্ত্র
byot	ভিডিও
bjik	বয়কট
kwim	ব্যঙ্গ
cwek	হকিখেলা
grif	গেরিলা
hgem	ম্যাগ্নেজিঅ্যাম্
hyes	সচেতনতা
fram	ঔষধালয়
nwos	উচ্চাভিলাষশূন্য
ryap	পুনরায়সজ্জিতকরা
cwim	বিশ্বাসযোগ্যতা
klep	কেলপ
psec	পরিশোধকরা
djic	বিশ্বব্যাপী
kfut	নিষ্প্রদীপ
crep	হ্যামবার্গার
frim	উপপাদ্য
gjas	জ্বলেউঠা
hdef	বিকলন
ryum	ইউরেনিয়াম
pluk	পরিমাপকরা
krop	তুল্য
nraf	করদাতা
tyes	সংহত
plip	opined
hgom	গ্রীকবর্ণমালারতৃতীয়বর্ণ
hgus	গুণাঙ্ক
cwuc	উনান
zret	বিয়োগকরা
nles	বিশ্লেষক
trof	অকর্মক
hmof	মুদ্গর
hzim	বিস্মিতক
dzac	ভোজনকারী
psok	পোস্টকার্ড
blon	অভিসৃতি
djet	অবান্তরহত্তয়া
ksum	ভাগীদার
mrup	জীবাণু
clif	হেলিক্স
cloc	অঙ্গসংস্থানসংক্রান্ত
tfes	খাদ্যেরজোগানদার
gjis	জিন্স
jren	শ্রেণীবিন্যাস
tlep	ডাটাবেজ
kcup	কুপন
glot	ভোল্টেজ,বৈদ্যুতিকএককবিশেষ
glut	হিসাবকারী
srep	সাইবারস্পেসকে
nwes	বিনিয়োগকারী
ksef	এক্সরশ্মি
bzis	ভিসা
frut	অবকাঠামো
nyuk	জোনাকি
dyik	আবিষ্কারক
plec	সংযুক্তকরান
brom	ব্রোমিন
plop	রক্ষারউপায়
zlik	সিলিকোন
flut	ভোল্ট
ksop	প্রসাধন
gjun	সাজগোজের
kfok	হিক্কা
hpof	ভুট্টারখই
hzuk	চিড়িয়াখানা
nyoc	সংজ্ঞা
jwak	যোগশাস্ত্র
brim	মেঠোবিষ
kles	কতলকরা
mwam	হাঁ
fwik	আতশবাজি
djas	জ্যাজ
dyim	অডিও
tsum	দুষ্প্রাপ্যধাতু
drip	লালাঝরান
lyaf	খোরপোশ
prom	প্রোগ্রামার
nrup	ইনপুট
hfes	আত্মবাচক
rwaf	চন্দ্রমল্লিকা
dlen	ডকুমেন্টেশন
byas	টীকা
fron	মর্ফিনহইতেতৈয়ারিমাদকবিশেষ
dluk	বিযুক্তকরা
dyun	লক্ষণদেখিয়ানির্ণয়করা
flap	ফোল্ডার
kfet	ঋণাত্মকপ্রান্ত
dlim	ভাবাদর্শ
prek	পার্কিং
syoc	স্ন্যাপশট
slus	অভিগম্যতা
nlos	ভাবাবরোহ
mlen	সেলেনিউম্
pres	বল্কল
hlof	গন্ধক
nlek	বর্তমানপ্রাসঙ্গিকতামার্কার
gwot	বিমানবন্দর
mwip	প্রতারক
klop	তেলাপোকা
kwom	ক্রৌমিয়াম
hl6t	লিটার
nwec	তবু
glip	আবর্তনশীল
nrop	মাইনে
crum	হরমোন
dlep	ডেভেলপার
frot	বিঁধা
bwoc	অন্তর্ঘাত
fwis	নারীবাদী
djok	অনুবন্ধী
draf	আধুনিকায়নের
trum	চরমপন্থী
graf	অ্যালগরিদম
lwes	লেজার
mlem	একমিটারেরএকসহশ্রাংশ
flen	আনমন
zlot	ধনধ্রুব
swok	আশ্লেষেজড়ানো
klec	কুকুরক্লান্ত
pwim	অংশসময়
htuf	টুনা
fyis	শোধনাগার
lwet	সংবেদনশীলতা
mrem	মেইনফ্রেম
jwic	নবজীবন
droc	সক্রিয়অংশগ্রহণকারী
clem	হীলিয়াম্
dzik	দ্বিভাষিক
psem	রক্তরস
hjom	তন্তুসদৃশবস্তু
rwuc	পূরণবাচক
tyus	পূর্ণসংখ্যা
klom	কিলোমিটার
hfos	ফ্যাক্স
nwek	সুপ্রজননবিদ্যা
jrap	স্ক্রুড্রাইভার
zwas	এপেটাইজার
bwok	ব্রোকলি
dwap	এডাপটার
syem	স্প্যাম
blek	ভেক্টর
tlus	যুদ্ধকৌশল
pyif	অসূচিত
cwoc	ঠিকহ্যায়
mrep	বিদ্যুত্প্রবাহেরএকক
hbem	ভিটামিন
hxan	দারোয়ান
hxut	ভর্তুকি
hk6m	ক্যাডমিয়াম
hxin	যুগপত্তা
txin	টাইটেইনিঅ্যাম
kxin	কেজি
klum	সঙ্গমকরা
xlis	বালিঘড়ি
hqak	অন্বিত
hxat	সৃজনশীলতা
hxik	ইবই
hxas	কর্মস্থলে
bxon	ধাতবউপাদানবিশেষ
dxin	আবেশাঙ্ক
hxit	হেলিকপ্টার
tlum	মৌলিকপরমাণু
txit	নির্দিষ্টসময়সীমা
kxat	জারিত
hvik	শ্রেণীবদ্ধকরা
nluk	এনালগ
nyem	সেনটিমিটার
hm6t	মলিবডিনাম
hl6m	লিথিয়াম
ht6t	মাল্টিমিডিয়া
xlit	উত্তাপেরমাপবিশেষ
ryop	রোবট
pxas	কম্পউণ্ডার
hxak	বাড়িরকাজ
lwif	অধিকরণ
grim	লগ্যারিদম
hqat	দীর্ঘপদপতঙ্গ
qlit	বাস্তুসংস্থান
xlik	ভেজালমেশান
mlep	টেমপ্লেট
hqit	তেজস্ক্রিয়তা
kxim	কিলোগ্রাম
hxen	প্রজা
hxot	অতিভোজনকরা
kyif	কপিয়ার
fwet	বিনামূল্যের
txet	উপসেট
hs6n	অনুক্রমিতাসংবন্ধীয়
hxet	আড়িপেতেশোনা
xrat	কেশকর্তন
hqan	বাজেয়াপ্তকরা
hr6t	ইরিডিয়াম
bxat	ব্যান্ডউইথ
dxet	ডেস্কটপ
hxis	ব্যাখ্যামূলক
hxok	সদরে
hxek	অস্থানকরা
srem	সীরিয়াম
hp6t	বিয়োজক
pxik	বিয়োজককেস
kxet	ক্যাসেট
pruk	সুপারমার্কেট
hvit	ইচ্ছাশক্তি
xlin	অফলাইন
frip	এনক্রিপশন
hvep	অতিরিক্তদেত্তয়া
hxon	সময়েরসামঁজস্যবিধানকরা
kxit	চরমেতোলা
hqin	সেমিনার
tr6n	স্টেরিও
ht6n	দৃঢ়ভাবেআবদ্ধকারী
hvat	আসন্ন
sl6s	তাপমাপকযন্ত্র
hn6n	নিঅন্গ্যাসংক্রান্ত
ts6t	বাস্তবসময়
hvin	স্ট্রিমলাইন
pxat	পত্রিকারদোকান
myoc	মডিউল
ps6s	পাস্তা
bwek	ব্রিফকেস
dlok	ডিলাক্স
fraf	ফায়ারওয়াল
hr6k	হস্তনির্মিতবস্তু
txat	লাঞ্চেরসময়
hqon	ওরেগানো
pxun	প্লুটোনিয়াম
ks6n	ওয়ার্কস্টেশন
slef	চলন্তসিঁড়ি
xrit	দেহরক্ষী
hvut	ঠাসাঠাসিকরা
xrim	ইত্রিউম্
hx6t	বর্ধক
hqum	ব্যবহারকারীরনাম
hl6n	সেলসম্যান
gron	বায়ুমণ্ডলীয়গ্যাসবিশেষ
pxan	প্রচারমূলক
hvac	বাসনপরিস্কারক
xlan	বিশ্বায়ন
txon	তরঙ্গদৈর্ঘ্য
xrik	রাসায়নিকপদ্ধতিতেব্যবহারকরাজিনিসকেআবারব্যবহারেরউপযোগীকরেতোলা
hxap	ব্যাকপ্যাক
hxac	আবারশুরু
xyat	যকৃতেরপ্রদাহ
cwep	paycheck
hxos	অর্ধবৃত্তাকারপার্শ্বচিত্রেরমূর্তি
txif	টাইপফেস
qlat	স্থাবরসম্পত্তিরনিযুক্তক
txot	মধ্যভাগেশরৎ
hxam	একগ্রামেরএর্কসহস্রাংশ
pxis	পিক্সেল
pwif	প্রিভিউ
txam	ধাতবপদার্থ
myek	তাপগতীয়
hbop	বিরতিমধ্যে
hqot	দ্রবীভূতপদার্থ
xlic	হুইলচেয়ার
gxit	গণহত্যা
hvan	অগ্নিকাণ্ড-নির্বাপণ
glim	গ্যালিয়াম
pfop	পপআপ
hzum	জিরকোনিয়াম
xlon	হটলাইন
qlin	অরৈখিক
kxam	স্ক্যান্ডিয়াম
blim	বেরিলিয়াম
kxik	কনফিগার
nr6n	নিউরন
hpef	বিধেয়স্বরূপ
hruf	রাউটার
kxan	গৌণিক
hxic	গাইডলাইন
xlip	ভলিবলখেলা
dyek	ডেবাগ্করা
hxop	ঘড়ি
qrot	প্রশমিতকণা
nwip	নাইত্তবিয়ামপদার্থ
hs6t	পায়খানা
grem	জার্মেনিয়াম
tles	ধাতুকল্প
hp6k	prolativeকেস
qyin	জীববৈচিত্র্য
txak	জীবাণু-প্রতিরোধী
mlun	immobilization
txan	actinium
xran	নভশ্চর
dres	ডেকোম্প্রেস্করা
tr6t	একটিextraterrestrial
hk6t	অষ্টপাদীকবিতা
hxus	খোলাউৎস
xlat	ছিটগ্রস্তব্যক্তি
mraf	সহ্যশক্তিরপরীক্ষা
ts6n	মিডবসন্ত
ht6s	অটিজম
nlif	স্থূলাণুতেপরিণতকরা
txut	প্রখ্যাতব্যক্তি
hm6n	emitting
kxis	ক্লিপশিল্প
xrin	চলছে
xren	পুনঃনির্দেশ
bxak	বুকমার্ক
pfos	স্বপক্ষেফ্রেজ
hvis	মল
hd6n	হর
brum	boardroom
hqis	উত্কটস্বদেশভক্ত
hk6n	সংকলনকরা
xyit	স্থানপরিবর্তনচাবি
xyin	একদ্বিতীয়
hxun	subsisting
hvas	ভূমিকা
glok	ব্লগ
hvak	আঁকাবাঁকা
pxit	আইপিঠিকানা
hvet	পরবর্তীথেকে
xram	কুসুম
hc6n	সুস্পষ্টতা
qran	কোরান
zyen	জেনোন্
hqas	শপথমধ্যে
bzas	আরআমোদ-প্রমোদচাহেনাএমন
hj6n	অমানবীয়
hnof	noncommittal
txas	নির্মাতা
hbum	বৌদ্ধধর্ম
ts6s	দ্বন্দ্বী
pxin	উপাদানগুলো
hr6n	বরাদ্দঅংশ
hxim	মধ্যগ্রীষ্মে
dxit	মাঝামাঝিশীতকাল
hxaf	খননকরা
nlus	ঘরউদ্ভিদ
txap	অবস্থাবার
vrit	ঘোস্টরাইটার
kxak	মূর্খকাছাকাছি
bxin	মানবীয়শরীর
hqik	রেইনকোট
hxes	হের্ত্স্
hxif	সম্মোহিতকরা
xras	ঘনঘন
pl6k	প্যারালিগাল
dxat	হঠকারিতা
hxip	অ্যান্টিবডি
vrat	হাফপ্যান্ট
hqek	আকৃতিগত
qrit	প্রান্তিকতা
pxot	পোস্টদপ্তর
hxom	আবর্জনামেইল
hqic	সমালোচক
lwun	নীলজিন
hp6n	পূর্ণতা
dxan	সংযোজনের
xrak	অভিনেতাভূমিকা
dxak	দুর্ঘটনা
hven	পাত্রে
mwap	কমিকফালা
qlan	রঙঅন্ধ
xros	অপেশাদার
srom	শোরুম
hc6t	চ্যাটিং
qrat	গোলমালেনিচে
hn6t	নিষেধ
hqet	ওয়েবসাইট
fres	fundraise
froc	কামারশালা
xlak	হাইপারলিঙ্ক
vlat	শব্দব্যবহার
dvan	disembarking
gxin	অতিক্রমকারী
ryes	অভ্যর্থনারনিমিত্তকর্মচারী
kxot	সংযোগকারীগুলিকে
xyan	বর্ণা
vlan	বিজ্ঞাপনদাতা
ryom	তেজস্ক্রিয়ধাতুপরমাণু
hluf	পুরাতনবয়স
hquk	উদ্বুদ্ধকরা
lyum	থিউলিয়াম্পরমাণু
tyem	টার্বিয়ামপরমাণু
hp6m	প্রাসিওডিমিয়াম
txic	বাড়িপৃষ্ঠা
mros	মোটরযাত্রী
dyam	Rhodiumপরমাণু
pc6n	পরীক্ষাসংখ্যা
nyos	ইনবক্স
pyek	প্রজেক্টর
kxon	ক্রিপটন
hxuc	উদ্ধরণ
qrik	কেন্দ্রীকেস
xwin	অনভিজ্ঞতা
kxic	নির্বাপক
hvot	ফ্লোচার্ট
dxot	দই
hqut	লগইনকরুনবাইরে
pxen	বিভাগী
drok	লক্ষ্যট্রিগার
flon	মোবাইলফোন
txos	মধ্যমকণ্ঠস্বর
hqok	তেরছাকেস
xwik	রোগীকেস
hx6n	প্রাকবর্তমানসময়সংক্রান্ত
txik	সূচকআঙ্গুল
hqen	প্রেরক
mlap	ম্যালওয়্যার
hvun	যুক্তিপরামর্শদিয়াকার্যাদিতেপ্রবৃত্তকরান
hvon	পরাবাইরে
vran	মেইলবাহক
pfes	অধ্যাপক
pwip	কবি
hqam	কাজবাইরে
gxat	বৈধতা
ks6t	ণিজন্ত
vrin	আড়কাটি
kxip	ক্লিপতক্তা
sr6n	অনভিলাষী
vlit	evaluative
tyup	শহরতলী
mrom	রূপমূল
xron	মাথায়বাঁধিয়াব্যবহার্যবেতারযন্ত্র
gxak	ব্যয়বহুল
hrof	সাহসীযোদ্ধাঘোড়া
xlas	পক্ষাঘাতগ্রস্ত
dzet	redecorate
txac	আত্মসমর্পণ
xrot	অব্যবহৃত
txis	ডটজরায়ু
syif	Siইউনিট
xrac	আশ্চর্যজনক
brif	বাইনারিমূল্য
dlos	প্রকারীয়কেস
txun	বৈশিষ্ট্যাবলী
dvat	খারাপবদমেজাজি
psom	প্রথমহাত
gjek	আরযদি
nlem	এককএরভর
qret	খুচরাদোকান
txip	ত্রৈধবিন্দু
dlek	স্বতন্ত্রভাবে
lwut	প্রবাহবর্তমান
dxis	নাটকীয়ভাবে
hs6m	সিজিয়াম
vlak	railcar
hn6m	nerium
kxap	পিচবোর্ড
bxan	বিদায়ী
myem	মেমাস
gxik	বেসামরিকঅধিকার
hxoc	বাতাসবল
xrok	সহকারী
kr6t	স্ক্রীনশট
txok	স্বয়ংক্রিয়ভাবে
hxep	স্কেটবোর্ডের
srop	স্মার্টফোন
pxak	ক্যাপতালা
hk6k	লোকসঙ্গীত
hl6k	অয়লারেরসংখ্যা
pyom	পোলোনিয়ামপরমাণু
xyam	থ্যালিঅ্যাম্পরমাণু
hvic	হানাদার
lyok	অধিকরণকেস
xlot	ফ্ল্যাটের
txen	restatement
kxac	পালটাআক্রমণ
qrak	strikebreaker
hbup	সাঁতারপুকুর
txuk	সংক্ষিপ্তবর্তনী
tsef	tapered
bxit	ওয়েবনিমন্ত্রণকর্তা
ksem	পড়াকেবল
byim	রূবিডিয়মপদার্থপরমাণু
hvam	ভানাদিত্তমপরমাণু
lw6n	lanthanum
frum	ফ্লোরিনপরমাণু
nyom	নিওডিমিয়াম
mlom	multalসংখ্যা
kxas	ব্যক্তিগতকৃত
xret	টেরাবাইট
hs6k	অনুসন্ধানইঞ্জিন
frus	corroding
gxan	ছায়াপথলিঙ্গ
vlas	vocalizations
glet	গ্যাসপ্যাডেল
hvim	রানটাইম
bxip	বিটম্যাপ
qrin	তারকালিঙ্গ
bvak	abessiveকেস
pxon	অপ্রাপ্য
dvik	adessiveকেস
dvek	agentiveকেস
hlef	প্রতিনিধিট্রিগার
kwek	থেকেকেস
kxen	সাধারণলিঙ্গ
ht6m	তলবফর্ম
tsuf	ট্রান্সসংখ্যাগত
hf6n	fining
tc6t	সরাসরিউদ্দেশ্য
gvik	ergativeকেস
gxon	টুকরাটুকরাকরা
ksep	রিসেপটর
vyin	চলচ্চিত্রথিয়েটার
pyos	নিষ্ক্রিয়কণ্ঠস্বর
hnef	সসীমক্রিয়া
xwit	প্রাথমিকউদ্দেশ্য
hqim	নীতি-বাক্র্যসংক্রান্তমেজাজ
jlak	সাধারণীকরণ
vrik	চূড়ান্তকণা
qyan	কল্পিতএকক
kxaf	গতিএরআলো
xyic	ফিশিং
qyit	সংকটপূর্ণবিন্দু
hvek	evitativeকেস
bvik	subessiveকেস
hzes	আবিষ্টকেস
prus	কম্পিউটারদুষ্ট
ples	প্রসেসর
pxif	পুলিশঅফিসার
dvak	lativeকেস
brun	ভ্রমণকরণ
tsi_k	antessiveকেস
tyum	রূটীনিয়মপদার্থপরমাণু
vyak	ক্রিয়া-বিশেষণিককেস
pxim	প্রধানমন্ত্রী
syum	স্ট্রন্শায়ুম্পরমাণু
sy6n	suspiciousness
hy6n	সজীবলিঙ্গ
pxac	সহানুভূতিশীলআনন্দ
vlin	বাহনলিঙ্গ
qwin	খনিজলিঙ্গ
hr6s	রেফারেল
tf6n	টোনার
xris	ব্যবহারকারীইন্টারফেস
hw6n	কুবচন
xlen	মৌখিকবিশেষ্য
pyec	স্প্রেডশীট
vlim	ভার্চুয়ালস্মৃতি
bres	শব্দপ্রসেসর
hqip	মেঘকম্পিউটিং
vlic	ভার্চুয়ালমেশিন
pfam	স্প্যামার
dyap	দ্বিতীয়ভাষা
txek	nতমশিকড়
dxen	উপাত্তখনন
byip	ব্যবসায়ব্যক্তি
hs6c	স্ববিশ্বাস
txim	উল্লেখকরা
hb6t	পরিবর্তনএরঘটনা
hdem	ডোমেইননাম
dxon	বিভিন্নঘটনা
lwaf	ফ্ল্যাশড্রাইভ
sl6t	crastinalক্রিয়ারকাল
xyik	ফ্লপিডিস্ক
fyif	আত্মবাচককণ্ঠস্বর
bvin	বিশ্বলিঙ্গ
hm6p	মাদারবোর্ড
tfip	সকর্মকক্রিয়া
jlen	বসতিলিঙ্গ
xrap	ডোরাকাটা
tc6n	গবেষণালিঙ্গ
sl6n	শিল্পিসুলভলিঙ্গ
xrek	রোগীট্রিগার
xwan	বিমূর্তলিঙ্গ
dxif	ভিডিওকনফারেন্স
dyip	পরোক্ষবক্তৃতা
zrek	exocentricকেস
hvuk	evoking
xwat	অতীতperfective
hr6m	রীনিউমপদার্থ
txaf	আলোড়ন
hmef	নৈর্ব্যক্তিকক্রিয়া
tx6t	পাঠসম্পাদক
txes	সমষ্টিগতবিশেষ্য
bvat	খারাপব্যবহার
bvuk	absolutiveকেস
ry6t	রেইডিয়ান
vlis	ভার্চুয়ালবাস্তবতা
qren	অস্থিরমতিলিঙ্গ
gvak	ব্যাকরণগতকেস
bxok	পালকহীন
mrum	কম্পিউটারকার্যক্রম
ps6t	অপারেটিংপদ্ধতি
hfom	নির্দিষ্টকোনোভাষারযেধ্বনিগুচ্ছকেএকইধ্বনিরবিভিন্নরূপবলিয়ামনেহয়
tlem	পড়াকেবলস্মৃতি
pwam	স্পাইওয়্যার
kfif	মূলbenefactive
qwit	যৌক্তিকতা
nlaf	ইনস্টল
nwok	মিশুককেস
dzas	অখুশিকরা
swuk	মহীয়ানকেস
syos	সংক্ষেপিত
kr6n	বৈদ্যুতিকবর্তমান
dvin	জড়লিঙ্গ
pxom	propositiveমেজাজ
vris	পারস্পরিককণ্ঠস্বর
rwos	এরোসল
dr6t	distractor
ht6k	টেলিযোগাযোগ
slaf	সামাজিকনেটওয়ার্কিং
lyuk	ধারাবাহিকদফা
qras	উর্ধ্বতন
ty6n	প্রান্তিক
gwet	শীঘ্রইভবিষ্যৎক্রিয়ারকাল
hp6s	আবেদনকণ্ঠস্বর
tsof	antipassiveকণ্ঠস্বর
ht6p	ধারাবাহিকদৃষ্টিভঙ্গি
hn6f	necessitativeমেজাজ
pfip	নিষ্ক্রিয়পার্টিসিপেল
glap	টুলবার
sy6k	অস্তিত্ববাদেরদফা
qyat	ভাস্বরআতিশয্য
hy6t	ব্যাকরণগতউদ্দেশ্য
vyan	উচ্চারর্ণনির্দেশক
sluf	singulativeসংখ্যা
dvit	অত্যধিকস্থিতিকাল
qyak	একককর্মক্রিয়া
bzik	পদার্থবিদ্যা
xlet	মহীয়ানডিগ্রী
hqap	বর্তমানপার্টিসিপেল
qwat	পরিমাণএরপদার্থ
qyik	সংযোজককণা
sr6t	supercriticalতরল
hfem	epentheticরূপমূল
tl6t	দূরবর্তীভবিষ্যৎক্রিয়ারকাল
mrif	মাইক
pcuk	postpositionalকেস
tfim	এলোমেলোপ্রবেশস্মৃতি
fwim	ethidium
ly6t	allocutionচুক্তি
hvap	স্ক্রলবার
hfep	বীপ্সাব্যঁজকদৃষ্টিভঙ্গি
bvan	বিভাজকসর্বনাম
fyun	নির্দলীয়বিন্দুসংখ্যা
xyas	মুছেদেওয়ার
hvif	ক্রিয়াবর্ধন
xyis	অতীতনিষ্ক্রিয়পার্টিসিপেল
tl6n	মধ্যপ্রক্রিয়াজাতকরণএকক
tfok	অধিকরণগতিপথসংক্রান্তকেস
qwan	ঘনঘনজিজ্ঞাসাপ্রশ্ন
