hnit	infinitiv
hnak	nominativ
hkak	akuzativ
htak	témapřípad
hpap	táta
hmam	maminka
hyat	parental
hcan	Ahoj
hwik	vokativ
hsuc	předek
htat	prarodič
hcac	hladový
hnik	genitiv
hcit	přídavnéjméno
hwan	a
hman	mě
hnan	vy
hwam	nás
htit	to
htac	destinacepřípad
htik	dativ
hyit	REALISnálada
htim	deonticnálada
hcut	podmiňovacízpůsob
hsit	epistemicnálada
hyak	instrumentálnípřípad
htan	interiérkontext
hpan	osobakontext
htin	Hlavnívěta
hyan	vedlejšívěta
hfap	perfectiveaspekt
hkat	minulýčas
hnin	mužskýrod
hmak	komitativ
hnat	přítomnýčas
hpak	benefactivepřípad
swik	Essiv
htut	zápornýquantifier
hsan	povrchkontext
hpin	adpositionalpřípad
hwin	Polohapřípad
hkan	spacekontext
hnac	způsob,jakpřípad
hyut	tázacínálada
hnam	anebo
hkit	výlučnánebo
hsuk	zdrojpřípad
hpik	ablativ
hcat	blízkost
hmat	demonstrativní
hkuk	klauzuleocas
hlan	ale
hsut	všechno
hyin	univerzálníquantifier
hcin	ženskýrod
hpac	množnéčíslo
hyik	jedna
htic	jejich
hkik	kdo
tcat	budoucíčas
hsin	sociálníkontext
hkac	kdy
hmip	imperfectiveaspekt
klan	tam
hlak	Elativ
hlik	illativ
htam	směrnicenálada
hlat	volitelnýquantifier
hkam	co
hwat	tázacíslovo
htap	spona
hpat	osoba
nyan	samec
hkas	mohl
tcan	ostatní
hnuc	číslo
twit	asertivníquantifier
hsak	dobakontext
htuk	temporálnípřípad
htun	pouze
htum	napomínajícínálada
hyip	retrospektivníaspekt
hlit	volnínálada
pcic	musí
tyut	dva
hsat	vidět
hkut	vědět
hcic	dolů
hcap	po
hpam	První
hlac	zcizitelnýdržení
hkap	nikdy
hnic	nezcizitelnédržení
tyat	starý
tcit	deliberativnínálada
tcin	den
hlam	takpojd
hwak	samohláska
hkin	jít
lwak	perlativepřípad
hpip	progresivníaspekt
lyan	dlouhý
hsac	říci
kyan	jak
htas	znovu
hsic	zde
hcik	myslet
hcak	vkontextu
hfan	nalezeno
hsun	ruka
hyac	také
nwan	mladý
tyit	proti
tlan	Bůh
twak	delativepřípad
hmin	nic
hyas	jednou
hlap	semelfactiveaspekt
kcac	vlevo
hyic	Pilka
hcas	Dům
hwac	svět
tyin	tři
hnun	neo
hcuk	soustředitse
pyan	láska
hsis	vždy
hyam	noc
hyap	král
hkic	mezi
hmas	mysl
cyit	srdce
pluc	paucalčíslo
kyik	protože
ksak	kauzálnípřípad
tcun	hotový
hnim	jméno
tsan	vlastníjméno
klac	země
hpun	zeptal
cyat	viditelnédůkazní
pcac	lepší
hmac	moment
hnas	nemůže
hwic	voda
twim	desiderativenálada
kwan	světlo
tlat	slovo
tyan	dveře
hsas	ráno
syat	aždo
twik	terminativ
hpit	bílý
pcan	peníze
hyis	chudý
mwan	smrt
hfam	formulář
nwik	inessiv
kcat	spolu
tsac	často
pyat	přítel
psan	polovina
hpim	rozkazovacízpůsob
hyuc	kolo
hfat	poslal
hcis	manželka
kcan	věřit
hsik	veřejnost
htus	státkontext
hpas	syn
clat	děti
tyak	tedy
cwan	naděje
syin	milý
hkuc	vysoký
tyac	číst
syit	město
hlic	již
hfit	factivedůkazní
tcac	dívka
hcun	slyšet
ksan	nejméně
hyaf	možná
kyat	vskutku
tcic	tělo
hwit	vrátitse
cwat	vzduch
hfaf	zákon
hput	pomoc
lyat	dopis
ksas	čtyři
hpic	optativ
hfuk	oheň
hcam	hodina
twat	válka
kyak	několik
tlit	druhý
pcin	za
hmut	ztracený
clan	tisíc
hfac	rodina
twan	duše
hwas	otázka
syan	pravda
htis	tvorba
tsat	potenciálnálada
lwik	allativ
nyin	anthropicpohlaví
hfak	pět
tcak	Stejnálátkamarkeru
htuc	jinýpředmět
hnap	odpověď
hmit	moře
hcuc	strach
pcat	pochopit
syas	podmínky
hcaf	pochybovat
twut	dubitativenálada
hkis	černý
tlak	přinést
hyus	krásný
nyit	druh
htip	deset
ksis	příběh
hpuk	rezervovat
hlin	elektronický
hkun	účet
lyas	zajímat
lyit	napsat
pwat	postel
hnis	stáří
hnut	hypotetickápodmíněný
slas	umění
hwis	VIALISpřípad
pyak	bratr
lyin	čára
tyas	tabulka
hyun	řeka
kyac	oko
tfan	Najednou
kcin	hluboký
hmuc	účel
cyac	krev
hmap	růže
tlin	Studený
hyif	vpřed
tyam	pozdě
hnaf	předpokládat
hkip	téměř
myan	moje
tsin	znalost
hkup	kopírovat
hsam	manžel
hlis	šest
cwit	živobytí
cyan	mír
myat	mějnapaměti
tyic	přírodní
hfut	podzim
swas	servis
hsap	ažna
pcit	copyright
hyim	armáda
kyas	kůň
plic	budoucnost
pcak	západ
hpis	platit
hyuk	červený
hwun	zlato
twin	touha
plan	hrát
hpus	kancelář
syun	vláda
kyic	kostel
htaf	pevnost
hlun	délka
kyin	společnost
kyis	papír
mlan	pravděpodobnost
hcim	zvláště
cyas	medvěd
twac	okno
nyat	krása
hcus	Ten
htup	povinnost
htif	vzdálenost
pyas	noha
hlas	divoký
ksin	zelená
hmaf	problémy
myac	úsměv
hsim	spát
kyit	citoval
kwik	quotativepřípad
fwan	návštěva
slan	následovat
psit	přítomnost
hmic	sladký
hmuf	pusa
hfin	bohatý
tcam	nepřítel
psuk	zlomený
kcap	loď
pwan	inclusiveosoba
hfic	vliv
tcuc	jeví
hkim	tajný
pyin	prosím
pwit	precativenálada
pyit	zdvořilýregistr
cwak	zlo
myak	pochod
tcas	místa
hlaf	pobyt
psat	namísto
nlan	modrý
psac	nemožné
kcuk	škola
kcit	ženatý
kcak	jídlo
syis	dvacet
tlac	klid
hcip	perspektivníaspekt
kwin	dávat
tsit	zastavil
pyac	jazyk
hsus	týden
hcup	hala
cyap	zázrak
tfin	narozený
fyat	soud
hnip	gnómickýaspekt
tsak	respekt
tlas	hodnota
syuc	strom
plat	stěna
cyak	nebe
twip	začínajícíaspekt
mlat	příkaz
swit	jussivenálada
mwas	měsíc
hwaf	perfektní
tyap	zažít
ksac	okolnosti
syac	čerstvý
hnuk	vévoda
kwak	pokrytý
tyuk	východ
pwac	kámen
hkif	ušlechtilý
nyac	směr
cyis	židle
tyuc	čekání
tsun	vesnice
tyik	souhlasit
hnum	tolerantnínálada
slak	úspěch
tsic	snaží
slat	kopec
hmik	hudba
hkus	plakat
hsip	sedm
hpaf	soukromý
nwas	zprávy
tfac	scéna
fyan	zahrada
cwas	začít
hfik	rozdělovacípřípad
lyac	učitse
syik	politický
clin	henry
cyin	lež
tsas	obsazení
cyik	autorita
tlap	patro
cyam	letní
tcut	náboženství
tcap	útěk
hlut	autor
pyun	hnědý
tcuk	bolest
swan	jarní
hmun	měkký
kyun	roh
nyak	ochrannáznámka
tsis	spravedlnost
psas	produkce
cyaf	smích
hwut	zapomenout
hyup	Evropa
hwap	osm
psak	pomíjivý
kyap	hrozný
pyic	požadovaný
hmim	střední
hsaf	dech
hmis	moudrý
hsum	majetnickáznačka
ksat	příjemný
ksit	hrob
tsap	ostrov
kyam	tábor
tcum	dotek
cyun	štěstí
psic	pobřeží
tyun	doména
mwit	commissivenálada
tlut	stupeň
myit	zima
kfan	chování
slac	běh
myin	minuta
tyip	vést
klas	sklo
pfat	deska
cyic	marný
swam	záležitosti
syam	trezor
tsut	doktor
hlip	doplňujícíaspekt
kcas	tma
nyun	teplý
hpuc	napítse
tlam	příklad
hfun	hněv
tsik	vzdor
tsam	přímo
hmup	čepice
klak	pes
slin	stříbro
swac	služebník
kcam	hrdost
pyik	vlak
myut	morální
syak	vstoupit
swat	meč
kyuk	Záchvat
clac	zdraví
tyaf	odstavec
swic	sociální
tfit	vrácení
hkaf	oficiální
pcas	pohled
nyam	sláva
tfat	dvanáct
pcut	zasnoubený
pwin	víno
mwat	chuť
fyac	železo
syap	rozdělit
myap	obchod
hyum	použitím
fwak	soudce
klat	kapitán
twap	cessativeaspekt
kcic	zvědavý
kwic	zahraniční
hnif	zesilovač
myun	důležitost
tlic	Konečně
cyuk	krk
syut	Svoboda
pfan	strany
kyuc	Suchý
pcap	stranou
tfak	dokazující
tcik	průkaznýpřípad
twun	vzdálený
tyis	pokrok
nyap	úzký
plit	budova
hpif	strana
pwic	podíl
syic	smutný
tsip	hřích
syim	nemocný
tcis	upřímný
pcun	banka
ksap	akceptovat
lyam	proud
tcaf	opatrně
kwac	ucho
hpup	chléb
kcut	vybrat
nwam	zvíře
hsup	zoicpohlaví
nwit	eventivenálada
tcim	Stejnýukazateludálost
tlik	multiplikativnípřípad
kyus	kříž
hmus	tlustý
kfat	odvážitse
nwat	růst
myic	déšť
hpum	povrch
swut	Svatý
clis	červenec
mwun	móda
hfas	soubor
cwac	rameno
kwat	pohodlí
nwac	kdokoliv
tcip	žádoucí
kfac	tráva
hmuk	kreslit
plin	otevírání
kwun	červen
mlik	Ryba
klin	hlavníměsto
pfut	prsa
twam	tvrzení
fyin	výdaj
nlit	tvůj
mlin	milión
pyut	modlitse
hluk	unavený
ksut	zabít
cyut	stín
psin	hmotnost
kcis	šedá
pyam	statečný
mwac	spokojený
klam	vyprávění
ksam	národní
hfip	slabý
klik	údolí
hkum	spekulativnínálada
clas	žlutá
cyuc	teplo
mlac	zbytky
syip	stejně
pwak	box
tcif	špičatý
psip	princip
ksik	následek
tsim	sezóna
flan	věda
pcam	podlevšeho
kcun	otvor
ksuk	strýc
mlit	seznam
pcik	nebezpečný
kwas	srpen
hluc	oblíbený
klit	neznámý
flak	obeznámený
fyit	obeznámenregistr
lwat	čtenář
plun	chůze
twas	dvakrát
pcis	kněz
fyas	zraněný
nlat	palác
myuk	blázen
pfak	laskavost
tcuf	devět
cwap	sympatie
plac	výbuch
pyap	uvedení
lyic	oblečený
hcum	hluk
lwit	literatura
tsuk	hodnost
hfup	bouřka
kcik	kapsa
nwap	listopad
tyim	prosinec
psaf	absence
nlac	populace
kyaf	poděkovat
slis	série
pyaf	pták
mlak	majitel
kwut	kabát
hwuc	vztahy
pyis	rychle
twuc	kouř
nwak	leden
mlic	stroj
tlis	zuby
ksun	hořící
clam	ostuda
klaf	kvalitní
clit	prsten
fyak	fráze
fyam	frázeznačka
kwap	náměstí
hwip	Neděle
psis	poezie
pwut	předurčená
kyim	Koupit
clic	pole
pyip	duben
kfap	říjen
psut	objektů
kcuc	hořký
nlap	otrok
hsok	volný
htet	text
hbat	nejhorší
hrit	kredit
hzit	funkce
hpet	patnáct
krac	krutý
hduc	prach
hrik	praktický
hron	barva
hnus	nos
hric	přátelský
srik	zásobování
hten	včera
tlet	hesternalnapjatá
slap	selhat
hban	nosit
hdat	slepý
fran	létat
hdan	ďábel
htec	postupně
hmon	mise
cran	obětovat
hran	svědomí
hmos	ministr
nrit	energie
hcet	nenávist
hset	centrum
hrin	racionálnípohlaví
hcot	užívatsi
hrip	stručný
htep	uctívání
hcif	kůže
hrat	střecha
kran	koruna
hkon	hrad
tran	zoufalství
hmif	míle
trin	kruh
hgin	vězení
hkop	šálek
hcen	člen
swin	civilní
hrac	všude
hris	zvyk
hbin	slušivý
hmot	maso
hdut	mléko
hwen	rostlinnýpohlaví
nran	vzácný
hbac	bratranec
crut	most
hsoc	sklad
hsom	sůl
nris	nevinný
hbit	vyhnoutse
crin	obdiv
rwin	královna
hgut	počítat
hdas	tanec
hnot	hotel
hdin	vyplnit
hton	vězeň
hdak	nakupovat
hlet	schody
hson	Pardon
hgek	homosexuál
hras	písek
hsep	září
hbic	zřícenina
hlen	licence
hcon	dostatečně
hgit	svědek
kfon	kuchyně
hbak	prodat
tlim	zacházení
hsot	rychlost
kyut	počítač
hnen	věčný
htek	knihovna
hzan	obsahující
hbis	báze
hbun	zmatek
kcus	kuchař
hgat	dezert
hwus	polibek
hbif	led
hbot	míč
hrut	hádka
hdit	benedictivenálada
hdis	vinný
hjan	trest
plis	POLICIE
hgan	skrýt
hsen	expedice
nrin	neznalý
hyen	mrak
frif	únor
hdik	choroba
hnek	případiniciativy
hbam	teta
hmen	pokořit
hdip	zpožděnáimperativ
prat	hlášenodůkazní
hdet	půlnoc
hjit	prst
hmoc	někde
pran	lis
kcec	kraj
hken	nedávno
hloc	melancholie
hrak	personál
htes	hledět
rwan	odměna
hdon	darovat
htot	čelo
hnet	anděl
hdun	pozoruhodný
croc	chyba
hlon	svítání
hyec	ovce
hjin	trpělivost
hrec	referenční
mran	kukuřice
htos	většina
hcos	opatření
hkoc	občas
hlif	zisk
clak	cukr
hjat	lidstvo
tram	rám
hdic	disk
hkok	osamělý
srat	umělec
crak	kouzlo
hmet	e-mail
hden	rozhodnutí
gran	guvernér
crac	větev
hjac	nadšení
hdim	indukčnínálada
hcok	spěchat
hyet	olej
pwap	trubka
trat	tisk
tcot	pevnálátka
hdoc	Ach
hren	diskurskontext
tcon	poledne
krin	chata
plam	poplach
hnes	nervový
tcen	pozorování
hsek	aspekt
plik	použitelný
slik	hedvábí
hfen	cent
hgen	činidlo
hnon	svaz
crik	peklo
tcet	vadný
mrat	smíšený
hdam	admonitivenálada
hgac	ctižádost
htoc	nějak
hdac	advokát
nwin	ústava
srit	nástroj
hret	pevně
nlin	on-line
hzat	slapy
klic	vysokáškola
hkek	ocas
nric	generace
hgic	přeplněný
hgak	kočka
trit	přímýdůkazní
tyot	dohoda
hnok	obsah
crit	opuštěný
slen	jedenáct
srin	instinkt
hpok	kmen
hyot	chápajícínálada
cric	přístřeší
hruc	hrubý
cwin	jezdecké
hzak	otřást
dyit	průmysl
hpec	profese
nras	zdravotnísestra
hcec	výuka
hbut	obuv
hmec	vágní
twot	aktivita
crat	sobota
hkot	kapacita
hnec	slunečnísvit
hwuf	vdova
cren	kůlna
nrat	hvězda
hget	host
hbik	žehnat
brin	vnitřní
hpot	dostupný
trac	odpor
prac	odvodit
hcoc	dutý
hpon	provincie
hwim	civilizace
dwan	pověsit
cwok	šokovat
hdok	řidičský
crun	poklad
hzik	semínko
hrot	nedávnéminulostičas
hket	probudit
hcek	nábytek
hrop	lano
mrac	dobrodružství
byit	hody
trak	roční
hzin	jižní
sric	obřad
clik	lov
trap	liberální
hrim	křesťanství
hrus	princezna
blat	oltář
cyon	drobný
hwep	web
krat	kardinál
tris	nachový
kcot	shromáždit
hben	volby
trik	opilý
kfit	výtah
tcec	výměna
nrik	určitýčlen
grat	císař
dran	správa
hpen	dříve
cluk	škaredý
nrac	neškodný
ryin	výcvik
hrun	válec
nwic	palec
slit	střílet
gzat	noviny
krot	výstřižek
drit	vousy
hzis	slza
hdap	osmnáct
sris	historický
mrut	Hrubý
nyik	bláto
bran	nevěsta
drat	záviset
djan	obří
glat	jednoduchost
hpoc	podzim
pras	závoj
hgot	shromáždění
tret	divadlo
tras	porovnání
rwit	soupeřit
hfon	formující
klot	trenér
hmum	humor
drac	rozmluva
rwas	román
tset	pomsta
hdot	distálnídemonstrativní
ryut	žárlivý
hwon	pozvání
byat	Spálený
flac	blikat
prot	portrét
crek	navrhnout
htok	konflikt
htop	kletba
prit	imprecativenálada
hces	bezmocný
klup	klub
hnos	zaplavit
dwin	lhostejnost
prin	horizont
mrit	assumptivenálada
tcoc	příkrý
hcom	harmonie
grit	hrom
tlot	dětství
hgik	koleno
hwes	vbezvědomí
hzac	vzájemný
hsec	software
tson	instituce
ryit	příjem
dlin	disciplína
slip	uklouznutí
klon	revoluce
hfim	zemědělec
hpom	plošina
cyen	student
hgec	jeskyně
hroc	tradice
srac	předložit
ryat	tragédie
kcen	panna
hbap	rozloučení
krik	kritika
krap	bavlna
fwat	NEMOCNICE
kcet	nájemné
hgas	plyn
pfin	nevyhnutelný
dlit	list
ryan	překlad
sran	pohřeb
mrin	mouka
hram	romantický
dlan	dolar
hzas	žert
hsos	šestnáct
klen	kolonie
gyin	křídlo
hsif	lev
cluc	mazaný
prip	příprava
hzut	mlha
dwat	medicína
krit	zkorigovat
sras	hnízdo
hses	čtrnáct
brat	námitka
flat	kyselina
hjic	ato
slic	zbraň
hbuc	uživatel
tron	pomerančový
byan	koupel
hrif	primitivní
tlip	zřídit
blan	košík
kris	sekretářka
hyon	mezitím
tren	dnes
dlat	dnešnínapjatý
hzic	jed
tfic	puška
tlen	talent
hlim	podnebí
dyat	kamarád
kcon	zjevení
dlac	umýt
krak	zpověď
hbas	nesmysl
hkec	uhlí
hrek	obnovit
hkos	kánoe
hwif	svěrák
tric	dočasný
hdep	delimitativeaspekt
mwak	hromada
ksot	kost
hnoc	pondělí
nlas	úterý
brac	středa
frap	federální
pfit	zástupce
pcoc	pól
lyen	prádlo
swak	dřez
pcen	prezident
brit	krvavý
hwec	obležení
hwet	žaludek
hlos	nahoruposchodech
hbon	pestrý
pcon	mosaz
hsem	vrcholek
lwac	levný
tsos	soutěž
kwen	exkluzivníosoba
trun	přistání
trut	socha
hrap	dělostřelectvo
hgap	zatknout
trot	teplota
grin	okolí
hjak	přijmout
hpek	balíček
hlus	Jelen
hwos	ložnice
tsuc	keř
pcuc	vybít
cris	dědic
clun	dub
hpes	nepříjemný
nlet	neúplný
hrom	program
pyon	klavír
swet	přesvědčit
dric	neviditelný
tyen	dobřeznámý
hruk	krutost
frat	přidělen
hyoc	pokušení
hlep	telicaspekt
nrot	mezinárodní
nret	násilně
hfif	filozof
pfic	reprezentace
hmek	citlivý
hfec	blaho
myik	rybolov
truc	ukrást
tcop	ret
rwic	odejít
htom	ekonomika
glan	galerie
pren	paralelní
hlek	atelicaspekt
nrak	kontinent
truk	klepat
hjim	prohibitivnínálada
rwat	kravata
hcep	buňka
dyan	vejce
jrat	umělý
nren	inspirace
ksic	krize
tsoc	vyhledávání
lwan	oběd
hpos	borovice
hcuf	TAM
tcus	žalovat
pset	rozšířit
hkep	měď
swis	námořník
prim	císařský
trip	bič
cras	košile
swap	zametat
syet	skica
htof	zloděj
clen	kanál
kwit	osobnost
klok	přebytek
hrok	reforma
hguc	žízeň
kcim	hrozivý
hpem	dlaň
psik	mluvčí
frit	práh
cret	stopy
mrak	kopí
syen	zasedání
tcup	vlhký
hyek	cestovatel
trim	cín
plak	stížnost
hyok	úhel
hgam	kráva
hmok	mlýn
jrac	mapa
kloc	límec
gyit	záměrně
hbip	pivo
mlet	samet
lyap	zneužívání
cwen	stádo
bwan	neteř
tses	13
jrit	ospravedlnit
nlak	rukopis
sron	bojovník
cruc	pátek
broc	štětec
dlot	download
krim	krém
pric	stoupání
prut	jury
hgon	zmrzlý
sram	doslovně
pfot	hrnec
hlot	plánovaný
djin	mince
hlok	skok
hpep	jablko
hwot	zkroucený
dlak	prodiskutovat
brik	upsat
nlis	přepsat
hbet	sázka
pris	virus
hjik	pohostinost
blit	dětinský
hjap	župan
tfik	odrážet
hdaf	dosáhnout
hpop	opera
kcaf	skrývání
kcoc	loket
hrum	opravit
cyim	podezřelý
dyic	vzdělávací
hgoc	jáma
drak	porucha
plas	potlesk
byin	dvojitý
hzap	opatství
nlot	věrnost
mrik	mechanický
hsop	úspěšně
crap	past
kyek	dort
nrut	bavit
syes	Pane
hjet	sedmnáct
hjen	ženský
hmom	miláček
hdec	bohužel
lwen	legenda
slot	kamna
frac	rebel
gwan	prima
mruk	zlepšit
swot	bažina
zlan	vydělat
hnem	animovaný
hdes	obvaz
prak	kázat
frin	scenérie
hfet	odporovat
cros	sbor
ryon	racionální
tcos	plodina
tsen	zpracování
hwek	vlk
nlik	zamítnutí
klap	koberec
dras	opovrhovat
prop	úrodný
slim	pískat
hgis	sýr
krut	kousat
srot	doprovod
bjan	bloudit
nwen	válečnéloďstvo
myas	maska
kwaf	rozvíjet
twis	kabina
pcip	tužka
srap	zeleninový
sren	exponát
tlun	kalhoty
hrup	korupce
nrip	skříň
srup	polévka
jran	chirurg
bjat	přídavek
gyat	vyzvědač
hlem	bezohledný
srak	abstraktní
kson	přízvuk
cwis	čtvrtek
sret	Spozdravem
hraf	provoz
hres	architektura
hsuf	likvidace
rwak	crack
twon	ornament
hfus	zotavení
hkom	kód
djat	lovec
nlut	bulletin
hsef	had
mris	demokracie
bric	baterie
mlam	vosk
zran	sdílet
cron	vzrušení
hzen	plavat
traf	proužek
cwaf	obálka
srip	cigareta
mrot	motor
swon	dobrovolník
ryak	reakce
pfun	částečně
blac	zavazadla
mret	ministerstvo
hjon	sexuální
kcok	sekera
dram	diamant
kren	střídat
tcek	ozvěna
hdif	identita
tfas	velvyslanec
hfot	skládatse
lwas	líný
hmep	momentaneaspekt
kfin	kódování
mwin	představivost
hrem	paprsek
pram	šplhání
byac	sklep
mren	památný
swen	senát
kras	rakev
hgun	polykat
nlok	hovět
ryic	zemědělský
gwin	houpačka
srut	louka
hkes	komplex
hfis	rezignace
frak	opakovaně
hnom	spiknutí
hcop	hospoda
hlec	pepř
mlot	melodie
zrat	kandidát
proc	patron
flik	liška
cyet	zalitoval
hgim	komín
slet	živýplot
tcok	přesnost
bjit	bývalýzesnulý
brot	pupen
bwat	deka
hdus	prase
gwat	slonovákost
kret	výtažek
nwet	pozorovatel
jwan	avenue
nwis	nehty
mwic	včela
bzat	herec
gyan	pot
zyit	výkonný
blic	iluze
pcet	nejistota
tsot	složit
bwit	hranice
tres	stres
hkof	spotřeba
nyen	zasténání
hles	podobatse
cyek	pytel
hjis	jehla
gjan	jev
prec	chovatse
drot	kontrolovaných
kcek	křivka
twic	kuře
brak	hlaveň
zwat	obvyklý
clap	obvyklýaspekt
tsec	expert
bwin	zapůsobit
cwet	ohraničený
hbek	pekař
zlin	olivový
mron	dodávka
drin	věnovat
psap	odhalit
gjin	narozeniny
clut	kladivo
cwun	vonný
twaf	triviální
pcot	domácízvíře
krok	lebka
dlik	zákonodárnýsbor
cwic	naštěstí
srun	mračit
crec	ničit
jlan	okraj
kcip	mistr
blin	miliarda
ryik	chemický
mlas	puls
flit	pilot
hzet	uzel
cwik	majestátní
twet	sukně
mwik	týdně
tfis	technický
tlon	vozidlo
cram	lichotivý
grac	posílit
kraf	vrána
trup	atribut
hduk	háček
cruk	tygr
nrap	služebná
crot	Dálnice
mlip	milice
hfoc	fotografie
nres	integrita
plos	Plus
tfam	průhledný
nlic	devatenáct
hwok	kvalifikovaný
nlen	esej
fyic	účinnost
hwuk	unikátní
hgok	organický
flic	teologie
flot	plovák
hboc	zavázat
hwoc	čarodějnice
syot	studio
cwip	šampaňské
hbes	prapor
lwic	rozvod
blot	šroub
cwot	zajetí
cwam	žíla
prik	pasivní
hfum	pěna
grik	štěrk
zrin	zástěra
gren	planeta
hfuc	vzkříšení
claf	police
flas	fanoušek
hjot	tropický
hbim	libovolný
krek	rtuť
hbec	laskavý
tsaf	sebevražda
pwas	trhat
plot	zpravodaj
kfak	vynaložit
blak	balkón
hdos	skvrna
kwis	klasický
kcos	obvinit
psen	důchod
kres	sloveso
hzon	opice
srim	podpis
glin	neochota
mlut	známý
myot	import
fwac	zakladatel
troc	pochodeň
hgaf	gramatika
hyop	jachta
ksip	vyhynulý
sres	výlet
hnup	kupole
hzun	tvrdohlavý
mric	sval
gjat	rozsah
hros	třít
zrac	zbabělý
tros	přípitek
myus	myš
dwac	dialog
byak	koza
htef	přizpůsobit
hfek	vzkvétat
dzan	uložit
nyon	anonymní
zrit	formálníregistr
pcos	sporty
hjec	tát
dlas	vymazat
mras	deštník
mram	minerální
cwut	příměří
hbok	kachna
swun	mýdlo
dwak	panenka
plif	vila
slon	šití
tfut	blahopřát
djac	smířitse
hjas	potlačit
kric	králičí
kwot	dirigent
gzan	záruka
clot	hráč
ksek	hmyz
psam	držení
mwut	sova
htem	natrvalo
clon	housle
dzin	rezident
rwim	příslušně
hyof	příznivý
dron	drak
dwit	sluchovýdůkazní
sroc	export
hzot	ukončení
djik	prodlévat
kfik	víčko
ryun	nařízení
hmes	starosta
rwac	železářskézboží
sruk	cirkus
sros	menšina
bzan	výtržnost
kset	orchestr
bjon	slanina
hjut	neomezený
tfen	obraně
zwac	nevýhoda
dyin	uvažování
myis	hudebník
mlis	mentálně
pret	nedostačující
tsek	architekt
hlom	citrón
ksos	kašlat
crok	bolesthlavy
flin	plodnost
mrun	tesař
swec	náhodný
syuk	lžíce
blun	balón
tcep	křída
fric	občerstvení
rwik	vertikální
rwen	prevenci
flet	inferentialdůkazní
pfac	vydavatel
srek	ocet
tfun	tunel
pwet	hádanka
gyik	matematika
fwot	slábnout
lwin	vyrovnaný
jwin	játra
bwik	Subessivepřípadsublativepřípad
hdup	ponoření
hnop	monopol
bwic	ponorka
ryen	bezohleduna
hcem	zemětřesení
hbos	laboratoř
nrek	pracovník
ryim	rytmus
nyic	interpretovat
dwas	ambasáda
rwok	provokovat
kram	neschopnost
ksim	deklarativnínálada
clok	čokoláda
pcec	výsadní
nyis	poustevník
tyoc	náhoda
grak	poškrábat
zlat	rukavice
hjuk	klečet
trif	zeměpis
djit	systematický
pson	neporazitelný
mwis	investice
cwec	slovní
hdek	světský
blik	jestřáb
sloc	psychologie
brap	šrot
jlat	pirát
dros	dávka
slam	losos
pwun	pudink
gwik	magnetický
pcop	čerpadlo
myen	podobně
ksen	kyslík
mrap	předák
tfot	osvědčení
ksus	shluk
trok	rétorika
tloc	příčel
zyan	veslo
nlun	přihlásitse
hlop	dalekohled
jlin	pravopis
lyut	zakalený
hsof	surfovat
fyik	whisky
klet	poměrně
hwof	vrba
hlum	velbloud
myet	amatér
klis	izolace
hbaf	životopis
gwac	osel
hwum	pověst
pwik	perspektivní
pron	pro
myes	měsíční
mwen	snění
kfic	dovolená
klek	cvaknutí
cwon	ovál
lyak	elastický
kwon	slovník
hjam	šunka
rwon	duha
crip	tímto
zwan	vyskytující
srok	redakční
craf	desátník
tlok	nádrž
brip	motýl
tfap	graf
jwat	dvojče
pros	provozní
psun	omen
clet	ubohost
hbus	bambus
dyas	obchodník
klun	akumulace
jlit	jednomyslný
hdom	nočnímůra
kron	uhlík
hzam	džem
cyot	posluchač
hmem	muzeum
lwam	abeceda
fras	rozptyl
psoc	ránapěstí
hgum	guma
brek	brzda
glit	stabilita
frun	trouchnivění
gris	útočný
mroc	tření
bzit	pavouk
plut	brambor
glac	chamtivost
gzac	násobit
prun	roztočit
jlet	kalendář
nyim	jmenování
tlos	bilion
slut	salát
fwit	kladnámood
pyen	aplikace
nlon	nominální
dren	prokázat
drun	nespokojenost
cyok	pokrčit
hfop	fotbal
ryac	partnerství
gzin	průkopník
hgip	zelí
tyet	atletický
hdof	ideophone
hwup	neocenitelný
lwek	páka
syec	senátor
jyak	ubytovat
mlim	mravenec
fwic	efektivně
gzit	těhotná
blas	důvěra
jrin	každýden
gwak	kotník
drik	podivně
prif	proměnná
jwit	rozmanitost
krip	diskriminace
ryot	awed
nwut	chodník
kcif	aktivně
jrak	žába
twek	exessivepřípad
psot	smíření
pfon	mycíhouba
sluk	veverka
nlim	irrealisnálada
ksaf	nedostatek
glak	sopka
plen	rovnováha
kfaf	šátek
kyon	využívat
jlik	geologický
psop	cestovnípas
kfis	volnémísto
fyon	afinita
nram	nemorální
hbuk	suchar
gras	trans
hyos	chápavý
flim	film
plet	tableta
rwam	atom
blis	vanilka
zlit	AIDS
fyut	vybíravý
crim	pyramida
hjif	protiprávní
crif	plachost
lwap	loutna
tyon	astronomie
mrim	bludiště
drut	popisný
nrim	stipendium
kruc	želva
kwam	poradce
jrik	kriket
dlut	naznačovat
pyot	holub
dyon	přizpůsobování
prap	operátor
bzin	odznak
tyek	trojúhelník
trec	pokladník
nron	vodík
pyet	tiskárna
tsok	sytič
zyin	chronický
slek	jízdníkolo
jyin	inženýrství
ryas	přenos
zrak	Obnovit
nyas	tanečník
gric	stěhování
zlak	porušit
tces	tenis
hjun	větrný
twen	vazba
kyet	kolektor
gwit	páteř
kyot	akord
fwin	frekvence
tfuc	tkalcovskýstav
dlet	adresář
pfik	myslitel
bjet	rozpočet
trek	strategie
kros	křemen
gjit	nůžky
gwic	vypínač
frik	teoretický
tluc	ručník
pruc	hlídka
glic	ledovec
krun	úplnost
bjin	předpověď
tlaf	účastnitse
tfet	výrobce
bras	postranní
dwik	obžalovaný
clec	vyčerpat
cres	šachy
tcef	třešeň
tcom	klopýtnutí
nyot	překladatel
tyok	nákladníauto
cyip	překonávat
grot	hořčice
bris	bezdrátový
nlam	aukce
slif	síto
hgos	rez
swoc	nestálý
jyat	konkurzu
slum	islám
hjes	sčítánílidu
dzat	choditpošpičkách
slun	pozastavit
nwot	kontinuita
gyic	kytara
pfas	předsudek
zyik	zinek
blen	lesklý
hyem	jilm
hnep	shon
nyut	pletený
ryam	zájmenoznačka
clim	koření
jret	ostrost
tfon	vtipálek
jwac	Jáva
hrep	recept
dyac	volebníprávo
myip	metr
rwis	rasový
hkem	kometa
nwon	inovace
zwin	zákaz
dyis	středověký
mrec	Vrabec
fyot	poznámkapodčarou
mlon	měření
pfis	ratifikace
rwot	obíhat
hfok	skromný
glof	golf
zron	nula
hzip	zip
hwom	bezdomova
bjic	žvýkání
pcim	splnit
hjip	čip
bwac	zívnutí
mlos	krtek
mrip	keramika
bron	embryo
ksoc	dedukce
cyum	droždí
jyan	žargon
plim	švestka
mwet	hřbitov
ryet	absolvovat
glik	irigace
plap	kapitalista
tsif	pružnost
gyak	žralok
djon	standardní
nwun	přesný
cles	realismus
dris	stále
hkef	kavárna
blus	ambulance
blap	peněženka
bjak	extatický
klim	grimasa
gyac	vědec
jyit	vyrovnanost
dzit	realistický
bwak	venkovní
dyot	rádio
bwon	fazole
fris	neformální
klut	spekulovat
tfek	steak
nrok	dusík
zyat	Břitva
bram	mumlat
ryis	úvodní
nlip	analyzovat
nros	kontrastní
hcof	svléknout
tfif	pobídka
kroc	brázda
hdum	judaismus
pses	příjemce
plok	doplněk
lyet	objektiv
pwek	pegativepřípad
kfas	rakovina
pwen	pěšák
nrun	připomínka
clek	unikat
pcif	ospravedlnění
glas	složitost
zwit	hovorný
kces	dostatečnost
crem	maloobchodní
grap	urvat
kwip	zasahovat
dyut	sleva
crus	hierarchie
gyet	nefrit
gram	vrčet
kyip	ještěrka
nyet	podložka
crop	vodopád
glon	galon
mrok	komár
fluc	plynulý
dwic	odchylka
slec	badatel
srec	vypršeníplatnosti
blut	zápasit
myok	mozaika
tlek	zástrčka
nruk	infekční
nwoc	nadále
bjut	squat
hges	těhotenství
twoc	potraviny
kyos	komunistický
mrek	ohromit
clip	kajícnost
pwok	prosecutivepřípad
dwot	diktátor
zyac	předpojatost
jlic	družice
slop	pantofel
ryip	úměrný
psim	přibližný
byet	bezpráce
cyop	hobby
rwun	kritérium
blop	žárovka
syok	podporovatel
klos	chlór
lwot	chlorid
byic	bakterie
lyik	lepkavý
blok	biologický
jlac	předstírat
bret	byte
krif	vylučování
blet	balet
nruc	moč
tsus	česnek
dyak	střednítřída
tcem	kleště
cyoc	náročný
trep	jahoda
dlun	znečištění
hlup	album
hbep	baseball
praf	pirátství
pwis	participium
grek	garáž
kruk	berle
hfof	fosfor
rwut	strukturální
myam	tělocvična
krec	jeřáb
jras	dodavatel
zrik	oznámit
blam	tanečnísál
klip	řemeslník
hwef	nezaplacený
zlac	banán
gret	generátor
lwuk	žebro
nyek	nikl
blos	autobus
sles	cenzurovat
tlif	dlaždice
kses	klobása
mwot	rajče
lyot	auto
tsom	draslík
brut	virtuální
djap	algebra
hjok	obecný
kfen	koncepty
pcok	optický
bzut	ustoupit
syek	nezaměstnanost
mruc	housenka
bwas	prohlížeč
klif	vápník
rwet	dálkovýminulémčase
srif	historickénapjatá
hwem	spektrum
syom	sodík
tyos	poručník
jyic	rukojmí
hguk	tykev
dwun	vráska
swip	špice
tlec	klíště
blaf	znásilnění
tsem	ateizmus
mloc	monitor
gyot	podmiňovací
trop	sonda
rwap	čtvrtletní
hjep	rod
pyim	platina
dlon	dualčíslo
pcep	plíce
twuk	drhnutí
tyec	štítek
syup	super
trom	trolejbus
nyip	lokálně
glis	benzín
gjik	ledvina
hjos	bezdozoru
hjuc	kořist
swek	přepracovaný
psek	arzén
twok	statistický
tsep	saranče
slos	socialista
nwim	smyslovédůkaznínálada
tlop	ubrus
trus	kontroverzní
pwot	řemínek
djot	usazenina
nloc	ignorování
mwon	mandarinka
hjek	žokej
crom	spolupracovat
myon	pneumonie
twec	situovat
ryek	raketa
dlic	dividenda
kwet	brusle
bwen	posedlost
plon	přidělování
syon	supění
djis	digitální
byut	fena
hyep	očnívíčko
dwon	úhlopříčka
byis	podvědomý
brec	obočí
cyec	kýchnutí
hwop	watt
clus	bujarý
kfun	obsazenost
nwum	hinduismus
fyim	uprchlík
cwos	kyvadlovádoprava
tfoc	škubnutí
pwon	protein
sraf	samostatněspokojen
hbom	zvracení
gyen	gen
drim	studentprvníhoročníku
trem	nezbytnédoplňky
tsup	roztříštit
slok	sociologie
kwoc	dýně
bwam	volič
mlok	pohyblivost
kyen	regionální
hmop	pohybnahoru
rwek	retrospektivní
kfup	krychle
grok	mrkev
drap	polapit
lwis	molekulární
ksuc	účetní
tsop	smrad
kyok	okurka
nroc	orgie
jlot	solventní
psof	fosfát
hgif	fascinovat
kfim	alkalický
psos	gymnastika
pfen	ověření
kcom	ekonom
krom	čárka
tluk	kroutit
hyom	jód
nwuc	motionzkopce
gjac	potrat
pcom	lusk
dzic	návrhář
grun	chvástání
dzot	dárce
hzek	mangan
kfot	klávesnice
jlas	nespolehlivý
lyim	elita
jyen	yen
pcaf	vsuvka
rwip	ragby
blip	bible
kyoc	příčina
lyon	vřed
flis	flektivní
nrif	okusovat
kfam	kvantum
swes	svetr
lwon	vývojový
drec	pitva
gjap	lázně
lyec	lineární
tyom	antimon
pwuk	superessivepřípad
flaf	alpha
myim	imunní
pcek	únos
bjac	pivovar
bzac	zkrátit
bzak	ponožka
twes	televize
dwut	dokumentární
ksom	kosmos
lyis	lesnictví
lwim	hliník
ksok	horoskop
sruc	urychlit
dlif	delfín
byik	zabiják
tfec	papírnictví
hjaf	savec
ryok	protokol
dwis	dioxid
jlon	dvojtečka
brus	byrokracie
gjak	galaxie
lyip	klinický
ryem	rádium
href	řidší
prok	lednička
slep	satyr
dret	opakování
kluk	archeologický
dlis	výstřednost
kfip	nepřijatelný
mlec	masáž
pfif	specifikace
nrec	smyslový
pfet	leták
hzoc	základ
dlam	ideálně
nlec	antropologie
kluc	chutný
dyet	limuzína
tyif	tranzitivní
krus	krčitse
nluc	slunečnice
lyun	ion
zrot	vydání
ksif	falšovat
psif	emise
crup	překrytí
fret	nálezce
grut	invertní
ksec	spolužák
jric	itinerář
mrop	mikrovlnnátrouba
srus	vyhnat
gyas	kadeřník
floc	folklór
plek	kapilární
nwop	hýždě
nrom	kontrolor
twos	terorismus
lwok	heslo
dwet	přesčas
slem	sublimovat
grip	gril
gwas	Páni
kwok	kobalt
gwon	oves
hdop	pohybprotiproudu
glam	anus
bwot	hovězí
bren	střevo
byot	video
bjik	bojkot
kwim	kviz
cwek	hokej
grif	partyzán
hgem	magnézium
hyes	povědomí
fram	LÉKÁRNA
nwos	ambiciózní
ryap	přeskupit
cwim	spolehlivost
klep	kelp
psec	uhradit
djic	celosvětový
kfut	zákazvycházení
crep	hamburger
frim	teorém
gjas	zapálit
hdef	debet
ryum	uran
pluk	posoudit
krop	koordinovat
nraf	poplatník
tyes	integrovaný
plip	mínit
hgom	gama
hgus	součinitel
cwuc	ohřívač
zret	odčítat
nles	analytik
trof	intranzitivní
hmof	nákupnícentrum
hzim	vizmut
dzac	večeře
psok	pohlednice
blon	konvergence
djet	odbočit
ksum	akcionář
mrup	mikrob
clif	spirála
cloc	morfologická
tfes	dodavateljídel
gjis	džíny
jren	zarovnání
tlep	databáze
kcup	kupón
glot	Napětí
glut	kalkulačka
srep	kyberprostor
nwes	investor
ksef	xray
bzis	vízum
frut	infrastruktura
nyuk	svatojánskámuška
dyik	detektor
plec	spojovat
brom	bróm
plop	palladium
zlik	křemík
flut	volt
ksop	kosmetický
gjun	grooming
kfok	škytavka
hpof	praženákukuřice
hzuk	zoologickázahrada
nyoc	konotace
jwak	jóga
brim	baryum
kles	stít
mwam	tojo
fwik	ohňostroj
djas	jazz
dyim	audio
tsum	wolfram
drip	driblovat
lyaf	výživné
prom	programátor
nrup	vstup
hfes	reflexní
rwaf	chryzantéma
dlen	dokumentace
byas	vakcína
fron	heroin
dluk	odpojit
dyun	diagnostikovat
flap	Složka
kfet	katoda
dlim	ideologie
prek	parkoviště
syoc	momentka
slus	přístupnost
nlos	zklamání
mlen	selen
pres	kůra
hlof	síra
nlek	aktuálnostznačka
gwot	letiště
mwip	podvodník
klop	šváb
kwom	chróm
hl6t	litr
nwec	Nicméně
glip	cyklický
nrop	mzdy
crum	hormon
dlep	vývojář
frot	perforovat
bwoc	sabotovat
fwis	feminista
djok	sdružené
draf	modernizovat
trum	extremista
graf	algoritmus
lwes	laser
mlem	milimetr
flen	ohnutí
zlot	anoda
swok	přitulitse
klec	pesunavený
pwim	částečnýúvazek
htuf	tuňák
fyis	rafinerie
lwet	citlivost
mrem	mainframe
jwic	omlazení
droc	demonstrátor
clem	hélium
dzik	bilingvní
psem	plazma
hjom	chromozóm
rwuc	pořadový
tyus	celéčíslo
klom	kilometr
hfos	fax
nwek	genetika
jrap	šroubovák
zwas	předkrm
bwok	brokolice
dwap	adaptér
syem	spam
blek	vektor
tlus	taktika
pyif	NS
cwoc	vpořádku
mrep	ampér
hbem	vitamín
hxan	vrátný
hxut	subvencovat
hk6m	kadmium
hxin	souběžnost
txin	titan
kxin	kilo
klum	pářitse
xlis	přesýpacíhodiny
hqak	syntaktický
hxat	tvořivost
hxik	ebook
hxas	pracoviště
bxon	bor
dxin	indukčnost
hxit	helikoptéra
tlum	tellurium
txit	Uzávěrka
kxat	okysličovat
hvik	seřadit
nluk	analogový
nyem	centimetr
hm6t	molybden
hl6m	lithium
ht6t	multimédia
xlit	kalorie
ryop	robot
pxas	farmaceut
hxak	domácípráce
lwif	lokativ
grim	logaritmus
hqat	nábožná
qlit	ekologie
xlik	obloudit
mlep	šablona
hqit	radioaktivita
kxim	kilogram
hxen	nájemce
hxot	přejídatse
kyif	kopírka
fwet	freeware
txet	podmnožina
hs6n	sekvenční
hxet	poslouchatzadveřmi
xrat	střih
hqan	zabavit
hr6t	iridium
bxat	Šířkapásma
dxet	desktop
hxis	exponenciální
hxok	centrála
hxek	založitněkam
srem	minerál
hp6t	partitive
pxik	partitivepřípad
kxet	kazeta
pruk	supermarket
hvit	sílavůle
xlin	vrežimuoffline
frip	šifrování
hvep	přeplatit
hxon	synchronizovat
kxit	maximalizovat
hqin	seminář
tr6n	stereo
ht6n	sponka
hvat	nadcházející
sl6s	Celsia
hn6n	neon
ts6t	reálnýčas
hvin	usměrnit
pxat	trafika
myoc	modul
ps6s	těstoviny
bwek	aktovka
dlok	deluxe
fraf	firewall
hr6k	artefakt
txat	časoběda
hqon	oregano
pxun	plutonium
ks6n	Pracovnístanice
slef	eskalátor
xrit	PLAVČÍK
hvut	přeplnit
xrim	ytrium
hx6t	zvětšující
hqum	uživatelskéjméno
hl6n	prodejci
gron	argon
pxan	propagační
hvac	myčka
xlan	globalizace
txon	vlnovádélka
xrik	recyklovat
hxap	batoh
hxac	restart
xyat	zánětjater
cwep	výplata
hxos	torus
txif	písmo
qlat	realitníkancelář
txot	uprostředpodzimu
hxam	miligram
pxis	pixel
pwif	náhled
txam	tantal
myek	termodynamický
hbop	vloupatse
hqot	solute
xlic	invalidnívozík
gxit	genocida
hvan	hašenípožáru
glim	kovovýprvek
pfop	pop-up
hzum	zirkon
xlon	horkálinka
qlin	nelineární
kxam	skandium
blim	beryllium
kxik	konfigurace
nr6n	neuron
hpef	přísudkový
hruf	router
kxan	factorial
hxic	vodítko
xlip	volejbal
dyek	ladit
hxop	náramkovéhodinky
qrot	neutron
nwip	niobium
hs6t	toaleta
grem	germanium
tles	podobnýkovu
hp6k	prolativ
qyin	biodiverzita
txak	antibiotikum
mlun	imobilizace
txan	actinium
xran	astronaut
dres	rozbalit
tr6t	mimozemský
hk6t	oktet
hxus	opensource
xlat	bláznivý
mraf	maratón
ts6n	midjaro
ht6s	autismus
nlif	ionizovat
txut	významnáosobnost
hm6n	vyzařující
kxis	ClipArt
xrin	podstupují
xren	přesměrování
bxak	záložka
pfos	Profráze
hvis	výkaly
hd6n	jmenovatel
brum	zasedacímístnost
hqis	šovinista
hk6n	kompilovat
xyit	keyshift
xyin	jednasekunda
hxun	jsoucímu
hvas	role
glok	blog
hvak	meandrující
pxit	IPadresa
hvet	vedle
xram	světlicebarvířská
hc6n	samozřejmost
qran	korán
zyen	xenon
hqas	vzítdopřísahy
bzas	znuděný
hj6n	nončlověk
hnof	nonremittal
txas	tvůrci
hbum	buddhismus
ts6s	Svářící
pxin	přísady
hr6n	příděl
hxim	vpoloviněléta
dxit	midwinter
hxaf	vybagrovat
nlus	domácírostlina
txap	stavovýřádek
vrit	ghostwriter
kxak	pohrávatsi
bxin	Lidskétělo
hqik	pláštěnka
hxes	hertz
hxif	hypnothize
xras	hodinově
pl6k	koncipientku
dxat	nerozvážnost
hxip	protilátka
vrat	šortky
hqek	přetváření
qrit	polarita
pxot	pošta
hxom	nevyžádanápošta
hqic	recenzent
lwun	modrédžíny
hp6n	zrání
dxan	uchycení
xrak	roleherec
dxak	nehoda
hven	kontejnery
mwap	komiks
qlan	barvoslepý
xros	svlékání
srom	showroom
hc6t	chatování
qrat	vzhůrunohama
hn6t	zábrana
hqet	webovástránka
fres	fundraise
froc	kování
xlak	hypertextovýodkaz
vlat	výřečnost
dvan	vystupování
gxin	vítězící
ryes	recepční
kxot	konektory
xyan	vymezení
vlan	inzerent
ryom	thoriumatom
hluf	starývěk
hquk	vstříknout
lyum	thuliumatom
tyem	terbiumatom
hp6m	praseodymu
txic	domovskástránka
mros	motorista
dyam	atomrhodium
pc6n	zkušebníčíslo
nyos	doručenápošta
pyek	projektor
kxon	krypton
hxuc	záchraně
qrik	centricpřípad
xwin	nezkušenost
kxic	hasicípřístroj
hvot	vývojovýdiagram
dxot	jogurt
hqut	odhlásitse
pxen	resortní
drok	cílemspoušť
flon	mobilnítelefon
txos	middlehlas
hqok	šikmýpřípad
xwik	případpacienta
hx6n	prehodiernal
txik	ukazováček
hqen	odesílatel
mlap	malware
hvun	přemlouvání
hvon	opotřebovat
vran	pošťák
pfes	profesor
pwip	básník
hqam	cvičení
gxat	legálnost
ks6t	kauzativní
vrin	náborář
kxip	clipboard
sr6n	odmítavý
vlit	ohodnocující
tyup	předměstí
mrom	morfém
xron	sluchátka
gxak	nákladný
hrof	trojskýkůň
xlas	paralyzovaný
dzet	vymalovat
txac	odevzdání
xrot	nepoužitý
txis	jehličkové
syif	jednotkySI
xrac	překvapivě
brif	binárníhodnota
dlos	modálnípřípad
txun	atributy
dvat	popudlivý
psom	zprvníruky
gjek	elseif
nlem	jednotkahmotnosti
qret	maloobchod
txip	triplepoint
dlek	jednotlivě
lwut	tokproudu
dxis	dramaticky
hs6m	caesium
vlak	motorovývůz
hn6m	netium
kxap	lepenka
bxan	odlétající
myem	měsíckvěten
gxik	občanskápráva
hxoc	letectvo
xrok	spolupracovník
kr6t	screenshot
txok	automaticky
hxep	skateboard
srop	smartphone
pxak	capslock
hk6k	lidováhudba
hl6k	eulersčíslo
pyom	poloniumatom
xyam	thaliumatom
hvic	napadající
lyok	locativepřípad
xlot	byty
txen	přepočet
kxac	protiútok
qrak	stávkokaz
hbup	plaveckýbazén
txuk	zkrat
tsef	zúžený
bxit	webhostingu
ksem	pouzekečtení
byim	rubidiaatom
hvam	vanadatom
lw6n	lanthanu
frum	atomfluoru
nyom	neodymu
mlom	multalčíslo
kxas	personalizace
xret	terabyte
hs6k	vyhledávač
frus	korodující
gxan	galaxypohlaví
vlas	vocalizations
glet	plynovýpedál
hvim	runtime
bxip	bitmap
qrin	starpohlaví
bvak	abessiv
pxon	nedostupné
dvik	adessiv
dvek	agentivepřípad
hlef	Agentspoušť
kwek	případu
kxen	společnýpohlaví
ht6m	citačníforma
tsuf	transčíslovka
hf6n	čeřící
tc6t	přímýobjekt
gvik	ergativepřípad
gxon	roztříštění
ksep	receptor
vyin	kino
pyos	pasivníhlas
hnef	určitýslovesný
xwit	primárnímcílem
hqim	gnómickýnálada
jlak	zevšeobecnění
vrik	hotovéčástice
qyan	imaginárníjednotka
kxaf	rychlostsvětla
xyic	phishing
qyit	kritickýbod
hvek	evitativepřípad
bvik	subessivepřípad
hzes	vlastnilpřípad
prus	počítačovývirus
ples	procesor
pxif	policista
dvak	Lativepřípad
brun	touring
tsi_k	antessivepřípad
tyum	rutheniumatom
vyak	příslovečnýpřípad
pxim	premiér
syum	atomstroncia
sy6n	podezřelost
hy6n	animovatpohlaví
pxac	empatickýradost
vlin	pohlavívozidlo
qwin	minerálnípohlaví
hr6s	postoupení
tf6n	toner
xris	uživatelskérozhraní
hw6n	klení
xlen	verbálnísubstantivum
pyec	tabulkovýprocesor
vlim	virtuálnípaměť
bres	textovýprocesor
hqip	cloudcomputing
vlic	virtuálnístroj
pfam	spammer
dyap	druhýjazyk
txek	n-táodmocnina
dxen	datamining
byip	podnikatele
hs6c	sebevědomí
txim	předkládající
hb6t	Změnaakce
hdem	doménovéjméno
dxon	jináudálost
lwaf	fleška
sl6t	crastinalnapjatá
xyik	disketa
fyif	reflexivníhlas
bvin	vesmírpohlaví
hm6p	Základnídeska
tfip	tranzitivnísloveso
jlen	lokalitapohlaví
xrap	pruhovaný
tc6n	výzkumpohlaví
sl6n	umělecképohlaví
xrek	spoušťpacient
xwan	abstraktnípohlaví
dxif	videokonference
dyip	nepřímářeč
zrek	exocentricpřípad
hvuk	vyvolávat
xwat	minulostperfective
hr6m	rhenium
txaf	spuštěno
hmef	neosobnísloveso
tx6t	textovýeditor
txes	Hromadnéjméno
bvat	týrat
bvuk	absolutivepřípad
ry6t	radián
vlis	virtuálnírealita
qren	planetárnípohlaví
gvak	gramatickýpřípad
bxok	plešatý
mrum	počítačovýprogram
ps6t	operačnísystém
hfom	foném
tlem	pamětpouzepročtení
pwam	spyware
kfif	jádrobenefactive
qwit	rozumnost
nlaf	Instalace
nwok	asociativnípřípad
dzas	neuspokojit
swuk	superlativpřípad
syos	shrnující
kr6n	elektrickýproud
dvin	neživýpohlaví
pxom	propositivenálada
vris	recipročníhlas
rwos	aerosol
dr6t	distraktor
ht6k	telekomunikace
slaf	sociálnísíť
lyuk	posobějdoucídoložka
qras	nadřízení
ty6n	teminal
gwet	Brzybudoucíčas
hp6s	applicativehlas
tsof	antipassivehlas
ht6p	continutiveaspekt
hn6f	necessitativenálada
pfip	pasivníparticipium
glap	Panelnástrojů
sy6k	existenciálnídoložka
qyat	svítivost
hy6t	gramatickýobjekt
vyan	vyslovení
sluf	singulativečíslo
dvit	nadměrnádélkatrvání
qyak	jednočinnésloveso
bzik	fyzika
xlet	superlativstupeň
hqap	přítomnéparticipium
qwat	látkovémnožství
qyik	pojivovéčástice
sr6t	nadkritickátekutina
hfem	epentheticmorfém
tl6t	dálkovýbudoucíčas
mrif	mikrofon
pcuk	postpositionalpřípad
tfim	paměťsnáhodnýmpřístupem
fwim	ethium
ly6t	allocutivedohoda
hvap	Posuvník
hfep	frequentativeaspekt
bvan	rozdělovacízájmeno
fyun	číslosplovoucíčárkou
xyas	mazání
hvif	slovesopřipevnit
xyis	minulépasivníparticipium
tl6n	centrálníprocesorovájednotka
tfok	locativepřípadsměrová
qwan	Častokladenéotázky
