ni	infinitivo
na	nominativocaso
ka	acusativocaso
ta	temacaso
ca	Hola
wu	vocativocaso
kcah	hambriento
ti	genitivocaso
ci	adjetivo
wa	y
mi	yo
sa	usted
nyah	nos
ya	ello
ma	destinocaso
yi	dativocaso
li	realisestadoanimico
tu	deónticaestadoanimico
cu	condicionalestadoanimico
si	epistémicaestadoanimico
yu	instrumentalcaso
nu	interiorcontexto
pa	personacontexto
tyah	cláusulaindependiente
la	dependientecláusula
fa	perfectivoaspecto
ki	pasadotiempo
ne	masculinogénero
mwah	comitativecaso
ra	presentetiempo
pwah	benefactivocaso
swih	essivecaso
no	negativocuantificador
pi	superficiecontexto
da	adpositionalcaso
te	ubicacióncaso
to	espaciocontexto
ga	caminocaso
ri	interrogativoestadoanimico
ba	yo
ku	exclusivoo
so	fuentecaso
pwih	ablativocaso
ksah	proximidad
tsah	demostrativo
ko	cláusuladelacola
pyah	pero
wi	universalcuantificador
ji	femeninogénero
pu	pluralnúmero
bi	futurotiempo
co	socialcontexto
me	imperfectiveaspecto
klah	allí
twah	relativocaso
twih	ilativocaso
di	directivaestadoanimico
tlah	electivocuantificador
kyah	qué
tcah	preguntapalabra
ja	cópula
cyah	lapersona
clah	otro
do	número
tlih	positivocuantificador
se	horacontexto
myah	temporalcaso
tyuh	sólo
tcih	hortativeestadoanimico
tyih	retrospectivoaspecto
lo	volitivoestadoanimico
cwah	después
nlah	alienableposesión
nlih	inalienableposesión
cyih	deliberativoestadoanimico
lwah	perlativecaso
pfih	progresivoaspecto
tsih	aquí
ce	debajocontexto
pcah	además
lwih	delativecaso
swah	semelfactiveaspecto
nyih	neo
fu	atención
plah	amor
po	paucalnúmero
kyih	porque
ksih	causalcaso
gi	nombre
tfah	apropiadosustantivo
crih	visibleprobatorio
kceh	mejor
dwih	desiderativoestadoanimico
wo	palabra
srah	Hastaque
tweh	terminativecaso
nwih	inesivocaso
pcih	imperativoestadoanimico
crah	creer
ro	estadocontexto
cwih	esperanza
kwih	Factiveprobatorio
fi	regreso
psih	optativoestadoanimico
tseh	potencialestadoanimico
lweh	allativocaso
nrih	antrópicogénero
tceh	mismotemamarcador
re	diferentetema
croh	miedo
mrah	comprender
cyuh	duda
twuh	dubitativoestadoanimico
myih	hermosa
lyih	interesar
flah	contrafactualcondicional
we	vialiscaso
clih	frío
pyih	paz
su	excepto
kwah	deseo
le	largo
bo	probabilidad
mlah	problema
syah	sonrisa
slih	dormir
zi	citado
twoh	decitacióncaso
mo	inclusivolapersona
kcih	Porfavor
rwih	precativeestadoanimico
mrih	Cortésregistro
rwah	futuroaspecto
cyeh	preguntarse
go	gnomicaspecto
tsoh	elrespeto
za	incoativoaspecto
jwih	yusivoestadoanimico
mwih	permisivoestadoanimico
sloh	éxito
prih	privado
de	distributivocaso
tcoh	dolor
ryah	risa
mlih	sabio
ye	posesivomarcador
ke	comisivosestadoanimico
creh	vano
mweh	definitivoaspecto
nrah	calentar
nroh	enfado
bwah	despecho
trah	orgullo
mroh	moral
slah	salud
syih	social
pe	cesaciónaspecto
krih	curioso
tfih	intensificador
fe	finalmente
prah	aparte
trih	probatorio
nwah	probatoriocaso
srih	triste
zo	zoicogénero
nweh	eventivoestadoanimico
cwoh	mismoeventomarcador
plih	multiplicativocaso
dwah	deseado
kcoh	cansado
drah	satisfecho
lu	especulativoestadoanimico
frih	familiarregistro
frah	herido
mruh	engañar
djih	simpatía
krah	gracias
cruh	vergüenza
fyah	frasemarcador
ryih	preordenada
kruh	amargo
tyeh	texto
kreh	cruel
tleh	hesternaltiempo
kfah	sacrificio
dyih	odio
cloh	racionalgénero
nloh	disfrutar
psah	desesperación
sleh	vegetalgénero
nruh	inocente
drih	admiración
sroh	perdón
brih	base
kluh	confusión
bwih	bendiciónestadoanimico
klih	culpable
grih	ignorante
nyeh	iniciativacaso
nleh	humilde
dlih	retrasadoimperativo
proh	reportadoprobatorio
mloh	melancolía
du	singular
jrih	paciencia
freh	referencial
kloh	solitaria
kroh	encanto
tcuh	entusiasmo
kcuh	inductivoestadoanimico
xa	discursocontexto
nreh	nervioso
pseh	aspecto
ge	agente
mu	amonestaciónestadoanimico
byah	ambición
pcoh	llenodegente
treh	directoprobatorio
yo	aprensivoestadoanimico
cwuh	choque
tloh	recientepasadotiempo
dlah	definidoartículo
cluh	feo
myuh	humor
dyah	distaldemostrativo
rwuh	celoso
troh	imprecatorioestadoanimico
dzih	indiferencia
swuh	assumptiveestadoanimico
bzah	broma
gwih	asaber
dloh	hodiernotiempo
dweh	delimitativeaspecto
kweh	exclusivolapersona
truh	latemperatura
tfeh	télicaaspecto
lyeh	atelicaspecto
ru	prohibitivoestadoanimico
kfih	infantil
cyoh	suspicaz
nluh	lealtad
cweh	trampa
nwoh	animado
sruh	emoción
ksoh	sexual
lyah	perezoso
mreh	momentaneaspecto
pceh	lamentar
bjih	exfallecido
pcuh	incertidumbre
xi	habitualaspecto
blih	encerrado
tsuh	trivial
fwih	majestuoso
grah	halagüeño
brah	arbitrario
cleh	benevolente
sreh	formalregistro
pfah	beneficioso
droh	auditivoprobatorio
flih	inferencialprobatorio
sweh	Sublativecaso
ksuh	declarativoestadoanimico
pleh	privilegiado
psoh	invencible
be	verbal
mwoh	ensueño
kleh	miseria
glah	codicia
kseh	afirmativoestadoanimico
zrah	insatisfacción
dyoh	idiophone
syoh	awed
gwah	excesivocaso
zlih	irrealisestadoanimico
zrih	timidez
byih	adaptación
ryeh	pronombremarcador
fwah	frugal
bjah	extático
kxah	ecuanimidad
gvih	pegativecaso
pxih	vindicación
xrah	expirando
tfoh	enlosucesivo
kxih	arrepentimiento
ryoh	prosecutivecaso
qyah	preocupación
r6	participio
txah	remotopasadotiempo
xrih	históricotiempo
dxah	dualnúmero
syuh	súper
vweh	conexcesodetrabajo
n6	sensorialprobatorioestadoanimico
bweh	obsesión
xlih	divertidísimo
txih	punzada
sluh	autosatisfecho
txoh	movimientocuestaarriba
xe	retrospectivo
pxah	entrampar
vwah	movimientocuestaabajo
xyih	élite
fleh	declinada
psuh	superessivecaso
syeh	sátiro
qi	transitivo
xruh	acobardarse
zwah	Guau
tr6h	movimientoríoarriba
qwah	sinambición
xlah	entodoelmundo
tyoh	intransitivo
tluh	anticlímax
qa	corrientepertinenciamarcador
kxoh	perrocansado
rwoh	ordinal
ve	vector
kyoh	kilo
swoh	secuencial
pxeh	partitivocaso
txeh	aumentativo
dxih	predicativo
pxoh	prolativecaso
pfoh	Profrase
blah	hastiado
fyih	nohumano
xo	actorpapel
pc6h	pruebanúmero
greh	céntricocaso
groh	Goldesencadenar
dxoh	mediovoz
rweh	oblicuocaso
xwah	pacientecaso
xu	hodiernopre
xroh	aldesgasteacabo
ks6h	causante
vi	binary-valor
dleh	modalcaso
gjeh	else-if
xreh	compañerodetrabajo
lwoh	locativocaso
ml6h	multalnúmero
gjih	galaxiagénero
qlah	estrellagénero
bvih	abessivecaso
dvah	adesivocaso
je	agentivacaso
t6	agentedesencadenar
kxeh	acaso
gxih	comúngénero
tc6h	citaciónformar
ts6h	transnúmero
ryuh	directoobjeto
gveh	ergativecaso
pyoh	pasivovoz
qe	finitoverbo
xwih	primarioobjeto
myoh	gnomicestadoanimico
vrih	finalpartícula
va	evitativecaso
bveh	subessivecaso
dxeh	poseídocaso
dvih	lativecaso
tsa7h	antessivecaso
dyeh	adverbialcaso
mleh	animargénero
pfeh	empáticoalegría
xleh	vehículogénero
qlih	mineralgénero
xloh	verbalsustantivo
dreh	segundoidioma
bvah	yoconfianza
qrah	cambiodeevento
fo	diferenteevento
sl6h	crastinaltiempo
fyoh	reflexivovoz
bxih	universogénero
jlih	transitivoverbo
kyeh	localidadgénero
txuh	investigacióngénero
s6	artísticogénero
preh	pacientedesencadenar
sr6h	abstractogénero
nyoh	indirectohabla
zreh	exocéntricacaso
kfeh	pasadoperfectivo
jo	impersonalverbo
kxuh	colectivosustantivo
bu	absolutivecaso
qrih	planetariogénero
kfoh	núcleobenefactivo
kwoh	deasociacióncaso
pluh	superlativocaso
jrah	eléctricocorriente
glih	inanimadogénero
p6	propositivaestadoanimico
vrah	recíprocovoz
lyuh	sucesivocláusula
gleh	prontofuturotiempo
lyoh	aplicativovoz
ps6h	antipasivavoz
tfuh	continuativasaspecto
nr6h	necessitativeestadoanimico
pr6h	pasivoparticipio
sy6h	existencialcláusula
qyih	luminosointensidad
gluh	singulativonúmero
kwuh	excesivoduración
xyah	solteroacciónverbo
vlih	superlativolalicenciatura
djah	presenteparticipio
m6	cantidaddesustancia
ti7	conectivopartícula
f6	epentéticomorfema
tli7h	remotofuturotiempo
si_	postposicionalcaso
l6	alocuciónacuerdo
k6	frecuentativoaspecto
bzih	distributivopronombre
tu7	depuntoflotantedenúmeros
vo	verbo-sufijo
ki7	pasadopasivoparticipio
ta_	locativodireccionalcaso
