ﺭﺪﺼﻣ: ﺖﻳﺎﻬﻧﻲﺑ, ﺖﯾﺎﻬﻧﯽﺑ, ﺐﺴﻧﻭﻞﺻﺍ, ﻊﺒﻨﻣ
ﯽﻠﻋﺎﻓﺩﺭﻮﻣ: ﻪﻓﺎﺿﺍﻑﺮﺣﺩﺭﻮﻣ
ﯽﻣﺎﻬﺗﺍﺩﺭﻮﻣ: 
ﻉﻮﺿﻮﻣﺩﺭﻮﻣ: ﻉﻮﺿﻮﻣﺩﺭﻮﻣ
ﻦﯾﺪﻟﺍﻭ: ﯽﻨﯾﺪﻟﺍﻭ, ﮒﺭﺰﺑ, ﺪﺷﺭﺍ, ﺝﺎﻨﻔﺳﺍ
ﺭﺪﭘ: ﺭﺪﭘ
ﺭﺩﺎﻣ: ﺭﺩﺎﻣ, ﺭﺩﺎﻣ, ﯼﺭﺩﺎﻣ
ﺩﻭﺭﺩ: ﻆﻓﺎﺣﺍﺪﺧ, ﻡﻼﺳ, ﯽﻫ
ﺪﺟ: ﻒﻠﺳ, ﮒﺭﺰﺑﺎﺑﺎﺑ
ﻩﺪﺟﺎﯾﺪﺟ: ﮒﺭﺰﺑﺎﺑﺎﺑ, ﮒﺭﺰﺑﺭﺩﺎﻣ
ﻪﻨﺳﺮﮔ: ﯽﮕﻨﺳﺮﮔ, ﻥﺩﺮﻣﯽﮕﻨﺳﺮﮔﺯﺍ
ﻪﯿﻟﺍﻑﺎﻀﻣﺖﻟﺎﺣﺩﺭﻮﻣ: ﻪﯿﻟﺎﻓﺎﻀﻣﺩﺭﻮﻣ
ﺖﻔﺻ: 
ﻭ: ﻉﻮﻤﺠﻣ, ﻂﺳﻮﺗ, 
ﻦﻣﻪﺑ: ﻡﺩﻮﺧ, ﻦﻣ, ﻦﻣ, ﺎﻣ, ﻥﺪﯿﺴﯿﻟ
ﺎﻤﺷ: ﺎﻬﻧﺁ, ﻮﺗ, ﻮﺗ, ﻪﻠﺑ
ﺎﻣ: ﺎﻣ, ﺎﻣ, ﺎﻣﻝﺎﻣ
IT: ﻭﺍ, ﻪﮐ, ﻭﺍ, ﻦﯾﺍ, ﺎﻬﻨﯾﺍ, ﻪﮐ
ﺪﺼﻘﻣﺩﺭﻮﻣ: ﻑﺪﻫﺩﺭﻮﻣ
ﯽﻟﻮﻌﻔﻣﺖﻟﺎﺣﺩﺭﻮﻣ: 
REALISﺖﻟﺎﺣ: 
deonticﺖﻟﺎﺣ: 
ﻁﻭﺮﺸﻣﺖﻟﺎﺣ: ﯽﻃﺮﺷﻪﺟﻭﺖﻟﺎﺣ, ﯽﺿﺮﻓﺖﻟﺎﺣ
ﯽﺘﻓﺮﻌﻣﺖﻟﺎﺣ: 
ﻪﻠﯿﺳﻭﺩﺭﻮﻣ: 
ﯽﻠﺧﺍﺩﻪﻨﯿﻣﺯ: 
ﺺﺨﺷﻪﻨﯿﻣﺯ: 
ﻪﺘﺴﺑﺍﻭﺪﻨﺑ: 
perfectiveﻪﺒﻨﺟ: 
ﻪﺘﺷﺬﮔﺖﻔﺳ: 
ﻪﻧﺍﺩﺮﻣﺲﻨﺟ: ﯽﺜﻨﺧﺲﻨﺟ
comitativeﺩﺭﻮﻣ: 
ﺮﺿﺎﺣﺖﻔﺳ: 
benefactiveﺩﺭﻮﻣ: 
essiveﺩﺭﻮﻣ: 
ﻪﻧ: ﺮﯿﺧ, ﺮﯿﻏ, ﯽﺘﺨﺳﻪﺑ, ﻥﺍﻮﺗﺎﻧ, ﺮﯿﻗ, ﺰﮔﺮﻫ, ﻪﻧﻭ, ﭻﯿﻫ, ﺎﺘﺒﺴﻧ, ﮏﯾﭻﯿﻫ, ﻥﺍﻮﺗﯽﻤﻧ, ﻥﺩﺍﺩﺖﺳﺩﺯﺍ
ﻥﺁ: ﻥﺎﺷ, ﺩﻮﺧ, ﻭﺍ, ﺍﺭﻭﺍ, ﻥﺁ, ﻭﺍ..., ﺯﺍ, ﻪﮐ, ﻞﻘﺘﺴﻣ
ﺢﻄﺳﻪﻨﯿﻣﺯ: 
adpositionalﺩﺭﻮﻣ: 
ﻞﺤﻣﺩﺭﻮﻣ: 
ﺎﻀﻓﻪﻨﯿﻣﺯ: 
ﺮﯿﺴﻣﺩﺭﻮﻣ: 
ﯽﺸﺳﺮﭘﺖﻟﺎﺣ: 
ﻭﺎﯾ: 
ﺎﯾﺩﺮﻓﻪﺑﺮﺼﺤﻨﻣ: 
ﻊﺒﻨﻣﺩﺭﻮﻣ: 
ﻊﻓﺍﺭﺩﺭﻮﻣ: 
ﯽﺸﯾﺎﻤﻧ: ﺪﻣﺎﺟ, ﻪﺟﻮﺗﻞﺑﺎﻗ, ﻦﺘﺑ, ﻩﺪﻨﻨﮐﺪﻋﺎﻘﺘﻣ, ﺩﻮﻤﻨﻫﺭ, ﯽﺸﯾﺎﻤﻧ, ﻥﺎﯿﺑ, ﺮﻫﺎﻇ, ﻥﺎﯿﺑ
ﺎﻣﺍ: ﻥﻮﻨﮐﺎﺗ, ﺎﻣﺍ, ﻪﭼﺮﮔ, ﻪﻜﻨﻳﺍﺎﺑ, ﻑﺎﺻﻭﺍﻦﯾﺍﺎﺑ
ﻪﻤﻫ: ﺲﮐﺮﻫ, ﯽﺴﮐﺮﻫ, ﻊﻤﺟ, ﻡﺎﻤﺗ, ﯽﻠﮐﺭﻮﻃﻪﺑ, ﻡﺎﻤﺗ, ﯼﺰﯿﭼﺮﻫ, ﺮﻫ, ﻩﺪﻨﯾﺍﺰﻓﺭﻮﻃﻪﺑ, ﻉﻮﻤﺠﻣ
ﻪﻧﺎﻧﺯﺲﻨﺟ: 
ﺎﻬﻧﺁ: ﺎﻬﻧﺁ, ﻭﺍ, ﻥﺁ, ﻥﺎﺷ, ﯽﻧﺎﻣﺩﻮﺧ, ﯽﮔﺩﺍﻮﻧﺎﺧﻡﺎﻧ, ﺎﻬﻨﯾﺍ, ﻥﺎﺴﮑﯾ, ﻪﻧﻻﺩﺎﻋ, ﻢﻫﻪﯿﺒﺷ, ﻪﺑ
ﻊﻤﺟﺩﺪﻋ: 
ﮏﯾ: ﺎﻬﻨﺗ, , ﻪﺑ, ﺲﮐﯽﺑ, , ﻥﺩﺯﺭﻭﺩ, ﺎﻣﺍ
ﯽﺴﮐﻪﭼ: ﯽﺴﮐ, ﻪﮐﯽﺴﮐﺮﻫ, ﻪﮐ, ﻪﮐ, ﻪﻟﺰﻨﻣﻪﺑ, ﻪﮐ, ﻱﺰﻴﭼﺮﻫ, ﯽﺼﺨﺷﺮﻫ, ﻪﮐ, ﻥﺎﺷ, ﻥﺁ, ﻥﺪﻧﺍﻮﺧ, ﻪﻠﺑ
ﻩﺪﻨﯾﺁﺖﻔﺳ: 
ﯽﻋﺎﻤﺘﺟﺍﻪﻨﯿﻣﺯ: 
ﯽﻧﺎﻣﺯﻪﭼ: ﻪﮐﻥﺎﻣﺯﺮﻫ, ﻪﺸﯿﻤﻫ
ﺏﻮﯿﻌﻣﻪﺒﻨﺟ: 
ﺎﺠﻧﺁ: ﺩﻮﺟﻭ, ﻪﺒﻨﺷﺞﻨﭘ
ﺶﯿﺑ: ﺮﺑﻎﻟﺎﺑ, ﻦﯾﺮﺘﺸﯿﺑ, ﺮﺘﺸﯿﺑ, ﺮﺗﺍﺮﻓ, ﻻﺎﺑﻑﺮﻄﺑ, ﻻﺎﺑﻑﺮﻄﺑ, ﺪﻨﭼ, ﻪﺑﺖﺒﺴﻧ, ﺎﺘﺒﺴﻧ, ﻦﯿﻨﭽﻤﻫ, ﻦﯾﺍﺮﺑﻩﻭﻼﻋ, ﻩﻭﻼﻌﺑ, ﺯﻮﻨﻫ, ﻥﻮﻨﮐﺎﺗ, ﯼﺮﮕﯾﺩ, ﺪﻨﭼ, ﻦﯾﺪﻨﭼ, ﺮﮕﯾﺩ, ﺕﺭﻮﺻﻦﯾﺍﺮﯿﻏﺭﺩ, ﺮﮕﯾﺩ, ﯽﻗﺎﺑ
ﺝﺭﺎﺧ: ﺯﺍﺝﺭﺎﺧ, ﯽﻧﻭﺮﯿﺑ, ﯽﺟﺭﺎﺧ, ﻝﺰﻨﻣﺯﺍﺝﺭﺎﺧ, ﻪﻧﺎﺧﺯﺍﻥﻭﺮﯿﺑ, ﺵﻮﻣﺎﺧ, ﺯﺍﺝﺭﺎﺧ, ﺮﺗﺍﺮﻓ, ﻻﺎﺑ, ﺮﺑ, ﯼﻭﺭﺮﺑ, ﻮﻠﺟ, ﮎﺮﺗ, ﺝﻭﺮﺧ
ﯽﻠﯿﻣﺎﻓﺖﺒﺴﻧﺩﺭﻮﻣ: ﯽﻠﯿﻣﺎﻓﺖﺒﺴﻧﺩﺭﻮﻣ
ﯽﻃﺎﺒﻨﺘﺳﺍﺩﺭﻮﻣ: 
ﻡﺎﺠﻧﺍ: ﻦﺘﺧﺎﺳ, ﻥﺩﺍﺩﻡﺎﺠﻧﺍ, ﻦﺘﻓﺮﮔﻩﺪﻬﻌﺑ, ﻪﺋﺍﺭﺍ, ﻥﺩﺮﮐﻝﺎﻌﻓ, ﺩﺍﺩﻡﺎﺠﻧﺍ, ﺐﮑﺗﺮﻣ, ﻥﺩﺍﺩﺭﺍﺮﻗ, ﯽﭼ, ﻥﺩﺍﺩﻥﺎﺸﻧﺶﻨﮐﺍﻭ, ﻱﺰﻴﭼﺮﻫ, ﻪﭼ, ﻪﭼﺮﻫ, ﻥﺩﺮﮐﺭﺎﮐ
ﺩﻮﻤﻨﻫﺭﺖﻟﺎﺣ: ﻩﺪﻨﻫﺩﻥﺎﺸﻧﺖﻟﺎﺣ
ﻝﺍﻮﺳﻪﻤﻠﮐ: 
ﻂﺑﺍﺭﻮﻀﻋ: ﻝﺎﺼﺗﺍ, ﻪﺿﺮﻗﻕﺍﺭﻭﺍ, ﻪﺘﺳﺩ, ﻥﺩﺍﺩﻁﺎﺒﺗﺭﺍ
ﺺﺨﺷ: ﻥﺎﺴﻧﺍ, ﺎﻫﻥﺎﺴﻧﺍ, ﯼﺩﺮﻓ, ﯽﺴﮐ, ﯽﺴﮐ, ﺩﺮﻣ, ﻥﺎﺴﻧﺍ, ﺕﺭﻮﺻ, ﺖﯿﺼﺨﺷ, ﺍﺭﻭﺍ, ﺎﻬﻧﺁ, ﺎﺼﺨﺷ, ﻩﺩﺎﯿﭘﺮﺑﺎﻋ, ﺭﺎﮑﻤﻫ
ﺮﻧ: ﻪﻧﺍﺩﺮﻣ, ﻩﺭﺎﺷﺍ, ﺎﻗﺁ, ﻥﺎﺴﻧﺍ, ﻢﯾﻼﻣ, ﻥﺯ
ﺖﺳﺍﻪﺘﺴﻧﺍﻮﺗ: ﻥﺍﻮﺗﯽﻣ, ﻦﮑﻤﻣ, ﻻﺎﻤﺘﺣﺍ, ﺪﯾﺎﺷ, ﯼﺮﯾﺬﭘﻥﺎﮑﻣﺍ, ﻝﺎﻤﺘﺣﺍ, ﺖﺳﺍﻦﮑﻤﻣ, ﻦﮑﻤﻣ, ﺭﺩﺎﻗ
ﺩﺪﻋ: ﻥﺍﺰﯿﻣ, ﻉﻮﻤﺠﻣ, ﻞﮑﺷ, ﯼﺩﺪﻋ, ﺩﺪﻋ, ﺭﺍﺪﻘﻣ, ﻩﺭﺎﻤﺷ
ﺭﺎﯿﺴﺑ: ﯼﺩﺎﯾﺯﺪﺣﺎﺗ, ﯽﻠﯿﺧ, ﺭﻮﺟﺪﺑ, ﺭﺎﯿﺴﺑ, ﻢﻫ, ﯽﮐﺎﻨﺘﺸﺣﻭ, ﻩﺩﺮﺘﺴﮔﺭﻮﻃﻪﺑ, ﺭﺎﯿﺴﺑ, ﺎﻌﻗﺍﻭ, ﺪﺑ, ﻢﯿﻈﻋ, ﯽﻬﺟﻮﺗﻞﺑﺎﻗﺭﻮﻄﺑ, ﺭﺎﯿﺴﺑ, ﺪﻨﭼ, ﻩﺩﺎﻌﻟﺍﻕﻮﻓ, ﻦﯾﺮﺘﺸﯿﺑ, ﻼﻣﺎﮐ, ﻪﻧﺎﻔﺼﻨﻣ, ﺭﺎﯿﺴﺑ, ﺭﺎﯿﺴﺑ, ﻪﺷﺎﺑ, ﻪﺷﺎﺑ, ﺏﻮﺧﯽﻠﯿﺧ, ﻁﺮﻔﻣ, ﻢﺧﺯ, ﻥﺍﻭﺍﺮﻓ, ﻩﺮﻈﺘﻨﻣﺮﯿﻏ, ﻩﺩﺎﻌﻟﺍﻕﻮﻓ, ﯽﻟﺎﻋ, ﻒﯿﻌﺿ, ﺕﺪﺷﻪﺑ, ﺕﺪﺷﻪﺑ
ﻥﺎﻣﺯ: ﻦﯿﺣﺭﺩ, ﻪﻈﺤﻟ, ﻥﺎﯾﺮﺟﺭﺩ, ﻊﻗﻮﻤﺑ, ﻥﺎﻣﺯﺕﺪﻣ, ﯽﻧﺎﻣﺯ, ﻥﺎﻣﺯ, ﯽﻧﺎﻣﺯﻝﻭﺪﺟ, ﯽﻧﺎﻣﺯﻩﺭﻭﺩ, ﺍﻮﻫ, ﻩﺪﻧﻮﺷﺭﺍﺮﮑﺗ, ﺖﻋﺎﺳ, ﻩﺮﻈﻨﻣ
ﻥﺎﻣﺯﻪﻨﯿﻣﺯ: 
ﯽﻧﺎﻣﺯﺩﺭﻮﻣ: 
ﻩﺭﺎﺑﺭﺩ: ﺖﺑﺎﺑﺯﺍ, ﻩﺭﺎﺑﺭﺩ, ﺎﺒﯾﺮﻘﺗ, ﺩﻭﺪﺣﺭﺩ, ﺯﺍ, ﻂﺳﻮﺗ, ﻪﺑﺖﺒﺴﻧ, ﻑﺍﺮﻃﺍﺭﺩ, ﯼﺍﺮﺑ, ﺮﺑ, ﺎﺒﯾﺮﻘﺗ, ﺎﺒﯾﺮﻘﺗ, ﺰﯿﭼ, ﻡﺍﺮﺘﺣﺍ, ﻞﺼﻓ, ﻭﺭﺍﺩ
ﯽﻈﻔﻠﻟﺍﺖﺤﺗ: ﺎﻨﯿﻋ, ﯽﻌﻗﺍﻭ, ﯽﻠﺻﺍ, ﻖﻠﻄﻣ, ﯽﻫﺎﻔﺷ, ﯽﺑﺩﺍ, ﻖﯿﻗﺩ, ﻖﯿﻗﺩ, ﻖﯿﻗﺩ
ﻂﻘﻓ: ﻂﻘﻓ, ﺎﻬﻨﺗ, ﻩﺩﺎﺳﻥﺎﺑﺯﻪﺑ, ﻥﺩﺮﻛﻩﺭﺎﺷﺍ, ﺾﺤﻣ, ﺎﻓﺮﺻ, ﺩﻭﺪﺤﻣ, ﯽﺘﺨﺳﻪﺑ, ﺰﻣﺮﻗﻪﺑﻞﯾﺎﻣﺥﺮﺳ, ﺲﮐﯽﺑ, ﺖﺨﻟ
ﯽﻤﮐﺭﺍﺪﻘﻣ: ﮏﭼﻮﮐ, ﮏﭼﻮﮐ, ﮎﺪﻧﺍ, ﯽﻤﮐ, ﻩﺭﺫ, ﯽﺋﺰﺟ, ﺩﺮﺧ, ﮏﭼﻮﮐ, ﻞﻤﺣﻞﺑﺎﻗ, ﺭﺎﻤﺷﺖﺸﮕﻧﺍ, ﮏﺒﺳ, ﻩﺎﺗﻮﮐﺪﻗ
ﻊﻗﻮﻣﻥﻭﺍ: ﻮﻧﺯﺍ, ﻪﻠﺑ, ﻥﻮﭼ, ﺶﯿﭘ, ﻥﺍﺪﺳ, ﺪﻌﺑ, ﻥﺁﺯﺍﺪﻌﺑ, ﺩﻮﺟﻭﻦﯾﺍﺎﺑ, ﻥﺁﺯﺍﺪﻌﺑ, ﺐﻗﺎﻌﺘﻣ, ﺎﺒﻗﺎﻌﺘﻣ, ﺯﺍﺪﻌﺑ
ﺰﯿﻣﺍﺖﺤﯿﺼﻧﺖﻟﺎﺣ: 
ﺮﮕﻧﻪﺘﺷﺬﮔﻪﺒﻨﺟ: 
ﯽﻟﺎﻋ: ﮒﺭﺰﺑ, ﮒﺭﺰﺑ, ﺐﯿﺠﻧ, ﯼﺪﺟ, ﻊﯿﺳﻭ, ﺪﻨﻠﺑﯼﺍﺪﺻﺎﺑ, ﻢﯿﻈﻋ, ﻝﻮﻏ, ﻢﯿﻈﻋ, ﺐﻟﺎﻏ, ﺏﻮﺧ, ﺏﻮﺧ, ﻪﺟﻮﺗﻞﺑﺎﻗ, ﮒﺭﺰﺑ, ﻪﺟﻮﺗﻞﺑﺎﻗ, ﺰﯿﮕﻧﺍﺖﻔﮕﺷ, ﯽﻟﺎﻋ, ﻪﻨﯿﻬﺑ, ﮒﺭﺰﺑ, ﮒﺭﺰﺑ, ﻞﻣﺎﮐ, ﻪﺟﻮﺗﺐﻟﺎﺟ, ﻥﺎﺸﺧﺭﺩ, ﻪﻨﺗ, ﻭﺮﮐﺎﻣ
volitiveﺖﻟﺎﺣ: 
ﺯﺍﻞﺒﻗ: ﯽﻠﺒﻗ, ﺶﯿﭘ, ﺶﯿﭘ, ﻞﺒﻗ, ﻪﮑﻨﯾﺍﺎﺗ, ﺎﺗ, ﻮﻠﺟ, ﻖﺑﺎﺳ, ﺮﺑﺍﺮﺑﺭﺩ, ﻞﺑﺎﻘﻣﺭﺩ, ﻮﻠﺟﻪﺑ, ﻥﺩﺮﺑﺶﯿﭘ, ﺮﺗﺭﻭﺩ, ﺶﯿﭘﺭﺩ, ﯽﻠﺒﻗ, ﻼﺒﻗ
ﺪﯾﺎﺑ: ﺪﯾﺎﺑ, ﺎﻣﻭﺰﻟ, ﯼﺭﻭﺮﺿﺮﯿﻏ, ﺪﯾﺎﺑ, ﻦﺘﺷﺍﺩﻡﺯﻻ, ﺪﯾﺎﺑ, ﺪﯾﺎﺑ, ﺪﯿﻫﺍﻮﺧﯽﻣ, ﺪﯾﺎﺑ
ﻭﺩ: ﻭﺩ, ﻭﺩﺮﻫ, ﺍﺪﺟ, ﺮﻫﻮﺷﻭﻥﺯ
ﻥﺪﯾﺩ: ﻦﮐﻩﺎﮕﻧ, ﺯﺍﺪﻧﺍﻢﺸﭼ, ﻩﺮﻈﻨﻣ, ﻉﻼﻃﺍ, ﮎﺭﺩ, ﻥﺩﺮﮐﺎﺷﺎﻤﺗ, ﻥﺩﺮﮐﻩﺎﮕﻧﻝﺯﻝﺯ, ﺪﯿﻨﮐﻪﻌﺟﺍﺮﻣ, ﺕﺎﻗﻼﻣ
ﻦﺘﺴﻧﺍﺩ: ﻡﻮﻠﻌﻣ, ﻊﻠﻄﻣ, ﺵﺯﻮﻣﺁ, ﻢﭼﺮﭘ, ﺖﯾﻭﺭﻞﺑﺎﻗ, ﻦﮐﮎﺭﺩ
ﻦﯿﯾﺎﭘ: ﻦﯿﯾﺎﭘﻪﺑﻭﺭ, ﻦﯿﯾﺎﭘﻪﺑﻭﺭ, ﺮﯾﺯ, ﺮﯾﺯﺭﺩ, ﺮﯾﺯﺭﺩ, ﺮﯾﺯﺭﺩ, ﺮﺘﻤﮐ, ﻦﯿﯾﺎﭘ, ﺖﺴﭘ, ﻦﯿﯾﺎﭘﻪﻘﺒﻃ
ﻝﻭﺍ: ﺭﺎﮐﺯﺎﻏﺍ, ﻪﯿﻟﻭﺍ, ﻥﻮﭼ, ﺪﻌﺑ, ﻻﻭﺍ, ﺍﺪﺘﺑﺍﺭﺩ
ﺩﻮﺧ: ﺩﻮﺧ, ﺕﺩﻮﺧ, ﯼﺍﺭﺍﺩ, ﺎﺼﺨﺷ, ﺩﻮﺧ, ﺩﻮﺧ, ﺩﻮﺧ, ﯽﺼﺨﺷ
ﻝﺎﻘﺘﻧﺍﻞﺑﺎﻗﻦﺘﺷﺍﺩﺭﺎﯿﺘﺧﺍﺭﺩ: 
ﺍﺰﺠﺘﯾﻻﻦﺘﺷﺍﺩﺭﺎﯿﺘﺧﺍﺭﺩ: 
ﯽﻤﯾﺪﻗ: ﺪﺷﻩﺩﺎﻔﺘﺳﺍ, ﯽﻧﺎﺘﺳﺎﺑ, ﻦﺴﻣ, ﻦﺴﻣﺩﺍﺮﻓﺍ, ﻖﺑﺎﺳ, ﻖﺑﺎﺳ, ﻦﺳ, ﯽﻠﺒﻗ, ﻒﻠﺳ
ﯽﺗﺭﻮﺸﻣﺖﻟﺎﺣ: 
ﺯﻭﺭ: ﻪﻧﺍﺯﻭﺭ, ﺪﯿﻫﺩﻩﺯﺎﺟﺍ, ﻥﺩﺮﮐﺭﺎﮐ, ﺮﻣﺍ, ﺭﺎﮐ
ﻪﮐﯽﯾﺎﺟ: ﻪﮐﺎﺠﮐﺮﻫ, ﻥﺁﺐﺟﻮﻣﻪﺑ, ﻥﺩﺍﺩﯼﺎﺟ
ﺎﯿﺑ: ﻪﺑ, ﺎﺗ, ﻪﺑﻥﺪﯿﺳﺭ, ﺩﻭﺭﻭ, ﻥﺪﯿﺳﺭ, ﻥﺪﺷ, ﻦﺘﺳﻮﯿﭘﻉﻮﻗﻭﻪﺑ
ﺮﯿﺴﻣ: ﺵﻭﺭ, ﯽﺳﺎﻨﺷﺵﻭﺭ, ﻩﺎﮕﺷﺩﺮﮔ, ﯼﺎﻨﻌﻣﻪﺑ, ﺮﯿﺴﻣ, ﺮﯿﺴﻣ, ﻪﻟﺎﺳﺭ, ﻩﺎﮔﺭﺬﮔ, ﻪﻟﺎﺒﻧﺩ, ﺵﻭﺭ, ﻩﺩﺎﺟ, ﻥﺎﺑﺎﯿﺧ, ﺪﻨﻗ, ﺮﯿﺴﻣ, ﺮﯿﺴﻣ, ﺕﺩﺎﻋ, ﻪﻧﻮﮕﭼ, ﺪﻨﯾﺁﺮﻓ, ﺖﻟﺎﺣ, ﻩﺪﯿﻘﻋ
ﺭﺎﮐ: ﺭﺎﮐ, ﯼﺭﺍﺬﮔﺍﻭ, ﻝﺎﻌﻓ, ﻪﻔﯿﻇﻭ, ﺭﺎﮐ, ﺭﺎﮐ, ﯼﺍﻪﻓﺮﺣ, ﺩﺮﮑﻠﻤﻋ, ﻞﻤﻋ, ﯽﻌﺑﺎﺗ, ﺕﺭﺎﺠﺗ, ﻞﻤﻋ, ﻥﺩﺮﮐﺭﺎﮐ, ﻡﺍﺪﺨﺘﺳﺍ, ﯼﺍﻪﻓﺮﺣ, ﻥﺩﺮﮐﺭﺎﮐ, ﯼﺮﻨﻫﺮﺛﺍ
ﺭﺍﺩﺍﺪﺻﻑﺮﺣ: ﻑﻭﺮﻌﻣ, ﯽﮔﺪﻧﺯ, ءﺎﻘﺑ, ﯽﯾﺎﺠﺑﺎﺟ, ﺖﮐﺮﺣ, ﮏﯿﻓﺍﺮﺗ, ﺎﺒﻔﻟﺍ, ﺐﻟﺎﻗ
ﻦﺘﻓﺭ: ﻦﺘﻓﺭﻩﺍﺭ, ﻪﯾﺍﺮﮐ, ﮎﺮﺗ, ﺖﻤﯾﺰﻋ, ﺕﺮﺟﺎﻬﻣ
perlativeﺩﺭﻮﻣ: 
ﯽﻗﺮﺘﻣﻪﺒﻨﺟ: 
ﯽﻧﻻﻮﻃ: ﺕﺪﻣﯽﻧﻻﻮﻃ, ﻡﺍﻭﺩﺎﺑ, ﺪﻨﻠﺑ, ﻩﺍﺮﻤﻫ, ﯽﻧﺎﻣﺯﻩﺭﻭﺩ, ﺮﺼﻋ, ﻥﺎﻣﺯ, ﺭﻭﺩ, ﻥﺪﯿﺸﮐﺮﯾﻮﺼﺗ
ﻦﺘﻔﮔ: ﯼﺭﺎﺘﻔﮔ, ﻪﺑ, ﻦﺘﻔﮔﻦﺨﺳ, ﯽﮔﺪﻨﯾﺎﻤﻧ, ﻁﺎﺒﺗﺭﺍ, ﺪﻧﻮﺷﯽﻣﻩﺪﯿﻣﺎﻧ
ﯽﺘﺣ: ﻦﯿﻨﭽﻤﻫ, ﻢﻫ, ﻪﮑﻨﯾﺍﺎﺗ, ﺎﺗ, ﻦﯾﺍﺮﺑﻩﻭﻼﻋ, ﻢﻫ, ﺐﯿﺗﺮﺗﻦﯿﻤﻫﻪﺑ, ﺮﺘﺸﯿﺑ, ﻦﯾﺍﺮﺑﻩﻭﻼﻋ, ﺩﻮﺧ
ﺖﺸﮔﺯﺎﺑ: ﺖﺸﭘ, ﺐﻘﻋ, ﺐﻘﻋﻪﺑ, ﻪﻧﻭﺭﺍﻭ, ﺖﺸﮔﺮﺑ, ﻥﺪﻧﺍﺩﺮﮔﺯﺎﺑ, ﻥﺩﺮﮐﻞﻃﺎﺑ, ﻮﻧﺯﺍ, ﻥﺩﺮﮐﺭﺍﺮﮑﺗ, ﺶﯿﭘ, ﺎﺑﻖﺑﺎﻄﻣ, ﻥﺪﯿﺸﮐﺭﺎﻨﮐ, ﻦﺘﻓﺎﯾﺩﻮﺒﻬﺑ, ﯽﺑﺎﯾﺯﺎﺑ
ﺎﺠﻨﯾﺍ: ﺭﺩ
ﺮﮑﻓ: ﺮﮑﻔﺗ, ﺮﮑﻓ, ﻦﺘﻓﺮﮔﺮﻈﻧﺭﺩ, ﻦﮐﺭﻮﺼﺗ, ﺭﻮﺼﺗ, ﻥﺩﺮﮐﺮﮑﻔﺗ, ﺍﺭ, ﺪﻧﻮﺷﯽﻣﻩﺪﯿﻣﺎﻧ, ﻦﻫﺫ, ﺱﺎﺴﺣﺍ, ﺪﺳﺭﯽﻣﺮﻈﻧﻪﺑ, ﻥﺩﺍﺩﻥﺎﺸﻧ, ﻪﺟﻮﺗ
ﺮﻫ: ﯼﺰﯿﭼﺮﻫ, ﮏﺗﮏﺗ, ﺮﻫ, ﻪﮐ, ﯼﻮﺳﻪﺑ, ﺮﻫﺭﺩ, ﯽﺴﮐﺮﻫ, ﺝﺮﺨﻣ, ﻡﺎﻤﺗ, ﻂﺳﻮﺘﻣ
ﻪﺘﺷﺬﮔ: ﻥﺎﯾﺎﭘ, ﯽﻣﻭﺩ, ﯽﯾﺎﻬﻧ, ﯽﯾﺎﻬﻧ, ﺮﮕﯾﺩ, ﯼﺮﮕﯾﺩ, ﻦﯾﺮﺧﺁ, ﺮﯿﺧﺍ, ﻥﺎﯾﺎﭘ, ﻪﺘﺷﺬﮔ, ﻞﻤﺤﺗ, ﻪﻣﺍﺩﺍ, ﯽﻠﺒﻗ, ﺮﯾﺩ
ﺮﯾﺯﻪﻨﯿﻣﺯ: 
ﻦﺘﻓﺮﮔ: ﺭﺮﮑﻣﺪﻣﺁﻭﺖﻓﺭ, ﻝﺎﻐﺷﺍ, ﯽﺸﮐﺍﻭ, ﺫﺎﺨﺗﺍ, ﻦﺘﻓﺮﮔ, ﻦﺘﻓﺮﮔ, ﻥﺩﺮﻛﺖﻓﺎﻳﺭﺩ, ﺪﯿﻨﮐﺏﺎﺨﺘﻧﺍ, ﻦﺘﻓﺮﮔ, ﻦﺘﻓﺮﮔ, ﮊﺭﺎﺷ, ﺪﯿﻨﮐﺪﯿﯾﺎﺗ, ﺍﺭ, ﻞﻤﺣ, ﻦﺘﺨﯾﺭﻥﻭﺮﯿﺑ, ﺖﺳﺍﻮﺧﺭﺩ, ﻥﺩﺍﺩﺹﺎﺼﺘﺧﺍ, ﯽﻠﻤﻋ
ﻩﺪﺷﺍﺪﯿﭘ: ﻥﺩﺮﮐﺍﺪﯿﭘ, ﻥﺩﺮﻛﻒﺸﻛ, ﻒﺸﮐ, ﻒﺸﮐ, ﺱﺮﺘﺳﺩﺭﺩ, ﻦﺘﻓﺮﮔ, ﺕﺎﻗﻼﻣ
ﺖﺳﺩ: ﻭﺯﺎﺑ, ﺖﺳﺩﭻﻣ, ﺡﻼﺳ
ﻥﺍﻮﺟ: ﻥﺎﻧﺍﻮﺟ, ﺮﺘﻫﺯﺎﺗ, ﻥﺍﻮﺟﻮﻧ, ﻥﺍﻮﺟﻮﻧ, ﺪﯾﺪﺟ
ﻥﺩﺍﺩ: ﻥﺩﺍﺩﺽﺮﻗ, ﺪﻨﮐﯽﻣﻢﻫﺍﺮﻓ, ﺩﺎﻬﻨﺸﯿﭘ, ﻥﺩﺭﻭﺁﻢﻫﺍﺮﻓ, ﻪﺋﺍﺭﺍ, ﻪﺋﺍﺭﺍ, ﻦﺘﺷﺍﺩﺖﻋﺎﻄﺘﺳﺍ, ﻥﺩﺍﺩﺭﺍﺮﻗ, ﻥﺩﺮﮐﺍﺪﻫﺍ, ﺪﯿﻫﺩﻩﺯﺎﺟﺍ, ﻥﺩﺮﮐﺎﻄﻋﺍ, ﻩﺰﯾﺎﺟ, ﯼﺎﻫﺭﻭﺩ, ﻪﺧﺮﭼ, ﻥﺩﺮﮐﺭﺍﺮﻗﺍ, ﻥﺩﻮﺑﺭﺎﮑﻫﺪﺑ
ﺍﺪﺧ: ﯽﻬﻟﺍ
delativeﺩﺭﻮﻣ: 
ﯽﭼﭻﯿﻫ: ﯼﺰﯿﭼﻪﯾ, ءﯽﺷ, ﺲﮑﭽﯿﻫ, ﻱﺰﻴﭼﺮﻫ, ﭻﯿﻫ, ﺲﻛﭻﻴﻫ, ﺯﺍﯽﺧﺮﺑ, ﺭﺎﻤﺷﺖﺸﮕﻧﺍ, ﯽﻀﻌﺑ, ﯼﺪﺣﺎﺗ
ﺖﺳﺭﺩ: ﺖﻔﺟ, ﺖﺳﺭﺩ, ﺖﻗﺩ, ﻪﻧﻻﺩﺎﻋ, ﺖﻟﺍﺪﻋ, ﻩﺪﺷﻞﯾﺪﻌﺗ, ﻪﻧﺎﻔﺼﻨﻣﺮﯿﻏ, ﻂﯾﺍﺮﺷﺪﺟﺍﻭ, ﻖﺣ, ﻥﻮﻧﺎﻗ, ﺖﺳﺭﺩ, ﺖﺳﺭﺩ, ﯽﻀﻌﺑ, ﻢﺸﭼﯼﻭﺭﻪﺑ, ﻥﺩﺎﻬﻧﻡﺎﻧ, ﻲﺑﻮﺧﻪﺑ, ﻥﺎﯿﻣﺭﺩ, ﺯﺍﯽﺷﺎﻧ, ﺐﺳﺎﻨﻣ, ﯽﺘﺳﺭﺩﻪﺑ, ﺐﺳﺎﻨﻣ, ﺐﺳﺎﻨﻣ
ﺭﺎﺑﮏﯾ: ﻪﻠﺻﺎﻓﻼﺑ, ﮓﻧﺭﺩﯽﺑ, ﺵﻭﺭ, ﻮﮕﻟﺍ, ﯽﺳﺎﻨﺷﺵﻭﺭ
semelfactiveﻪﺒﻨﺟ: 
ﺩﺮﮐﮎﺮﺗ: ﺭﻭﺩ, ﻥﺩﺮﮐﮎﺮﺗ, ﺰﯿﺧﻭﺖﺴﺟ
ﺶﺨﺑ: ﺶﺨﺑ, ﯼﺍﻩﺯﺍﺪﻧﺍﺎﺗ, ﺶﺨﺑ, ﯼﺪﺣﺎﺗ, ﻪﺘﺴﺑ, ﺮﺴﮐ, ﺶﺨﺑ, ﻢﻬﺳ, ﻩﺭﺫ, ﻪﻌﻄﻗ, ﺭﻮﺒﻋ, ﻪﻋﻮﻤﺠﻣﺮﯾﺯ, ﻞﺼﻓ, ﺶﺨﺑ, ﺖﻤﺴﻗ, ﻲﺋﺰﺟ, ﺶﺨﺑ, ﺶﺨﺑ, ﺶﺨﺑ, ﺖﺒﺴﻧ, ﯽﮔﺪﻨﯾﺎﻤﻧ, ﻥﺩﺮﮐﺖﮐﺮﺷ, ﯽﻣﻮﺘﻧﺍﻮﮐ
ﻪﻧﺎﺧ: ﻪﻧﺎﺧ, ﻞﺤﻣ, ﺪﺒﻌﻣ, ﻦﮑﺴﻣ, ﻝﺰﻨﻣﻡﺯﺍﻮﻟ
ﻥﺎﻬﺟ: ﻩﺯﻮﺣ, ﯽﻧﺎﻬﺟ, ﻥﺎﻬﺟ
ﺮﺳ: ﻥﺍﻮﻨﻋ, ﯽﻠﺻﺍ, ﺲﯿﺋﺭ, ﻞﺼﻓ, ﺮﺒﻫﺭ, ﺭﻮﻬﻤﺟﺲﯿﺋﺭ, ﺲﯿﺋﺭ, ﺮﯾﺪﻣ, ﺲﻴﺋﺭ, ﻢﻠﻗ, ﺩﺭﺩﺮﺳ, ﻮﻣ
ﻪﺳ: ﻡﻮﺳ, ﻦﯿﻤﻬﻧ, ﺕﺎﯿﻟﺎﻣ
ﺰﮐﺮﻤﺗ: ﻩﺪﺷﻪﺘﻓﺮﮔﺮﻈﻧﺭﺩ, ﻦﺘﻓﺮﮔﻪﻧﺎﺸﻧ, ﻑﺪﻫ, ﻑﺪﻫ, ﻦﺘﺷﺍﺩﺰﮐﺮﻤﺗ, ﻪﺟﻮﺗ, ﺰﮐﺮﻤﺗ, ﺍﺮﮕﻤﻫ, ﺯﺍﺪﻧﺍﻢﺸﭼ
ﻖﺸﻋ: ﺖﺒﺤﻣ, ﻪﻗﺪﺻ, ﺪﻨﻧﺎﻣ, ﻥﺪﺷﻪﻟ
ﻪﺸﯿﻤﻫ: ﻪﺸﯿﻤﻫﯼﺍﺮﺑ, ﻡﻭﺍﺪﻣﺭﻮﻃﻪﺑ, ﻪﺸﯿﻤﻫ
ﺐﺷ: ﺐﺷ, ﻡﺎﺷ, ﺮﻬﻇﺯﺍﺪﻌﺑ, ﺐﺸﻣﺍ
ﻩﺎﺷﺩﺎﭘ: ﺖﻨﻄﻠﺳ, ﺪﻧﻭﺍﺪﺧ, ﻩﺎﺷﺩﺎﭘ, ﻢﻬﻣﯽﻠﯿﺧﺭﺍﺩﻪﯾﺎﻣﺮﺳ, ﻩﺩﺍﺰﻫﺎﺷ
ﻦﯿﺑ: ﻥﺎﯿﻣﺭﺩ, ﻥﺎﯿﻣﺭﺩ, ﺯﺍ, ﺭﺩﻪﮐ, ﻪﺑ, ﺩﻭﺪﺣﺭﺩ،ﻞﺧﺍﺩﺭﺩ, ﻂﺳﻮﺘﻣ, ﻪﻤﯿﻧ, ﻥﺎﯾﺮﺟﺭﺩ
ﺐﻠﻗ: ﻥﺩﺮﮐﻖﯾﻮﺸﺗ, ﻩﺪﻨﻨﮐﻡﺮﮕﻟﺩ, ﯽﻧﻮﮕﻧﺮﺳ, ﺮﻧﻭﺮﮐﻕﻭﺮﻋ
paucalﺩﺪﻋ: 
ﺍﺮﯾﺯ: ﺯﺍﯽﺷﺎﻧ, ﻥﻮﭼ, ﺩﺭﻮﻣ, ﺩﻮﺷﯽﻣﺐﺒﺳ, ﻞﯿﻟﺩ
ﯽﺒﺒﺳﺩﺭﻮﻣ: 
ﻡﺎﻧ: ﯽﮔﺩﺍﻮﻧﺎﺧﻡﺎﻧ, ﻢﺳﺍ, ﺕﺭﺎﻬﻣ
ﺐﺳﺎﻨﻣﻢﺳﺍ: 
ﺭﻮﺸﮐ: ﺖﻠﻣ, ﻦﯿﻣﺯ, ﻦﯿﻣﺯ, ﻥﺩﺍﺩﺡﺮﺷءﺰﺟﻪﺑءﺰﺟ, ﻦﯿﻣﺯ, ﮎﺎﺧ, ﺏﺰﺣ, ﺮﻬﺷﻪﻣﻮﺣ
ﻪﺘﺳﺍﻮﺧ: ﻥﺪﯿﺳﺮﭘ, ﺕﺭﻮﺸﻣ, ﻢﯿﻫﺍﻮﺧﯽﻣ, ﺶﺳﺮﭘ
ﺖﯾﻭﺭﻞﺑﺎﻗﯽﮐﺭﺪﻣ: 
ﺮﺘﻬﺑ: ﺮﺗﺮﺑ, ﻦﯾﺮﺘﻬﺑ, ﯽﻟﺎﻋ, ﻝﺁﻩﺪﯾﺍ, ﻪﺘﺴﺟﺮﺑ, ﺮﺘﺸﯿﺑ, ﺮﺗﺭﻭﺩ, ﺏﻮﺧ
ﺖﻤﺳ: ﯽﺒﻧﺎﺟ, ﻒﻄﻟ, ﻒﻄﻟ, ﯽﮔﺪﻨﯾﺎﻤﻧ, ﻥﺩﺯﺭﻭﺩ, ﻪﺤﻔﺻ, ﻪﺒﻨﺟ, ﻢﯿﻧ, ﻞﮑﺷ, ﯼﻮﺳﻪﺑ, ﺭﺎﻨﻛﺭﺩ, ﺯﺍﻪﺘﺷﺬﮔ
ﻩﺭﻭﺩ: ﯽﻠﯿﺼﺤﺗﻪﻣﺎﻧﺮﺑ, ﺱﺭﺩ, ﯽﻧﺍﺮﻨﺨﺳ, ﺎﻌﻄﻗ, ﺎﻤﻠﺴﻣ, ﺎﻌﻄﻗ, ﺥﺮﻧ, ﺮﯿﺴﻣ, ﻦﺌﻤﻄﻣ
ﯽﻓﺎﮐ: ﯽﻓﺎﮐ, ﯽﻓﺎﮐﻩﺯﺍﺪﻧﺍﻪﺑ, ﯽﻓﺎﮐ, ﻥﺍﻭﺍﺮﻓ, ﻪﻧﺎﻔﺼﻨﻣ, ﻥﺍﻭﺍﺮﻓ, ﯽﻓﺎﮐ, ﻼﻣﺎﮐ, ﺭﺎﯿﺴﺑ, ﻪﺟﻮﺗﻞﺑﺎﻗ, ﯽﻬﺟﻮﺗﻞﺑﺎﻗﺭﻮﻄﺑ, ﻪﺟﻮﺗﻞﺑﺎﻗ, ﻪﻈﺣﻼﻣﻞﺑﺎﻗﺭﻮﻃﻪﺑ, ﯼﺍﻪﻈﺣﻼﻣﻞﺑﺎﻗ, ﻝﻮﻘﻌﻣ, ﻥﺩﺍﺩﺭﺍﺮﻗ, ﻼﻣﺎﮐ
ﯼﺩﻭﺯﻪﺑ: ﯽﻫﺎﺗﻮﮐﺕﺪﻣ, ﻊﯾﺮﺳ, ﮓﻧﺭﺩﯽﺑ, ﺖﻋﺮﺳﻪﺑ, ﻊﯾﺮﺳ, ﯼﺭﻮﻓ, ﻊﯾﺮﺳ, ﻪﻠﺠﻋ, ﯼﺭﻮﻓ, ﻦﯾﺍﺮﺑﺎﻨﺑ, ﻪﻠﺻﺎﻓﻼﺑ, ﯽﻧﺎﺳﺁﻪﺑ, ﮏﯾﺩﺰﻧ, ﻪﯿﻟﻭﺍ, ﯽﻧﺎﻬﮔﺎﻧﻭﻢﮑﺤﻣﻪﺑﺮﺿ
ﻩﺪﺷﺮﭘ: ﻼﻣﺎﮐ, ﯽﻓﺎﮐﻩﺯﺍﺪﻧﺍﻪﺑ, ﻖﻠﻄﻣ, ﻞﯿﻤﮑﺗ, ﺺﻗﺎﻧ, ﻡﺎﻤﺗ, ﻼﻣﺎﮐ, ﻖﯿﻗﺩ, ﻖﻠﻄﻣ, ﺎﻘﯿﻗﺩ, ﻞﻣﺎﮐ, ﻡﺎﻤﺗ, ﻊﻣﺎﺟ, ﻩﺯﺍﺪﻧﺍ, ﻼﻣﺎﮐ, ﻞﻣﺎﮐﺕﺭﻮﺻﻪﺑ, ﻼﻣﺎﮐ, ﺪﯿﺳﺭﻥﺎﯾﺎﭘﻪﺑ, ﻩﺪﺷﻡﺎﺠﻧﺍ, ﻥﺩﺍﺩﻡﺎﺠﻧﺍ, ﯽﻨﻤﺿ, ﻡﺎﺠﻧﺍ, ﻥﺩﺮﮐﻪﯿﻬﺗ
ﻕﺎﺗﺍ: ﻕﺎﺗﺍ, ﻡﺭﺎﻬﭼ, ﺏﺍﻮﺧﻕﺎﺗﺍ, ﺢﻠﺻ, ﻪﭘﻮﮐ, ﺭﺎﺒﻧﺍ, ﻖﻤﻋ
ﺏﺍ: ﻊﯾﺎﻣ, ﻊﯾﺎﻣ, ﻪﺿﻮﺣ
desiderativeﺖﻟﺎﺣ: 
ﮏﺒﺳ: ﺶﺑﺎﺗ, ﻦﺷﻭﺭ, ﻊﻤﺷ, ﮎﺪﻧﺍ, ﮏﺒﺳ, ﮏﺒﺳ, ﻩﺪﯾﺮﭘﮓﻧﺭ, ﺢﺿﺍﻭ, ﻦﺷﻭﺭﺯﻭﺭ, ﻪﺋﺍﺭﺍ
ﻩﮊﺍﻭ: ﯼﻮﻐﻟ, ﺍﺪﺻ, ﻥﺎﮔﮊﺍﻭ, ﺕﺭﺎﺒﻋ, ﻞﻌﻓ, ﻢﺳﺍ, ﯼﺪﻨﺑﻪﻠﻤﺟ, ﺕﺪﻣ
ﺏﺭﺩ: ﯼﺩﻭﺭﻭﺭﺩ, ﻩﺎﮔﺭﺩ, ﺩﻭﺭﻭ, ﻞﺼﻓ, ﺭﺪﻨﺑ, ﻝﺎﺗﺭﻮﭘ
ﻥﺩﺮﮐﻩﺩﺎﻔﺘﺳﺍ: ﻩﺩﺎﻔﺘﺳﺍ, ﻩﺩﺎﻔﺘﺳﺍ, ﻑﺮﺼﻣ, ﻪﻨﯾﺰﻫ, ﻩﺪﻨﻨﻛﻑﺮﺼﻣ, ﻥﺩﺮﮐﻝﻮﻐﺸﻣ, ﺭﺍﺰﻓﺍﻡﺮﻧ, ﺭﺍﺰﺑﺍ, ﺖﺳﺍﻮﺧﺭﺩ, ﻡﺍﺪﺨﺘﺳﺍ, ﻥﺩﺮﮐﻑﺮﺼﻣ
ﺢﺒﺻ: .ﺢﺒﺻ, ﻪﻧﺎﺤﺒﺻ
ﯽﻌﻄﻗﺩﺭﻮﻣ: 
ﺕﺭﺪﻗ: ﻡﺎﮑﺤﺘﺳﺍ, ﯼﮊﺮﻧﺍ, ﻦﮑﻤﻣ, ﯼﻮﻗ, ﻥﺩﺮﻛﺭﻮﺒﺠﻣ, ﺪﻨﻤﺗﺭﺪﻗ, ﺎﯾﻮﭘ, ﺩﻻﺎﺳ, ﻂﻠﺴﺗ, ﻦﺘﺷﺍﺩﺭﺎﯿﺘﺧﺍ
ﻥﺎﺷﺩﻮﺧ: ﻥﺎﻣﺩﻮﺧ, ﺕﺩﻮﺧ, ﺩﻮﺧ, ﻡﺩﻮﺧ, ﺵﺩﻮﺧ, ﺩﻮﺧ, ﺩﻮﺧ, ﺲﻔﻧ, ﺲﮐﯽﺑ
ﺍﺪﺻ: ﺍﺪﺻ, ﺪﻨﻠﺑﯼﺍﺪﺻﺎﺑ, ﯼﺍﺭﻪﻗﺭﻭ, ﯽﻌﻤﺳ, ﯼﺍﺭ, ﺩﺭﻮﻣ, ﻪﻌﯾﺎﺷ, ﻪﻌﯾﺎﺷ, ﺍﺪﺻﻭﺮﺳ
ﺪﯿﻔﺳ: ﯽﻟﺎﺧﯼﺎﺟ, ﺖﯾﺎﮑﺷ
ﻝﻮﭘ: ﺕﻭﺮﺛ, ﻩﺮﻘﻧ, ﯽﻟﺎﻣ, ﺪﻘﻧ, ﻝﻮﭘﺪﺣﺍﻭ, ﯽﯾﺍﺭﺍﺩ, ﯽﻟﻮﭘ
ﺪﻌﺑ: ﺭﺎﻨﻛﺭﺩ, ﺭﺎﻨﮐﺭﺩ, ﺐﻨﺟ, ﻥﺩﺮﮐﻝﺎﺒﻧﺩ, ﺪﻌﺑ, ﺪﻌﺑ, ﺪﻌﺑ, ﺐﻗﺎﻌﺘﻣ, ﺯﺍﺪﻌﺑ, ﻥﺁﺯﺍﺪﻌﺑ, ﺎﺒﻗﺎﻌﺘﻣ, ﻥﺁﺯﺍﺪﻌﺑ, ﻮﻠﺟ, ﻮﻠﺟﻪﺑ, ﺮﺗﺭﻭﺩ, ﺶﯿﭘﺭﺩ, ﻪﻣﺍﺩﺍ
ﺮﯿﻘﻓ: ﻭﺯﺎﺑ, ﯽﻟﻮﭘﯽﺑ, ﺪﺑ, ﻒﯿﻌﺿ
ﮒﺮﻣ: ﺮﯿﻣﻭﮒﺮﻣ, ﮒﺮﻣﻝﺎﺣﺭﺩ, ﻥﺎﺟﯽﺑ
ﻥﺪﺷﻞﻴﻜﺸﺗ: ﻞﮑﺷ, ﺐﻟﺎﻗ, ﺐﻟﺎﻗ, ﻞﺻﺎﻓﺪﺣ, ﻮﮕﻟﺍ, ﻪﻋﺭﺰﻣ, ﻞﮑﺷ, ﯽﺳﺎﻨﺷﺖﺨﯾﺭ
inessiveﺩﺭﻮﻣ: 
ﺮﮕﯾﺪﮑﯾﺎﺑ: ﻥﺎﻣﺰﻤﻫﺭﻮﻄﺑ, ﻩﺍﺮﻤﻫ, ﮎﺮﺘﺸﻣ, ﯽﻌﻤﺟ, ﻢﯿﻈﻨﺗ, ﺭﺎﻨﮐﺭﺩ, ﯽﮕﺘﺳﻮﯿﭘ, ﻦﺘﺨﯿﻣﺁ
ﻩﺩﺎﻣ: ﺩﺭﻮﻣ, ﺮﻣﺍ, ﺰﯿﭼ, ﻩﺪﯾﺪﭘ, ﻪﻠﺌﺴﻣ, ﻩﺩﺎﻣ, ﻩﺩﺎﻣ, ﻉﻮﺿﻮﻣ, ﻪﻟﺎﺴﻣ, ﻝﺍﻮﺳ, ﺰﯿﭼ, ﻉﻮﺿﻮﻣ, ﺐﻟﺎﺟ
ﻊﻗﺍﻮﻣﺮﺘﺸﯿﺑ: ﺎﺒﻟﺎﻏ, ﻡﻭﺍﺪﻣﺭﻮﻃﻪﺑ, ﺐﺗﺮﻣﺭﻮﻃﻪﺑ, ﺭﺮﮑﻣ, ﺎﻣﻮﻤﻋ, ﻝﻮﻤﻌﻣﺭﻮﻃﻪﺑ, ﻻﻮﻤﻌﻣ
ﺖﺳﻭﺩ: ﺪﺤﺘﻣ, ﺮﺴﭘﺖﺳﻭﺩ, ﺭﺎﮑﻤﻫ, ﺮﺴﻤﻫ, ﻪﺘﺴﺑﺍﻭ
ﺐﯿﺗﺮﺗ: ﻢﺘﺴﯿﺳ, ﺐﯿﺗﺮﺗ, ﻥﺩﺍﺩﺐﯿﺗﺮﺗ, ﯼﺭﺎﮐﺩﺍﺩﺭﺍﺮﻗ, ﻪﯾﺍﺭﺁ, ﻥﺎﻣﺮﻓ, ﻥﺩﺯﺭﻭﺩ, ﻒﯾﺩﺭ, ﻒﺻ, ﻪﻟﺎﺒﻧﺩ, ﯽﭘﺭﺩﯽﭘ, ﻥﺩﺮﻛﺕﻮﻋﺩ, ﻦﯾﺍﺮﺑﺎﻨﺑ, ﺪﯿﻫﺩﻩﺯﺎﺟﺍ, ﻥﺩﺮﮐﺏﺎﻨﺘﺟﺍ, ﻥﺩﺮﮐﯽﺠﻫ
ﯼﺭﻭﺮﺿﯼﺮﻣﺍﺖﻟﺎﺣ: 
ﺩﺮﮔ: ﻩﺪﺷﺩﺮﮔ, ﻩﺮﯾﺍﺩ, ﻥﺩﺮﮐﭗﻠﺷﭗﻠﺷ, ﻩﺮﮐ
ﻦﺘﺷﺍﺩﻩﺎﮕﻧ: ﻦﺘﺷﺍﺩﻪﮕﻧ, ﻦﺘﺷﺍﺩﻪﮕﻧ, ﯽﻧﺎﺣﻭﺭﺮﯿﻏ, ﻥﺩﺍﺩﺭﺍﺮﻗ, ﻢﯿﻈﻨﺗ, ﺮﯿﻤﺧ, ﻆﻔﺣ, ﻥﺩﺮﮐﺖﻈﻓﺎﺤﻣ, ﻥﺩﺮﮐﻝﻮﻐﺸﻣ, ﺪﻨﻧﺎﻣ, ﻆﻔﺣ, ﺖﻇﺎﻔﺣ, ﻆﻔﺣ, ﺖﺷﺍﺩﺯﺎﺑ, ﻥﺪﯿﺒﺴﭼ, ﻥﺩﺮﮐﺖﻣﺎﻗﺍ, ﻥﺪﻧﺎﻣ, ﺪﺷﺖﺳﺭﺩ, ﯼﺭﺍﺪﻬﮕﻧ
ﻥﺯ: ﺮﺴﻤﻫ, ﻥﺯ
ﻦﺘﺷﺍﺩﺩﺎﻘﺘﻋﺍ: ﺩﺎﻤﺘﻋﺍ, ﻥﺩﺮﮐﺏﺎﺴﺣﯼﺰﯿﭼﯼﻭﺭ, ﺽﺮﻓ, ﻥﺎﻤﯾﺍ, ﺭﻭﺎﺑ, ﺲﻔﻧﻪﺑﺩﺎﻤﺘﻋﺍ, ﻦﺌﻤﻄﻣ, ﯽﻨﯿﺑﺵﻮﺧ, ﻦﯿﺑﺵﻮﺧ, ﯽﮕﺘﺴﺑﺍﻭ
ﮏﯾﺩﺰﻧ: ﻥﺩﺮﮐﯽﻃ, ﺭﺎﻨﻛﺭﺩ, ﺎﺒﯾﺮﻘﺗ, ﻑﺍﺮﻃﺍﺭﺩ, ﻦﺘﺴﺑ, ﺎﺒﯾﺮﻘﺗ, ﺭﻭﺎﺠﻣ, ﺎﺒﯾﺮﻘﺗ, ﮏﯾﺩﺰﻧ, ﻝﺎﻤﯾﺰﮔﻭﺮﭘ, ﻪﯾﺎﺴﻤﻫ, ﻪﯾﺎﺴﻤﻫ
ﻡﺩﺮﻣﻡﻮﻤﻋ: ﯽﻣﻮﻤﻋ, ﺭﺎﻀﺣ, ﺞﯾﺍﺭ, ﺎﻣﻮﻤﻋ
ﺖﻟﺎﺣﻪﻨﯿﻣﺯ: 
ﺮﺴﭘﺪﻧﺯﺮﻓ: ﻡﺎﺣﺩﺯﺍ, ﺮﺴﭘ
ﺪﺻ: ﻡﺪﺻﮏﯾ, ﺕﺭﻮﺻ, ﺪﺻﺭﺩ, ﻥﺮﻗ
ﺎﻫﻪﭽﺑ: ﻪﭽﺑ, ﺪﻧﺯﺮﻓ, ﻞﻔﻃ, ﮎﺩﻮﮐ
ﺐﯿﺗﺮﺗﻦﯾﺪﺑ: ﻪﺠﯿﺘﻧﺭﺩ, ﻦﯾﺍﺮﺑﺎﻨﺑ, ﻭﺭﻦﯾﺍﺯﺍ, ﻦﯿﻨﭼ, ﻪﻠﺑ, ﻭﺭﻦﯾﺍﺯﺍ
ﺪﯿﻣﺍ: ﻥﺩﺮﮐﻭﺯﺭﺁ, ﺯﺍﺪﻧﺍﻢﺸﭼ, ﯽﻨﯿﺑﺶﯿﭘ, ﯽﻨﯿﺑﺵﻮﺧ, ﻦﯿﺑﺵﻮﺧ, ﺩﻭﺭﯽﻣﺭﺎﻈﺘﻧﺍ, ﺭﺎﻈﺘﻧﺍ, ﺭﺎﻈﺘﻧﺍ
ﻻﺎﺑﺭﺩ: ﻻﺎﺑ, ﺮﺑﻎﻟﺎﺑ, ﺎﻫﻪﻠﭘﺯﺍ, ﻻﺎﺑ, ﻻﺎﺑ, ﻪﺘﻓﺮﺸﯿﭘ, ﻻﺎﺑ, ﻥﺎﯿﻣﺭﺩ, ﻩﺭﺎﺑﺭﺩ, ﻖﻳﺮﻃﺯﺍ, ﺮﺑ, ﺮﺳﯼﻻﺎﺑﺭﺩ, ﯼﻭﺭﺮﺑ, ﺶﯿﭘﺭﺩ
ﺰﯾﺰﻋ: ﻖﺷﺎﻋ, ﻥﺍﺮﮔ
ﻥﺪﻧﺍﻮﺧ: ﺖﺋﺍﺮﻗ, ﻥﺪﻧﺍﻮﺧ, ﻖﺒﻧﺯ, ﻩﺪﻨﻧﺍﻮﺧ
ﻥﺎﺘﺳﺮﻬﺷ: ﺮﻬﺷ, ﯼﺭﺍﺩﺮﻬﺷ, ﻥﺎﺘﺳﺮﻬﺷ, ﯼﺮﻬﺷ
ﻼﺒﻗ: ﻥﺩﻮﺑﻩﺩﺎﻣﺁ, ﻩﺪﺷﻩﺩﺎﻣﺁ, ﻞﯾﺎﻣ, ﻝﺎﺣﺮﻫﻪﺑ, ﺶﯿﭘ
ﺖﯿﻌﻗﺍﻭ: ﺖﻘﯿﻘﺣ, ﺖﯿﻌﻗﺍﻭ, ﯽﯾﻮﮕﻘﺣ, ﺖﺳﺭﺩ, ﯽﻌﻗﺍﻭ, ﯽﻌﻗﺍﻭ, ﻊﻗﺍﻭﺭﺩ, ﺎﻌﻗﺍﻭ, ﻊﻗﺍﻭﺭﺩ, ﺩﺍﺩﻡﺎﺠﻧﺍ
factiveﯽﮐﺭﺪﻣ: 
ﺮﺘﺧﺩ: ﻥﺯﺖﻣﺪﺨﺸﯿﭘ, ﺮﺘﺧﺩﺪﻧﺯﺮﻓ, ﻥﺯ, ﻢﻧﺎﺧ, ﺮﺘﺧﺩﺖﺳﻭﺩ, ﺲﮐﯽﺑ
ﻥﺪﯿﻨﺷ: ﻩﺪﺑﺵﻮﮔ, ﯽﯾﺍﻮﻨﺷ, ﺱﺎﺴﺣﺍ
ﻦﯾﺮﺘﻤﮐ: ﻞﻗﺍﺪﺣ, ﻞﻗﺍﺪﺣ, ﻥﺪﻧﺎﺳﺭﻞﻗﺍﺪﺣﻪﺑ, ﯼﺎﻬﻨﻣ, ﺮﺘﻤﮐ, ﻦﯾﺮﺗﻦﯿﯾﺎﭘ, ﻦﯾﺮﺘﺸﯿﺑ, ﻦﯾﺮﺘﻬﺑ, ﻦﯾﺮﺗﻻﺎﺑ, ﻪﻨﯿﻬﺑ
ﺪﯾﺎﺷ: ﺪﯾﺎﺷ, ﺪﯾﺎﺷ, ﻻﺎﻤﺘﺣﺍ, ﻦﮑﻤﻣ, ﻻﺎﻤﺘﺣﺍ, ﻦﮑﻤﻣ, ﺩﺭﺍﺩﻝﺎﻤﺘﺣﺍ, ﯽﻟﺎﻤﺘﺣﺍ, ﺍﺮﻫﺎﻇ
ﻦﮐﺯﺎﺑ: ﺢﺿﺍﻭ, ﻩﺩﺎﺳ, ﯽﻨﺷﻭﺭﻪﺑ, ﺖﺨﻟ, ﺺﺨﺸﻣﺭﻮﻃﻪﺑ, ﯽﻟﺎﺧ, ﺢﯾﺮﺻ, ﺢﺿﺍﻭ, ﻝﺰﻨﻣﺯﺍﺝﺭﺎﺧ, ﺩﻮﺒﻤﮐ, ﻩﺩﺮﭘﯽﺑ, ﻦﺘﺷﺍﺬﮔﺽﺮﻌﻣﺭﺩ, ﺭﺎﺑ, ﻦﺘﺧﺎﺳﺭﺎﮑﺷﺁ
ﻥﺪﺑ: ﺖﺷﻮﮔ, ﯽﻧﺪﺑ, ﯽﮑﯾﺰﯿﻓ, ﯽﻤﺴﺟﻅﺎﺤﻟﺯﺍ, ﻢﺴﺟ, ﻮﻀﻋ, ﺪﺴﺟ
ﺍﻮﻫ: ﺩﺎﺑ, ﻢﯿﺴﻧ, ﯼﺩﺭﻮﻧﺍﻮﻫ, ﺍﻮﻫ, ﯽﯾﺎﻤﯿﭘﺍﻮﻫ, ﺯﺍﻭﺮﭘ
ﺖﻌﯿﺒﻃ: ﯽﻌﯿﺒﻃ, ﯽﻣﻮﺑ, ﯽﻌﯿﺒﻃﺭﻮﻃﻪﺑ, ﺐﺴﻧﻭﻞﺻﺍ, ﻝﻭﺰﻧ, ﯽﻣﻮﺑ, ﯽﺸﺣﻭﺕﺎﻧﺍﻮﯿﺣ, ﺖﯿﺼﺨﺷ
ﮏﻤﮐ: ﯼﺭﺎﮑﻤﻫ, ﺪﯿﻔﻣ, ﮏﻤﮐ, ﺖﻧﻭﺎﻌﻣ, ﺭﺎﯿﺘﺳﺩ, ﯽﻧﺎﺣﻭﺭﺮﯿﻏ, ﻦﯿﮑﺴﺗ
ﻪﻣﺎﻧ: ﻞﯿﻤﯾﺍ, ﻪﻣﺎﻧﺮﺳ, ﻪﺘﺷﻮﻧ
ﺭﺎﻬﭼ: ﻡﺭﺎﻬﭼ
ﯽﯾﺎﻨﻤﺗﺖﻟﺎﺣ: ﯽﻃﺮﺷﻪﺟﻭﺖﻟﺎﺣ
ﯼﺯﻮﺳﺶﺗﺁ: ﻡﺮﮔ, ﻪﻠﻌﺷ, ﺐﺗ, ﯼﺭﺎﺨﺑ, ﺍﺩﻮﺑ
ﻥﺩﺮﮐﺩﺍﺯﺁ: ﯼﺩﺍﺯﺁ, ﯼﺩﺍﺯﺍ, ﻑﺎﻌﻣ, ﻥﺎﮕﯾﺍﺭ, ﻩﺩﻮﻬﯿﺑ, ﻪﻧﺍﺩﺍﺯﺁ, ﯽﻟﺎﺧ, ﻪﻧﺍﺩﺍﺯﺁ, ﻥﺩﺮﮐﺩﺍﺯﺁ
ﮓﻨﺟ: ﺩﺮﺒﻧ, ﻩﺯﺭﺎﺒﻣ, ﻥﺩﺮﮐﻩﺯﺭﺎﺒﻣ, ﮓﻨﺟﻥﺍﺪﯿﻣ, ﻦﺘﻓﺮﮔﯽﺘﺸﮐ
ﻦﯿﻣﻭﺩ: ﺮﮕﯾﺩ, ﻭﺩﺮﻫ, ﺎﺑﻖﺑﺎﻄﻣ, ﺮﮕﯾﺩ, ﻡﻭﺩﻪﻠﺣﺮﻣﺭﺩ
ﺪﺤﺘﻣ: ﺩﺮﻔﻣ, ﺕﺪﺣﻭ, ﻞﻣﺎﺷ, ﻪﯾﺩﺎﺤﺗﺍ, ﺪﺤﺘﻣ, ﺪﺤﺘﻣ, ﺩﺮﻔﺑﺮﺼﺤﻨﻣ, ﻝﻮﻘﻟﺍﻖﻔﺘﻣ, ﮎﺮﺘﺸﻣ, ﺐﮐﺮﻣ, ﻑﻼﺘﺋﺍ, ﻥﻮﯿﺳﺍﺭﺪﻓ
ﻥﺩﺯﮓﻧﺯ: ﺶﻟﺎﭼ, ﻥﺩﺯﮓﻧﺯ, ﺖﺳﺍﻮﺧﺭﺩ, ﺮﺑ, ﻝﺎﺼﺗﺍ, ﺐﯿﮐﺮﺗ, ﮎﺮﺘﺸﻣ, ﻡﺎﻏﺩﺍ, ﻪﻣﺎﻧﺕﻮﻋﺩ, ﺮﻤﻋﻝﻮﻃ, ﻮﮕﺘﻔﮔ, ﻦﻔﻠﺗ
ﯽﭼﻪﺳﺍﻭ: ﻢﻫﻪﯿﺒﺷ, ﻪﺑﺎﺸﻣﺭﻮﻃﻪﺑ
ﻩﺪﺷﻢﮐ: ﻥﺎﯾﺯ, ﻥﺩﺍﺩﺖﺳﺩﺯﺍ, ﻢﮔ, ﻥﺪﺷﺪﯾﺪﭘﺎﻧ
ﺭﺍﺰﻫ: ﻡﺭﺍﺰﻫ, ﺎﻫﺱﺎﺒﻟ, ﻪﭼﺭﺎﭘ
ﻩﺩﺍﻮﻧﺎﺧ: ﻝﺰﻨﻣﻡﺯﺍﻮﻟ, ﻩﺪﻧﺎﻣﺯﺎﺑ
ﺡﻭﺭ: ﺡﻭﺭ, ﺡﻭﺭ, ﺮﮑﻔﺘﻣﺰﻐﻣ
ﻥﺩﺍﺩﺖﻴﻤﻫﺍ: ﻥﺍﺮﮕﻧ, ﻪﻗﻼﻋ, ﻪﺟﻮﺗ, ﻪﺒﻗﺍﺮﻣ, ﯽﻧﺎﺳﺭﺖﻣﺪﺧ, ﺖﯾﺎﻤﺣ, ﻥﺩﺮﮐﺖﻈﻓﺎﺤﻣ, ﯽﻨﻤﯾﺍ, ﺖﻇﺎﻔﺣ, ﺖﯿﻨﻣﺍ, ﻉﺎﻓﺩ, ﻆﻔﺣ, ﺖﻇﺎﻔﺣ, ﺶﺷﻮﭘ, ﻉﺎﻓﺩ, ﻁﺎﯿﺘﺣﺍ, ﻥﺎﻣﺭﺩ, ﻥﺎﻣﺭﺩ, ﻒﯿﻗﻮﺗ, ﻥﺩﻮﺑﻥﺍﺮﮕﻧ, ﻥﺍﺮﮕﻧ, ﻩﺪﻨﻨﮐﻥﺍﺮﮕﻧ
ﻦﺘﺷﺍﺩﺭﻮﻈﻨﻣ: ﺪﻨﻧﺎﺳﺮﯿﻣﺍﺭﻡﻮﻬﻔﻣﻦﯾﺍ, ﺲﺣ, ﯽﻨﻌﻣ, ﺭﺍﺩﺎﻨﻌﻣ, ﻥﺩﺮﮐﯽﻨﻌﻣ, ﻂﺳﻮﺘﻣ, ﻞﻣﺎﻋ, ﻂﺳﻮﺘﻣ, ﻂﺳﻮﺘﻣ, ﻂﺳﻮﺘﻣﺪﺣﺭﺩ, ﺎﺳﺎﺳﺍ, ﻦﮐﮎﺭﺩ
ﻒﻠﺘﺨﻣ: ﺰﯾﺎﻤﺘﻣ, ﻦﺘﺷﺍﺩﺕﻭﺎﻔﺗ, ﻒﻠﺘﺨﻣ, ﻉﻮﻨﺘﻣ, ﻦﯾﺪﻨﭼ, ﺕﻭﺎﻔﺗ, ﻪﻧﺎﮔﺍﺪﺟ, ﺮﯿﯿﻐﺗ, ﻪﻧﺎﮔﺍﺪﺟﺕﺭﻮﺼﺑ, ﯼﺮﯾﺬﭘﺮﯿﯿﻐﺗ, ﻞﯿﺴﻧﺍﺮﻔﯾﺩ, ﻑﻼﺧﺮﺑ, ﺮﮕﯾﺩﻉﻮﻧ, ﺕﻭﺎﻔﺘﻣ, ﻉﻮﻨﺘﻣ, ﺮﮕﯾﺩ, ﯼﺮﮕﯾﺩ, ﺮﮕﯾﺩ, ﺪﻨﭼ, ﺕﻭﺎﻔﺘﻣﺭﻮﻄﺑ, ﻉﺍﻮﻧﺍ
ﻩﻮﻘﻟﺎﺑﺖﻟﺎﺣ: 
allativeﺩﺭﻮﻣ: 
ﮏﯿﭘﻭﺮﺘﻧﺁﺲﻨﺟ: 
ﺞﻨﭘ: ﻢﺠﻨﭘ, ﻝﺎﺳ, ﯼﺍﺮﺑ
ﻩﺪﻧﺯ: ﯽﮔﺪﻧﺯ, ﻥﺪﻧﺎﻣﻩﺪﻧﺯ, ﻥﺩﺮﻛﺭﺎﺘﻓﺭ, ﻥﺩﺮﻛﻲﮔﺪﻧﺯ, ﻪﻧﻻ, ﻪﯿﺣﺎﻧ, ﯽﮕﯾﺎﺴﻤﻫ, ﯽﮕﯾﺎﺴﻤﻫ, ﻩﺪﻧﺯ, ﻩﺪﻧﺯ, ﻡﺎﺧ, ﺖﺳﺍﺭﺮﺳ, ﺖﺳﺍﺭﺮﺳ, ﻦﮐﺎﺳ, ﻢﯿﻘﺘﺴﻣ
ﻒﻠﺘﺨﻣﻉﻮﺿﻮﻣ: 
ﻩﺪﺑﺏﺍﻮﺟ: ﻝﺎﻤﺷ, ﺦﺳﺎﭘ, ﺦﺳﺎﭘ, ﻞﺣﻩﺍﺭ, ﻥﺩﻮﺑﻖﺑﺎﻄﻣ, ﺦﺳﺎﭘ, ﯽﻟﺎﻤﺷ, ﯼﺯﺎﺳﺪﻨﻧﺎﻤﻫ
ﺎﯾﺭﺩ: ﺱﻮﻧﺎﯿﻗﺍ, ﯽﯾﺎﯾﺭﺩ, ﯽﯾﺎﯾﺭﺩﯼﺍﺬﻏ
ﺱﺮﺗ: ﺖﺸﺣﻭ, ﻩﺪﯿﺳﺮﺗ, ﺖﺸﺣﻭ, ﺖﺒﯿﻫ, ﻩﺪﯿﺳﺮﺗ, ﺖﺸﺣﻭ, ﺏﺍﺮﻄﺿﺍ, ﯽﻧﺍﺮﮕﻧﻭﺖﺸﺣﻭﺱﺎﺴﺣﺍ, ﺖﺸﺣﻭ, ﻥﺪﻧﺎﺳﺮﺗ, ﻩﺩﺯﺖﺸﺣﻭ, ﺭﺎﺟﺰﻧﺍ
ﺖﺨﺳ: ﺭﺍﻮﺷﺩ, ﺖﻔﺳ, ﺞﻧﺮﻐﺑ, ﻦﺸﺧ, ﺪﻨﻠﺑﯼﺍﺪﺻﺎﺑ, ﺖﻧﻮﺸﺧ, ﻩﺪﻧﺭﺩ, ﺖﺨﺳ, ﺖﺨﺳ, ﺰﯿﮕﻧﺍﺮﺑﺶﻟﺎﭼ, ﺮﯾﻭﺰﺗﻭﻪﻠﯿﺣﯼﻭﺭ, ﺪﻣﺎﺟ, ﮓﻨﺗ
ﺕﺎﺣﻼﻄﺻﺍ: ﺕﺪﻣ, ﻥﺎﮔﮊﺍﻭ, ﻪﻟﺎﺴﻣ, ﺮﻘﺘﺴﻣ, ﻪﻨﯿﻣﺯ, ﺱﺎﺳﺍ, ﺎﺳﺎﺳﺍ, ﺎﺳﺎﺳﺍ, ﺎﺳﺎﺳﺍ, ﯽﮔﮋﯾﻭ
ﻥﺩﺮﻛﻚﺷ: ﻦﻇءﻮﺳ, ﯼﺩﺎﻤﺘﻋﺍﯽﺑ, ﮓﻧﺭﺩ, ﻥﻮﻨﻈﻣ, ﻩﺪﻨﻨﮐﻦﯿﻣﺎﺗ
dubitativeﺖﻟﺎﺣ: 
ﻩﺎﯿﺳ: ﻥﺩﺮﮐﺩﻭﺪﺴﻣ
ﻞﮕﺷﻮﺧ: ﺏﻮﺧ, ﺏﻮﺧ, ﻲﻨﺘﺷﺍﺩﺖﺳﻭﺩ, ﯽﯾﺎﺒﯾﺯ, ﻪﻧﺎﻔﯾﺮﻇ, ﺭﺎﯿﺴﺑ, ﯽﻨﻨﻔﺗ, ﮏﻨﺧ, ﺏﺍﺬﺟ
ﮏﯾﺭﺎﺗ: ﯽﮕﻨﺗﻝﺩ, ﯽﮑﯾﺭﺎﺗ
ﯼﺯﺎﺳﺐﺗﺮﻣ: ﯼﺪﻨﺑﻢﯿﺴﻘﺗ, ﻥﺩﺮﮐﯼﺪﻨﺑﻪﺘﺳﺩ, ﯼﺪﻨﺑﻪﻘﺒﻃ, ﻉﻮﻧ, ﺎﻫﻪﻧﻮﮔ, ﻉﺍﻮﻧﺍ, ﺩﺭﻮﻣ
ﻩﺩ: ﻪﻫﺩ, ﻢﻫﺩ, ﻪﻧﻻﺩﺎﻋ
ﺶﯾﺎﻤﻧ: ﻥﺩﺍﺩﺶﯾﺎﻤﻧ, ﻥﺩﺍﺩﻡﺎﺠﻧﺍ, ﺩﺮﮑﻠﻤﻋ, ﺕﺍﺮﻫﺎﻈﺗ, ﻪﺋﺍﺭﺍ, ﻥﺩﺍﺩﻥﺎﺸﻧ, ﻥﺩﺮﮐﯽﻨﻌﻣ, ﻪﻌﻗﺍﻭ, ﺡﺮﻃ, ﻩﺎﮕﺸﯾﺎﻤﻧ, ﺮﻨﻫ, ﺮﯾﻮﺼﺗ, ﺡﺮﻃ, ﺮﯾﻮﺼﺗ
ﻥﺎﺘﺳﺍﺩ: ﻩﺭﻮﻄﺳﺍ, ﺦﯾﺭﺎﺗ, ﺖﯾﺍﻭﺭ, ﻥﺎﺘﺳﺍﺩ, ﺡﺮﻃ, ﻥﺎﺘﺳﺍﺩ, ﺪﯿﻨﮐﺖﺒﺤﺻ, ﻉﻮﺿﻮﻣ
ﺏﺎﺘﮐ: ﺭﺎﻣﻮﻃ, ﻩﺮﯿﺧﺫ, ﺪﻧﻮﭘ, ﯽﺳﺭﺩﺏﺎﺘﮐ
ﮏﯿﻧﻭﺮﺘﮑﻟﺍ: ﮏﯿﻧﻭﺮﺘﮑﻟﺍ, ﻥﻭﺮﺘﮑﻟﺍ, ﻕﺮﺑ, ﯽﻗﺮﺑ, ﻕﺮﺑ, ﯽﮑﯾﺮﺘﮑﻟﺍ, ﻕﺮﺑﻦﯿﺴﻨﮑﺗ, ﮏﯿﻧﻭﺮﺘﮑﻟﺍﺖﺴﭘ, ﻖﺑﺎﺳ
ﺏﺎﺴﺣ: ﻞﯿﻟﺩ, ﺩﻮﺷﯽﻣﺐﺒﺳ, ﻥﺩﺮﻛﺏﺎﺴﺣ, ﻪﺒﺳﺎﺤﻣ, ﻪﻠﺿﺎﻓﻭﻪﻌﻣﺎﺟﺏﺎﺴﺣ, ﻪﺤﯾﻻ, ﻪﺒﺳﺎﺤﻣ, ﻥﺩﺮﻤﺷ, ﻥﺩﺮﮐﺏﺎﺴﺣﯼﺰﯿﭼﯼﻭﺭ, ﺏﺎﺴﺣ
ﺖﻣﻼﻋ: ﺮﮕﻧﺎﺸﻧ, ﺩﺭ, ﻪﻟﺎﺒﻧﺩ, ﻩﺮﻤﻧ, ﻡﺭﺁ, ﻪﺘﺴﺟﺮﺑ, ﮏﯿﺗ, ﺐﺴﭼﺮﺑ, ﻥﺩﺮﮐﺎﻀﻣﺍ, ﻝﺎﻨﮕﯿﺳ, ﻪﻧﺎﺸﻧ, ﻒﺻ, ﮎﺭﺎﻣ, ﺖﯿﺼﺨﺷ, ﺐﺴﭼﺮﺑ, ﺱﺎﺴﺣﺍ, ﻦﯾﺩﺎﻤﻧ, ﺭﺎﯿﺷﻮﻫ, ﻞﺒﻤﺳ, ﻥﻮﮑﯾﺁ
ﻪﻗﻼﻋ: ﻞﮔ, ﺪﻨﻣﻪﻗﻼﻋ, ﻪﻗﻼﻋ
ﻦﺘﺷﻮﻧ: ﻥﺩﻭﺮﺳ, ﻪﺘﺷﻮﻧ, ﻉﻮﻧ, ﺖﺳﺍﻩﺪﺷﻪﺘﺷﻮﻧ, ﺎﺘﺴﯾﺍ
ﺮﺘﺴﺑ: 
ﻡﺯﻻ: ﯼﺭﻭﺮﺿ, ﺖﯿﻤﻫﺍﺎﺑ, ﺪﯿﻔﻣ, ﯽﻧﺍﺮﺤﺑ, ﯽﺗﺎﯿﺣ, ﻪﺟﻮﺗﻞﺑﺎﻗ, ﺖﯿﻤﻫﺍﯽﺑ, ﻝﺍﺮﮕﺘﻧﺍ, ﯽﺗﺎﯿﺣ, ﺮﺘﻤﻬﻣ, ﻦﺘﺷﺍﺩﻡﺯﻻ, ﺎﻣﻭﺰﻟ, ﻡﺯﻻ, ﻡﺯﻻ, ﻡﺯﻻ, ﯼﺭﻮﻓ, ﻩﺪﻨﺒﺴﭼ, ﺕﺭﻭﺮﺿ, ﯼﺭﻭﺮﺿ, ﺯﺎﯿﻧ
ﻪﺸﯾﺪﻧﺍ: ﺮﮑﻓ, ﻪﺟﻮﺗ, ﺮﻈﻧ, ﻡﻮﻬﻔﻣ, ﯽﻧﺎﻬﮔﺎﻧﻭﺮﮑﺑﺮﮑﻓ, ﺮﮑﻔﺗ, ﻦﮐﺭﻮﺼﺗ, ﻞﯿﺨﺗ
Vialisﺎﻫﺩﺭﻮﻣ: 
ﺭﺩﺍﺮﺑ: ﺭﺩﺍﺮﺑﻭﺮﻫﺍﻮﺧ, ﺮﻫﺍﻮﺧ, ﯼﺭﺎﺨﺑ, ﺭﺎﮑﻤﻫ
ﺎﻬﺘﻗﻭﯽﻀﻌﺑ: ﺕﺭﺪﻨﺑ, ﻩﺎﮕﯿﺑﻭﻩﺎﮔ, ﺖﻗﻭﺪﻨﭼ
ﻂﺧ: ﻢﯿﺳ, ﺦﻧ, ﻒﯾﺩﺭ, ﻪﭼﻮﮐ, ﻝﺎﻘﺘﻧﺍ, ﻩﺮﯿﺗﻂﺧ, ﻩﺍﺭﻩﺍﺭﻪﭼﺭﺎﭘ, ﺕﺎﯿﻟﺎﻣ, ﻂﺧ, ﻁﻮﻄﺧ, ﻥﺍﻮﻨﻋ
ﺰﯿﻣ: ﻪﻌﻟﺎﻄﻣﺰﯿﻣ, ﻪﻣﺎﻧﺮﺑ, ﺖﺳﺮﻬﻓ, ﺖﺳﺮﻬﻓ
ﻪﻧﺎﺧﺩﻭﺭ: ﺶﻟﺎﺑ, ﻦﺳﻮﮐ, ﺭﺎﺷ
ﻢﺸﭼ: ﻦﯿﯿﻌﺗ, ﻑﺍﺮﻃﺍﺭﺩ, ﻑﺮﺑ
ﺕﺎﻋﻼﻃﺍ: ﻡﺎﯿﭘ, ﺢﯿﺿﻮﺗ, ﺕﺎﺤﯿﺿﻮﺗ, ﻪﻣﺎﻨﺸﻫﻭﮋﭘ, ﺶﻧﺍﺩ, ﺎﻫﻩﺩﺍﺩ, ﻪﺒﺗﺭ, ﻥﺩﺮﮐﻩﺎﮔﺁ
ﻩﺭﺎﺒﮑﯾﻪﺑ: ﻩﺮﻈﺘﻨﻣﺮﻴﻏ, ﻪﺒﻗﺮﺘﻣﺮﯿﻏ
ﺐﻳﺮﻏﻭﺐﻴﺠﻋ: ﺐﯿﺠﻋ, ﻩﺪﻨﻨﮐﺮﯿﮕﻠﻓﺎﻏ, ﺐﯿﺠﻋ, ﺩﺮﻓ, ﺐﺠﻌﺗ, ﺰﯿﮕﻧﺍﺖﻔﮕﺷ, ﻪﺟﻮﺗﺐﻟﺎﺟ, ﻩﺩﺎﻌﻟﺍﻕﺭﺎﺧ, ﯽﻧﺩﺮﮑﻧﺭﻭﺎﺑ, ﺭﻭﺁﺖﻔﮕﺷ, ﺐﯿﺠﻋﻭﺐﯾﺮﻏ, ﺭﺍﺩﻩﺪﻨﺧ, ﻪﻧﺎﮕﯿﺑ, ﺐﯾﺮﻏﻭﺐﯿﺠﻋ, ﺎﭘﻭﺖﺳﺩﯽﺑ, ﻝﻮﻤﻌﻣﺮﯿﻏ, ﺐﯾﺮﻏﻭﺐﯿﺠﻋ, ﺰﯿﻣﺁﺭﺍﺮﺳﺍ, ﻭﺎﮑﺠﻨﮐ
ﻖﯿﻤﻋ: ﺎﻘﯿﻤﻋ, ﻖﻤﻋ, ﻊﯿﺳﻭ, ﻖﻤﻋﻢﮐ, ﻞﻣﺎﮐ, ﻖﯿﻗﺩ, ﻊﻣﺎﺟ, ﻪﻧﺍﺪﻘﺘﻨﻣ, ﻖﯿﻤﻋ, ﺩﻭﺪﺣﺭﺩ،ﻞﺧﺍﺩﺭﺩ, ﻞﺧﺍﺩ, ﯽﻠﺧﺍﺩ, ﻡﺮﮐ
ﻥﺩﺍﺩﺮﯿﯿﻐﺗ: ﺡﻼﺻﺍ, ﺮﯿﯿﻐﺗ, ﯽﻧﻮﮔﺮﮔﺩ, ﻞﯾﺪﺒﺗ, ﺶﻬﺟ, ﺮﯿﯿﻐﺗ, ﻥﺩﺍﺩﺮﯿﯿﻐﺗ, ﺡﻼﺻﺍ, ﻝﺎﻘﺘﻧﺍ, ﯽﯾﺍﺮﮕﻤﻫ, ﺕﺍﺮﯿﯿﻐﺗ, ﺲﻧﺎﯾﺭﺍﻭ, ﯼﺮﯾﺬﭘﺮﯿﯿﻐﺗ
ﺱﺎﺴﺣﺍ: ﺱﺎﺴﺣﺍ, ﺱﺎﺴﺣﺍ, ﮎﺍﺭﺩﺍ, ﺱﺎﺴﺣﺍ, ﯽﻧﺎﺠﯿﻫ, ﺖﻟﺎﺣ, ﺭﺍﺮﻗﺮﯿﺛﺎﺗﺖﺤﺗ, ﯽﻔﻃﺎﻋ, ﯽﺴﺣ, ﺱﺎﺴﺣﺍ, ﺲﺣ, ﺭﻮﺷ, ﻪﻧﺎﻫﺎﮔﺁ, ﯼﺭﺎﯿﺷﻮﻫ, ﻪﺑﻥﺩﺍﺩﻩﺰﯿﮕﻧﺍ, ﻡﻮﻬﻔﻣ, ﺭﻮﺼﺗ, ﻡﻮﻬﻔﻣ
ﻑﺪﻫ: ءﯽﺷ, ﻦﺘﻓﺮﮔﻪﻧﺎﺸﻧ, ﻑﺪﻫ, ﻑﺪﻫ, ﺪﺼﻘﻣ, ﺪﺼﻗ, ﻩﺪﺷﻪﺘﻓﺮﮔﺮﻈﻧﺭﺩ, ﻩﺰﯿﮕﻧﺍ, ﻑﺪﻫ, ﺖﯾﺰﻣ, ﻥﺩﺮﺑﻩﺮﻬﺑ
ﻝﺎﺤﺷﻮﺧ: ﺵﻮﺧ, ﻝﺎﺤﺷﻮﺧ, ﺕﺬﻟ, ﻝﺎﺤﺷﻮﺧ, ﺕﺬﻟ, ﯼﺩﺎﺷ, ﺕﺬﻟ, ﻝﺎﺤﺷﻮﺧ, ﯽﻣﺮﮔﺮﺳ, ﯽﻟﺎﺤﺷﻮﺧﺎﺑ, ﺲﻧﺎﺷﺵﻮﺧ, ﻝﺎﺤﺷﻮﺧ, ﺎﻫﮏﻠﮑﺷ, ﺎﺒﻟﺎﻏ, ﺪﯾﺮﺒﺑﺕﺬﻟ, ﻢﻫﺩﯽﻣﺢﯿﺟﺮﺗ, ﻡﺎﮐﺎﻧ
ﻥﻮﺧ: ﻦﺘﻓﺮﮔﻥﻮﺧ, ﻦﯿﻧﻮﺧ, ﯼﺰﯾﺭﻥﻮﺧ
ﺥﺮﺳﻞﮔ: ﯽﺗﺭﻮﺻﮓﻧﺭ
ﺏﻮﻨﺟ: ﯽﺑﻮﻨﺟ, ﺮﻬﻇ, ﺮﻬﻇ
ﺩﺮﺳ: ﻥﺎﺘﺴﻣﺯ, ﮏﻨﺧ, ﺩﺮﺳﺭﻮﻄﺑ
ﺖﯿﻌﻗﻮﻣ: ﻞﺤﻣ, ﺖﯿﻌﺿﻭ, ﺖﯿﻌﺿﻭ, ﺲﻧﺎﺷ, ﺖﺻﺮﻓ, ﺎﻀﻓ, ﺖﻟﺎﺣ, ﺖﻟﺎﺣ, ﻥﺩﺍﺩﯼﺎﺟ, ﺖﺴﭘ, ﺩﺭﻮﻣ, ﺖﻬﺟ, ﯽﻧﺎﺣﻭﺭﺮﯿﻏ, ﻊﻗﺍﻭ, ﻥﺎﮑﻣ
ﻥﺩﺎﺘﺴﯾﺍ: ﻩﺎﮕﺘﺴﯾﺍ, ﯼﺩﻮﻤﻋ, ﺵﺮﮕﻧ, ﺖﻟﺎﺣ, ﻥﺩﺮﮐﻒﻗﻮﺘﻣ, ﺖﻟﺎﺣ, ﺖﻟﺎﺣ, ﻪﻓﺮﻏ, ﻥﺩﻮﺑ, ﻥﺩﺮﮐﺖﻣﺎﻗﺍ, ﻥﺪﻧﺎﻣ, ﺩﻮﺟﻭ, ﻞﺑﺎﻘﻣﺭﺩ
ﺪﯿﻨﮐﺽﺮﻓ: ﺽﺮﻓ, ﻪﯿﺿﺮﻓ, ﻢﯿﻨﮐﺽﺮﻓ, ﺫﺎﺨﺗﺍ, ﺽﺮﻓ, ﻥﺩﺮﮐﺽﺮﻓ, ﯽﻧﺎﺣﻭﺭﺮﯿﻏ, ﻝﺰﻨﻣﻡﺯﺍﻮﻟ, ﺍﺮﻫﺎﻇ
ﻡﺩﻮﺧﻝﺎﻣ: ﻦﻣ
ﺵﺮﺑ: ﻡﺪﻋ, ﺪﻗﺎﻓ, ﺶﻫﺎﮐ, ﺩﻮﺒﻤﮐ, ﻥﺩﺮﮐﻝﻭﺰﻧ, ﺩﻮﺒﻤﮐ, ﻥﺩﺍﺩﺖﺳﺩﺯﺍ, ﻥﺩﺍﺩﺵﺮﺑ, ﻥﺩﺮﮐﻊﻄﻗ, ﻥﺩﺮﮐﻪﮑﺗ, ﻥﺩﺮﮐﻩﺪﯾﺮﺑﻩﺪﯾﺮﺑ, ﻝﻮﺼﺤﻣ, ﻪﺘﺴﮑﺷ, ﺾﻘﻧ, ﻪﺌﻃﻮﺗ
ﻪﺨﺴﻧ: ﺮﯿﺜﮑﺗ, ﯼﺯﺎﺳﺪﻨﻧﺎﻤﻫ, ﺭﺍﺮﮑﺗ, ﯽﺴﯾﻮﻧﻭﺭ, ﯽﭙﮐﻮﺘﻓ, ﻥﻮﻠﮐ, ﻪﺨﺴﻧ, ﻪﺨﺴﻧ, ﺡﺮﻃ, ﺕﻭﺮﺛ
ﺮﻫﻮﺷ: ﻥﺎﺴﻧﺍ, ﺮﺴﻤﻫ
ﺶﺷ: ﯽﺴﻨﺟﻁﺎﺒﺗﺭﺍ
ﻢﮐ: ﺮﺘﻤﮐ, ﻩﺎﺗﻮﮐﺪﻗ, ﻥﺍﺯﺭﺍ, ﻥﺍﺯﺭﺍ, ﻦﯿﻨﺟﻂﻘﺳ, ﻞﻗﺍﺪﺣ, ﻦﯿﯾﺎﭘ, ﻖﻤﻋﻢﮐ, ﺪﻨﮐ, ﺩﻮﺒﻤﮐ, ﺖﻟﻮﻬﺳ, ﻥﺩﺍﺩﺶﻫﺎﻛ, ﻥﺩﺮﮐﻝﻭﺰﻧ, ﻥﺪﻧﺎﺳﺭﻞﻗﺍﺪﺣﻪﺑ
ﻥﺩﺭﻭﺁﺩﺎﻳﻪﺑ: ﺪﯿﺷﺎﺑﻪﺘﺷﺍﺩﻪﺟﻮﺗ, ﻥﺍﻮﺧﺍﺮﻓ, ﯼﺭﻭﺁﺩﺎﯾ, ﻥﺩﺮﮐﻆﻔﺣ
ﺮﺛﺍ: ﺮﯿﺛﺎﺗ, ﺩﺭﺍﺬﮔﯽﻣﺮﯿﺛﺎﺗ, ﺱﺎﺴﺣﺍ, ﺮﯿﺛﺄﺗ, ﻂﻠﺴﺗ, ﺪﻣﺁﺭﺎﮐ, ﺮﺛﻮﻣﺭﻮﻃﻪﺑ, ﯽﺸﺨﺑﺮﺛﺍ, ﻪﺠﯿﺘﻧ, ﻪﺠﯿﺘﻧ, ﻪﺋﺍﺭﺍ, ﻪﺠﯿﺘﻧ, ﻡﻮﻬﻔﻣ
ﻁﻮﻘﺳ: ﺰﻴﻳﺎﭘﻞﺼﻓ, ﺩﺭﻮﻣ, ﻊﻗﺍﻭ, ﻁﻮﻘﺳ, ﻥﺩﺮﮐﺰﯿﺧﻭﺖﺴﺟ, ﻦﺘﺴﮑﺷﻢﻫﺭﺩ, ﻁﻮﻘﺳ, ﻥﺩﺮﮐﺎﻫﺭ, ﺶﻫﺎﮐ, ﻥﺩﺮﮐﻝﻭﺰﻧ
ﺰﺠﺑ: ﻪﮑﻨﯾﺍﺮﮕﻣ, ﺯﺍﺝﺭﺎﺧ, ﺭﺎﻨﮐﺭﺩ, ﺯﺍ،ﺍﺪﺟﻢﻫﺯﺍ, ﺯﺍﺝﺭﺎﺧ, ﺍﺪﺟ, ﯼﺎﻨﺜﺘﺳﺍﻪﺑ, ﺯﺍﯼﺍﺪﺟ, ﻥﻭﺪﺑ
ﺖﯾﺍﺭﯽﭙﮐ: 
ﺶﺗﺭﺍ: ﯼﺎﻫﻭﺮﯿﻧ, ﯽﻣﺎﻈﻧﯼﺎﻫﻭﺮﯿﻧ, ﻥﺎﺑﺰﯿﻣ, ﺯﺎﺑﺮﺳ
ﻥﺪﯾﻭﺩ: ﻦﺘﺨﯾﺮﮔ, ﯽﺸﮐﻩﺯ, ﺍﺮﺟﺍﻝﺎﺣﺭﺩ, ﻥﺩﺮﮐﺍﺮﺟﺍ, ﻞﻤﻋ, ﻮﯾﺍﺭﺩ, ﻩﺪﻧﺩ, ﺕﺎﯿﻠﻤﻋ, ﯽﺗﺎﯿﻠﻤﻋ, ﻉﺎﻓﺩ
ﺐﺳﺍ: ﺐﺳﺍﻞﻌﻧ, ﺭﺩ, ﺭﺎﻬﻇﺍ, ﻦﺨﺳ
ﻩﺪﻨﯾﺁ: ﺪﻌﺑ, ﻥﺁﺯﺍﺪﻌﺑ, ﻥﺁﺯﺍﺪﻌﺑ, ﻥﺎﺘﺴﻣﺯ
ﺏﺮﻏ: ﯽﺑﺮﻏ
ﺖﺧﺍﺩﺮﭘ: ﺩﺰﻣ, ﻪﻤﺣﺰﻟﺍﻖﺣ, ﻕﻮﻘﺣ, ﺭﺎﺸﻓ, ﺖﺧﺍﺩﺮﭘ, ﻥﺩﺍﺩﻥﺍﻭﺎﺗ, ﺖﺧﺍﺩﺮﭘ, ﻪﻨﯾﺰﻫ, ﺪﯿﻫﺩﻩﺯﺎﺟﺍ
ﺰﻣﺮﻗ: ﺶﻫﺎﮐ
ﻼﻃ: 
ﻦﺘﺷﺍﺩﻞﻳﺎﻤﺗ: ﻩﺩﺍﺭﺍ, ﻕﺎﯿﺘﺷﺍﺎﺑ, ﺎﻬﺘﺷﺍ, ﻥﺩﺮﮐﻭﺯﺭﺁ, ﻦﺘﺷﺍﺩﻕﺎﯿﺘﺷﺍ, ﻢﯿﻫﺍﻮﺧﯽﻣ, ﺕﻮﻬﺷ
ﯼﺯﺎﺑ: ﺺﻗﺭ, ﺭﺎﻤﻗ, ﯼﺯﺎﺑ, ﻪﻧﻮﮔ, ﯼﺯﺎﺑﺏﺎﺒﺳﺍ, ﻝﻭﺭ, ﺶﺧﺮﭼ, ﻥﺪﻧﺎﺧﺮﭼ
ﺩﺎﺘﺳﺍ: ﺪﻧﻭﺍﺪﺧ, ﯽﻠﺻﺍ, ﯽﻠﺻﺍ, ﺩﺎﺘﺳﺍ, ﻦﺘﺷﺍﺩﻂﻠﺴﺗ, ﻥﺩﺮﮐﺖﻣﻮﮑﺣ, ﯼﺎﻗﺁ, ﺎﻗﺁ, ﻥﺪﺷﯽﻬﺘﻨﻣ, ﺎﻗﺁ, ﮏﻟﺎﻣ, ﺮﮑﻔﺘﻣﺰﻐﻣ, ﻝﺮﺘﻨﮐ
ﯼﺭﺍﺩﺍﺮﺘﻓﺩ: ﯽﮔﺪﻨﯾﺎﻤﻧ, ﻪﻌﻟﺎﻄﻣﺰﯿﻣ, ﺕﺭﺍﺯﻭ
ﺖﻟﻭﺩ: ﻥﺩﺍﺩﺡﺮﺷءﺰﺟﻪﺑءﺰﺟ, ﻒﯾﺩﺭ
ﺎﺴﯿﻠﮐ: 
ﻝﻮﻃ: ﻉﺎﻔﺗﺭﺍ, ﻉﺎﻔﺗﺭﺍ, ﻝﻮﻃ, ﻩﺍﺮﻤﻫ, ﻥﺎﻣﺯﺕﺪﻣ, ﺪﻨﻠﺑ
ﺖﮐﺮﺷ: ﺖﮐﺮﺷ, ﺖﮐﺮﺷ, ﻪﻌﻣﺎﺟ, ﺕﺭﺎﺠﺗ, ﮒﺭﺰﺑﯼﺎﻫﺖﮐﺮﺷ, ﺩﻮﺟﻭ, ﻪﺴﺳﻮﻣ, ﯽﮔﺪﻨﯾﺎﻤﻧ, ﻪﺴﺳﻮﻣ, ﯼﺭﺍﺬﮔﻪﯾﺎﻣﺮﺳ, ﯼﺭﺍﺬﮔﻪﯾﺎﻣﺮﺳ
ﺬﻏﺎﮐ: ﻕﺭﻭ, ﺕﺭﺎﮐ, ﺭﻮﺸﻨﻣ, ﻪﻣﺎﻧﺯﻭﺭ
ﻝﺎﻤﺘﺣﺍ: ﯼﺮﯾﺬﭘﻥﺎﮑﻣﺍ, ﻝﺎﻤﺘﺣﺍ, ﺩﺭﺍﺩﻝﺎﻤﺘﺣﺍ, ﻻﺎﻤﺘﺣﺍ, ﺪﯿﻌﺑ, ﺯﺍﺪﻧﺍﻢﺸﭼ, ﺲﻧﺎﺷ, ﯽﻟﺎﻤﺘﺣﺍ, ﯼﺎﻫﺮﯿﻐﺘﻣ, ﺲﻧﺎﺷ
ﺹﻮﺼﺨﺑ: ﻩﮋﯾﻭ, ﻩﮋﻳﻭﻪﺑ, ﺹﺎﺧﺭﻮﻃﻪﺑ, ﺹﻮﺼﺧﻪﺑ, ﺹﺎﺧ, ﻼﻣﺎﮐ, ﻩﺪﻤﻋﺭﻮﻃﻪﺑ, ﺐﻠﻏﺍ, ﻝﻭﺍﻪﺟﺭﺩﺭﺩ, ﺹﺎﺧ, ﺮﺘﻤﻬﻣ, ﻻﻮﻤﻌﻣ
ﻞﻤﺤﺗ: ﻞﻤﺣ, ﻞﻤﺤﺗ, ﻞﻤﺤﺗ, ﻞﻤﺤﺗ, ﺪﻧﺭﺍﺩ, ﯼﺍﺭﺍﺩ, ﻦﺘﺷﺍﺩﺖﻋﺎﻄﺘﺳﺍ, ﻥﺩﺮﻛﻞﻤﺤﺗ
ﻩﺮﺠﻨﭘ: 
ﯼﺭﺎﮑﻤﻫﺩﺍﺩﺭﺍﺮﻗ: ﻞﮑﺗﻭﺮﭘ, ﻥﺎﮑﺳﺍ, ﺵﺯﺎﺳ, ﻉﺎﻤﺟﺍ, ﻩﺪﻫﺎﻌﻣ, ﻥﺩﺮﮐﻝﻮﺒﻗ, ﻪﻣﺎﻧﻢﻫﺎﻔﺗ, ﻖﻓﺍﻮﺗ, ﻪﺼﻗﺎﻨﻣ, ﺮﺗﻭ, ﯼﺭﺎﮐﺩﺍﺩﺭﺍﺮﻗ, ﺩﺍﺩﺭﺍﺮﻗ, ﺐﯿﺗﺮﺗ, ﻪﻠﻣﺎﻌﻣ
ﯽﯾﺎﺒﯾﺯ: ﯽﯾﺎﺒﯾﺯ, ﯽﮔﺪﻨﺸﺧﺭﺩ, ﯽﯾﺎﺒﯾﺯ
ﻪﻔﯿﻇﻭ: ﯽﻫﺪﺑ, ﺖﯿﻟﻮﺌﺴﻣﺱﺎﺴﺣﺍ, ﺪﻬﻌﺗ, ﻝﻮﺌﺴﻣ, ﮎﺮﻤﮔ, ﻪﻔﯿﻇﻭ, ﯼﺭﺍﺬﮔﺍﻭ, ﯽﻫﺪﺑ, ﻥﺩﻮﺑﺭﺎﮑﻫﺪﺑ, ﺪﯾﺎﺑ, ﻡﺍﺪﺨﺘﺳﺍ, ﺖﺷﻮﻧﺮﺳ
ﻝﺎﺳﺭﺍ: ﻝﺎﻘﺘﻧﺍ, ﻝﺎﺳﺭﺍ, ﺖﺴﭘ, ﺶﺨﭘ, ﮏﯿﻧﻭﺮﺘﮑﻟﺍﺖﺴﭘ, ﻝﺎﻘﺘﻧﺍ, ﺪﯾﺎﺑ, ﻪﺋﺍﺭﺍ, ﻝﺎﺳﺭﺍ
ﻪﻠﺻﺎﻓ: ﺖﺷﺍﺩﺮﺑ, ﻩﺩﻭﺪﺤﻣ, ﯽﯾﺍﺪﺟ, ﻥﺎﺑﺎﯿﺧ, ﻑﺎﮑﺷ
ﺕﻮﮑﺳ: ﻥﻮﮑﺳ, ﻡﺍﺭﺁ, ﺍﺪﺻﯽﺑ, ﯽﯾﺎﻬﻨﺗ, ﺢﻠﺻ
ﺎﭘ: ﺎﭘ, ﻒﻗﻮﺗ, ﻥﺍﺭ, ﻪﺠﻨﭘ, ﻊﺑﺭ, ﻪﺠﻨﭘ, ﺍﺮﺟﺍﻝﺎﺣﺭﺩ, ﯽﺘﺳﺭﺩﻪﺑ, ﻡﺎﮔ
ﯽﺸﺣﻭ: ﺪﯾﺪﺷ, ﯽﻧﻮﻧﺎﻗﺮﯿﻏ, ﻩﺪﻧﺭﺩ, ﯽﺸﺣﻭﺕﺎﻧﺍﻮﯿﺣ, ﻞﮕﻨﺟ
ﻥﺩﺮﻣ: ﻥﺎﺟﯽﺑ, ﮒﺮﻣﻝﺎﺣﺭﺩ, ﺵﻮﻣﺎﺧ, ﻪﺘﺴﺑ
ﯽﯾﻮﺟﻪﻓﺮﺻ: ﻥﺩﺮﮐﯽﯾﻮﺟﻪﻓﺮﺻ, ﻆﻔﺣ, ﻦﺘﻓﺎﯾﺩﻮﺒﻬﺑ, ﻭﺮﺴﻨﮐ, ﺖﻇﺎﻔﺣ, ﻥﺩﺮﮐﻆﻔﺣ, ﻩﺎﮕﺷﻭﺮﻓ, ﻥﺩﺭﻭﺍﺭﺩﻭﺮﮔﺯﺍ, ﺕﺎﺠﻧﻭﺩﺍﺪﻣﺍ, ﺩﺭﻮﮐﺭ, ﺖﻇﺎﻔﺣ, ﻆﻔﺣ, ﺮﺷﺯﺍﻥﺪﺷﺹﻼﺧ
ﺰﺒﺳ: ﻡﺎﺧ, ﻡﺎﺧ
ﻞﮑﺸﻣ: ﺖﻤﺣﺯ, ﻪﻟﺎﺴﻣ, ﻪﻠﺌﺴﻣ, ﯽﺘﺨﺳ, ﻞﮑﺸﻣ, ﻥﺩﺮﮐﻁﻮﻠﺨﻣ, ﻥﺪﯿﺸﮐﺞﻧﺭ, ﺯﺎﺳﻞﮑﺸﻣ, ﻊﻧﺎﻣ, ﺭﺎﺴﻣﺮﺷ, ﺖﻟﺎﺠﺧ
ﺪﻨﺨﺒﻟ: ﺪﻨﺧﺯﻮﭘ
ﻩﺎﺒﺘﺷﺍ: ﻩﺎﺒﺘﺷﺍ, ﺎﻄﺧ, ﻩﺎﺒﺘﺷﺍ, ﺪﺑ, ﻥﺩﺍﺩﻡﺎﻨﺷﺩ, ﻂﻠﻏ, ﺎﻄﺧ, ﺖﺴﮑﺷ, ﺐﯿﻋ, ﻩﺎﺒﺘﺷﺍ, ﻩﺎﺒﺘﺷﺍ
ﺏﺍﻮﺧ: ﻩﺪﯿﺑﺍﻮﺧ, ﺏﺍﻮﺧ, ﻥﺩﺯﺕﺮﭼ
quotativeﺩﺭﻮﻣ: 
ﻉﻭﺮﺷ: ﺯﺎﻏﺁ, ﻉﻭﺮﺷ, ﻦﺘﻓﺮﮔﻩﺪﻬﻌﺑ, ﺵﺍﺮﺧ, ﻉﻭﺮﺷ, ﻪﯿﻟﻭﺍ, ﻪﯿﻟﻭﺍ, ﻉﻭﺮﺷ, ﺭﺎﮐﺯﺎﻏﺍ, ﻞﺻﺍ, ﻮﺷﺭﺍﻮﺳ, ﺯﺎﻏﺁ
ﻞﻤﻋ: ﻪﻔﯿﻇﻭ, ﻥﺩﺮﻛﻩﺭﺎﺷﺍ, ﻡﺎﮔ, ﻪﻨﺤﺻ, ﻞﻤﻋ, ﺵﻭﺭ, ﻝﺎﻌﻓ, ﺩﺮﮑﻠﻤﻋ, ﯽﺗﺎﯿﻠﻤﻋ, ﻥﺩﺮﮐﻝﺎﻌﻓ, ﻝﺎﻌﻓ, ﺖﮐﺮﺣ, ﻞﻤﻋ, ﻞﻤﻋ, ﻞﻤﻋ, ﺱﺭﻮﺑﻥﺎﻣﺯﺎﺳ, ﺍﺮﺟﺍ, ﻥﺩﺮﮐﺍﺮﺟﺍ, ﺭﺎﺘﻓﺭ
ﺪﯾﺩﺯﺎﺑ: ﯽﺳﺮﺘﺳﺩ, ﻪﺒﺣﺎﺼﻣ, ﺱﺮﺘﺳﺩﺭﺩ, ﻦﺘﻓﺭﺮﻔﺳ, ﺮﻔﺳ, ﺮﻔﺳ, ﺮﻔﺳ, ﻪﻔﺴﻠﻓ, ﻥﺩﺮﮐﺩﺎﻘﺘﻧﺍ, ﯼﺭﺎﮐﻪﺴﻠﺟ, ﻪﯾﺪﻫ
ﻥﺩﺮﮐﻝﺎﺒﻧﺩ: ﻕﺎﺒﻄﻧﺍ, ﻥﺪﯿﺒﺴﭼ, ﻥﺩﺮﮐﻝﺎﺒﻧﺩ, ﻥﺩﺮﮐﻝﺎﺒﻧﺩ, ﺮﯿﺴﻣ, ﻥﺩﺮﮐﯽﻫﺍﺮﻤﻫ, ﻥﺩﺮﮐﺖﻋﺎﻃﺍ, ﺐﻗﺎﻌﺘﻣ, ﻪﻣﺍﺩﺍ
ﻥﺩﺮﻛﺵﻼﺗ: ﺶﺷﻮﮐ, ﺵﻼﺗ, ﺵﻼﺗ, ﻞﻤﻋﺭﺎﮑﺘﺑﺍ, ﻪﺑﺮﺠﺗ, ﺖﺴﺗ, ﻪﻧﻮﻤﻧ, ﯽﺷﻮﮐﺖﺨﺳ, ﺶﯾﺎﻣﺯﺁ, ﻪﻨﯾﺎﻌﻣ, ﻥﺎﺤﺘﻣﺍ
ﺭﻮﻀﺣ: ﺩﻮﺟﻭ, ﺩﻮﺟﻭ, ﺩﻮﺟﻭ, ﯽﯾﺍﺭﺍﺩ, ﻉﻮﻗﻭ, ﻩﺮﻈﻨﻣ, ﺭﻮﻀﺣ
ﻦﯿﮕﻨﺳ: ﺭﺍﺮﮑﺗ, ﺕﺪﺷﻪﺑ, ﺭﺍﻮﺷﺩ, ﺪﯾﺪﺷ, ﻥﺯﻭ, ﯼﺪﺟﺭﻮﻃﻪﺑ, ﻢﯿﻈﻋ, ﺪﺒﮐ, ﮒﺭﺰﺑ, ﻢﯿﻈﻋ
ﻦﯾﺮﯿﺷ: ﺮﺳﺩ, ﺕﺎﺒﻧ, ﻢﯾﻼﻣ, ﺏﻮﻠﻄﻣﻭﻦﯾﺮﯿﺷ, ﺏﺍﺬﺟ
ﻥﺎﻫﺩ: ﯽﻫﺎﻔﺷ, ﻥﺍﻮﯿﻟ, ﻪﻋﺮﺟ, ﺕﺭﻮﺻ
ﺪﻨﻤﺗﻭﺮﺛ: ﻥﺍﻭﺍﺮﻓ, ﻥﺍﻭﺍﺮﻓ, ﺪﻨﻤﺗﻭﺮﺛ, ﺱﺎﺒﻟ, ﻩﺪﻨﺸﺨﺑ
ﻦﻤﺷﺩ: ﻢﺻﺎﺨﺘﻣ, ﻒﯾﺮﺣ, ﻞﺑﺎﻘﻣﺭﺩ
ﯽﺘﺸﮐ: ﻖﯾﺎﻗ, ﻥﺎﺑﺩﺎﺑ, ﻥﺎﮔﻭﺎﻧ, ﯽﻧﺍﺮﯿﺘﺸﮐ, ﯽﺘﺸﮐ, ﯽﯾﺎﯾﺭﺩﺮﻔﺳ, ﯽﺘﺸﮐ, ﻢﮑﺷ, ﻥﺩﺮﮐﺖﯾﺍﺪﻫ
ﺖﯿﻌﺿﻭ: ﻁﺮﺷ, ﯼﺪﻨﺑﻁﺮﺷ, ﻥﺩﺍﺩﺡﺮﺷءﺰﺟﻪﺑءﺰﺟ, ﺖﯿﻌﺿﻭ, ﯽﮕﻧﻮﮕﭼ, ﺖﯿﻌﺿﻭ, ﺕﻭﺮﺛ, ﻪﻨﺤﺻ, ﺢﻄﺳ, ﻡﺍﺪﻧﺍﺐﺳﺎﻨﺗ, ﺯﺎﯿﻧ
ﻪﻠﻤﺟﺯﺍ: ﯼﻭﺎﺣ, ﻞﻣﺎﺷ, ﻞﻣﺎﺷ, ﻖﻠﻌﺗ, ﻞﻣﺎﺷ, ﯼﺎﻨﺜﺘﺳﺍﻪﺑ
ﻞﻣﺎﺷﺺﺨﺷ: 
ﺪﺳﺭﯽﻣﺮﻈﻧﻪﺑ: ﯼﺮﻫﺎﻇﻞﮑﺷ, ﺪﻨﯾﺁﯽﻣﺩﻮﺟﻮﺑ, ﻥﺪﺷﺭﺍﺪﯾﺪﭘ, ﺝﻭﺮﺧ, ﺖﯾﻭﺭﻞﺑﺎﻗ, ﺪﺳﺭﯽﻣﺮﻈﻧﻪﺑ, ﻦﮐﻩﺎﮕﻧ, ﺩﺎﯾﺯﺪﺷﻭﺪﻣﺍ
ﺯﺍﺭ: ﺰﯿﻣﺁﺭﺍﺮﺳﺍ, ﺯﺍﺭ, ﻕﺎﺠﻨﺳ, ﻦﯿﻣﺯﺮﯾﺯ
ﻢﻨﻛﻰﻣﺶﻫﺍﻮﺧ: ﺰﯿﻣﺁﺖﺒﺤﻣ, ﻥﺪﯿﺳﺮﭘ, ﺖﻓﺍﺮﻇ
precativeﺖﻟﺎﺣ: 
ﺏﺩﺍﺎﺑﻡﺎﻧﺖﺒﺛ: 
ﺪﺑ: ﻪﻣﺪﺻ, ﻩﺪﻨﻧﺯﻭﺪﻨﺗ, ﺮﯾﺮﺷ, ﺪﺑ, ﺪﺑ, ﺡﺎﻀﺘﻓﺍ, ﺭﺎﻤﯿﺑ, ﺮﺗﺪﺑ
ﺱﺭﺎﻣ: ﻩﮊﺭ, ﺽﺍﺮﺘﻋﺍ, ﺕﺍﺮﻫﺎﻈﺗ, ﻡﺍﺮﻬﺑ
ﯽﻣﺍﺭﺁﻪﺑ: ﻪﺘﻓﺭﻪﺘﻓﺭ, ﻡﺍﺭﺁ, ﯽﻣﺍﺭﺁﻪﺑ, ﻢﯾﻼﻣ, ﺮﯾﺩ, ﯽﺠﯾﺭﺪﺗ
ﯼﺎﺠﺑ: ﯼﺎﺠﺑ, ﺎﺘﺒﺴﻧ, ﺭﺎﻨﮐﺭﺩ, ﯽﻨﯾﺰﮕﯾﺎﺟ, ﯽﻨﯾﺰﮕﯾﺎﺟ, ﺎﺑﻭﺎﻨﺘﻣ, ﯽﮔﺪﻨﯾﺎﻤﻧ
ﯽﺑﺁ: ﯼﺍﻩﺯﻭﺮﯿﻓ
ﻦﮑﻤﻣﺮﯿﻏ: 
ﻪﺳﺭﺪﻣ: ﺲﯾﺩﺮﭘ, ﻥﺎﺑﺩﺮﻧ
ﺖﺒﺳﺎﻨﻣ: ﺖﺻﺮﻓ, ﻪﻌﻗﺍﻭ, ﻉﻮﻗﻭ, ﺲﻧﺎﺷ, ﻥﺎﺑﺎﯿﺧ, ﻪﻠﻣﺎﻌﻣ, ﺖﻋﺎﺳ
ﻩﺩﺮﮐﺝﺍﻭﺩﺯﺍ: ﺝﺍﻭﺩﺯﺍ, ﻥﺩﺮﮐﺝﺍﻭﺩﺯﺍ, ﺝﺍﻭﺩﺯﺍﻦﺸﺟ
ﺍﺬﻏ: ﯽﯾﺍﺬﻏﻩﺪﻋﻭ, ﯽﯾﺍﺬﻏﻢﯾﮊﺭ, ﺏﺎﻘﺸﺑ, ﻥﺩﺮﮐﻪﯾﺬﻐﺗ, ﻥﺩﺭﻮﺧﺭﺎﻫﺎﻧ
ﺖﺴﯿﺑ: 
ﯽﻧﺎﺳﺁﻪﺑ: ﺩﺭﺍﺩﻝﺎﻤﺘﺣﺍ, ﯽﻧﺎﺳﺁﻪﺑ, ﻝﻮﺌﺴﻣ, ﻥﺎﺳﺁ, ﯽﺘﺣﺍﺭ, ﮎﺪﻧﺍ, ﯽﻤﮐ, ﮏﺒﺳ, ﺖﺣﺍﺭ, ﺖﺳﺍﺭﺮﺳ, ﻪﺻﻼﺧﺕﺭﻮﺻﻪﺑ
ﺮﮕﻧﻩﺪﻨﯾﺁﻪﺒﻨﺟ: 
ﻥﺎﺑﺯ: ﯽﻧﺎﺑﺯ, ﻥﺎﺑﺯ, ﯼﺎﻨﺑﺮﯾﺯ
ﻥﺎﯿﺑ: ﻥﺎﯿﺑ, ﻪﯿﻧﺎﯿﺑ, ﺕﺭﺎﺒﻋ, ﻥﺎﯿﺑ, ﻪﺋﺍﺭﺍ, ﻦﺨﺳ, ﻪﻟﺩﺎﻌﻣ, ﯽﮔﺪﻨﯾﺎﻤﻧ
ﻪﺘﻔﻫ: ﻪﺒﻨﺸﮑﯾ, ﯽﮕﺘﻔﻫ
ﻦﻟﺎﺳ: ﺮﺗﺎﺌﺗ, ﺭﻭﺪﯾﺮﮐ, ﺎﻀﻓ, ﻕﺎﺗﺍ, ﻦﻟﺎﺳ, ﻦﻟﺎﺳ, ﻭﺮﻫﺍﺭ, ﻩﺪﻧﻭﺩ, ﻭﺮﻫﺍﺭ, ﺥﺍﺭﻮﺳ, ﻞﻘﻧﻭﻞﻤﺣ
ﺮﻄﺧ: ﮎﺎﻧﺮﻄﺧ, ﺮﻄﺧ, ﺮﻄﺧ, ﻡﺍﺮﺘﺣﺍ
ﻝﻮﻤﻌﻣ: ﯽﻠﮐﺭﻮﻄﺑ, ﯽﻣﻮﻤﻋ, ﺞﯾﺍﺭ, ﻝﺍﻭﺭ, ﯽﻣﻮﻤﻋ, ﻻﻮﻤﻌﻣ, ﯽﻟﻮﻤﻌﻣ, ﻝﻮﻤﻌﻣﺮﯿﻏ, ﺎﻣﻮﻤﻋ, ﻦﺗﻭﺮﻓ, ﯽﻌﯿﺒﻃ, ﻪﯾﻭﺭﯽﺑ, ﯽﻟﻮﻤﻌﻣ, ﯽﻟﻮﻤﻌﻣ, ﯽﻗﺎﻔﺗﺍ, ﻝﻮﻤﻌﻣﺭﻮﻃﻪﺑ, ﻻﻮﻤﻌﻣ, ﯽﻠﺻﺍﺮﯿﺴﻣ, ﻢﻈﻨﻣ, ﯽﮕﺸﯿﻤﻫ, ﻩﺩﺎﺳ, ﺎﺒﯾﺮﻘﺗ, ﻩﺩﺎﺳ, ﻂﺳﻮﺘﻣﺪﺣﺭﺩ
ﻥﺪﻣﺁﺎﯿﻧﺪﺑ: ﺪﻟﻮﺗ, ﺕﺎﯿﺣﺪﯾﺪﺠﺗ, ﯽﺗﺍﺫ
ﻩﺎﮔﺩﺍﺩ: ﯽﯾﺎﻀﻗ, ﺏﺎﻘﺸﺑ, ﻦﻤﺠﻧﺍ, ﯽﯾﺎﻀﻗﯼﻮﻋﺩ
ﯽﻠﺜﻤﻟﺍﺏﺮﺿﻪﺒﻨﺟ: 
ﺵﺯﺭﺍ: ﻦﺘﺷﺍﺩﻕﺎﻘﺤﺘﺳﺍ, ﺵﺯﺭﺍ, ﺪﻨﻤﺷﺯﺭﺍ, ﺭﺎﺒﺘﻋﺍ, ﯽﮕﺘﺴﯾﺎﺷ, ﻪﻨﯾﺰﻫ, ﺖﻤﯿﻗ
ﺖﺧﺭﺩ: ﻩﺎﯿﮔ, ﺏﻮﭼ, ﺭﻮﺤﻣ, ﺏﻮﭼ
ﺭﺍﻮﯾﺩ: 
ﻥﺎﻤﺳﺁ: ﻥﺎﻤﺳﺁ
inchoativeﻪﺒﻨﺟ: 
ﯼﺮﻣﺍءﻪﻤﻠﮐﺖﻟﺎﺣ: 
ﻦﺤﻟ: ﺮﯿﻗ, ﯼﺩﻮﻠﻣ, ﻦﺗ, ﻦﺗ, ﻪﯾﺎﺳ, ﻦﺗﯽﻫﺎﻣ, ﺍﺪﺻ
ﻪﺟﻮﺗ: ﻡﺍﺮﺘﺣﺍ, ﻢﯿﻨﮐﺽﺮﻓ, ﺽﺮﻓ, ﻪﺟﻮﺗ, ﻪﺟﻮﺗ, ﻦﺘﻓﺮﮔﺮﻈﻧﺭﺩ, ﻁﺎﺒﺗﺭﺍ, ﻦﻤﺠﻧﺍ, ﻁﺎﺒﺗﺭﺍ, ﺭﺎﻬﻇﺍ, ﺶﺷﻮﭘ, ﻂﺑﺍﻭﺭ, ﻁﺎﺒﺗﺭﺍ, ﻩﺍﺮﻤﻫ, ﻁﻮﺑﺮﻣ, ﻥﺍﺮﮕﻧ, ﻖﻠﻌﺗ, ﺖﺑﺎﺑﺯﺍ, ﺮﻇﺎﻨﺘﻣ, ﻥﺩﻮﺑﻖﺑﺎﻄﻣ, ﻁﻮﺑﺮﻣ
ﻩﺎﻣ: ﻩﺎﻣ
ﻪﺑﺮﺠﺗ: ﯽﺑﺮﺠﺗ, ﯽﺑﺮﺠﺗ, ﻪﺑﺮﺠﺗﺎﺑ, ﺺﺼﺨﺗ, ﻩﺰﻣ, ﻪﺑﺮﺠﺗ
ﺖﯿﻌﻗﻮﻣ: ﻮﯾﺭﺎﻨﺳ, ﯽﮕﻧﻮﮕﭼ, ﺖﯿﻌﺿﻭ, ﻪﻧﺍﺩﺍﺯﺁ
ﺕﻭﺍﺮﻃﺎﺑ: ﻩﺯﺎﺗ, ﺺﻟﺎﺧ, ﺰﯿﻤﺗ, ﻩﺪﻨﻨﮐﮎﺎﭘ, ﺪﯾﺪﺟ, ﺭﺎﮐﻩﺯﺎﺗ, ﻦﯾﺮﺧﺁ
ﮎﻭﺩ: ﺶﻛﻂﺧ, ﻩﺩﺍﺰﻫﺎﺷ, ﺎﺘﻤﻫ
ﻩﺪﺷﻩﺩﺍﺩﺶﺷﻮﭘ: ﺶﺷﻮﭘ, ﺶﺷﻮﭘ, ﺵﻮﻣﺎﺧ, ﻪﺘﺴﺑ, ﯽﻠﺧﺍﺩ, ﺶﺷﻮﭘ, ﻥﺩﺮﮐﺖﻣﻮﮑﺣ
ﻥﺍﺮﮐ: ﺪﺣ, ﺖﯾﺩﻭﺪﺤﻣ, ﺪﺣ, ﺯﺮﻣ, ﺖﯾﺩﻭﺪﺤﻣ, ﺮﺼﺤﻨﻣ, ﻞﺼﺘﻣ, ﺩﺭﺍﺩﯽﮕﺘﺴﺑ, ﻥﺩﺮﮐﺮﯿﺳﺍﻭﺭﺎﺘﻓﺮﮔ, ﺯﺮﻣ, ﻥﺩﺮﮐﺩﻭﺪﺤﻣ
ﻕﺮﺷ: ﯽﻗﺮﺷ, ﺶﯿﭘ, ﯽﻠﺒﻗ, ﯽﻠﺒﻗ, ﺶﯿﭘ, ﻕﺮﺷ
ﮓﻨﺳ: ﺮﻣﺮﻣﮓﻨﺳ, ﮓﻨﺳ, ﺮﻫﻮﮔ
ﺖﻬﺟ: ﺖﻬﺟ, ﺪﻌﺑ, ﺪﻧﻭﺭ, ﻞﮑﺷ, ﻞﻤﻌﻟﺍﺭﻮﺘﺳﺩ
ﯽﻟﺪﻨﺻ: ﯽﻟﺪﻨﺻ, ﯽﺘﺣﺍﺭﯽﻟﺪﻨﺻ, ﻉﻮﻓﺪﻣ, ﻦﻟﺎﺳ
ﻥﺩﺮﮐﺖﯾﺎﻤﺣ: ﻆﻔﺣ, ﺪﯿﯾﺎﺗ, ﺖﻧﻭﺎﻌﻣ, ﯼﺭﺎﮑﻤﻫ, ﺏﻼﻗ, ﮏﻤﮐ, ﺱﺎﺳﺍ, ﻞﻐﺑﺮﯾﺯﺏﻮﭼ
ﺦﯾﺭﺎﺗ: ﺦﯾﺭﺎﺗ, ﺩﺭﻮﺧﺮﺑ
ﻩﺪﮑﻫﺩ: ﻩﺪﮑﻫﺩ, ﺮﻬﺷﻪﻣﻮﺣ
ﻩﺯﻮﺣ: ﻩﺮﮐ, ﻩﺯﻮﺣ, ﻪﻘﻄﻨﻣ, ﻭﺮﻤﻠﻗ, ﻪﻘﻄﻨﻣ, ﻪﻘﻄﻨﻣ, ﺶﺨﺑ, ﻪﻨﻣﺍﺩ, ﻪﺻﺮﻋ, ﻩﺎﮕﺷﺯﺭﻭ, ﺎﻀﻓ, ﻪﯿﺷﺎﺣ, ﺮﻬﺷﻪﻣﻮﺣ, ﻩﺎﮔﻭﺩﺭﺍ, ﻪﻋﺭﺰﻣ
ﻦﻛﺮﺒﺻ: ﺭﺎﻈﺘﻧﺍ, ﻦﺘﺷﺍﺩﻪﮕﻧ, ﻥﺩﺮﮐﺖﻣﺎﻗﺍ
ﻩﺯﺎﺟﺍ: ﻥﺩﺍﺩﻩﺯﺎﺟﺍ, ﺵﻮﮔ, ﻩﺯﺎﺟﺍ, ﮎﺮﻤﮔﺯﺍﻻﺎﮐﺺﯿﺧﺮﺗ, ﻥﺩﺮﮐﮎﺮﺗ, ﺯﻮﺠﻣ, ﺯﻮﺠﻣ, ﺖﯾﺎﺿﺭ, ﭖﺎﭼ, ﻦﺘﺷﺍﺩﺭﺎﯿﺘﺧﺍﺭﺩ, ﺐﯾﻮﺼﺗ
ﺯﺎﺠﻣﺖﻟﺎﺣ: 
ﺖﯿﻘﻓﻮﻣ: ﻥﺪﺷﻖﻓﻮﻣ, ﻥﺪﺷﻖﻓﻮﻣ, ﯽﺑﺎﯿﻣﺎﮐ, ﺖﯿﻘﻓﻮﻣ, ﯼﺯﻭﺮﯿﭘ, ﯼﺯﻭﺮﯿﭘ, ﺖﺑﺎﺻﺍ, ﻩﺪﻧﺮﺑ, ﻩﺪﻧﺮﺑ, ﻖﻧﻭﺭ
ﻪﭙﺗ: ﻩﻮﮐ, ﻩﻮﮐ, ﻥﺎﺸﻔﺸﺗﺍ
ﯽﻘﯿﺳﻮﻣ: ﯽﻘﯿﺳﻮﻣ, ﮏﯿﺳﻼﮐ
ﻝﺎﺘﺴﯾﺩﯽﺸﯾﺎﻤﻧ: 
ﺮﻬﻇﺯﺍﺪﻌﺑ: ﺮﻬﻇﺯﺍﺪﻌﺑ, ﺮﻬﻇ, ﺮﻬﻇ, ﺐﺷ
ﻥﺩﺮﮐﻪﯾﺮﮔ: ﻥﺩﺮﮐﻪﯾﺮﮔ, ﺩﺎﯾﺮﻓ, ﺩﺎﯾﺮﻓ
ﺭﺎﺨﺘﻓﺍ: ﺭﺎﺨﺘﻓﺍ, ﻡﺍﺮﺘﺣﺍ, ﺭﺎﻗﻭ, ﻡﺍﺮﺘﺣﺍﻞﺑﺎﻗ, ﺰﯿﻣﺁﺭﺎﺨﺘﻓﺍ, ﯽﻠﯿﻠﺠﺗ, ﻊﺿﺍﻮﺗ, ﻩﻮﮑﺷ, ﺥﺮﻧ, ﺖﻤﯿﻗ
ﺖﻔﻫ: 
ﯽﺻﻮﺼﺧ: ﯽﺼﺨﺷ, ﺩﻮﺧ, ﺎﺼﺨﺷ, ﻩﮋﯾﻭ, ﯽﺻﻮﺼﺧﻢﯾﺮﺣ, ﺹﺎﺧ, ﯼﺭﺎﺼﺤﻧﺍ
ﻦﺘﺴﺸﻧ: ﻥﺩﺮﮐﺖﻣﺎﻗﺍ, ﻞﺼﻓﻭﻞﺣ
ﺭﺎﺒﺧﺍ: ﻡﺎﯿﭘ
ﻪﻨﺤﺻ: ﻞﺤﻣ, ﻩﺮﻈﻨﻣ, ﻪﻨﯿﻣﺯ, ﻥﺩﺍﺩﺶﯾﺎﻤﻧ, ﯼﺮﺼﺑ, ﻪﻨﺤﺻ, ﺯﺍﺪﻧﺍﻢﺸﭼ, ﺯﺍﺪﻧﺍﻢﺸﭼ, ﺭﺩﺎﭼ, ﯼﺮﻫﺎﻇﻞﮑﺷ
ﻍﺎﺑ: ﻥﺎﺒﻏﺎﺑ, ﮎﺭﺎﭘ
ﻪﻘﺑﺎﺴﻣ: ﯼﺩﺍﮋﻧ, ﻪﻘﺑﺎﺴﻣ, ﺍﺮﺟﺍﻝﺎﺣﺭﺩ, ﻪﻘﺑﺎﺴﻣ, ﻪﻘﺑﺎﺴﻣ, ﻪﺼﻗﺎﻨﻣ, ﺩﺍﮋﻧﺡﻼﺻﺍﻭﺵﺭﻭﺮﭘ, ﻦﺘﺷﺍﺩﯽﻧﺍﻮﺨﻤﻫ, ﺖﻠﻣ, ﺵﻼﺗ, ﯼﺭﻮﺗ
ﯽﻌﯾﺯﻮﺗﺩﺭﻮﻣ: 
ﺮﯿﮕﺑﺩﺎﯾ: ﻥﺩﺮﮐﻞﯿﺼﺤﺗ, ﺵﺯﻮﻣﺁ, ﯼﺪﻤﻋ
ﯽﺳﺎﯿﺳ: ﺖﺳﺎﯿﺳ, ﯽﺳﺎﯿﺳ, ﺭﺍﺪﻤﺘﺳﺎﯿﺳ, ﺖﺳﺎﯿﺳ
ﯽﻧﺍﺮﻨﺨﺳ: ﯽﻧﺍﺮﻨﺨﺳ, ﺪﯿﻨﮐﺖﺒﺤﺻ, ﻮﮕﺘﻔﮔ, ﻦﺨﺳ, ﯼﺭﺎﺘﻔﮔ
ﻍﻭﺭﺩ: ﻂﻠﻏ, ﻥﺩﺍﺩﺐﯾﺮﻓ, ﻥﺩﺍﺩﺐﯾﺮﻓ, ﻥﺩﺮﮐﯼﺭﺎﮑﺘﺳﺩ
ﺐﻟﺎﻗ: ﺏﺎﺗﺮﭘ, ﻥﺩﺮﻛﺕﺮﭘ, ﻥﺩﺮﮐﺕﺮﭘ, ﺏﺎﺗﺮﭘ, ﺐﻟﺎﻗ, ﺐﻟﺎﻗ, ﯼﺯﺍﺪﻧﺍﻩﺍﺭ, ﻦﺘﺨﯾﺭ, ﮎﺮﺗ
ﻥﺩﺭﻮﺧ: ﯽﯾﺍﺬﻏﻩﺪﻋﻭ, ﻥﺩﺮﮐﻪﯾﺬﻐﺗ, ﺏﺎﻘﺸﺑ, ﻥﺩﺭﻮﺧﺭﺎﻫﺎﻧ, ﻑﺮﺼﻣ
ﻪﻘﺒﻃ: ﻪﭽﯿﻟﺎﻗ, ﻦﯿﻣﺯ, ﻦﯿﯾﺎﭘ, ﮎﺎﺧ, ﻦﺘﻓﺭﻩﺍﺭ, ﻻﺎﺑ, ﺪﻨﻠﺑ, ﺪﺼﻘﻣ
ﻥﺎﺘﺴﺑﺎﺗ: ﺕﺭﺍﺮﺣ, ﻡﺮﮔ, ﺶﯾﺎﻣﺮﮔ
ﻦﯾﺩ: ﯽﻨﯾﺩ, ﯽﻫﺪﺑ, ﻩﺪﯿﻘﻋ, ﺮﺘﺳﺎﻓ
ﺮﯾﻮﺼﺗ: ﺮﯾﻮﺼﺗ, ﯼﺰﯿﻣﺁﮓﻧﺭ, ﺮﯾﻮﺼﺗ, ﺲﮑﻋ, ﯽﺴﮑﻋ, ﯽﺳﺎﮑﻋ, ﺲﮑﻋ, ﯽﭙﮐﻮﺘﻓ, ﻢﺳﺭ, ﯽﻧﺎﻬﮔﺎﻧﻭﻢﮑﺤﻣﻪﺑﺮﺿ, ﻢﻠﯿﻓ, ﺮﯾﻮﺼﺗ, ﺮﯾﻮﺼﺗ, ﻞﮑﺷ, ﻞﮑﺷ
ﻦﺘﻓﺭﺭﺩ: ﻦﺘﺨﯾﺮﮔ
ﻩﺪﻨﺴﯾﻮﻧ: ﻩﺪﻨﺴﯾﻮﻧ, ﻢﻠﻌﻣ, ﺮﮕﺸﯾﺍﺮﯾﻭ
ﻱﺍﻩﻮﻬﻗ: ﯼﺮﺘﺴﮐﺎﺧ, ﯼﺮﺘﺴﮐﺎﺧ, ﺥﺮﺴﺑﻞﯾﺎﻣﻩﻮﻬﻗ, ﯼﺰﻧﺮﺑ, ﺕﻼﮑﺷ, ﻡﺪﻨﮔﻪﺷﻮﺧ
ﺺﺨﺸﻣ: ﻦﯿﯿﻌﺗ, ﻦﺘﻓﺮﮔﻢﻴﻤﺼﺗ, ﻥﺪﺷﻦﯿﯿﻌﺗ, ﯽﻌﻄﻗ, ﻩﺪﻨﻨﮐﺭﺎﻬﻇﺍ, ﺡﺍﺮﻃ, ﻩﺪﺷﻦﯿﯿﻌﺗ, ﻡﻮﻠﻌﻣ, ﺕﺎﺒﺛﺎﺑ, ﯽﻀﻌﺑ, ﻢﯿﻤﺼﺗ, ﻩﺪﻧﺮﯿﮔﻢﯿﻤﺼﺗ, ﺪﺷﺖﺳﺭﺩ
ﺩﺭﺩ: ﻪﻣﺪﺻ, ﻩﻭﺪﻧﺍﻭﻢﻏ, ﮎﺎﻧﺩﺭﺩ, ﻢﻏ, ﻢﺧﺯ, ﺞﻧﺭ
ﺭﺎﻬﺑ: ﺮﭘ, ﺎﻣ, ﺎﻣﻝﺎﻣ
ﻡﺮﻧ: ﯽﻘﯾﺪﺼﺗ, ﻑﺎﺻ, ﺰﯾﺭ, ﻪﺼﻗﺎﻨﻣ, ﯽﻣﺍﺭﺁﻪﺑ, ﻢﯾﻼﻣ, ﻢﯾﻼﻣ, ﺏﻮﻠﻄﻣﻭﻦﯾﺮﯿﺷ, ﻢﯾﻼﻣ, ﻒﯾﺮﻇ, ﯽﺗﺍﺫ
ﻪﺷﻮﮔ: ﻪﯾﻭﺍﺯ, ﻊﯿﺳﻭ
: , , , , , , , , , , , , , , , , , , , , , , , , , , , , , , , , , , , , , , , , , , , , , , , , , , , , , , , , , , , , , , , , , , , , , , , , , , , , , , , , , , , , , , , , , , , , , , , , , , , , , , , , , , , , , , , , , , , , , , , , , , , , , , , , , , , , , , , , , , , , , , , , , , , , , , , , , , , , , , , , , , , , , , , , , , , , , , , , , , , , , , , , , , , , , , , , , , , , , , , , , , , , , , , , , , , , , , , , , , , , , , , , , , , , , , , , , , , , , , , , , , , , , , , , , , , , , , , , , , , , , , , , , , , , , , , , , , , , , , , , , , , , , , , , , , , , , , , , , , , , , , , , , , , , , , , , , , , , , , , , , , , , , , , , , , , , , , , , , , , , , , , , , , , , , , , , , , , , , , , , , , , , , , , , , , , , , , , , , , , , , , , , , , , , , , , , , , , , , , , , , , , , , , , , , , , , , , , , , , , , , , , , , , , , , , , , , , , , , , , , , , , , , , , , , , , , , , , , , , , , , , , , , , , , , , , , , , , , , , , , , , , , , , , , ﻝﺎﺳﺭﺍ, ﺖﯾﻮﻘﺗ, ﻥﺩﺮﮐﮏﭼ, ﯽﻧﺍﺭﺎﺑﺱﺎﺒﻟ, ﻞﻤﺣﻞﺑﺎﻗ،ﺵﻮﻣﺎﺧ, ﺵﺮﯾﺬﭘﻝﻮﺌﺴﻣ, ﺏﺎﺘﻓﺁﺪﺿﯼﺎﻫﻡﺮﮐ, ﻩﺪﻨﻨﮐﻪﺋﺍﺭﺍ, ﺭﻮﺘﮐﮊﻭﺮﭘ, ﺩﺭﻮﺑﺖﯿﮑﺳﺍ, ﻕﺮﺑﻦﯿﺴﻨﮑﺗ, ﮎﺰﺑ, ﺮﺘﻣﯽﺘﻧﺎﺳ, ﻝﻮﭘﻒﯿﮐ, ﮓﻧﺭﺩ, ﻪﯾﺪﯿﺋﺎﺗ, ﯽﺴﮐﺎﺗ, ﺭﺎﺑ, ﯽﮕﺸﯿﻤﻫ, ﯽﻗﺎﻔﺗﺍ, ﺮﻄﺧ, ﻁﺎﯿﺧ, ﻦﻟﻮﯾﻭ, ﻥﺎﺒﻏﺎﺑ, ﺭﺎﺠﻧ, ﻥﺍﺪﻠﮔ, ﺲﻣﺍﺩﺁ, ﻪﻣﺎﻨﻫﺎﮔ, ﻭﺭﻩﺩﺎﯿﭘ, ﻥﺎﻓﻮﻃ, ﯼﺮﺳﻭﺭ, ﮏﯿﻧﮏﯿﭘ, ﻞﯿﻧﺍﻭ, ﻥﺎﺸﻧ, ﺮﺳﺩ, ﺱﻮﻗ, ﺮﮕﻧﻩﺪﻨﯾﺁ, ﺭﺎﺒﻧﺍ, ﺭﺍﺪﻗﻭﺪﻨﺻ, ﯽﯾﻻ, ﯽﻨﯾﺮﯿﺷ, ﺭﺍﺪﺑﺎﺘﮐ, ﻩﺎﮕﺷﺯﺭﻭ, ﻞﯿﻘﺛﺮﺟ, ﺰﭙﺷﺁ, ﯽﻣﻮﻤﻋ, ﻩﺪﻨﻨﮐﮎﺎﭘ, ﻥﺯﺖﻣﺪﺨﺸﯿﭘ, ﺭﻭﺎﺸﻣ, ﺮﻳﺮﺤﺘﻟﺍﻡﺯﺍﻮﻟ, ﮊﺎﺳﺎﻣ, ﯽﯾﺍﻮﻧﺎﻧ, ﻥﺍﺪﺳ, ﻮﯾﻭﻭﺮﮑﯾﺎﻣ, ﺶﮐﻪﻟﻮﻟ, ﺦﯿﺳ, ﻡﺎﻬﺳﺭﺍﺰﮔﺭﺎﮐ, ﻪﭽﺑﺎﺘﮐ, ﺮﮔﺮﺒﻤﻫ, ﯼﺭﺎﺨﺑ, ﯽﺘﺷﺍﺪﻬﺑﻭﯽﺸﯾﺍﺭﺁﻡﺯﺍﻮﻟ, ﺏﺎﺒﮐ, ﻩﺩﺍﺩﻮﺑﺕﺭﺫ, ﯽﺑﺎﺗﺯﺎﺑ, ﻡﺭﺁ, ﻦﺗﯽﻫﺎﻣ, ﺍﺬﻏﺶﯿﭘ, ﺞﻨﺳﻥﺎﻣﺯ, ﺯﺎﺳﻭﺭﺍﺩ, ﺪﻣﺁﻭﺖﻓﺭ, ﻦﺗﺭﺎﮐ, ﺡﺮﻃ, ﻒﯿﮐ, ﯽﻗﺮﺑﻪﻠﭘ, ﻖﯾﺮﻏﺕﺎﺠﻧ, ﻪﻣﺎﻧﺮﺳ, ﯽﯾﻮﺸﻓﺮﻇﻦﯿﺷﺎﻣ, ﯽﺘﺸﭘﻪﻟﻮﮐ, ﯽﯾﺎﯾﺭﺩﯼﺍﺬﻏ, ﺭﺍﺩﺥﺮﭼﯽﻟﺪﻨﺻ, ﻩﺎﮕﺷﺩﺮﮔ, ﻝﺎﺒﯿﻟﺍﻭ, ﻩﺪﻨﻨﮐﻡﺮﻧ, ﻪﻨﮕﻨﻣ, ﯼﺪﻧﻼﻨﻓﺭﺎﺨﺑﻡﺎﻤﺣ, ﯽﺳﺭﺍﻭ, ﺮﻧﻮﺗ, ﺖﻌﻨﺻ, ﺵﺯﺮﻟ
ﻥﺩﺮﮐﺪﯿﻟﻮﺗ: ﺪﯿﻟﻮﺗ, ﺪﯿﻟﻮﺗ, ﻩﺪﻨﻨﮐﺪﯿﻟﻮﺗ, ﻦﺘﺧﺎﺳ, ﺪﯿﻟﻮﺗ, ﺪﯿﻟﻮﺗ, ﻝﻮﺼﺤﻣ, ﯽﻋﺍﺭﺯﺕﻻﻮﺼﺤﻣ, ﻝﻮﺼﺤﻣ, ﺩﺎﺠﯾﺍ, ﻞﯿﮑﺸﺗ
ﻩﺪﻨﺧ: ﯽﺧﻮﺷ, ﻩﺪﻨﺧ
ﻥﺩﺮﮐﺵﻮﻣﺍﺮﻓ: ﻥﺩﺮﮐﯽﺷﻮﭘﻢﺸﭼ, ﺭﺎﮑﻧﺍ, ﻪﺟﻮﺘﻣ
ﺎﭘﻭﺭﺍ: 
ﺖﺸﻫ: ﻢﺘﺸﻫ
ﺭﻮﺒﻋ: ﻂﺳﻮﺗ, ﻖﯾﺮﻃﺯﺍ, ﻥﺩﺮﮐﯽﻃ, ﻖﻳﺮﻃﺯﺍ, ﻩﺪﺷﯼﺮﭙﺳ, ﺭﻮﺒﻋ, ﺭﻮﺒﻋ, ﺮﯿﯿﻐﺗ, ﻝﺎﻘﺘﻧﺍ, ﻭﺮﻫﺍﺭ
ﮎﺎﻨﺘﺸﺣﻭ: ﺡﺎﻀﺘﻓﺍ, ﺭﺎﺑﺖﺒﯿﺼﻣ, ﯽﮐﺎﻨﺘﺸﺣﻭ, ﮎﺎﻨﺳﺮﺗ, ﻢﯿﻈﻋ, ﺰﯿﮕﻧﺍﻢﻏ, ﻩﺪﻨﻫﺩﺭﺍﺪﺸﻫ, ﻥﺪﻧﺎﺳﺮﺗ, ﻻﻮﯿﻫ, ﺭﻮﺟﺪﺑ
ﺭﻮﻈﻨﻣ: ﻩﺰﯿﮕﻧﺍ, ﻒﻄﻟ, ﻒﻄﻟ
ﺲﻔﻧ: ﯽﺴﻔﻨﺗ, ﻥﺪﯿﺸﮐﺲﻔﻧ, ﺲﻔﻨﺗ, ﻥﺩﺍﺩﻥﻭﺮﯿﺑ, ﺲﻔﻧ, ﻥﺩﺯﺲﻔﻧﺲﻔﻧ, ﻩﺁ, ﻥﺩﺮﮐﻪﻣﺰﻣﺯ, ﻕﺎﺸﻨﺘﺳﺍ, ﻥﺪﯿﺸﮐﻮﺑ
ﺎﻧﺍﺩ: ﻝﻮﻘﻌﻣ, ﻝﻮﻘﻌﻣ, ﻁﺎﯿﺘﺣﺍﺎﺑ, ﺮﮑﻔﺘﻣ, ﺵﻮﻫﺎﺑ, ﺪﻨﻤﺷﻮﻫ, ﺪﻨﻤﺷﻮﻫ-ﺵﻮﻫﺎﺑ, ﻎﻟﺎﺑ, ﻥﺎﺸﺧﺭﺩ
ﻪﯿﻟﺎﻓﺎﻀﻣﺮﮕﻧﺎﺸﻧ: 
ﺮﯾﺬﭙﻟﺩ: ﺵﻮﺧ, ﺶﺨﺑﺕﺬﻟ, ﺏﻮﻠﻄﻣ, ﺖﺣﺍﺭ, ﯽﺘﺣﺍﺭﻪﺑ, ﺐﻟﺎﺟ, ﺏﻮﺧ, ﻪﻧﺎﻔﯾﺮﻇ, ﻉﻮﻧ, ﯽﯾﺎﺒﯾﺯ, ﯽﻣﺮﮔﺮﺳ
ﻼﻣﺎﮐ: ﻼﻣﺎﮐ, ﻼﻣﺎﮐ, ﻞﻣﺎﮐﺕﺭﻮﺻﻪﺑ, ﻼﻣﺎﮐ, ﻪﻧﻻﺎﻌﻓ, ﻞﻣﺎﮐ, ﯽﺘﺳﺍﺮﺑ, ﻉﻮﻤﺠﻣ, ﻼﻣﺎﮐ, ﻼﻣﺎﮐ, ﻼﻣﺎﮐ, ﻖﻠﻄﻣ
ﻪﻈﻓﺎﺣ: ﻥﺩﺮﮐﻆﻔﺣ, ﻊﺟﺮﻣ, ﺩﻮﺑﺩﺎﯾ, ﺩﺭ
ﺮﺒﻗ: ﯼﺪﺟ, ﺪﯾﺪﺷ, ﺕﺪﺷﻪﺑ, ﻥﺎﺘﺳﺮﺒﻗ, ﯽﻧﺍﺮﺤﺑ
ﻥﺭﺪﻣ: ﺮﺻﺎﻌﻣ, ﻪﺘﻓﺮﺸﯿﭘ, ﻥﺩﺮﮐﻦﯾﻮﻧ, ﺯﻭﺭﺪﻣ, ﺮﯿﺧﺍ, ﻦﺨﺳ, ﯽﻣﻭﺩ, ﻪﺘﻓﺮﺸﯿﭘ, ﻩﺯﻭﺮﻣﺍ
ﻪﻄﻘﻧ: ﻥﺩﺮﻛﻩﺭﺎﺷﺍ, ﻪﻄﻘﻧ, ﺖﻋﺎﺳ, ﻞﺤﻣ, ﻪﮑﻟ, ﻪﻠﺻﻭ, ﻥﺩﺍﺩﯼﺎﺟ, ﯽﯾﺎﺟﭻﯿﻫ, ﻞﺤﻣ, ﻥﺎﮑﻣ, ﻞﺤﻣ, ﯽﻠﺤﻣ, ﻥﺩﺍﺩﺭﺍﺮﻗ, ﻥﺩﺮﮐﺎﻀﻣﺍ, ﮒﺭﺰﺑﻩﺩﻭﺭ
ﺢﻳﺮﻔﺗﮓﻧﺯ: ﺭﺩﻦﺘﺴﮑﺷ, ﺰﻣﺮﺗ, ﺭﺮﮑﻣﺪﻣﺁﻭﺖﻓﺭ, ﻦﻟﺎﺳ, ﻪﻔﻗﻭ, ﻩﺯﺎﺑ, ﻑﺎﮑﺷ, ﻥﺪﯿﺑﻮﮐﻢﻫﺭﺩ, ﻦﺘﺴﮑﺷ, ﻥﺩﺮﮐﻒﻗﻮﺘﻣ, ﻒﻗﻮﺗ, ﻥﺩﺮﮐﻊﻄﻗ, ﺭﺍﺮﻗﻲﺑ
ﻩﺮﯾﺰﺟ: 
ﻪﺑﻥﺩﺯﺖﺳﺩ: ﺱﺎﻤﺗ, ﺮﯿﺷ
ﺮﺑﺍﺮﺑ: ﻝﺩﺎﻌﻣ, ﻥﺎﺴﮑﯾ, ﻢﻫﻪﯿﺒﺷ, ﯽﺘﺳﺭﺩ, ﻪﺷﺎﺑ, ﺏﻮﺧﯽﻠﯿﺧ, ﻥﺎﺴﮑﯾﺭﻮﻃﻪﺑ, ﻪﺟﺭﺩ, ﻝﺩﺎﻌﺗ, ﻥﺎﺴﮑﯾ
ﻞﺣﺎﺳ: ﯼﺮﯿﮔﻥﺎﺒﯿﺘﺸﭘ, ﺯﺮﻣ, ﻞﺣﺎﺳ
ﻩﺪﻋﻭ: ﺐﮑﺗﺮﻣ, ﺪﻬﻌﺗ, ﻭﺮﮔ, ﺏﺎﺼﺘﻧﺍ, ﻦﯿﻤﻀﺗ
commissiveﺖﻟﺎﺣ: 
ﺡﺮﻃ: ﺡﺮﻃ, ﻪﻣﺎﻧﻢﻫﺎﻔﺗ, ﻪﻣﺎﻧﺮﺑ, ﻪﻣﺎﻧﺮﺑ, ﻞﻤﻋﺭﺎﮑﺘﺑﺍ, ﺶﮐﻪﺸﻘﻧ, ﺡﺮﻃ, ﯼﺩﺎﻬﻨﺸﯿﭘﺡﺮﻃ, ﻩﮊﻭﺮﭘ, ﺡﺮﻃ, ﺡﺮﻃ, ﺡﺮﻃ, ﺡﺮﻃ, ﺖﺨﺗ, ﻢﺳﺭ, ﻥﺩﺮﮐﯽﺣﺍﺮﻃ, ﻩﺭﺍﺰﮔ, ﻱﺰﻳﺭﻪﻣﺎﻧﺮﺑ, ﺮﮑﻔﺗ
ﻥﺩﺮﮐﺮﯿﮕﻠﻓﺎﻏ: ﺐﯿﺠﻋ, ﻪﺒﻗﺮﺘﻣﺮﯿﻏ, ﯽﻓﺩﺎﺼﺗ, ﻩﺪﻨﻨﮐﺮﯿﮕﻠﻓﺎﻏ, ﺐﺠﻌﺗ, ﺐﺠﻌﺗﯼﺎﺟ, ﻥﺪﺷﺮﯿﮕﻠﻓﺎﻏ
ﻪﻘﯿﻗﺩ: 
ﺲﮑﻋ: ﻦﺘﺨﯾﺭﻥﻭﺮﯿﺑ, ﯼﺯﺍﺪﻧﺍﺮﯿﺗ, ﻪﻟﻮﻠﮔ, ﺕﺎﻤﻬﻣ, ﺲﮑﻋ, ﺲﮑﻋ, ﻪﺑﺮﺿ, ﺭﺎﺠﻔﻧﺍ, ﺎﺗﺩﻮﮐ, ﻥﺩﺮﻛﺕﺮﭘ, ﺏﺎﻗ, ﻥﺩﺯﺪﮕﻟ
ﯼﺮﺒﻫﺭ: ﯼﺮﺒﻫﺭ, ﻥﺪﺷﯽﻬﺘﻨﻣ, ﻥﺩﺮﮐﺖﯾﺍﺪﻫ, ﻪﻟﻮﻠﮔ, ﻮﯾﺍﺭﺩ, ﺎﻤﻨﻫﺍﺭ, ﺍﺭ, ﺮﻏﻻ
ﻪﺸﯿﺷ: ﻪﻨﯿﯾﺁ, ﻝﺎﺘﺴﯾﺮﮐ, ﻪﺸﯿﺷ, ﮏﻨﯿﻋ, ﻪﺤﻔﺻ, ﺕﺍﺭﺩﺎﺻ
ﻪﺘﺨﺗ: ﮓﻨﺳﻪﺘﺨﺗ, ﺍﺭﻮﺷ, ﻻﺎﺑ, ﻥﺪﻣﺁﻻﺎﺑ, ﻥﺪﺷﺭﺍﻮﺳ, ﻩﻭﺮﮔ, ﻥﻮﯿﺴﯿﻤﮐ, ﻮﻠﺑﺎﺗ, ﺖﺤﯿﺼﻧ, ﻪﺒﻟ, ﻥﻮﯿﺴﯿﻤﮐ, ﺹﺮﻗ, ﭖﺎﭼ
ﻝﺎﺜﻣ: ﻝﺎﺜﻣ, ﺮﯾﻮﺼﺗ, ﻝﺪﻣ, ﻮﮕﻟﺍ, ﻩﺭﺎﻌﺘﺳﺍ, ﻪﯿﻟﻭﺍﻪﻧﻮﻤﻧ, ﻪﻟﺰﻨﻣﻪﺑ, ﯽﮔﺪﻨﯾﺎﻤﻧ, ﻪﻧﻮﻤﻧ, ﺩﺭﻮﻣ, ﻪﻘﺑﺎﺳ, ﻪﻧﻮﻤﻧ, ﻮﮕﻟﺍ, ﻥﺩﺍﺩﻥﺎﺸﻧ, ﻪﻠﺑ
ﺮﻄﺧﯽﺑ: ﻦﻣﺍ, ﯽﻨﻤﯾﺍ, ﺖﯿﻨﻣﺍ, ﺮﻄﺧﻥﻭﺪﺑ, ﻦﺌﻤﻄﻣ, ﻪﻤﯿﺑ, ﻢﺸﭼﯼﻭﺭﻪﺑ, ﺭﺍﺯﺁﯽﺑ, ﺖﺷﺍﺩﺮﺑ
ﺮﺘﮐﺩ: ﮏﺷﺰﭘ, ﺱﺎﻨﺸﻧﺎﻣﺭﺩ, ﺺﺼﺨﺘﻣ, ﯽﮑﺷﺰﭘ, ﮏﺷﺰﭙﻧﺍﺪﻧﺩ
ﺱﻼﮐ: ﻉﻮﻧ, ﺭﺍﺪﻣ, ﺱﺭﺩﺱﻼﮐ, ﻪﺟﺭﺩ, ﯽﯾﺍﺪﺟ, ﻪﯾﻻ, ﯼﺪﻨﺑﻪﺘﺳﺩ, ﻪﺒﺗﺭ, ﻪﯿﺣﺎﻧ
completiveﻪﺒﻨﺟ: 
ﺭﺮﮑﻣ: ﺎﺒﻟﺎﻏ, ﻢﻈﻨﻣ, ﺖﺑﺎﺛ, ﻡﻭﺍﺪﻣﺭﻮﻃﻪﺑ, ﻩﺎﮕﯿﺑﻭﻩﺎﮔ, ﺭﺮﮑﻣ, ﺐﺗﺮﻣﺭﻮﻃﻪﺑ, ﻪﻣﺎﻨﻫﺎﮔ, ﺭﺍﺮﮑﺗ, ﻥﺩﺮﮐﺭﺍﺮﮑﺗ, ﻩﺪﻧﻮﺷﺭﺍﺮﮑﺗ, ﺮﻈﻧﺪﯾﺪﺠﺗ, ﺭﺍﺮﮑﺗ
ﯽﻣﺎﻈﻧ: ﻥﺎﺘﺳﺮﻬﺷ
ﻡﺮﮔ: ﻡﺮﮔ, ﺕﺭﺍﺮﺣ, ﯽﻣﺮﮔ, ﺕﺭﺍﺮﺣﻪﺟﺭﺩ, ﺶﯾﺎﻣﺮﮔ, ﻡﺮﮔ, ﻡﺮﮔ
ﻥﺪﯿﺷﻮﻧ: ﻪﺑﺎﺷﻮﻧ, ﯽﺘﺴﻣ
ﻢﺸﺧ: ﻦﯿﮕﻤﺸﺧ, ﻢﺸﺧ, ﺖﻣﺮﺣﮏﺘﻫ, ﮏﯾﺮﺤﺗ, ﻪﻨﯿﮐ, ﺯﺍﻥﺪﺷﻦﯿﮕﻤﺸﺧ, ﺖﯾﺫﺍ
ﻢﯿﻘﺘﺴﻣﺭﻮﻃﻪﺑ: ﺖﺳﺍﺭﺮﺳ, ﻢﯿﻘﺘﺴﻣ, ﻢﯿﻘﺘﺴﻣﺮﯿﻏ, ﮏﯿﺗﺎﻣﻮﺗﺍ, ﺖﺳﺍﺭﺮﺳ, ﯼﺭﻮﻓ, ﺖﺳﺍﺭ, ﻪﻠﺻﺎﻓﻼﺑ, ﯽﻫﺎﻔﺷ
ﻩﻼﮐ: ﺭﺍﺩﻪﺒﻟﻩﻼﮐ, ﯽﻨﻤﯾﺍﻩﻼﮐ
ﮓﺳ: 
ﺭﺍﺰﮕﺘﻣﺪﺧ: ﺮﺷﺎﺒﻣ, ﺖﻣﺪﺨﺸﯿﭘ, ﻥﺯﺖﻣﺪﺨﺸﯿﭘ, ﻥﺯﺖﻣﺪﺨﺸﯿﭘ, ﻩﺩﺮﺑ, ﯽﮕﻧﺎﺧ
ﺭﻭﺮﻏ: ﺮﺒﮑﺘﻣ, ﺭﻭﺮﻐﻣ, ﺭﺎﺨﺘﻓﺍﺎﺑ, ﺭﻭﺮﻏ
ﺖﯿﻌﻤﺟ: ﻥﺩﺮﺑﻡﻮﺠﻫ, ﻍﻮﻠﺷ, ﺖﯿﻌﻤﺟ, ﻥﺍﺰﯿﻣ, ﺭﺍﺪﻘﻣ, ﺖﯿﻌﻤﺟ, ﻥﺎﺑﺰﯿﻣ, ﻩﺩﻮﺗ, ﺭﺎﯿﺴﺑ, ﯼﺭﺎﯿﺴﺑ, ﺩﺪﻌﺘﻣ, ﯼﺪﺟﺭﻮﻃﻪﺑ, ﻥﺍﻭﺍﺮﻓ, ﻢﺠﺣ, ﻪﻠﮔ
ﺭﺎﻄﻗ: ﻪﮑﺴﻟﺎﮐ, ﻭﺭﺩﻮﺧ, ﻦﮔﺍﻭ, ﯼﺭﺎﮔ, ﻦﻫﺁﻩﺍﺭ, ﻞﯾﺭ, ﺵﺯﻮﻣﺁ
ﯽﻗﻼﺧﺍ: ﻕﻼﺧﺍ, ﯽﻗﻼﺧﺍﺮﻈﻧﺯﺍ, ﯽﻗﻼﺧﺍ, ﻕﻼﺧﺍﻝﻮﺻﺍ, ﻪﯿﺣﻭﺭ, ﯽﻧﺎﺣﻭﺭ
ﯽﻧﺎﻧﻮﯾ: 
ﻥﺪﺷﺎﺟ: ﺖﺳﺍﻮﺧﺩﺍﺩ, ﺐﺳﺎﻨﻣ, ﺐﺳﺎﻨﻣ, ﺭﺎﮔﺯﺎﺳ, ﺐﺳﺎﻨﻣ, ﺖﺣﺍﺭ, ﺐﺳﺎﻨﻣ, ﻥﺩﻮﺑﻖﺑﺎﻄﻣ, ﻂﯾﺍﺮﺷﺪﺟﺍﻭ, ﻁﻮﺑﺮﻣ, ﻖﻓﺍﻮﺗ, ﻥﺩﺮﮐﻢﯿﻈﻨﺗ, ﻖﯿﻗﺩ, ﻖﯿﻗﺩ, ﻥﺪﺷﻑﺩﺎﺼﻣ
ﻥﺪﺷﻞﺧﺍﺩ: ﻢﺘﺴﯿﺳﻪﺑﺩﻭﺭﻭ, ﺩﻭﺭﻭ, ﻥﺩﺍﺩﺡﺮﺷءﺰﺟﻪﺑءﺰﺟ, ﻥﺩﺍﺩﻥﺎﺸﻧ, ﻥﺩﺍﺩﺭﺍﺮﻗ, ﻞﻣﺎﺷ, ﻡﺎﻧﺖﺒﺛ, ﺖﺒﺛ
ﻥﻮﻧﺎﻗ: ﺖﻣﻮﮑﺣ, ﻪﻄﻠﺳ, ﻢﯾﮊﺭ, ﯼﺭﻭﺍﺩ, ﻢﮑﺣ, ﯼﺭﻭﺍﺩ, ﺭﻭﺍﺩ, ﻥﺩﺮﮐﺖﻣﻮﮑﺣ, ﻥﻮﻧﺎﻗ, ﻥﻮﻧﺎﻗ, ﺭﺎﺠﻨﻫ, ﻥﺩﺍﺩﺡﺮﺷءﺰﺟﻪﺑءﺰﺟ, ﻢﯿﻈﻨﺗ, ﺖﻨﻄﻠﺳ, ﺕﺍﺭﺮﻘﻣ, ﻪﺨﺴﻧ
ﺮﯿﺸﻤﺷ: ﻪﻐﯿﺗ, ﻮﻗﺎﭼ
ﻪﻠﻤﺣ: ﻢﺟﺎﻬﺗ, ﻪﻠﻤﺣ, ﺯﻭﺎﺠﺗ, ﻡﺮﺟ, ﻪﻠﻤﺣ, ﻦﯿﻫﻮﺗ, ﺏﺎﺼﺘﻋﺍ, ﻉﻭﺮﺷ, ﻪﻠﻤﺣ, ﺵﺭﻮﯾ
ﺖﻣﻼﺳ: ﻢﻟﺎﺳ, ﻦﺘﻔﮔﮏﯾﺮﺒﺗ
ﺪﻨﺑ: ﺮﻌﺷ, ﺪﻨﺑ, ﻪﮑﺗ, ﻥﺩﺮﻛﻩﺭﺎﺷﺍ, ﺵﺮﮕﻧ, ﺖﻟﺎﺣ, ﻝﺩﺎﻌﺗ
ﯽﻋﺎﻤﺘﺟﺍ: ﻪﻌﻣﺎﺟ, ﯽﻋﺎﻤﺘﺟﺍ
ﺩﺍﺩﺮﺘﺳﺍ: ﺦﺳﺎﭘ, ﺦﺳﺎﭘ
ﻒﺳﺎﺘﻣ: ﻥﺪﺷﻥﺎﻤﻴﺸﭘ, ﺐﻄﻗ, ﺶﺸﺨﺑ, ﻪﻧﺎﻬﺑ, ﯽﻫﺍﻮﺧﺭﺬﻋ, ﻢﺣﺮﺗ, ﻩﻭﺪﻧﺍﻭﻢﻏ, ﻥﺩﺮﺑﺞﻧﺭ, ﻥﺪﯿﺸﮐﺞﻧﺭ, ﻢﻏ, ﻩﻭﺪﻧﺍﻭﻢﻏ, ﯼﺭﺍﺩﺍﺰﻋ, ﻪﺼﻏﻭﻢﻏ, ﻥﺩﺮﮐﻪﯾﺮﮔ, ﯽﺘﺨﺳ
ﺖﻋﺎﺠﺷ: ﺕﺍﺮﺟﻭﻝﺩ, ﺭﻮﺴﺟ, ﻦﺌﻤﻄﻣ, ﺐﺼﻋ, ﯽﯾﺎﺒﯿﮑﺷ, ﺖﻣﺎﻬﺷ, ﻉﺎﺠﺷ, ﯽﺘﺸﮐ
ﯽﻤﺳﺭ: ﯽﻤﺳﺭ, ﯽﻤﺳﺭﺭﻮﻃﻪﺑ, ﺎﻤﺳﺭ, ﺮﺴﻓﺍ, ﯽﺸﻨﻣ, ﮏﯿﺗﺍﺮﮐﻭﺭﻮﺑ, ﻥﺩﺍﺩﻩﺯﺎﺟﺍ
ﻩﺪﺷﻪﺋﺍﺭﺍ: ﺪﻨﮐﯽﻣﻢﻫﺍﺮﻓ, ﺩﺎﻬﻨﺸﯿﭘ, ﻥﺩﺭﻭﺁﻢﻫﺍﺮﻓ, ﯽﻓﺮﻌﻣ, ﺱﺮﺘﺳﺩﺭﺩ, ﻦﯿﻣﺎﺗ, ﮎﺭﺍﺪﺗ, ﻥﺩﺮﮐﻪﯿﻬﺗ, ﺮﮔﺍ
ﻥﺩﺮﮐﺎﺿﺎﻘﺗ: ﺯﺎﻤﻧ, ﺎﺿﺎﻘﺗ, ﺎﻋﺩﺍ, ﺯﺎﯿﻧ, ﺯﺎﯿﻧ, ﻮﺟﻭﺱﺮﭘ, ﻮﺟﻭﺱﺮﭘ, ﮓﻧﺭﺩﯽﺑ, ﺩﺎﻬﻨﺸﯿﭘ, ﺭﺍﺰﻓﺍﻡﺮﻧ, ﻥﺩﺮﮐﻭﺯﺭﺁ
ﻩﺎﮕﻧ: ﯽﻟﺎﻤﺟﺍﺮﻈﻧ, ﺯﺍﺪﻧﺍﻢﺸﭼ, ﺵﺮﮕﻧ, ﮎﺍﺭﺩﺍ, ﺯﺍﺪﻧﺍﻢﺸﭼ, ﻩﺮﻈﻨﻣ, ﻦﮐﻩﺎﮕﻧ, ﻪﺟﻮﺗﻞﺑﺎﻗ, ﻥﺩﺮﮐﻩﺎﮕﻧﻝﺯﻝﺯ, ﻩﺪﻨﻨﮐﻩﺮﯿﺧﺶﺑﺎﺗ
ﻥﺩﺍﺩﺭﺎﺸﺘﻧﺍ: ﺕﺎﯿﺋﺰﺟ, ﻥﺩﺮﻛﺪﻳﺪﻤﺗ, ﺵﺮﺘﺴﮔ, ﻪﻌﺳﻮﺗ, ﻥﺩﺍﺩﻪﻌﺳﻮﺗ, ﻩﺩﺮﺘﺴﮔ, ﻉﻮﯿﺷ, ﺭﺎﺸﺘﻧﺍ, ﻥﺩﺮﮐﺶﺨﭘ, ﺫﻮﻔﻧ, ﻪﻨﻣﺍﺩ, ﻥﺩﺭﻭﺍﺭﺩﺵﺩﺮﮔﻪﺑ
ﻞﺑﺎﻘﻣ: ﻮﻠﺟ, ﻒﻟﺎﺨﻣ, ﻒﻟﺎﺨﻣ, ﻒﻟﺎﺨﻣ, ﻞﺑﺎﻘﻣﺭﺩ, ﻥﺎﯿﻣﺭﺩ, ﻩﺪﻧﺭﺎﻤﺷ, ﻑﻼﺧﺮﺑ, ﺾﻗﺎﻨﺗ, ﻥﺩﺮﮐﺱﻮﮑﻌﻣ, ﺮﮕﻨﻠﺗ, ﺮﺑﺍﺮﺑﺭﺩ, ﺖﻔﻟﺎﺨﻣ, ﻒﻟﺎﺨﻣ, ﺱﻮﮑﻌﻣ
ﻩﺩﺯﺍﻭﺩ: ﻦﯿﺟﻭﺩ
ﻝﻮﻐﺸﻣ: ﯼﺩﺰﻣﺎﻧ, ﻝﻮﻐﺸﻣ, ﺭﺎﮐﺭﺪﻧﺍﺖﺳﺩ, ﻥﺩﺮﮐﺖﮐﺮﺷ, ﻩﺪﺷﻝﺎﻐﺷﺍ, ﻥﺩﺮﮐﻝﻮﻐﺸﻣ, ﻥﺩﺮﮐﺎﺗ, ﯽﻠﻤﻋ, ﺱﻮﮑﻌﻣ
ﺏﺍﺮﺷ: ﻞﮑﻟﺍ, ﯽﻠﮑﻟﺍ
ﻢﻌﻃ: ﻢﻌﻃ, ﻢﻌﻃ, ﺬﯾﺬﻟ-ﻩﺰﻤﺷﻮﺧ, ﻪﻤﻌﻃ, ﻩﺰﻣ
ﻥﺪﯿﺸﮐﻮﺗﺍ: ﺩﻻﻮﻓ, ﺰﻠﻓ
ﻊﯾﺯﻮﺗ: ﻝﺎﻘﺘﻧﺍ, ﺵﺮﺘﺴﮔ, ﺭﺎﺸﺘﻧﺍ, ﺮﺸﻧﻭﭖﺎﭼ, ﺭﺎﺸﺘﻧﺍ, ﻥﺩﺭﻭﺍﺭﺩﺵﺩﺮﮔﻪﺑ, ﻊﯾﺯﻮﺗ, ﻥﺩﺍﺩﺹﺎﺼﺘﺧﺍ, ﻢﻬﺳ, ﻥﺩﺮﮐﻢﯿﺴﻘﺗ, ﻑﺎﮑﺷ, ﯼﺯﺎﺳﺍﺪﺟ, ﻥﺩﺮﮐﯼﺪﻨﺑﻪﺘﺳﺩ, ﯽﻌﯾﺯﻮﺗ, ﻊﯾﺯﻮﺗ
ﺕﺭﺎﺠﺗ: ﺕﺭﺎﺠﺗ, ﺕﺭﺎﺠﺗ, ﺕﺭﺎﺠﺗ, ﻻﺎﮐ, ﺖﻧﺮﺘﻨﯾﺍ, ﻪﻠﻣﺎﻌﻣ, ﺶﻨﮐﺍﺮﺗ, ﯽﺑﺎﯾﺭﺍﺯﺎﺑ, ﯼﺭﺎﺠﺗ
ﯽﺿﺎﻗ: ﯼﺭﻭﺍﺩ, ﯼﺭﻭﺍﺩ, ﺭﻭﺍﺩ, ﻥﺍﺭﻭﺍﺩﺖﺌﯿﻫ
ﺲﭘﺍﻮﻟﺩ: ﯼﺭﺍﺮﻄﺿﺍ, ﺕﺭﻭﺮﺿ, ﻥﺍﺮﮕﻧ, ﺏﺮﻄﻀﻣ, ﻥﺍﺮﮕﻧ, ﺏﺍﺮﻄﺿﺍ, ﻪﻗﻼﻋ, ﻥﺩﻮﺑﻥﺍﺮﮕﻧ, ﺮﮑﻔﺘﻣ, ﺖﺣﺍﺭﺎﻧ, ﻩﺪﻨﻨﮐﻥﺍﺮﮕﻧ, ﻩﺪﯿﺳﺮﺗ, ﻕﺎﺘﺸﻣ, ﻥﺍﺮﮕﻧ, ﻩﺪﻨﻫﺩﺭﺍﺪﺸﻫ, ﻕﺎﺘﺸﻣ, ﻕﺎﯿﺘﺷﺍﺎﺑ, ﺭﺍﺮﻗﻲﺑ, ﺏﺮﻄﻀﻣ, ﯼﻭﺎﮑﺠﻨﮐﺲﺣ, ﻡﺍﺭﺁﺎﻧ, ﯽﻧﺍﺮﮕﻧﻭﺖﺸﺣﻭﺱﺎﺴﺣﺍ
ﻥﺍﻭﺮﺳ: 
ﻒﻗﻮﺗﻪﺒﻨﺟ: 
ﯽﺟﺭﺎﺧ: ﺭﻮﺸﮐﺯﺍﺝﺭﺎﺧ, ﻪﻧﺎﮕﯿﺑ, ﯽﺟﺭﺎﺧ, ﺐﯾﺮﻏﻭﺐﯿﺠﻋ, ﻪﻧﺎﮕﯿﺑ, ﯽﺟﺭﺎﺧ, ﺝﺭﺎﺧ
ﻩﺪﻨﻨﮐﺪﯾﺪﺸﺗ: ﺪﯾﺪﺸﺗ
ﺖﯿﻤﻫﺍ: ﺕﺭﻭﺮﺿ, ﻁﺎﺒﺗﺭﺍ, ﯽﻨﻌﻣ, ﺖﯿﻤﻫﺍ, ﯽﺗﺎﯿﺣ, ﺪﯿﮐﺎﺗ
ﺖﯾﺎﻬﻧﺭﺩ: ﺖﯾﺎﻬﻧﺭﺩ, ﺖﯾﺎﻬﻧﺭﺩ, ﺩﻭﺪﺤﻣ, ﯽﯾﺎﻬﻧ, ﯽﯾﺎﻬﻧ, ﻪﻧﺎﯾﺎﭘ, ﺰﯾﺭ, ﻥﺎﯾﺎﭘ, ﯽﻧﻮﮕﻧﺮﺳ
ﻥﺩﺮﻛﺖﺑﺎﺛ: ﺕﺎﺒﺛﺍ, ﻥﺩﺮﻛﺪﻴﻳﺎﺗ, ﺪﯿﯾﺄﺗ, ﻥﺩﺍﺩﻥﺎﺸﻧ, ﻥﺩﺍﺩﺕﺩﺎﻬﺷ, ﻦﮐﮎﺭﺩ, ﻞﺻﺍ
ﻥﺩﺮﮐﯼﺮﯿﮔﻮﻠﺟ: ﻒﻗﻮﺗ, ﻉﻮﻨﻤﻣ, ﺖﺷﺍﺩﺯﺎﺑ, ﻥﺩﺮﮐﺏﻮﮐﺮﺳ, ﻥﺩﺮﮐﺩﻭﺪﺤﻣ, ﺭﺎﻬﻣ, ﻥﺩﺮﮐﺩﻭﺪﺴﻣ, ﻥﺩﺮﮐﺭﺎﻬﻣ, ﻥﺪﻧﺎﺳﺮﺗ, ﺖﺳﺍﻩﺩﺮﮐﻉﻮﻨﻤﻣ, ﻥﺩﺮﮐﺏﺎﻨﺘﺟﺍ, ﻥﺩﺮﮐﺏﻮﮐﺮﺳ, ﻥﺩﺮﮐﻖﻠﻌﻣ, ﻒﻗﻮﺗ
ﻥﺩﺮﮔ: ﻮﻠﮔ, ﺩﺭﻮﻣ
ﺖﺴﻫﺐﻟﺎﺟ: ﯽﻣﺮﮔﺮﺳ, ﻩﺪﻨﻨﮐﻡﺮﮔﺮﺳ, ﻩﺪﻨﻨﮐﻡﺮﮔﺮﺳ, ﺐﻟﺎﺟ, ﺏﺍﺬﺟ, ﻥﺩﺮﻛﺏﺬﺟ, ﺮﯿﮕﻤﺸﭼ, ﻢﺳﺭ, ﺖﺳﺍﻮﺧﺭﺩ, ﻥﺪﯿﺸﮐﺭﺎﻨﮐ, ﺞﯿﻬﻣ, ﻭﺎﮑﺠﻨﮐ
ﯽﻧﻮﻧﺎﻗ: ﯽﯾﺎﻀﻗ, ﻥﻮﻧﺎﻗ, ﻉﻭﺮﺸﻣ, ﺏﺎﻗ, ﯼﺎﯾﺎﻀﻗ
ﮏﺸﺧ: ﻪﻗﺎﺳ, ﺭﺩﻮﭘ
ﺖﻣﺪﺧ: ﯽﻧﺎﺳﺭﺖﻣﺪﺧ, ﻥﺩﺭﻭﺁﺖﺳﺪﺑ, ﻥﺩﺮﮐﻪﯿﻬﺗ, ﺩﺎﻬﻨﺸﯿﭘ
ﮎﺭﺪﻣ: ﯽﮐﺭﺪﻣ, ﺕﺎﺒﺛﺍ, ﺎﻤﻨﻫﺍﺭ, ﺪﯿﻠﮐ, ﺎﻤﻨﻫﺍﺭﺖﺳﺮﻬﻓ, ﻥﺩﺍﺩﺶﯾﺎﻤﻧ, ﺪﻫﺎﺷ, ﺩﻮﻬﺸﻣ, ﻥﺩﺍﺩﺕﺩﺎﻬﺷ
ﯽﮐﺭﺪﻣﺩﺭﻮﻣ: 
ﺭﻭﺩ: ﺭﻭﺩ, ﺭﺎﯿﺴﺑ, ﺵﻮﻣﺎﺧ, ﺍﺪﺟ, ﭖﺎﺗﭗﻟ, ﺭﻭﺩﻩﺍﺭﺯﺍ, ﺭﻭﺩ, ﻦﯾﺮﺗﺭﻭﺩ, ﻥﺩﺮﮐﺩﺮﻃ
ﻦﺘﻓﺭﺶﯿﭘ: ﻦﺘﺷﺍﺩﺮﺑﺪﻨﻠﺑﯼﺎﻫﻡﺎﮔ, ﺖﻓﺮﺸﯿﭘ, ﻪﻌﺳﻮﺗ, ﯽﻗﺮﺘﻣ, ﻪﻌﺳﻮﺗ, ﻥﺩﺮﺑﺶﯿﭘ, ﻪﻣﺍﺩﺍ, ﺩﻮﺒﻬﺑ, ﻥﺩﺮﺑﻻﺎﺑ, ﺪﺷﺭ, ﻊﯿﻓﺮﺗ, ﺵﻭﺭ, ﺪﻨﯾﺁﺮﻓ
ﮏﯾﺭﺎﺑ: ﺮﻏﻻ, ﮓﻨﺗ, ﻩﺎﺗﻮﮐﺪﻗ, ﻥﺩﺮﮐﺩﻭﺪﺤﻣ, ﻩﺪﻨﻫﺩﺭﺍﺯﺁ, ﻥﺪﻧﺎﺳﺭﻞﻗﺍﺪﺣﻪﺑ, ﺩﻭﺪﺤﻣ
ﺎﻨﺑ: ﻦﺘﺧﺎﺳ, ﺭﺎﺘﺧﺎﺳ, ﺭﺎﺘﺧﺎﺳ, ﺖﺧﺎﺳ, ﻞﺤﻣ, ﯼﺪﻨﺑﻥﺍﻮﺨﺘﺳﺍ
ﻥﺩﺮﮐﻮﺠﺘﺴﺟ: ﻥﺩﺮﮐﺍﺪﯿﭘ, ﻥﺩﺮﻛﻒﺸﻛ, ﻒﺸﮐ, ﻮﺠﺘﺴﺟ, ﻒﺸﮐ, ﻝﺎﺒﻧﺩﻪﺑ, ﻝﺎﺒﻧﺩﻪﺑ, ﻥﺩﺮﻛﻖﻴﻘﺤﺗ, ﯽﺳﺭﺮﺑ, ﺐﯿﻘﻌﺗ, ﻮﺟﻭﺱﺮﭘ, ﯽﺳﺭﺮﺑﻭﻖﯿﻘﺤﺗ, ﻮﺟﻭﺱﺮﭘ, ﻑﺎﺸﺘﮐﺍ, ﻉﺍﺮﺘﺧﺍ
ﻦﯿﮕﻤﻏ: ﻩﺩﺮﺴﻓﺍ, ﯽﺘﺣﺍﺭﺎﻧﺎﺑ, ﯽﺘﺨﺑﺪﺑ, ﻩﺪﻨﻨﻛﺖﺣﺍﺭﺎﻧ, ﻦﯿﮕﻤﻏ, ﺖﻣﺍﺪﻧ, ﻡﺎﮐﺎﻧ
ﻩﺎﻨﮔ: ﻩﺎﻨﮔ, ﯽﺘﺣﺍﺭﺎﻧﺎﺑ, ﺐﮑﺗﺮﻣ
ﺭﺎﻤﯿﺑ: ﺭﺎﻤﯿﺑ, ﻢﺧﺯ, ﯼﺭﺎﻤﯿﺑ, ﺭﺎﻤﯿﺑ, ﯼﺭﺎﻤﯿﺑ
ﻕﺩﺎﺻ: ﻕﺩﺎﺻ, ﺭﺍﺩﺎﻓﻭ, ﻪﻧﺎﻗﺩﺎﺻ, ﺢﯾﺮﺻ, ﺖﺳﺍﺭﺮﺳ, ﺐﻠﻘﺘﻣ
ﮏﻧﺎﺑ: ﺖﮑﻤﯿﻧ, ﻊﻠﻗ
ﻞﮕﻨﺟ: ﻞﮕﻨﺟ, ﯼﺭﺍﺪﻠﮕﻨﺟ
ﻦﺘﻓﺮﮔﻩﺯﺍﺪﻧﺍ: ﻩﺯﺍﺪﻧﺍ, ﯼﺮﯿﮔﻩﺯﺍﺪﻧﺍ, ﻥﺯﻭ, ﺮﺘﻣ, ﺮﺘﻣ
ﻥﺎﯾﺮﺟ: ﻥﺎﯾﺮﺟ, ﺪﻨﺑ, ﯼﺭﺎﺟ, ﻕﺮﺑ, ﺭﺎﺷ, ﺖﺟ
ﺖﻗﺩﺎﺑ: ﮏﯾﺩﺰﻧ, ﻖﯿﻗﺩ, ﻁﺎﺘﺤﻣ
ﻥﺎﻧ: ﻦﺘﺨﭘ, ﻕﺎﭼﻭﻪﺘﺨﻠﺷ, ﭻﯾﻭﺪﻧﺎﺳ, ﻪﻤﻘﻟ, ﻪﺑﺎﺗﯽﻫﺎﻣ
ﯽﻓﺎﺿﺍ: ﯽﻓﺎﺿﺍ, ﯽﮐﺪﯾ, ﻦﯾﺍﺮﺑﻩﻭﻼﻋ, ﺩﺍﺯﺎﻣ, ﺩﺍﺯﺎﻣ, ﺮﺘﺸﯿﺑ, ﻪﻓﺎﺿﺍ, ﻞﻤﮑﻣ, ﻥﺩﺮﮐﻪﻓﺎﺿﺍ, ﻪﻤﯿﻤﺿ, ﻞﻤﮑﻣ, ﯽﺒﻧﺎﺟ, ﻩﺰﯾﺎﺟ
ﻥﺩﺮﻛﺏﺎﺨﺘﻧﺍ: ﺏﺎﺨﺘﻧﺍ, ﺏﺎﺨﺘﻧﺍ, ﺪﯿﻨﮐﺏﺎﺨﺘﻧﺍ, ﯽﺑﺎﺨﺘﻧﺍ, ﺪﯿﻨﮐﺏﺎﺨﺘﻧﺍ, ﺐﺨﺘﻨﻣ, ﯼﺮﯿﮔﻩﺭﺎﻤﺷ, ﯼﺍﺭ, ﻪﻨﯾﺎﻌﻣ, ﺢﯿﺟﺮﺗ, ﻦﯿﯿﻌﺗ
ﻥﺍﻮﯿﺣ: ﺩﻮﺟﻮﻣ, ﯽﺜﻨﺧ
zoicﺲﻨﺟ: 
eventiveﺖﻟﺎﺣ: 
ﯽﺑﺮﺿﺩﺭﻮﻣ: 
ﻥﺩﺭﻭﺁﺖﺳﺩﻪﺑ: ﻥﺩﺮﮐﺐﺴﮐ, ﻥﺩﺭﻭﺁﺖﺳﺩ, ﺏﺎﺴﺘﮐﺍ, ﻥﺩﺮﻛﺖﻓﺎﻳﺭﺩ, ﻦﺘﻓﺮﮔ, ﻥﺩﺮﮐﺍﺪﯿﭘ, ﻦﻣﺍ, ﻆﻔﺣ, ﻆﻔﺣ, ﻖﺘﺸﻣ, ﯽﺸﮐﺍﻭ, ﺪﻧﺭﺍﺩ, ﻥﺩﺍﺩﻡﺎﺠﻧﺍ, ﻥﺪﯿﺳﺭ, ﻥﺩﺮﮐﺝﺍﻭﺩﺯﺍ
ﺐﯿﻠﺻ: ﻥﺎﯿﻣﺭﺩ, ﺭﻮﺒﻋ, ﻥﺩﺮﮐﯽﻃ, ﺯﻭﺎﺠﺗ, ﺫﻮﻔﻧ
ﻢﯿﺨﺿ: ﻕﺎﭼ, ﻢﯿﺨﺿﺎﺘﺒﺴﻧ, ﻢﮐﺍﺮﺘﻣ, ﯽﺑﺮﭼ
ﻥﺩﺮﮐﺪﺷﺭ: ﺖﺸﮐ, ﻥﺪﻣﺁﻻﺎﺑ, ﺪﺷﺭ
ﻥﺍﺭﺎﺑ: ﺏﻮﻃﺮﻣ, ﻥﺍﺭﺎﺑﺵﺭﺎﺑ, ﺵﻭﺩ, ﺵﺭﺎﺑ, ﺮﯿﻏ, ﺏﻭﺭﺎﺟ
ﺍﺪﺻﻭﺮﺳﯽﺑ: 
ﺢﻄﺳ: ﺕﺭﻮﺻ, ﺢﻄﺳ, ﺢﻄﺳ, ﻪﻘﻄﻨﻣ, ﻪﯾﻻ
ﺱﺪﻘﻣ: ﺱﺪﻘﻣ, ﻩﻮﮑﺷﺎﺑ
ﯼﻻﻮﺟ: 
ﺵﻭﺭ: ﺯﻭﺭﺪﻣ, ﺵﻭﺭ, ﺵﻭﺭ, ﺵﻭﺭ, ﺵﻭﺭ
ﺵﺭﺍﺰﮔ: ﻦﯿﯿﻌﺗ, ﻪﯿﻧﺎﯿﺑ, ﺖﺒﺴﻧ, ﻁﺎﺒﺗﺭﺍ, ﻁﺎﺒﺗﺭﺍ, ﻪﻧﻻﺩﺎﻋ, ﻩﺎﮕﺸﯾﺎﻤﻧ, ﻪﻟﺎﻘﻣ, ﻪﺋﺍﺭﺍ
ﻞﯾﺎﻓ: ﺪﻨﺳ, ﻝﺰﻨﻣ, ﻞﯾﺎﻓﻭﺮﭘ, ﯽﻧﺎﮕﯾﺎﺑ
ﻪﻧﺎﺷ: ﺭﻮﺤﻣ, ﺭﻮﺤﻣ, ﺮﯾﻮﺼﺗ, ﻪﻧﺎﺷ, ﻭﺯﺎﺑ
ﯽﺘﻨﻄﻠﺳ: ﯼﺭﻮﺗﺍﺮﭙﻣﺍ, ﺖﻨﻄﻠﺳ, ﯽﻫﺎﺷﺩﺎﭘ, ﯽﯾﺍﻭﺮﻧﺎﻣﺮﻓ, ﯽﻌﻗﺍﻭ, ﯽﻌﻗﺍﻭ
ﻪﻧﺍﺮﺗ: ﮓﻨﻫﺍ, ﺮﯿﺴﻣ, ﯽﮔﺪﻨﻧﺍﻮﺧ, ﺮﻌﺷ, ﻥﺪﻧﺍﻮﺧ
ﯽﺘﺣﺍﺭ: ﺖﻟﻮﻬﺳ, ﻡﺍﺭﺁ, ﺶﺨﺑﺶﻣﺍﺭﺁ, ﻖﯾﻮﺸﺗ, ﯽﺘﺣﺍﺭ, ﯽﻗﺎﺑ, ﻦﯿﮑﺴﺗ, ﻥﺎﮑﻣﺍ
ﯽﺴﮐﺮﻫ: ﯽﺼﺨﺷﺮﻫ, ﯽﺴﮐ, ﯽﺴﮐ, ﺲﻛﭻﻴﻫ, ﯽﺴﮐﺮﻫ, ﺲﮐﺮﻫ, ﻪﮐﯽﺴﮐﺮﻫ
ﻦﻤﭼ: ﮏﺸﺧﻒﻠﻋ, ﺯﺮﻫﻒﻠﻋ, ﻥﺎﻫﺎﯿﮔﮒﺮﺑﻭﺥﺎﺷ, ﻦﻤﭼ, ﻡﺮﮔ, ﯽﻧ
ﺡﺎﺘﺘﻓﺍ: ﯽﺗﺎﻣﺪﻘﻣ, ﻪﯿﻟﻭﺍ, ﻒﺸﮐ, ﻑﺎﮑﺷ, ﻑﺎﮑﺷ, ﻩﺩﺮﭘﯽﺑ, ﻪﯿﻟﻭﺍ
ﻦﺋﻭﮊ: 
ﯽﻫﺎﻣ: ﻡﻮﯾﺭﺍﻮﮐﺁ
ﺖﺨﺘﯾﺎﭘ،ﻪﯾﺎﻣﺮﺳ: ﻞﺼﻓ, ﻕﻭﺪﻨﺻ, ﯽﯾﺍﺭﺍﺩ
ﻥﺎﺘﺴﭘ: ﻪﻨﯿﺳﻪﺴﻔﻗ, ﺮﯿﺷ
ﺕﻼﯿﺼﺤﺗ: ﺵﺯﻮﻣﺁ, ﺱﺭﺩ, ﯽﺷﺯﻮﻣﺁ, ﺩﺍﻮﺳ, ﻞﯿﮑﺸﺗ, ﺵﺯﻮﻣﺁ, ﻩﺩﺮﮐﻞﯿﺼﺤﺗ, ﯽﻫﺎﮕﺸﻧﺍﺩ, ﻞﻤﻌﻟﺍﺭﻮﺘﺳﺩ, ﺵﺯﻮﻣﺁ, ﻢﯿﻠﻌﺗ
ﺰﯿﺗ: ﻦﺷﻭﺭ, ﻩﺪﻧﺭﺩ, ﺖﺨﺳ, ﺕﺪﺷﻪﺑ, ﺪﻨﺗ, ﻥﺎﺸﻧﺮﻃﺎﺧ, ﺩﺎﺣ, ﻕﺎﺘﺸﻣ, ﺩﺮﺗ, ﯽﻨﺷﻭﺭﻪﺑ, ﻩﺪﻨﻨﮐﻩﺮﯿﺧﺶﺑﺎﺗ
ﻪﻨﯾﺰﻫ: ﺖﺧﺍﺩﺮﭘ, ﻪﻨﯾﺰﻫ, ﻪﻨﯾﺰﻫ, ﭖﺎﭼ, ﺪﯿﻟﻮﺗ, ﮊﺭﺎﺷ, ﻥﺩﺮﮐﺝﺮﺧ
ﺎﻤﺷﻝﺎﻣ: ﺍﺭﺩﻮﺧ
ﻥﻮﯿﻠﯿﻣ: ﻥﻮﯿﻠﯿﻣ
ﻥﺩﺮﮐﺎﻋﺩ: ﻥﺪﯿﺳﺮﭘ, ﺯﺎﻤﻧ, ﻥﺩﺮﻛﺶﻫﺍﻮﺧ, ﻦﺘﻓﺮﮔﺖﻧﺎﻣﺍ
ﻪﺘﺴﺧ: ﯽﮕﺘﺴﺧ, ﻩﺪﻨﻨﮐﻪﺘﺴﺧ
ﻦﺘﺸﮐ: ﯽﺸﮐﻡﺩﺁ, ﻞﺘﻗ, ﻥﺩﺮﺑﻦﯿﺑﺯﺍ
ﻪﯾﺎﺳ: ﻪﯾﺎﺳ
ﻡﺮﺟ: ﺖﯿﻔﯿﮐ, ﯽﻌﻤﺟ, ﺭﺍﺪﻘﻣ, ﻢﺠﺣ, ﻊﻤﺟ, ﺭﺎﯿﺴﺑ, ﻩﺩﻮﺗ, ﻪﺷﻮﺧ, ﺖﯿﻌﻤﺟ, ﻡﺮﺟ, ﺮﯿﻤﺧ, ﺎﺘﺳﺎﭘ
ﺩﺎﺠﯾﺍ: ﺐﺼﻧ, ﺪﻣﺎﺟ, ﻢﮑﺤﻣ, ﺕﺎﺒﺛﺎﺑ, ﺩﺎﺠﯾﺍ, ﺩﺎﺠﯾﺍ, ﺖﻗﻭ, ﻪﺘﻓﺎﯾ, ﺭﺍﺮﻘﺘﺳﺍ, ﻞﯿﮑﺸﺗ, ﯽﯾﺎﭘﺮﺑ
ﯽﺿﺍﺭ: ﻝﺎﺤﺷﻮﺧ, ﺖﯾﺎﺿﺭ, ﺖﻋﺎﻨﻗ, ﻝﺎﺤﺷﻮﺧ, ﻥﺩﺮﮐﻊﻧﺎﻗ, ﺶﺨﺑﺖﯾﺎﺿﺭ, ﺍﻮﺘﺤﻣ
ﯽﺳﺭﺮﺑ: ﯽﺳﺭﺮﺑ, ﻦﮐﻩﺎﮕﻧ, ﻥﺩﺮﮐﺎﺷﺎﻤﺗ, ﻥﺩﺮﮐﮏﭼ, ﺏﺎﺨﺘﻧﺍ, ﯽﺳﺭﺮﺑ, ﯽﺳﺭﺯﺎﺑ, ﻪﻨﯾﺎﻌﻣ, ﺖﺴﺗ, ﯽﺳﺮﺑﺎﺴﺣ, ﯽﺳﺭﺍﻭ, ﻂﺳﺍﻭﺪﺣ, ﯽﺳﺭﺮﺑ, ﯽﺳﺭﺮﺑ, ﻡﻮﻠﻌﻣ, ﻥﺩﺮﮐﺮﻈﻧﺪﯾﺪﺠﺗ, ﻝﺮﺘﻨﮐ
ﺍﻮﻘﺗ: ﯽﻧﺎﺑﺮﻬﻣ, ﯽﺑﻮﺧ, ﯽﻫﺍﻮﺧﺮﯿﺧ, ﻪﺼﺨﺸﻣ, ﺖﻔﺻ, ﯽﮔﮋﯾﻭ
ﯽﯾﻼﻃ: ﺎﻫﺵﺯﺭﻭ
ﯽﻠﻣ: ﺖﻠﻣ, ﺖﯿﻠﻣ, ﯽﻣﻮﻗ, ﯽﮕﻧﺎﺧ, ﺖﺴﯿﻟﺎﻧﻮﯿﺳﺎﻧ
ﯽﻠﺻﺍ: ﺖﺴﺨﻧ, ﻩﮊﺍﻭﺪﯿﻠﮐ, ﮒﺭﺰﺑ, ﯽﻠﺻﺍ, ﺲﯿﺋﺭ, ﻥﺪﺷﯽﻬﺘﻨﻣ, ﯼﺰﯿﭼﺮﻫﯽﻠﺻﺍءﺰﺟ
ﻩﺭﺩ: ﻪﻧﺎﺧﺩﻭﺭﻩﺯﻮﺣ
ﻥﺰﺑﺱﺪﺣ: ﺝﺎﺘﻨﺘﺳﺍ, ﻥﻮﻨﻈﻣ, ﺽﺮﻓ, ﻥﺩﺯﻦﯿﻤﺨﺗ, ﻥﺩﺮﮐﺩﺭﻭﺁﺮﺑ, ﯽﻨﯿﺑﺶﯿﭘ, ﯽﻨﯿﺑﺶﯿﭘ, ﯽﻨﯿﺑﺶﯿﭘ, ﻥﺪﯿﺸﯾﺪﻧﺍ, ﯽﻬﻟﺍ, ﺱﺪﺣ, ﺩﻭﺭﯽﻣﺭﺎﻈﺘﻧﺍ, ﯽﺑﺎﯾﺯﺭﺍ, ﯽﺑﺎﯾﺯﺭﺍ, ﯽﺑﺎﯾﺯﺭﺍ, ﺐﯾﺮﻘﺗ, ﯽﻨﯿﺑﺶﯿﭘﻞﺑﺎﻗ
ﯼﺮﮑﻔﺗﺖﻟﺎﺣ: ﯽﺿﺮﻓﺖﻟﺎﺣ
ﺩﺭﺯﮓﻧﺭ: ﻩﺪﯾﺮﭘﮓﻧﺭ, ﺎﺑﺮﻬﮐ, ﺎﻫﺵﺯﺭﻭ
ﯽﻗﺎﺑ: ﻩﺪﻧﺎﻣﯽﻗﺎﺑ, ﻩﺪﻧﺎﻣﯽﻗﺎﺑ, ﻩﺪﻧﺎﻣﯽﻗﺎﺑ, ﯽﻗﺎﺑ, ﯽﻗﺎﺑ
ﻩﺪﺷﻢﺧ: ﯽﻨﺤﻨﻣ, ﻢﺧ, ﺪﻧﻭﺭ, ﻩﺩﺭﻮﺧﭻﯿﭘ, ﺐﯿﺷ, ﺞﮐ, ﻮﺷﺎﺗ, ﮎﺍﺭﺩﺍ, ﺽﺮﻓ
ﻪﺒﻌﺟ: ﻥﺍﺪﻤﭼ, ﻮﺸﮐ, ﻕﻭﺪﻨﺻ, ﺖﯿﮐ, ﻥﺍﻮﺗﯽﻣ, ﻦﺗﺭﺎﮐ, ﻦﺑ, ﺭﺍﺪﻗﻭﺪﻨﺻ, ﻊﺑﺮﻣ, ﯽﺷﺎﮐ, ﯼﺭﻮﺗ
ﻞﺼﻓ: ﯽﻠﺼﻓ, ﻞﺼﻓ, ﻩﺎﮕﺘﺴﯾﺍ, ﺮﺼﻋ
ﯽﺑﺮﺠﺗﻡﻮﻠﻋ: ﯽﻤﻠﻋ, ﯽﺳﺎﻨﺷﺖﺨﯾﺭ, ﯽﺳﺎﻨﺷﻥﺎﺑﺯ
ﺍﺮﻫﺎﻇ: ﺺﺨﺸﻣﺭﻮﻃﻪﺑ, ﺢﺿﺍﻭ, ﺢﺿﺍﻭ, ﻩﺩﺮﭘﯽﺑ, ﺎﺤﯾﺮﺻ, ﺍﺮﻫﺎﻇ, ﯽﻨﺷﻭﺭﻪﺑ, ﺩﻮﻬﺸﻣ
ﻥﺩﺮﮐﺥﺍﺭﻮﺳﻪﺘﻣﺎﺑ: ﺥﺍﺭﻮﺳ, ﻪﺘﻣ, ﺪﻨﮐ, ﺮﺑﺮﺳﻪﻠﺻﻮﺣ, ﻥﺩﺮﮐﺥﺍﺭﻮﺳ, ﻥﺩﺮﮐﮏﯾﺮﺤﺗ, ﻦﻤﺠﻧﺍ, ﻪﻠﺻﻮﺣﯽﺑ, ﺵﺩﺮﮔ
ﯽﯾﺍﺩ: ﻪﻤﻋ
ﺖﺳﺮﻬﻓ: ﺺﺧﺎﺷ, ﺖﺳﺮﻬﻓ, ﺖﺳﺮﻬﻓ, ﻮﻨﻣ, ﻡﺎﻧﺖﺒﺛ
ﺕﻭﺍ: 
ﻡﺍﺭﺁ: ﻡﺍﺭﺁ, ﻡﺍﺭﺁ, ﺰﯿﻣﺁﺢﻠﺻ, ﺍﺪﺻﯽﺑ, ﻡﺍﺭﺁ, ﻡﺍﺭﺁ, ﻥﻮﮑﺳ, ﻢﯾﻼﻣ
ﺪﻨﺴﭘﻪﻣﺎﻋ: ﻉﻮﯿﺷ, ﻑﻭﺮﻌﻣ, ﻪﺘﺴﺟﺮﺑ, ﻡﺩﺮﻣ, ﻥﺪﺷﯽﻬﺘﻨﻣ, ﺯﺎﺑﺮﺳﻪﻨﻬﮐ
ﻪﺘﺧﺎﻨﺷﺎﻧ: ﻪﻧﺎﮕﯿﺑ
ﺎﻨﺷﺁ: ﯽﯾﺎﻨﺷﺁ, ﺐﺴﻧﻭﻞﺻﺍ, ﻞﺴﻧ, ﺪﺷﻩﺩﺎﻔﺘﺳﺍ
ﺎﻨﺷﺁﻡﺎﻧﺖﺒﺛ: 
ﯼﻭﺭﻩﺩﺎﯿﭘ: ﻦﺘﻓﺭﻩﺍﺭ, ﺝﺁ, ﻪﻣﺍﺩﺍ, ﯼﻭﺭﻩﺩﺎﯿﭘ, ﻥﺩﺯﻡﺪﻗ, ﻩﺩﺎﯿﭘﺮﺑﺎﻋ
ﺮﺑﺍﺮﺑﻭﺩ: ﺮﺑﺍﺮﺑﻭﺩ
ﯼﺮﮑﻓ: ﻦﻫﺫ, ﺵﻮﻫ, ﯽﻧﺍﻭﺭ, ﺪﻨﻤﺷﻮﻫ-ﺵﻮﻫﺎﺑ, ﯽﻧﺍﻭﺭ, ﺯﺍﺩﺮﭘﻩﺪﯾﺍ, ﺩﺮﺧ, ﯽﻧﺎﺣﻭﺭ
ﺶﯿﺸﮐ: ﻥﻮﯿﻧﺎﺣﻭﺭ
ﺡﻭﺮﺠﻣ: ﺡﻭﺮﺠﻣ, ﻢﺧﺯ, ﻪﻣﺪﺻ
ﺥﺎﮐ: 
ﻢﺘﺷﻭﺏﺮﺿ: ﺖﺴﮑﺷ, ﺖﺸﻣ, ﻥﺩﺯﯽﻠﯿﺳ, ﻥﺩﺯﺭﺩ, ﻥﺩﺯﻢﻬﺑﺕﺪﺷﺎﺑ, ﻢﺘﯾﺭ, ﺮﺑﻪﺒﻠﻏ, ﺏﺎﺼﺘﻋﺍ, ﻩﺭﺫ, ﯼﺯﻭﺮﯿﭘ, ﯼﺯﻭﺮﯿﭘ, ﻩﺪﻧﺮﺑ
ﻖﻤﺣﺍ: ﻪﻧﺎﻘﻤﺣﺍ, ﻦﻓﻭﺕﻮﻓ, ﻥﺩﺍﺩﺐﯾﺮﻓ, ﻥﺩﺍﺩﺐﯾﺮﻓ, ﻖﻤﺣﺍ, ﻖﻤﺣﺍ, ﻪﻧﺍﻮﯾﺩ, ﻪﻧﺍﻮﯾﺩ, ﻪﻧﺍﻮﯾﺩ, ﻥﺩﺮﮐﻩﺍﺮﻤﮔ, ﻥﺍﺩﺎﻧ, ﻥﺍﺩﺎﻧ
ﺮﻔﻧﻪﻧ: ﻦﯿﻤﻬﻧ, ﺪﯾﺪﺟ
ﯼﺩﺭﺪﻤﻫﺯﺍﺮﺑﺍ: ﺖﻘﻔﺷ, ﯽﻟﺪﮑﯾ, ﻢﺣﺮﺗ, ﺖﻤﺣﺭ, ﺯﻮﺴﻟﺩ, ﻥﺎﺑﺮﻬﻣ
ﺭﺎﺠﻔﻧﺍ: ﺭﺎﺠﻔﻧﺍ, ﺭﺎﺠﻔﻧﺍ, ﻥﺪﺷﺮﺠﻔﻨﻣ, ﻩﺩﺭﻮﺧﮎﺮﺗ, ﺵﺮﻏ, ﺞﻨﺸﺗ, ﺭﺎﺠﻔﻧﺍ
ﻩﺪﯿﺷﻮﭘﺱﺎﺒﻟ: ﺱﺎﺒﻟ, ﺐﺷﺱﺎﺒﻟ, ﻡﺮﻓﺱﺎﺒﻟ, ﺎﻫﺱﺎﺒﻟ, ﺵﻮﭘﻦﺗ
ﺕﺎﯿﺑﺩﺍ: ﯽﺑﺩﺍ, ﻩﺩﺎﻣ, ﮒﺮﺑﻭﺯﺎﺳ
ﻪﻋﻮﻤﺠﻣ: ﺰﮐﺮﻤﺗ, ﯽﮕﺘﺷﺎﺒﻧﺍ, ﻢﯿﻈﻨﺗ, ﻩﻭﺮﮔ, ﺐﯿﮐﺮﺗ, ﻪﯾﺍﺭﺁ, ﺲﮑﻋﻡﻮﺒﻟﺁ, ﻪﻋﻮﻤﺠﻣ, ﻪﺘﺴﺑ, ﻡﺎﻘﻣ, ﺰﺘﻨﺳ, ﻪﻋﻮﻤﺠﻣ, ﻪﺠﯿﺘﻧ, ﻦﺘﻓﺮﮔﻪﺠﯿﺘﻧ, ﺝﺎﺘﻨﺘﺳﺍ, ﯼﺭﻭﺁﻊﻤﺟ
ﯽﻟﺎﺧ: ﯽﻟﺎﺧﯼﺎﺟ, ﯽﻟﺎﺧ, ﻞﺒﻃ, ﺖﻏﺍﺮﻓ, nullﺭﺍﺪﻘﻣ, ﯽﭼﻮﭘ, ءﻼﺧ, ﻩﺩﻮﻬﯿﺑ, ﺖﺨﻟ
ﻥﺎﻓﻮﻃ: ﻥﺎﻓﻮﻃ, ﻥﺩﺮﮐﺖﯾﺍﺪﻫ
ﺐﯿﺟ: ﻪﺴﯿﮐ, ﻪﺘﺴﺑ
ﻪﻠﻤﺟ: ﯼﺭﻭﺍﺩ, ﯼﺭﻭﺍﺩ, ﻩﺭﺍﺰﮔ, ﻪﯿﻀﻗ, ﺩﺎﻬﻨﺸﯿﭘ, ﯼﺩﺎﻬﻨﺸﯿﭘﺡﺮﻃ, ﺕﺍﺯﺎﺠﻣ, ﻩﺪﯿﻘﻋ, ﺕﺭﺎﺒﻋ, ﻥﺩﺮﮐﻡﻮﮑﺤﻣ, ﻡﻮﮑﺤﻣ, ﺕﺍﺯﺎﺠﻣ, ﻥﺩﺮﮐﻪﯿﺒﻨﺗ
ﺮﺒﻣﺍﻮﻧ: 
ﺮﺒﻣﺎﺳﺩ: 
ﻦﺘﺳﻮﯿﭘﻉﻮﻗﻭﻪﺑ: ﻦﺘﺳﻮﯿﭘﻉﻮﻗﻭﻪﺑ, ﻉﻮﻗﻭ, ﻥﺩﻮﺑ, ﺪﻨﯾﺁﯽﻣﺩﻮﺟﻮﺑ, ﯽﭼ, ﻪﻧﻭ, ﮏﯾﭻﯿﻫ, ﻥﺪﯿﺳﺭ
ﻡﺪﻋ: ﺐﯾﺎﻏ, ﻡﺪﻋ, ﺩﻮﺒﻤﮐ
ﺮﮑﺸﺗ: ﯽﺳﺎﻨﺷﻖﺣ, ﺭﺍﺰﮕﺳﺎﭙﺳ, ﺮﮑﺸﺗﺎﺑ, ﻡﺮﮑﺸﺘﻣ, ﻥﺩﺮﮐﺭﺍﺮﻗﺍ, ﻥﺎﻋﺫﺍ, ﻥﺩﺮﮐﺭﺍﺬﮔﺍﻭ, ﯽﻧﺍﺩﺭﺪﻗ, ﺰﯿﻤﻣ
ﻪﻠﺴﻠﺳ: ﺮﯿﺠﻧﺯ, ﻪﺘﺷﺭ, ﻪﯾﺍﺭﺁ, ﻪﻟﺎﺒﻧﺩ, ﻢﯿﻈﻨﺗ, ﻥﺩﺯﺭﻭﺩ, ﻩﺩﻭﺪﺤﻣ, ﻒﯾﺩﺭ
ﯽﻧﺎﺸﻧ: ﻥﺩﺮﮐﺍﺪﯿﭘ
ﻩﺪﻧﺮﭘ: ﺯﺍﻭﺮﭘ, ﺢﻄﺳ, ﺖﺟ, ﺎﻤﯿﭘﺍﻮﻫ, ﺎﻤﯿﭘﺍﻮﻫ, ﯽﯾﺎﻤﯿﭘﺍﻮﻫ, ﺪﻐﺟ
ﺖﮐ: ﺐﺷﺱﺎﺒﻟ, ﺶﺷﻮﭘ, ﺖﮐﺍﮊ, ﺰﺧ
ﻥﺩﺮﮐﻩﺩﺎﻣﺁ: ﻥﺩﻮﺑﻩﺩﺎﻣﺁ, ﻩﺪﺷﻩﺩﺎﻣﺁ, ﻥﺩﺍﺩﻥﺎﻣﺯﺎﺳ, ﯼﺯﺎﺳﻩﺩﺎﻣﺁ, ﻪﻟﻮﻣﺮﻓﻭﻦﯾﻭﺪﺗ, ﻩﺪﺷﻪﺘﻓﺮﮔﺮﻈﻧﺭﺩ, ﻞﯾﺎﻣ, ﻕﺎﯿﺘﺷﺍﺎﺑ, ﻞﯿﻣﯽﺑ, ﭻﮔ, ﻥﺩﺮﮐﺰﻬﺠﻣ, ﺪﯿﻟﻮﺗ, ﯽﯾﺎﭘﺮﺑ, ﻦﺘﺧﺎﺳ, ﻥﺩﺭﻭﺁﺩﻮﺟﻭﻪﺑ
ﻝﺎﺣﺭﺩﺖﻋﺮﺳﻪﺑ: ﺖﻋﺮﺳﻪﺑ, ﻊﯾﺮﺳ, ﻊﯾﺮﺳ, ﻊﯾﺮﺳ
ﺩﻭﺩ: ﻥﺪﯿﺸﮐﺭﺎﮕﯿﺳ, ﯽﮕﺘﺧﻮﺳ, ﻥﺩﺎﺘﻓﺍﻖﯾﻮﻌﺗﻪﺑ
ﻪﯾﻮﻧﺍﮊ: 
ﻦﯿﺷﺎﻣ: ﻩﺎﮕﺘﺳﺩ, ﺭﻮﺗﻮﻣ, ﺢﻄﺳ
ﯽﺸﮐﺙﺎﺛﺍ: ﺖﮐﺮﺣ, ﺭﺎﯿﺳ, ﻥﺩﺍﺩﻥﺎﮑﺗ, ﯽﯾﺎﺠﺑﺎﺟ, ﺖﮐﺮﺣ, ﺕﺮﺟﺎﻬﻣ, ﮏﯿﺗ
ﺎﻬﻧﺍﺪﻧﺩ: ﻥﺍﺪﻧﺩ, ﻩﺪﻧﺩ, ﻦﯾﺍ, ﺶﭙﺷ
ﻡﺮﺷ: ﯽﯾﺍﻮﺳﺭ, ﻩﺩﺯﺖﻟﺎﺠﺧ, ﯽﺘﻟﺎﺠﺧ, ﻞﺠﺧ, ﺭﻭﺁﻡﺮﺷ, ﺖﻟﺎﺠﺧ, ﺖﺨﻟ, ﻪﻨﻫﺮﺑ, ﻥﺩﺮﻛﻦﻴﻫﻮﺗ, ﺖﻣﺮﺣﮏﺘﻫ
ﺰﻐﻣ: ﺮﮑﻔﺘﻣﺰﻐﻣ, ﺰﻐﻣ
ﻪﻘﻠﺣ: ﺩﺮﺧ, ﯼﺮﯿﮔﻩﺭﺎﻤﺷ, ﻪﻘﻠﺣ, ﻪﻘﻠﺣ, ﮏﯿﺘﺳﻻ, ﮏﯿﺘﺳﻻ
ﺕﺭﺎﺒﻋﺮﮕﻧﺎﺸﻧ: 
ﻥﺩﺮﻛﻙﺭﺩ: ﻦﮐﮎﺭﺩ, ﺐﻠﻄﻣﮎﺭﺩ, ﺲﺣ, ﻢﻬﻓ, ﯽﻟﺪﮑﯾ, ﺶﻧﺍﺩ, ﮎﺭﺩ, ﺶﻨﯿﺑ, ﮎﺍﺭﺩﺍ, ﻉﻼﻃﺍ
ﻩﻮﯿﻣ: ﻪﺠﯿﺘﻧ, ﻪﺠﯿﺘﻧ
ﯼﺎﭼ: ﻦﺘﺷﺍﺩﻕﺎﯿﺘﺷﺍ, ﻭﺭﺩﻮﺧ, ﻡﻭﺩﻪﺟﺭﺩ
ﺢﯿﺿﻮﺗ: ﺢﯿﺿﻮﺗ, ﻥﺩﺍﺩﻥﺎﺸﻧ, ﻥﺎﯿﺑ, ﻥﺎﯿﺑ, ﻦﺘﺷﺍﺩﺭﺎﻬﻇﺍ, ﻥﺩﺮﮐﺢﯾﺮﺼﺗ, ﺮﯿﺴﻔﺗ, ﺢﯿﺿﻮﺗ, ﺮﯿﺴﻔﺗ, ﻥﺩﺮﮐﻒﯿﺻﻮﺗ, ﻒﺻﺍﻭ
ﯼﺪﻣﺁﺵﻮﺧ: ﯽﺳﺮﭘﻝﺍﻮﺣﺍﻭﻡﻼﺳ, ﺵﺮﯾﺬﭘ, ﻥﺩﺮﮐﻡﺮﮔﺮﺳ, ﯽﻫ, ﻡﻼﺳ, ﻦﺘﻔﮔﮏﯾﺮﺒﺗ
ﺮﻌﺷ: ﺮﻌﺷ, ﺮﻌﺷ, ﯼﺭﺍﺩﺮﻬﺷ, ﺖﻋﺎﺳ
ﺪﯾﺮﺧ: ﺪﯾﺮﺧ, ﻥﺩﺭﻭﺁﺖﺳﺩ, ﻦﺘﺷﺍﺩﺖﻋﺎﻄﺘﺳﺍ, ﺭﺍﺯﺎﺑ, ﻩﺎﮕﺷﻭﺮﻓ, ﻥﺍﺯﺭﺍ, ﯼﺭﺍﺬﮔﻪﯾﺎﻣﺮﺳ, ﻥﺩﺮﻛﺪﻳﺮﺧ
ﻥﺎﻤﯾﺍﺎﺑ: ﺐﻠﻘﺘﻣ, ﺭﺍﺩﺎﻓﻭ, ﻪﻧﺎﻗﺩﺎﺻ, ﺭﺎﮐﺍﺪﻓ, ﺖﺳﺭﺩ, ﺩﺎﻤﺘﻋﺍﻞﺑﺎﻗ
ﻥﺎﺠﯿﻫ: ﮏﯾﺮﺤﺗ, ﻪﺘﺨﯿﮕﻧﺍﺮﺑ, ﻦﺘﻓﺮﮔﺩﺍﺮﯾﺍ, ﺶﻨﺗ, ﮏﯾﺮﺤﺗ, ﺕﺬﻟ, ﯽﮕﺘﺨﯿﮕﻧﺍ, ﻥﺩﺮﮐﺖﯿﭘﻭﻂﯿﺧ, ﻕﺎﯿﺘﺷﺍ, ﺐﺼﻌﺗ, ﻕﺎﺘﺸﻣ, ﺕﺭﻭﺮﺿ, ﺱﺎﺴﺣﺍ
ﻞﯾﺭﻭﺁ: 
ﺮﺒﺘﮐﺍ: 
ﺦﻠﺗ: ﯽﺘﺨﺳ, ﺞﻧﺭ, ﻩﻭﺪﻧﺍﻭﻢﻏ, ﯽﺨﻠﺗﻪﺑ, ﻥﺪﯿﺸﮐﺞﻧﺭ, ﮎﺎﻧﺩﺭﺩ, ﺶﯿﻧ, ﺖﺳﺍﻩﺪﺷﻪﺘﺷﻮﻧ
ﻞﺷ: ﻞﻘﺘﺴﻣ, ﻪﻧﺍﺩﺍﺯﺁ, ﻥﺩﺮﮐﻑﺮﻃﺮﺑ, ﻥﺩﺮﻛﻞﺣ, ﯽﻟﺎﺧ, ﻪﻧﺍﺩﺍﺯﺁ
ﻦﺘﻣ: ﯼﺪﻨﺑﻪﻠﻤﺟ
ﻦﯾﺮﺗﺪﺑ: ﺪﺑ, ﺮﺗﺪﺑ, ﻦﺸﺧ, ﺮﻀﻣ, ﻩﺪﻨﻧﺯﻭﺪﻨﺗ, ﻪﻨﯿﮐ, ﻦﯾﺮﺘﺸﯿﺑ, ﻦﯾﺮﺗﻻﺎﺑ, ﻦﯾﺮﺗﻦﯿﯾﺎﭘ, ﻪﻟﺎﺑﺯ, ﺎﻫﻪﻟﺎﺑﺯ, ﻪﻟﺎﺑﺯ
ﺭﺎﺒﺘﻋﺍ: ﻦﻫﺭ, ﯼﺭﺎﺒﺘﻋﺍﺕﺭﺎﮐ, ﯽﻫﺪﺑ, ﻥﺩﺍﺩﺽﺮﻗ, ﻦﺘﻓﺮﮔﺖﻧﺎﻣﺍ, ﻡﺍﻭ, ﺭﺎﺒﺘﻋﺍ, ﺭﺎﺒﺘﻋﺍ, ﺭﺎﺒﺘﻋﺍ
ﺕﺎﻧﺎﮑﻣﺍ: ءﺍﺰﺟﺍ, ﻊﺑﺍﻮﺗ, ﯼﺎﻫﻪﺒﻨﺟ, ﺕﺎﯿﺻﻮﺼﺧ
ﻪﺑﺭﺩﺎﻗ: ﻦﺘﺧﺎﺳﺭﺩﺎﻗ, ﻪﺘﺴﯾﺎﺷ, ﺭﺩﺎﻗ, ﺖﯿﻓﺮﻇ, ﯽﯾﺎﻧﺍﻮﺗ, ﻥﺍﻮﺗﺎﻧ, ﻩﻮﻘﻟﺎﺑ, ﻦﺘﺷﺍﺩﺖﻋﺎﻄﺘﺳﺍ, ﺮﻫﺎﻣ, ﺪﻌﺘﺴﻣ, ﺕﺭﺎﻬﻣ, ﯽﺸﺨﺑﺮﺛﺍ, ﺖﯿﺣﻼﺻ, ﺮﻫﺎﻣ, ﯼﺭﻭﻩﺮﻬﺑ, ﺪﯿﻔﻣ
ﻩﺩﺰﻧﺎﭘ: 
ﻪﻧﺎﻤﻟﺎﻇ: ﻩﺪﻧﺭﺩ, ﺖﺨﺳ, ﻥﺎﺑﺮﻬﻣﺎﻧ
ﻥﺩﺮﮐﻞﺻﻭ: ﻥﺩﺮﮐﺖﮐﺮﺷ, ﻥﺩﺮﻛﻪﻌﺟﺍﺮﻣ, ﺭﺎﮐﺭﺪﻧﺍﺖﺳﺩ, ﻮﺷﺭﺍﻮﺳ, ﻥﺪﯿﺒﺴﭼ, ﻩﺪﻨﻨﮐﺖﮐﺮﺷ, ﯼﺮﯿﮔﺭﺩ, ﻥﺩﺮﮐﺪﺤﺘﻣ, ﻝﺎﺼﺗﺍ, ﺩﺭﺍﻭﻩﺯﺎﺗ, ﻡﺎﻏﺩﺍ
ﻩﺰﺑ؛ﺖﯾﺎﻨﺟ؛ﻡﺮﺟ: ﻩﺎﻨﮔ, ﻡﺮﺟ, ﻦﯿﻫﻮﺗ, ﯽﯾﺎﻨﺟ
ﮎﺎﺧﻭﺩﺮﮔ: ﺪﺳ, ﺭﺩﻮﭘ, ﮎﺎﺧ
ﯽﻠﻤﻋ: ﯽﻌﺑﺎﺗ, ﯽﻠﻤﻋ, ﻼﻤﻋ, ﺖﺣﺍﺭ, ﺎﺒﯾﺮﻘﺗ, ﯽﺘﺳﺩ, ﯽﻠﻤﻋ
ﮓﻧﺭ: ﮓﻧﺭ, ﮓﻧﺭ, ﮓﻧﺭ, ﻩﺪﯾﺮﭘﮓﻧﺭ, ﯽﮕﻧﺭ, ﮓﻧﺭﺎﮕﻧﺭ, ﻥﺩﺮﮐﺖﯿﭘﻭﻂﯿﺧ, ﻥﺎﺑﺎﯿﺧ, ﯽﺴﯾﻮﻧﻪﻣﺎﻧﺮﺑ
ﻦﺘﻓﺭﻦﯿﺑﺯﺍ: ﻥﺩﺮﮐﺏﺍﺮﺧ, ﻥﺩﺮﺑﻞﯿﻠﺤﺗ, ﯼﺭﺎﮑﺑﺍﺮﺧ, ﺶﻫﺎﮐ, ﻥﺩﺮﮐﺏﺍﺮﺧ, ﻥﺪﺷﻪﻟ, ﻥﺪﯿﺑﻮﮐﻢﻫﺭﺩ, ﺏﺍﺮﺧ, ﻥﺩﺮﮐﺕﺎﻣ, ﻥﺩﺮﮐﮎﺎﭘ, ﻥﺩﺮﮐﯽﺜﻨﺧ, ﺐﯾﺮﺨﺗ
ﻥﺩﺍﺩﺶﯾﺍﺰﻓﺍ: ﻪﻣﺍﺩﺍ, ﻥﺩﺮﺑﻻﺎﺑ, ﻩﻮﮐ, ﻥﺩﺮﺑﻻﺎﺑ, ﻥﺩﺮﮐﻪﻓﺎﺿﺍ, ﻥﺩﺍﺩﺭﺍﺮﻗ, ﺪﺷﺭ, ﻥﺩﺮﮐﮒﺭﺰﺑ, ﯼﻭﺭﻩﺩﺎﯿﭘ, ﻥﺩﺮﺑﻻﺎﺑ
ﯽﻨﯿﺑ: ﺭﺎﻘﻨﻣ
ﻪﻧﺎﺘﺳﻭﺩ: ﺐﺳﺎﻨﻣ, ﺏﻮﻠﻄﻣ, ﺲﻧﺎﺠﺘﻣ, ﺰﯿﻣﺁﺖﺒﺤﻣ, ﻕﺩﺎﺻ, ﺪﺤﺘﻣ, ﯽﺘﺳﻭﺩ, ﻉﻮﻧ
ﺯﻭﺮﯾﺩ: ﺍﺩﺮﻓ, ﻩﺯﻭﺮﻣﺍ
hesternalﺖﻔﺳ: 
ﺖﺴﮑﺷ: ﺖﺴﮑﺷ, ﻖﻓﻮﻣﺎﻧ, ﺖﺴﮑﺷ, ﻥﺍﻮﺗﺎﻧ, ﻥﺩﺮﮐﺕﺎﻣ, ﺪﯿﻣﺍﺎﻧ
ﻪﻣﺍﺩﺍ: ﻪﻣﺍﺩﺍ, ﻡﻭﺍﺪﻣ, ﻡﻭﺍﺪﻣ, ﻪﻣﺍﺩﺍ, ﻡﻭﺍﺪﻣﺭﻮﻃﻪﺑ, ﻪﻣﺍﺩﺍ, ﻥﺩﺍﺩﺹﺎﺼﺘﺧﺍ, ﻦﺘﺷﺍﺩﻪﮕﻧ, ﺪﻌﺑ, ﻝﺎﺼﺗﺍ, ﺯﺎﻏﺁ, ﻥﺩﺍﺩﻡﺎﺠﻧﺍ
ﻦﺘﺷﺍﺩﺮﺑ: ﺮﺷﺯﺍﻥﺪﺷﺹﻼﺧ, ﻥﺪﯿﺸﮐﺭﺎﻨﮐ, ﻥﺩﺮﺑﻦﯿﺑﺯﺍ, ﻑﺬﺣ, ﻥﺩﺮﮐﮎﺎﭘ, ﻥﺩﺮﮐﮎﺎﭘ, ﻥﺩﺮﮐﻑﺬﺣ, ﻥﺩﺮﺑﻥﺎﯿﻣﺯﺍ, ﻥﺩﺮﮐﻖﯾﺮﻔﺗ, ﻢﺳﺭ, ﻥﺪﯿﺸﮐ, ﻦﺘﺧﺍﺪﻧﺍﻥﻭﺮﯿﺑ, ﻥﺪﺷﺏﺬﺟ
ﻥﺪﯿﺷﻮﭘ: ﻞﻤﺣ, ﺮﺑﺭﺎﺑ
ﺎﻨﯿﺑﺎﻧ: 
ﺯﺍﻭﺮﭘ: ﺯﺍﻭﺮﭘ, ﺵﺮﭘ, ﺯﺍﻭﺮﭘ, ﯼﺩﺭﻮﻧﺍﻮﻫ
ﺶﯾﺎﺘﺳ: ﻦﯿﺴﺤﺗ, ﻥﺩﺮﮐﻦﯿﺴﺤﺗ, ﺕﺮﻬﺷ, ﯽﮕﺘﺴﯾﺎﺷ, ﻦﺘﻔﮔﮏﯾﺮﺒﺗ, ﻢﻳﻮﮔﻲﻣﻚﻳﺮﺒﺗ
ﺖﯾﺭﻮﻣﺎﻣ: 
ﯽﻧﺎﺑﺮﻗ: ﯽﻧﺎﺑﺮﻗ, ﺭﺎﮑﺷ, ﻪﺤﻧﺎﺳ, ﺽﺭﺍﻮﻋ
ﻦﯾﺮﻤﺗ: ﻥﺩﺮﮐﺭﺎﮐ, ﯼﺭﺍﺬﮔﺍﻭ, ﻞﻤﻋ, ﻞﻤﻋ, ﺵﺯﺭﻭ, ﻡﺍﺪﻧﺍﺐﺳﺎﻨﺗ, ﻦﯾﺮﻤﺗ, ﻪﺘﻣ, ﯽﯾﺎﺠﺑﺎﺟ, ﺖﮐﺮﺣ, ﯽﺗﺎﺑﺎﺨﺘﻧﺍﺕﺍﺯﺭﺎﺒﻣ, ﯽﺷﺯﺭﻭ
ﻥﺍﺪﺟﻭ: ﺮﯿﻤﺿ, ﯼﺭﺎﯿﺷﻮﻫ
ﻪﯾﺮﻈﻧ: ﻞﺻﺍ, ﺯﺍﺩﺮﭘﻪﯾﺮﻈﻧ, ﻪﯿﻀﻗ, ﯼﺮﻈﻧ
ﺮﯾﺯﻭ: 
ﺕﺮﻔﻧ: ﻩﺪﻨﻧﺯﻭﺪﻨﺗ, ﺭﻭﺁﺵﺪﻨﭼ, ﺕﺮﻔﻧ, ﻦﺘﺷﺍﺪﻧﺖﺳﻭﺩ, ﺐﺼﻌﺗ, ﻪﻨﯿﮐ, ﺯﺍﻥﺪﺷﻦﯿﮕﻤﺸﺧ, ﺮﺟﺰﻨﻣ, ﺕﺮﻔﻧ
ﻪﭼﺎﯾﺭﺩ: ﺾﺤﻣ
ﺰﮐﺮﻣ: ﯼﺰﮐﺮﻣ, ﺰﮐﺮﻣ, ﻩﺎﮕﺘﺴﯾﺍ, ﯽﻫﺪﻧﺎﻣﺮﻓﺰﮐﺮﻣ, ﻂﺳﻮﺘﻣ
ﻦﺘﻓﺭﻝﺎﺣﺯﺍ: ﻩﺎﮔﺁﺩﻮﺧﺎﻧ, ﺱﺎﯾ, ﻪﺘﺷﺬﮔﻥﺎﺟﺯﺍ, ﻒﯿﻌﺿ, ﻩﺪﯾﺮﭘﮓﻧﺭ
ﯽﻘﻄﻨﻣﺲﻨﺟ: 
ﺮﺼﺘﺨﻣ: ﻪﺻﻼﺧﺕﺭﻮﺻﻪﺑ, ﻒﻔﺨﻣ, ﻩﺎﺗﻮﮐﺪﻗ, ﯽﻫﺎﺗﻮﮐﺕﺪﻣ, ﺕﺭﺎﮐ, ﺭﻮﺟﻭﻊﻤﺟ, ﯽﻠﮐﺪﯾﺩ, ﯼﺩﺎﺼﺘﻗﺍ
ﺕﺩﺎﺒﻋ: ﺕﺎﻔﯾﺮﺸﺗ
ﺕﻻﻮﺼﺤﻣ: ﻝﻮﺼﺤﻣ, ﺭﺎﺑ, ﺩﺭﻮﻣ, ﻻﺎﮐ, ﻻﺎﮐ, ﺰﯿﭼ, ﺭﺎﺑ, ﺪﯾﺮﺧﺰﮐﺮﻣ, ﯽﻧﺩﺮﮐﺐﺼﻧﻡﺯﺍﻮﻟ
ﺖﺳﻮﭘ: ﻡﺮﭼ, ﺏﺬﺟ, ﮓﺳﺱﺭﺎﭘ, ﻪﺘﺳﻮﭘ, ﻥﺪﻨﮐﺖﺳﻮﭘ, ﺰﺧ, ﻩﺰﻣ
ﻒﻘﺳ: ﺱﺍﺮﺗ, ﻒﻘﺳ, ﺶﺷﻮﭘ, ﺶﺷﻮﭘ
ﯽﻫﺎﺷﺩﺎﭘﺝﺎﺗ: 
ﻪﻌﻠﻗ: ﺲﻔﻗ, ﻞﻔﻗ, ﯽﮔﺩﺍﻮﻧﺎﺧﻡﺎﻧ
ﯽﻫﺎﺷﺩﺎﭘﺖﺨﺗ: 
ﻪﺘﺴﺑﺍﻭ: ﻥﺩﺮﮐﻝﻮﻐﺸﻣ, ﻁﻭﺮﺸﻣ, ﻪﻤﯿﻤﺿ, ﻞﺼﺘﻣ, ﻪﺘﺴﺑﺍﻭ, ﻪﺘﺴﺑﺍﻭ, ﺖﻔﺟ
ﻞﯾﺎﻣ: ﺶﯾﺍﺮﮔ, ﺐﯿﺷ, ﺮﻏﻻ, ﺐﯿﺷ, ﻞﯾﺎﻣ
ﻥﺍﺪﻧﺯ: ﻥﺍﺪﻧﺯ
ﻞﻣﺎﮐﺭﻮﻄﺑ: ﻲﺑﻮﺧﻪﺑ, ﺖﺣﺍﺭ, ﯽﺘﺳﺭﺩﻪﺑ, ﺭﺍﻮﻤﻫ, ﻞﻣﺎﮐ, ﻼﻣﺎﮐ, ﻼﻣﺎﮐ, ﻉﻮﻤﺠﻣ, ﻞﻣﺎﮐﺕﺭﻮﺻﻪﺑ, ﻪﻧﺎﻔﺼﻨﻣ, ﻼﻣﺎﮐ, ﻼﻣﺎﮐ, ﻼﻣﺎﮐ, ﺎﻓﺮﺻ, ﻼﻣﺎﮐ, ﺎﻘﯿﻗﺩ, ﺖﻗﺩ
ﻥﺎﺠﻨﻓ: ﻥﺍﻮﯿﻟ
ﻮﻀﻋ: ﻮﻀﻋ, ﺖﯾﻮﻀﻋ, ﻡﺍﺪﻧﺍ, ﯼﺩﻮﺧ
ﯽﻧﺪﻣ: ﯽﮕﻧﺎﺧ, ﺪﻧﻭﺮﻬﺷ, ﯽﻧﺪﻣ, ﯽﻣﺎﻈﻧﺮﯿﻏ
ﺎﺟﻪﻤﻫﺭﺩ: ﺮﺳﺍﺮﺳ, ﯽﯾﺎﺟﮏﯾ
ﻖﺑﺎﻄﻣ: ﺍﺮﺟﺍ, ﻥﺩﺮﮐﺍﺮﺟﺍ, ﯼﺍﺮﺟﺍ, ﻥﺩﻮﺑﻖﺑﺎﻄﻣ, ﻥﺩﺮﮐﯽﻫﺍﺮﻤﻫ, ﺕﺎﻗﻼﻣ, ﻥﺩﺮﮐﺖﻋﺎﻃﺍ, ﺍﻮﺘﺤﻣ, ﻥﺩﺮﮐﻊﻧﺎﻗ, ﻥﺪﯿﺒﺴﭼ, ﻉﻮﺿﻮﻣ, ﻕﺎﺒﻄﻧﺍ
ﻪﮑﯿﻟﺎﺣﺭﺩ: ﻦﯿﺣﺭﺩ, ﻪﭼﺮﮔ, ﺎﻣﺍ, ﻪﻜﻨﻳﺍﺎﺑ, ﻑﺎﺻﻭﺍﻦﯾﺍﺎﺑ, ﻪﮑﯿﻟﺎﺣﺭﺩ, ﺩﻮﺟﻭﻦﯾﺍﺎﺑ
ﻢﺠﺣ: ﺭﺎﯿﺴﺑ, ﺪﺣ, ﻥﺍﺰﯿﻣ, ﯽﺒﺴﻧﺭﻮﻃﻪﺑ, ﯽﻤﮐ, ﻥﺩﺮﮐﺩﻭﺪﺴﻣ, ﺪﺣﺍﻭ, ﻢﺠﺣ, ﻂﯿﺤﻣ, ﺶﺷﻮﭘ, ﻩﺯﺍﺪﻧﺍ, ﻩﺭﺎﻗ, ﺪﻨﺑ
ﯽﺷﺭﺎﻔﺳ: ﻩﺪﻨﻫﺩﺵﺭﺎﻔﺳ, ﯼﺭﺎﯿﺘﺧﺍ, ﺱﺎﺒﻟ, ﻞﻤﻋ, ﺕﺩﺎﻋ, ﻦﺘﺷﺍﺩﺕﺩﺎﻋ
ﻢﯿﻈﻌﺗ: ﺱﻮﻗ, ﺱﻮﻗ, ﺯﺎﯿﭘ, ﯽﻨﺤﻨﻣ
ﺖﺷﻮﮔ: ﺖﺷﻮﮔ, ﻭﺎﮔﺖﺷﻮﮔ
ﯽﻫﺎﯿﮔﺲﻨﺟ: 
ﺭﺩﺎﻧ: ﺕﺭﺪﻧﻪﺑ, ﯽﺘﺨﺳﻪﺑ, ﺕﺭﺪﻨﺑ
ﻩﺩﺍﺯﻪﻟﺎﺧ: ﯽﻠﯿﻣﺎﻓﺖﺒﺴﻧ
ﻞﭘ: ﻪﺟﺭﺩ, ﻪﺷﺮﻋ, ﺎﭘ, ﺮﺨﺘﺳﺍ
ﺖﻈﻓﺎﺤﻣ: ﺖﻇﺎﻔﺣ, ﺖﻇﺎﻔﺣ, ﻥﺩﺮﮐﺖﻈﻓﺎﺤﻣ, ﺮﭙﺳ, ﻉﺎﻓﺩ, ﻆﻔﺣ, ﻦﺘﺷﺍﺩﻪﮕﻧ, ﻭﺮﺴﻨﮐ, ﻦﻣﺍ, ﻉﺎﻓﺩ, ﻉﺎﻓﺩ
ﮏﻤﻧ: ﺰﯿﻣﺁﻕﺍﺮﻏﺍ, ﻪﻐﻟﺎﺒﻣ, ﻩﺰﻣﺭﻮﺷ, ﻥﺍﻮﻠﻣ
ﻩﺎﻨﮔﯽﺑ: ﺰﯿﻤﺗ
ﻪﮑﻠﻣ: 
ﺺﻗﺭ: ﻞﺒﻃ, ﺺﻗﺭ, ﺵﺮﭘ, ﺰﯿﺧﻭﺖﺴﺟ
ﻞﺘﻫ: ﺖﻣﺎﻗﺍﻞﺤﻣ
ﻥﺩﺮﮐﺮﭘ: ﺍﻮﺘﺤﻣ, ﺖﺳﺮﻬﻓ
ﯽﻧﺍﺪﻧﺯ: ﻡﻮﮑﺤﻣ
ﺎﻫﻪﻠﭘ: ﻪﻠﭘﻩﺍﺭ, ﻪﻠﭘ, ﻥﺎﺑﺩﺮﻧ, ﻮﺸﮐ
ﺍﺮﮕﺴﻨﺠﻤﻫ: ﺯﺎﺑﺲﻨﺠﻤﻫ
ﻦﺷ: 
ﺪﯾﺪﺷ: ﺖﻧﻮﺸﺧ, ﻩﺪﻧﺭﺩ, ﺶﮐﺮﺳ, ﺰﯿﮕﻧﺍﺖﻔﮕﺷ, ﺪﯾﺪﺷ, ﯼﻮﻗ, ﺪﯾﺪﺷ, ﺪﯾﺪﺷ, ﺪﯾﺪﺷ, ﺪﯾﺪﺷ
ﺮﺒﻣﺎﺘﭙﺳ: 
ﯽﻫﺎﺒﺗ: ﺐﯾﺮﺨﺗ, ﯼﺭﺎﮑﺑﺍﺮﺧ, ﻥﺪﻧﺎﺳﺭﺐﯿﺳﺁ, ﻥﺩﺮﺑﻦﯿﺑﺯﺍ, ﻪﻌﺟﺎﻓ, ﻪﺑﺍﺮﺧ, ﻥﺩﺮﮐﺏﺍﺮﺧ, ﻥﺩﺮﮐﺏﺍﺮﺧ
ﻭﺎﮔ: ﻭﺎﮔ
ﺕﺍﺰﯿﻬﺠﺗ: ﻩﺎﮕﺘﺳﺩ, ﻩﺎﮕﺘﺳﺩ, ﺮﻳﺮﺤﺘﻟﺍﻡﺯﺍﻮﻟ, ﺖﯿﮐ, ﻩﺪﻧﺩ, ﮒﺮﺑﻭﺯﺎﺳ, ﺎﺑﺩﺭﻮﺧﺮﺑ, ﻥﺎﮑﻣﺍ, ﯽﻧﺩﺮﮐﺐﺼﻧﻡﺯﺍﻮﻟ
ﮎﺭﺩ: ﮎﺍﺭﺩﺍ, ﻊﻠﻄﻣ, ﮎﺭﺩ, ﺺﯿﺨﺸﺗ, ﻦﺘﺧﺎﻨﺷﺖﯿﻤﺳﺭﻪﺑ, ﻉﻼﻃﺍ
ﺎﺟﺮﻫ: ﯽﯾﺎﺟﮏﯾ, ﻪﮐﺎﺠﮐﺮﻫ, ﯽﯾﺎﺟﭻﯿﻫ, ﺮﮕﯾﺩﯼﺎﺟﺭﺩ
ﻪﻧﺎﺧﺰﭙﺷﺁ: ﺰﭘﻭﺖﺨﭘ, ﺯﺎﮔﻕﺎﺟﺍ
ﺵﻭﺮﻓ: ﺵﻭﺮﻓ, ﻪﻤﯿﻧ, ﻩﺪﻨﺷﻭﺮﻓ, ﻥﺩﺮﮐﺖﻧﺎﯿﺧ
ﺖﻋﺮﺳ: ﺖﻋﺮﺳ, ﺖﻋﺮﺳ, ﺖﮐﺮﺣ, ﺕﺪﺷﻪﺑ, ﮏﯿﻣﺎﻨﯾﺩ, ﺖﮐﺮﺣ, ﻥﺪﯿﺸﺨﺑﺖﻋﺮﺳ
ﺮﺗﻮﯿﭙﻣﺎﮐ: ﻪﺒﺳﺎﺤﻣ
ﯼﺪﺑﺍ: ﻪﺸﯿﻤﻫ, ﻪﺸﯿﻤﻫﯼﺍﺮﺑ, ﺖﻳﺎﻬﻧﻲﺑ, ﻲﻤﺋﺍﺩ
ﻪﻧﺎﺨﺑﺎﺘﮐ: ﺭﺍﺪﺑﺎﺘﮐ, ﺏﺎﺘﮐﻪﺴﻔﻗ
ﯽﺠﯿﮔ: ﯽﮕﺘﺨﯾﺭﻢﻬﺑ, ﺝﺮﻣﻭﺝﺮﻫ, ﻦﺘﻓﺮﮔﺩﺍﺮﯾﺍ, ﻩﺪﻨﻨﮐﺞﯿﮔ, ﻢﮔﺭﺩﺮﺳ, ﺝﺮﻣﻭﺝﺮﻫ
ﻪﻟﺎﻘﻣ: ﻪﻟﺎﻘﻣ, ﺩﺭﻮﻣ, ﺶﺨﺑ, ﺪﻨﺑ, ﺮﻄﻗ, ﺱﺪﻨﻬﻣ
ﻦﺘﺨﭘ: ﺰﭙﺷﺁ, ﺰﭘﻭﺖﺨﭘ, ﻦﺘﺨﭘ, ﺵﻮﺟ
ﺪﻧﺎﺑ: ﺪﻨﺑﺮﻤﮐ, ﻥﺎﺑﻭﺭ, ﺭﺍﻮﻧ, ﻪﺧﻮﺟ, ﻩﻭﺮﮔ, ﺭﺍﻮﻧ, ﻩﺍﺭﻩﺍﺭﻪﭼﺭﺎﭘ, ﻪﻘﻄﻨﻣ, ﻪﺘﺷﺭ, ﻪﺘﺳﺩ, ﻪﺷﻮﺧ, ﻪﭼﻮﮐ
ﺮﯾﻮﮐ: ﻥﺎﺑﺎﯿﺑ, ﻪﻨﮑﺳﺯﺍﯽﻟﺎﺧ
ﻪﺳﻮﺑ: 
ﺦﯾ: ﯽﻨﺘﺴﺑ, ﺭﺍﻮﻧ, ﻑﺮﺑ
ﭖﻮﺗ: ﮏﯿﺘﺳﻻ, ﻩﺮﮐ, ﻪﻟﻮﻠﮔ, ﻥﺩﺮﻛﺭﻮﺒﺠﻣ, ﮎﺩﻮﮐ, ﺹﺮﻗ, ﯽﭼﻮﭘ, ﻞﯾﻮﺤﺗ
ﺏﻮﭼ: ﺱﺭﻮﺑﻥﺎﻣﺯﺎﺳ, ﺮﮑﺸﯿﻧ, ﻥﺪﯿﺒﺴﭼ, ﺏﻮﭼ, ﺏﻮﭼ, ﺵﺎﻔﺧ, ﻒﺻ, ﻥﺎﻨﮐﺭﺎﮐ, ﺐﻄﻗ
ﻝﺪﺟﻭﺚﺤﺑ: ﻖﻄﻨﻣ, ﺖﮐﺮﺣ, ﻝﺍﺪﺟ, ﻪﺜﺣﺎﺒﻣ, ﻩﺮﻇﺎﻨﻣ, ﻉﺍﺰﻧ, ﻪﻟﺎﺳﺭ, ﺎﻋﺩﺍ, ﻝﺍﻮﺳ, ﺶﺳﺮﭘ
ﻥﺩﺮﮐﻩﺪﻫﺎﺸﻣ: ﯽﺳﺭﺯﺎﺑ, ﯽﺳﺭﺮﺑ, ﻒﺸﮐ, ﯽﺳﺭﺮﺑ, ﻩﺪﻫﺎﺸﻣ
ﺶﯾﺎﯿﻧﺖﻟﺎﺣ: 
ﻪﺟﻮﺗﻞﺑﺎﻗ: ﻪﺘﺴﺟﺮﺑ, ﻩﺪﻨﻨﮐﻩﺮﯿﺧ, ﺏﺎﺼﺘﻋﺍ, ﻪﺟﻮﺗﻞﺑﺎﻗ, ﻪﺟﻮﺗﻞﺑﺎﻗ, ﻪﺟﻮﺗﻞﺑﺎﻗ, ﻪﺟﻮﺗﻞﺑﺎﻗ, ﺮﯿﮕﻤﺸﭼ, ﻩﺪﻨﻨﮐﺮﯿﮕﻠﻓﺎﻏ, ﺐﯿﺠﻋ, ﻪﺟﻮﺗﺐﻟﺎﺟ
ﺭﺎﮑﻫﺎﻨﮔ: ﻩﺎﻨﮔ, ﻥﺩﻮﺑﺭﺎﮑﻫﺪﺑ, ﻥﺩﺮﮐﺖﯾﺫﺍ, ﻒﻠﺨﺘﻣ, ﻡﻮﮑﺤﻣ, ﻥﺩﺮﮐﻡﻮﮑﺤﻣ
ﮓﻨﻔﺗ: ﮓﻨﻔﺗ, ﺡﻼﺳ
ﺲﯿﻠﭘ: ﯼﺍﺮﺟﺍ, ﻥﺩﺮﮐﺕﺭﺎﻈﻧ
ﻥﺩﺮﮐﯽﻔﺨﻣ: ﻥﺩﺮﮐﻥﺎﻬﻨﭘ, ﻥﺩﺮﮐﻥﺎﻬﻨﭘ
ﺮﻔﺳ: ﯽﺗﺎﺑﺎﺨﺘﻧﺍﺕﺍﺯﺭﺎﺒﻣ, ﻮﯾﺍﺭﺩ, ﺮﻔﺳ, ﺮﻔﺳ, ﺮﻔﺳ, ﺮﻔﺳ, ﯽﺒﯿﻠﺻﮓﻨﺟ
ﺮﺑﺍ: ﯼﺯﺎﺠﻣﯼﺎﻀﻓ
ﯽﻨﺘﺨﯾﺭﺭﻭﺩ: ﺭﻮﺨﻧﺩﺭﺪﺑ, ﯼﺭﻭﺮﺿﺮﯿﻏ, ﺩﺭ, ﻉﺎﻨﺘﻣﺍ, ﻥﺪﺷﺩﺮﻃ, ﻪﻟﺎﺑﺯ, ﻪﻟﺎﺑﺯ, ﺎﻫﻪﻟﺎﺑﺯ
ﻪﯾﺭﻮﻓ: 
ﯼﺭﺎﻤﯿﺑ: ﯼﺭﺎﻤﯿﺑ, ﯼﺭﺎﻤﯿﺑ, ﺮﻧﻭﺮﮐﻕﻭﺮﻋ, ﺶﺨﺒﺘﯾﺎﺿﺭ, ﺶﺨﺑﺖﯾﺎﺿﺭ, ﻡﺭﺪﻨﺳ
ﺭﺎﮑﺘﺑﺍﺩﺭﻮﻣ: 
ﯽﻧﺎﻬﺟ: 
ﮎﻼﻣﺍ: ﻲﺑﻮﺧﻪﺑ, ﻉﺭﺯﻭﺖﺸﮐ, ﯽﯾﺍﺭﺍﺩ, ﻦﯿﻣﺯ, ﯽﮔﮋﯾﻭ, ﺖﯿﮑﻟﺎﻣ, ﺕﻭﺮﺛ, ﺕﻭﺮﺛ
ﻦﺗﻭﺮﻓ: ﺖﺴﮑﺷ, ﻦﺗﻭﺮﻓ
ﻦﺘﺧﺍﺪﻧﺍﺮﯿﺧﺎﺗ: ﻥﺩﺎﺘﻓﺍﻖﯾﻮﻌﺗﻪﺑ, ﺮﯾﺩ
ﺮﯿﺧﺎﺗﺎﺑﯼﺭﻭﺮﺿﯼﺮﻣﺍ: 
ﺵﺭﺍﺰﮔﯽﮐﺭﺪﻣ: 
ﻒﺳﺎﺗﻪﯾﺎﻣ: ﻪﻧﺎﻔﺳﺎﺘﻣ, ﺲﻧﺎﺷﺪﺑ, ﯽﻗﺎﻔﺗﺍ, ﻡﺎﮐﺎﻧ, ﯽﺘﺨﺑﺪﺑ, ﻩﺪﻨﺴﺑﺎﻧ, ﺲﻧﺎﺠﺘﻣﺎﻧ, ﺐﺳﺎﻨﻣﺎﻧ
ﺐﺷﻪﻤﯿﻧ: ﻝﺎﻤﺷ
ﻥﺎﻣﺮﻬﻗ: ﻮﺠﮕﻨﺟ, ﻥﺎﻣﺮﻬﻗ
ﺖﺸﮕﻧﺍ: ﻪﺠﻨﭘ, ﻢﻗﺭ
ﺕﺎﻋﻮﺒﻄﻣ: ﺎﻫﻪﻧﺎﺳﺭ, ﻪﻠﺠﻣ, ﻪﻠﺠﻣ, ﭖﺎﭼ, ﻉﻮﻧ, ﻝﻮﻣﺮﻓ, ﺭﺎﺸﻓ
ﻩﺰﯾﺎﺟ: ﻩﺰﯾﺎﺟ, ﻪﯾﺪﻫ, ﻩﺰﯾﺎﺟ, ﻩﺰﯾﺎﺟ, ﻥﺍﺮﺒﺟ, ﻥﺩﺮﮐﻥﺍﺮﺒﺟ
ﺶﻧﺯﺮﺳ: ﺎﻄﺧ, ﺺﻘﻧ, ﺐﯿﻋ, ﯽﻫﺪﺑ, ﻩﺎﻨﮔ, ﺶﻧﺯﺮﺳ, ﺭﺍﺮﻗﯽﻧﻮﻧﺎﻗﺩﺮﮕﯿﭘﺖﺤﺗ, ﯽﻫﺪﺑ, ﺖﯿﻟﻮﺌﺴﻣﺱﺎﺴﺣﺍ, ﻥﺩﺮﮐﻢﻬﺘﻣ, ﺎﻋﺩﺍ, ﻥﺩﺮﮐﻡﻮﮑﺤﻣ, ﻡﻮﮑﺤﻣ
ﯽﺘﺨﺑﺪﺑ: ﯽﺘﺨﺳ, ﻥﺪﯿﺸﮐﺞﻧﺭ, ﻩﻭﺪﻧﺍﻭﻢﻏ, ﯽﺘﺨﺑﺪﺑ, ﯽﮕﺘﺴﺧ, ﻥﺩﺮﺑﺞﻧﺭ, ﻢﻏ, ﺰﻨﻃ
ﯽﻧﺎﺸﯿﭘ: 
ﺩﻼﯿﻣﺯﺍﺪﻌﺑ: ﺕﺎﻐﯿﻠﺒﺗ, ﺕﺎﻐﯿﻠﺒﺗ, ﺕﺎﻐﯿﻠﺒﺗ, ﯽﻬﮔﺁ, ﻥﻼﻋﺍ, ﺕﺎﻐﯿﻠﺒﺗ, ﻉﻼﻃﺍ, ﻡﻼﻋﺍ, ﻪﺑ, ﯼﺍﺮﺑ, ﻪﯿﻧﺎﯿﺑ, ﺎﻋﺩﺍ, ﻊﯿﻓﺮﺗ, ﺞﯾﻭﺮﺗ
ﻪﺘﺷﺮﻓ: ﮏﻠﻣﺐﺣﺎﺻ, ﯼﺮﭘﻭﻦﺟ, ﺖﺨﺳ, ﺮﯾﻭﺰﺗﻭﻪﻠﯿﺣﯼﻭﺭ, ﻝﻮﺳﺭ
ﺕﺮﻬﺷ: ﻩﻮﮑﺷ, ﺕﺮﻬﺷ, ﻪﻌﯾﺎﺷ, ﻪﻌﯾﺎﺷ, ﺕﺎﻐﯿﻠﺒﺗ, ﺕﺎﻐﯿﻠﺒﺗ, ﺭﺎﺒﺘﻋﺍ
ﺩﺮﻔﻣﺩﺪﻋ: 
ﻡﺩﻩﺪﯿﭙﺳ: ﺶﯿﻣﻭﮒﺮﮔ
ﺶﺨﺒﺑ: ﻪﻧﺎﻬﺑ, ﺶﺸﺨﺑ, ﻥﺩﺮﻛﻞﻤﺤﺗ, ﻑﺎﻌﻣ, ﻥﺩﺮﺑﻦﯿﺑﺯﺍ, ﺩﺭ, ﺶﺸﺨﺑ
ﺪﻨﻔﺳﻮﮔ: ﻩﺮﺑ, ﺰﺑ, ﻥﺍﺰﯿﻣ, ﺖﺒﺜﻣ
ﺡﻮﺿﻭ: ﻥﺩﺮﮐﻑﺮﻃﺮﺑ, ﻞﺣﻩﺍﺭ, ﻢﯿﻤﺼﺗ, ﻪﺠﯿﺘﻧ, ﻞﯿﻠﺤﺗ, ﻦﺘﺴﮑﺷﻢﻫﺭﺩ, ﮏﯿﮑﻔﺗ, ﻦﯿﯿﻌﺗ, ﯽﮔﺪﯿﺳﻮﭘ
ﺮﺒﺻ: ﯽﯾﺎﺒﯿﮑﺷ, ﻞﻤﺤﺗ, ﺭﺎﻤﯿﺑ, ﺮﺒﺻﯽﺑ, ﺭﺎﺑﺩﺮﺑ, ﻞﻤﺤﺗ, ﯼﺭﺍﺩﻦﺘﺸﯾﻮﺧ
ﯽﻋﺎﺟﺭﺍ: ﻊﺟﺮﻣ, ﺪﯿﻨﮐﻪﻌﺟﺍﺮﻣ, ﻥﺩﺮﻛﺺﺨﺸﻣ, ﺩﻮﻤﻨﻫﺭ
ﺕﺭﺫ: ﻡﺪﻨﮔﻪﺷﻮﺧ, ﺥﺎﺷ, ﺕﻼﻏ
ﺪﯿﻠﮐ: ﻪﺿﺮﻗﻕﺍﺭﻭﺍ, ﻪﻤﮐﺩ, ﭻﯿﺋﻮﺳ, ﯽﻠﺻﺍ, ﯽﺗﺎﯿﺣ, ﻪﺘﺴﺟﺮﺑ, ﺱﺎﺴﺣ, ﮒﺭﺰﺑ, ﺭﺍﻮﯾﺩﺭﺩﯽﮕﺘﻓﺭﻮﺗ, ﯽﻠﺻﺍﺮﯿﺴﻣ, ﺪﯿﻠﮐ, ﻪﮐ
ﺖﯾﺮﺜﮐﺍ: ﯼﺭﺎﯿﺴﺑ, ﻦﯾﺮﺘﺸﯿﺑ
ﻞﻬﺟ: ﻥﺍﺩﺎﻧ, ﮏﺤﻀﻣ, ﻖﻤﺣﺍ, ﻥﺍﺩﺎﻧ, ﺖﺴﺷ
ﻒﻌﺿ: ﺰﺠﻋ
ﺩﻮﺳ: ﺖﯾﺰﻣ, ﻥﺩﺮﮐﺐﺴﮐ, ﻥﺩﺮﺑﻩﺮﻬﺑ, ﻡﺍﻭﺩﻞﺑﺎﻗ, ﯼﺯﻭﺮﯿﭘ, ﻊﻔﻨﯾﺫ
ﺱﻮﻗﺎﻧ: ﺮﻄﺧﮓﻧﺯ, ﺖﻋﺎﺳ, ﺖﻋﺎﺳ
ﻮﺟ: ﻂﯿﺤﻣ, ﻥﺎﻤﺳﺁ, ﯼﺩﺭﻮﻧﺍﻮﻫ, ﯽﯾﺎﻀﻓ, ﻢﯿﻠﻗﺍ, ﻑﺍﺮﻃﺍﻂﯿﺤﻣ
ﺖﯾﺮﺸﺑ: ﻥﺎﺴﻧﺍ
ﮏﺴﯾﺩ: ﮏﺴﯾﺩ, ﻪﮑﺗ, ﻩﺪﻧﺭﺎﻤﺷ, ﺭﺪﻨﻠﯿﺳ, ﻪﺤﻔﺻ, ﺩﺭﻮﮐﺭ, ﯽﻨﯿﺳ
ﺎﻬﻨﺗ: ﺲﮐﯽﺑ, ﯽﯾﺎﻬﻨﺗ, ﻪﻧﺎﮔﺍﺪﺟﺕﺭﻮﺼﺑ, ﺎﻬﻨﺗ, ﺎﻬﻨﺗ, ﻡﺍﺭﺁ, ﻪﻨﮑﺳﺯﺍﯽﻟﺎﺧ
ﺪﻨﻣﺮﻨﻫ: ﺮﮕﯾﺯﺎﺑ, ﺵﺎﻘﻧ, ﻩﺪﻨﻨﮐﻡﺮﮔﺮﺳ
ﻥﻮﺴﻓﺍ: ﮏﯿﺗﺎﻣﺰﯾﺭﺎﮐ, ﻪﺑﺫﺎﺟ, ﻭﺩﺎﺟ, ﻥﺩﺮﮐﯽﺠﻫ, ﯽﯾﺎﺒﯾﺯ
ﯽﮔﺩﺮﺑ: ﻩﺩﺮﺑ, ﻪﺿﺮﻗﻕﺍﺭﻭﺍ
ﺭﺍﺪﻧﺎﻣﺮﻓ: ﺭﺎﮐﻪﻈﻓﺎﺤﻣ, ﺶﻛﻂﺧ
ﻪﺧﺎﺷ: 
ﻊﺿﻭ: ﺐﯿﺗﺮﺗ, ﯼﺪﻨﺑﺮﮑﯿﭘ, ﺶﯾﺍﺮﮔ, ﺪﻧﻭﺭ, ﮎﺭﺍﺪﺗ, ﺡﺮﻃ, ﺖﻟﺎﺣ, ﻪﻣﺎﻧﺮﺑ, ﯽﻧﺎﻣﺯﻝﻭﺪﺟ, ﺖﻣﺎﻗﺍﻞﺤﻣ, ﺪﺼﻘﻣ
ﺲﻧﺎﺷ: ﺕﻭﺮﺛ, ﺖﺷﻮﻧﺮﺳ, ﺲﻧﺎﺷﺵﻮﺧ, ﯼﺩﺎﺷ, ﺲﻧﺎﺷ, ﺲﻧﺎﺷﺵﻮﺧ
ﻪﺘﻓﺮﮔﺕﺎﺸﻧ: ﻦﺘﻓﺮﮔ, ﻥﺩﺮﻛﺖﻓﺎﻳﺭﺩ, ﻖﺘﺸﻣ, ﯽﺸﮐﺍﻭ, ﻥﺪﯿﺳﺭ, ﯽﺑﺎﯾﺯﺎﺑ
ﯽﺋﺎﻘﻟﺍﺖﻟﺎﺣ: ﯽﻃﺎﺒﻨﺘﺳﺍﺖﻟﺎﺣ, ﯽﺳﺎﯿﻗﺎﯾﯽﯾﺍﺮﻘﺘﺳﺍﺖﻟﺎﺣ
ﻉﺎﻤﺘﺟﺍ: ﻪﻌﻣﺎﺟ, ﯼﺪﻨﺑﻪﺘﺳﺩ, ﺎﻫﻥﺎﺴﻧﺍ
ﺖﻔﻧ: ﯽﺑﺮﭼ, ﺖﺧﻮﺳ, ﻞﯿﺴﻓ, ﺰﻐﻣ, ﯽﺗﺭﺍﺮﺣ, ﻩﺮﮐ
ﻪﻟﻮﻟ: ﻪﻟﻮﻟ, ﺮﯿﺷ, ﺏﺁﺮﻴﺷ, ﻥﺩﺍﺩﺕﺭﻮﻗ
ﭖﺎﭼ: ﭖﺎﭼ, ﺭﺎﺸﻓ, ﭖﺎﭼ, ﺭﻮﺤﻣ, ﺐﻟﺎﻗ, ﺱﺎﺴﺣﺍ
ﻩﻭﺍ: ﻪﻠﺑ, ﻪﯾﺍﺭﺁ
ﻦﺨﺳﻪﻨﯿﻣﺯ: 
ﯽﯾﺍﺪﻧﺩﺭﻮﻣ: 
ﻦﯿﺑﺎﮐ: ﻪﺒﻠﮐ, ﺭﺩﺎﭼ, ﻝﺰﻨﻣ, ﻕﺎﺗﺍ, ﻝﻮﻠﺳ, ﻪﭘﻮﮐ
ﯽﺒﺼﻋ: ﻥﺎﻣﺯ, ﻢﮔﺭﺩﺮﺳ, ﻥﺪﺷﻢﺣﺍﺰﻣ, ﻦﯿﮕﻤﻏ, ﻞﺠﺧ, ﻥﺍﺮﮕﻧ, ﻥﺩﺮﮐﺖﯾﺫﺍ, ﻩﺪﻨﻨﻛﺖﺣﺍﺭﺎﻧ, ﯽﺒﺼﻋ, ﻥﺍﺮﮕﻧ, ﺐﺼﻋ, ﯼﻮﻗ, ﺪﻨﻤﺗﺭﺪﻗ, ﺪﯾﺪﺷ
ﻕﺮﻓ: ﺐﯿﺗﺮﺗﻪﺑ, ﺕﻭﺎﻔﺘﻣﺭﻮﻄﺑ, ﺕﺍﺮﯿﯿﻐﺗ, ﻉﻮﻨﺗ, ﻦﺘﺷﺍﺩﺕﻭﺎﻔﺗ, ﻥﺩﺍﺩﺰﯿﻤﺗ, ﻑﺎﮑﺷ, ﻕﺍﺮﺘﻓﺍ, ﺕﻭﺎﻔﺗ, ﺩﺎﻀﺗ, ﺮﯿﯿﻐﺗ, ﺲﻧﺎﯾﺭﺍﻭ
ﺭﺎﺑ: ﮎﺭﺩ, ﺭﺎﺑ
ﻢﺸﯾﺮﺑﺍ: ﻢﻬﻓ, ﮓﻨﭼ
ﺮﯿﻘﺤﺗ: ﻥﺩﺮﻤﺷﺭﺍﻮﺧ, ﺕﺮﻔﻧ, ﻦﺘﺷﺍﺪﻧﺖﺳﻭﺩ, ﺭﺎﺟﺰﻧﺍ, ﺕﺮﻔﻧ, ﺶﻧﺯﺮﺳ, ﻥﺩﺮﻛﻦﻴﻫﻮﺗ, ﺖﻣﺮﺣﮏﺘﻫ, ﯼﺭﺎﮕﻧﺍﻞﻬﺳ
ﻢﻨﻬﺟ: 
ﻢﻫﺯﺍﺍﺪﺟ: ﻪﻧﺎﮔﺍﺪﺟ, ﺯﺍﻪﺘﺷﺬﮔ, ﺍﺪﺟ, ﺰﯾﺎﻤﺘﻣ, ﻦﺘﺷﺍﺩﺕﻭﺎﻔﺗ, ﻪﻧﺎﮔﺍﺪﺟﺕﺭﻮﺼﺑ, ﺭﻭﺩ, ﻪﺘﺴﺴﮔ, ﺍﻭﺰﻧﺍ, ﺩﺮﻃ, ﯽﺼﺨﺸﻣﺯﺮﻣﻭﺪﺣ, ﯽﯾﺍﺪﺟ, ﻥﺩﺍﺩﺰﯿﻤﺗ, ﯼﻭﺰﻨﻣ, ﯽﯾﺍﺪﺟ
ﻁﻮﻠﺨﻣ: ﻁﻮﻠﺨﻣ, ﺐﯿﮐﺮﺗ, ﺐﮐﺮﻣ, ﻁﻮﻠﺨﻣ, ﮎﺮﺘﺸﻣ, ﻡﺎﻏﺩﺍ
ﯽﺑﻮﭼ: ﺏﻮﭼ, ﺏﻮﭼ
ﻥﺎﻣﺭﺩ: ﻥﺎﻣﺭﺩ, ﻥﺎﻣﺭﺩ, ﻥﺎﻣﺭﺩ, ﺪﻨﯾﺁﺮﻓ, ﻦﺘﻓﺮﮔﺮﻈﻧﺭﺩ, ﺱﺎﻨﺸﻧﺎﻣﺭﺩ, ﻥﺎﻣﺭﺩ, ﻪﻣﺎﻧﻢﻫﺎﻔﺗ, ﺎﻔﺷ, ﻥﺩﺮﻛﺭﺎﺘﻓﺭ, ﮏﻤﮐ, ﻪﻧﺎﭼ, ﮏﻓ
ﺭﺍﺪﺸﻫ: ﻁﺎﯿﺘﺣﺍ, ﻥﺩﺍﺩﺭﺍﺪﺸﻫ, ﺭﺎﯿﺷﻮﻫ, ﺩﻮﺑﺩﺎﯾ, ﻉﻼﻃﺍ
ﺮﮐﺬﺗﺖﻟﺎﺣ: 
ﯽﺒﻠﻃﻩﺎﺟ: ﺪﯿﻣﺍﺎﻧ, ﯼﺪﯿﻣﺍﺎﻧ, ﺕﻮﻬﺷ, ﻥﺩﺮﮐﺩﺮﺴﻟﺩ, ﺐﻠﻃﻩﺎﺟ
ﻩﺩﺯﺎﺑ: ﯼﺭﻭﻩﺮﻬﺑ, ﺮﯿﺜﮑﺗ, ﺪﻣﺁﺭﺩ
ﯼﻮﺤﻧﻪﺑ: ﯼﺪﺣﺎﺗ, ﯼﺰﯿﭼﻪﯾ
ﺕﺭﻮﺸﻣ: ﺭﻭﺎﺸﻣ, ﻩﺭﺎﺷﺍ, ﻪﯿﺻﻮﺗ, ﻩﺭﻭﺎﺸﻣ, ﺖﺤﯿﺼﻧ, ﻡﺎﻌﻧﺍ, ﻞﯿﮐﻭ, ﻞﯿﮐﻭ, ﻊﻓﺍﺪﻣ
ﻲﺳﺎﺳﺍﻥﻮﻧﺎﻗ: ﺭﻮﺸﻨﻣ, ﻪﻃﻭﺮﺸﻣ, ﻪﺛﺩﺎﺣ, ﻉﻮﻗﻭ
ﺭﺍﺰﺑﺍ: ﺭﺍﺰﺑﺍ, ﯽﺘﺸﮐ, ﺩﻮﺟﻭ, ﻮﻀﻋ, ﻑﺮﻇ, ﺭﺍﺰﺑﺍ, ﻩﺎﮕﺘﺳﺩ
ﺖﺑﺎﺛ: ﺕﺎﺒﺛﺎﺑ, ﻥﺩﺮﮐﺖﯿﺒﺜﺗ, ﻢﻈﻨﻣ, ﺐﺗﺮﻣﺭﻮﻃﻪﺑ, ﺪﺷﺖﺳﺭﺩ, ﺖﺑﺎﺛ, ﻡﻭﺍﺪﻣﺭﻮﻃﻪﺑ, ﻡﻭﺍﺪﻣ, ﺭﺍﺪﯾﺎﭘ, ﺩﺭﺍﺪﻧﺎﺘﺳﺍ, ﺎﺘﺴﯾﺍ, ﺖﺑﺎﺛ, ﺭﺍﻮﺘﺳﺍ, ﻲﻤﺋﺍﺩ, ﺎﺘﺴﯾﺍ, ﻡﺍﺭﺁ
ﺮﺻﺎﻨﻋ: ﻞﻣﺍﻮﻋ, ﺮﺼﻨﻋ, ءﺰﺟ, ءﺰﺟ, ءﺍﺰﺟﺍ, ﺖﯿﻫﺎﻣ, ﺪﺤﺘﻣ, ﻞﻣﺎﻋ, ﺮﺘﻣﺍﺭﺎﭘ
ﻡﻭﺍﺪﻣﻪﺒﻨﺟ: 
ﻦﯾﻼﻧﺁ: 
ﺪﻣﻭﺭﺰﺟ: ﻥﺩﺍﺩﻥﺎﮑﺗﺖﺳﺩ, ﯽﻧﺎﻬﮔﺎﻧﻭﻢﮑﺤﻣﻪﺑﺮﺿ
ﺞﻟﺎﮐ: ﻩﺪﮑﺸﻧﺍﺩ, ﻩﺎﮕﺸﻧﺍﺩ, ﺲﯾﺩﺮﭘ, ﻩﺎﮕﺸﻧﺍﺩ
ﻡﺩ: ﻒﺻ, ﻪﻟﺎﺒﻧﺩ
ﻞﺴﻧ: ﻞﺴﻧ
ﻪﺑﺮﮔ: 
ﻢﯿﻘﺘﺴﻣﯽﮐﺭﺪﻣ: 
ﻪﮐﻭﺮﺘﻣ: ﯽﻬﺟﻮﺗﯽﺑ, ﻥﺩﺮﮐﮎﺮﺗ, ﻪﻨﮑﺳﺯﺍﯽﻟﺎﺧ, ﮎﺮﺗ, ﻥﺩﺮﮐﮎﺮﺗ, ﻥﺩﺮﮐﻞﺣ, ﻥﺩﺮﮐﻮﻐﻟ
ﻩﺩﺯﺎﯾ: 
ﻩﺰﯾﺮﻏ: ﺩﻮﺨﺑﺩﻮﺧ
ﻪﻠﯿﺒﻗ: ﻪﻨﺗ, ﻪﻗﺎﺳ, ﺭﺎﺑ, ﻡﺪﻋ, ﺪﻗﺎﻓ, ﺩﻮﺒﻤﮐ, ﺩﻮﺒﻤﮐ, ﺩﻮﺒﻤﮐ
ﻥﺍﺮﮕﻧﺖﻟﺎﺣ: 
ﻩﺎﻨﭘﻥﺎﺟ: ﺭﺮﮑﻣﺪﻣﺁﻭﺖﻓﺭ, ﺖﻣﺎﻗﺍﻞﺤﻣ, ﻥﺎﮑﺳﺍ, ﺖﻧﻮﮑﺳﻞﺤﻣ, ﯽﻧﻮﮑﺴﻣ, ﺖﻇﺎﻔﺣ, ﻩﺎﮕﺑﺍﻮﺧ, ﻩﺎﻨﭘ, ﻩﺎﮔﺭﺪﻨﺑ
ﺏﺩﺍﯽﺑ: ﻪﻧﺎﺧﺎﺘﺴﮔ, ﻦﺸﺧ, ﻥﺎﺑﺮﻬﻣﺎﻧ, ﻦﺸﺧ
ﯼﺭﺍﻮﺳ: ﻥﺪﺷﺭﺍﻮﺳ, ﺭﺍﻮﺳ
ﻪﻓﺮﺣ: ﯼﺍﻪﻓﺮﺣ, ﯼﺍﻪﻓﺮﺣ, ﻝﺎﻐﺘﺷﺍ, ﯽﺼﺼﺨﺗ, ﯼﺍﻪﻓﺮﺣﻭﯽﻨﻓ, ﺕﺭﺎﺠﺗ
ﭗﻣﻻ: ﻊﻤﺷ
ﻩﻮﻬﻗ: ﻪﻓﺎﮐ, ﯽﻓﺎﮐ, ﯽﻓﺎﮐﻩﺯﺍﺪﻧﺍﻪﺑ, ﯽﻓﺎﮐ
ﺭﺎﺘﺳﺮﭘ: ﺮﻫﺍﻮﺧ
ﻥﺩﺍﺩﻥﺎﻨﯿﻤﻃﺍ: ﻦﯿﻤﻀﺗ, ﻢﮑﺣ, ﻭﺮﮔ, ﺖﻧﺎﻤﺿ, ﻥﺩﺮﮐﻪﻤﯿﺑ, ﻥﺎﻨﯿﻤﻃﺍ, ﻡﻮﻠﻌﻣ, ﻥﺩﺮﻛﺪﻴﻳﺎﺗ, ﺪﻨﮐﯽﻣﻢﻫﺍﺮﻓ, ﻥﺩﺮﮐﻪﯿﻬﺗ, ﻢﺸﭼﯼﻭﺭﻪﺑ, ﻥﺩﺮﻛﻊﻧﺎﻗ, ﺪﯿﯾﺄﺗ, ﻦﻣﺍ, ﻡﻮﯾﺩﻻﺎﭘ
ﺶﻔﮐ: ﺶﻔﮐ, ﻝﺪﻨﺻ
ﻪﻣﺪﺧ: ﻥﺎﻨﮐﺭﺎﮐ, ﻪﻠﮔ, ﻢﯿﺗ, ﻪﺘﺳﺩ, ﻞﻨﺳﺮﭘ
ﻁﺎﯿﺣ: ﺪﮐ, ﻪﺤﻔﺻ, ﻪﻘﺷﺎﻌﻣ
ﻢﻬﺒﻣ: ﻡﺎﻬﺑﺍ, ﻢﻬﺒﻣ, ﻢﻬﺒﻣ, ﺢﺿﺍﻭﺮﯿﻏ, ﺰﯿﻣﺁﺭﺍﺮﺳﺍ, ﯽﻌﻄﻗﺮﯿﻏ, ﻦﯿﻌﻣﺎﻧ, ﻥﺩﺍﺩﻥﺎﮑﺗﺖﺳﺩ, ﯽﻟﺎﺧ, ﻡﻮﻬﻔﻣﺎﻧ
ﯽﻧﻮﮑﺴﻣﻥﺎﻤﺗﺭﺎﭘﺁ: ﺖﺨﺗ, ﻩﺮﯾﺍﺩ, ﻪﭘﻮﮐ, ﻪﻋﻮﻤﺠﻣ, ﻦﮔﺍﻭ
ﺖﯿﻟﺎﻌﻓ: ﺶﻨﮐﺍﺮﺗ, ﺩﺮﮑﻠﻤﻋ, ﺕﺎﯿﻠﻤﻋ
ﻪﺒﻨﺷﺯﻭﺭ: ﻪﺘﻔﻫﺮﺧﺁ
ﻩﺪﻧﺭﺍﺩ: 
ﺏﺎﺘﻓﺍﺭﻮﻧ: ﯼﺪﯿﺷﺭﻮﺧ, ﺏﺎﺘﻓﺁﺪﺿﯼﺎﻫﻡﺮﮐ, ﺶﺸﺧﺭﺩ, ﻦﺷﻭﺭﺯﻭﺭ
ﻩﻮﯿﺑ: 
ﻁﺎﺒﺗﺭﺍ: ﺱﺎﻤﺗ, ﺕﺎﺒﺗﺎﮑﻣ, ﯽﻃﺎﺒﺗﺭﺍ, ﻥﺩﺮﻛﺭﺍﺮﻗﺮﺑﻁﺎﺒﺗﺭﺍ, ﻞﺑﺎﻘﺘﻣﺮﺛﺍ, ﻞﻣﺎﻌﺗ, ﻁﺎﺒﺗﺭﺍ, ﻁﺎﺒﺗﺭﺍ, ﻁﺎﺒﺗﺭﺍ, ﻁﺎﺒﺗﺭﺍ, ﻁﺎﺒﺗﺭﺍ, ﻉﻼﻃﺍ, ﻥﻼﻋﺍ, ﺶﻨﮐﺍﺮﺗ, ﻥﺪﯿﺷﺎﭘ, ﯼﺍﻪﻓﺮﺣ, ﺩﻮﻨﺷﻭﺖﻔﮔ, ﻂﺑﺍﺭ, ﻮﮕﺘﻔﮔ
ﺱﺎﮑﻌﻧﺍ: ﺮﮑﻔﺗ, ﺶﻨﮐﺍﻭ, ﻞﯿﺨﺗ
ﻥﺎﻣﺯﺎﺳ: ﺖﻓﺎﺑ, ﻥﺎﻣﺯﺎﺳ, ﻥﺩﺍﺩﻥﺎﻣﺯﺎﺳ, ﮒﺮﺑﻭﺯﺎﺳ, ﺖﮐﺮﺷ, ﺭﺍﺰﺑﺍ, ﯽﮔﺪﻨﯾﺎﻤﻧ, ﺩﻮﺟﻭ, ﻢﺘﺴﯿﺳ, ﺭﺎﺘﺧﺎﺳ, ﺖﻓﺎﺑ, ﺡﺮﻃ, ﻪﺴﺳﻮﻣ, ﻪﺴﺳﻮﻣ, ﻦﻤﺠﻧﺍ, ﺖﮐﺮﺷ, ﯼﺭﺍﺬﮔﻪﯾﺎﻣﺮﺳ, ﯽﯾﺎﻤﯿﭘﺍﻮﻫ, ﻪﺘﻓﺎﯾﻥﺎﻣﺯﺎﺳ
ﻩﺭﺎﺘﺳ: 
ﻥﺎﻤﻬﻣ: ﻪﻧﺎﮕﯿﺑ, ﻥﺎﻤﻬﻣ, ﻪﻧﺎﮕﯿﺑ, ﯽﺟﺭﺎﺧ, ﺩﺭﺍﻭﻩﺯﺎﺗ, ﻩﺪﻨﻫﺩﺵﺭﺎﻔﺳ, ﯼﺮﺘﺸﻣ, ﻥﺎﺑﺰﯿﻣ
ﺭﺎﺑ: ﺖﺨﻟ, ﻪﻧﺎﺨﯿﻣ, ﺭﺎﺑ, ﺭﺎﺑ, ﺭﺎﺑ, ﻪﻓﺎﮐ, ﻢﯾﺭﺎﺑ, ﺭﺍﻮﻧ, ﯼﺪﻨﺑﻢﺧﺯﺭﺍﻮﻧ, ﺪﻨﺑﺮﻤﮐ
ﯼﺮﻄﺑ: ﻪﺸﯿﺷ, ﯼﺭﺎﻤﯿﺑ
ﺖﮐﺮﺑ: ﺖﮐﺮﺑ, ﻦﺘﻔﮔﮏﯾﺮﺒﺗ
ﻥﺩﺯﻢﻬﺑ: ﻥﺩﺮﮐﯼﺭﺎﮑﺘﺳﺩ, ﻁﻮﻠﺨﻣ, ﻥﺪﯿﺸﮐﻥﻭﺮﯿﺑ, ﺵﺭﻮﺷ, ﻥﺩﺮﮐﮏﯾﺮﺤﺗ
ﻉﺍﺰﻧ: ﺲﻧﺎﯾﺭﺍﻭ, ﻉﺍﺰﻧ, ﻥﺩﺮﮐﻩﺯﺭﺎﺒﻣ, ﯽﯾﺎﻀﻗﯼﻮﻋﺩ, ﺚﺤﺑﻭﺮﺟ, ﺮﻈﻧﻑﻼﺘﺧﺍ
ﯽﻠﺧﺍﺩ: ﺩﻭﺪﺣﺭﺩ،ﻞﺧﺍﺩﺭﺩ, ﻞﺧﺍﺩ, ﯽﻠﺧﺍﺩ, ﯽﻠﺧﺍﺩ, ﯽﻠﺤﻣ, ﯽﮕﻧﺎﺧ, ﯽﻠﺧﺍﺩ, ﯽﻧﺍﻭﺭ, ﯼﺩﻮﺧ, ﯽﻠﺻﺍ, ﮒﺭﺰﺑ
ﺖﻣﻭﺎﻘﻣ: ﺖﻔﻟﺎﺨﻣ, ﻒﻟﺎﺨﻣ, ﺽﺍﺮﺘﻋﺍ, ﻡﻭﺎﻘﻣ, ﻒﻟﺎﺨﻣ, ﺯﺍﻥﺪﺷﻦﯿﮕﻤﺸﺧ, ﺽﺍﺮﺘﻋﺍ
ﯽﻟﺎﺧﻮﺗ: ﻩﺩﺎﺳ, ﺖﺨﻟ, ﯽﻟﺎﺧﯼﺎﺟ, ﻞﺑﺎﮐ, ﺥﺍﺭﻮﺳ
ﻥﺎﺘﺳﺍ: ﯽﻧﺎﺘﺳﺍ, ﻪﯿﺣﺎﻧ, ﻥﺎﺘﺳﺮﻬﺷ, ﯽﺑﺮﭼ
ﻥﺪﻤﺗ: ﮓﻨﻫﺮﻓ
ﻥﺪﺷﻥﺍﺰﯾﻭﺁ: ﻥﺩﺮﮐﺕﺭﺎﻈﻧ
ﻥﺪﺷﻪﮐﻮﺷ: ﻪﺑﺮﺿ, ﻢﺧﺯ, ﻩﺪﻨﻫﺩﻥﺎﮑﺗ, ﺩﺭﻮﺧﺮﺑ, ﺮﯿﺛﺄﺗ, ﻥﺩﺮﮐﺲﺣﯽﺑ
ﺎﻨﺜﺘﺳﺍ: ﻲﺋﺰﺟ, ﺾﯿﻌﺒﺗ, ﻪﺸﯿﻠﮐ, ﺖﯿﻓﺎﻌﻣ, ﺩﺎﻀﺗ, ﻪﺘﺴﺟﺮﺑ, ﻑﺎﻌﻣ, ﺮﺴﮐ
ﺩﺍﮋﻧ: ﺱﺮﺘﺳﺍ, ﺶﻨﺗ, ﺭﺎﺑ, ﯽﮕﺘﺴﺧ, ﺵﻼﺗ, ﺕﺪﺷ, ﻦﺘﻓﺮﯾﺬﭘ, ﯼﺩﺍﮋﻧ, ﯽﻣﻮﻗ
ﯽﮔﺪﻨﻧﺍﺭ: ﻮﯾﺍﺭﺩ, ﻩﺪﻨﻧﺍﺭ, ﺎﻤﻨﻫﺍﺭ, ﻥﺪﺷﺭﺍﻮﺳ
ﺪﻨﮔﻮﺳ: ﻥﺩﺭﻮﺧﻢﺴﻗ, ﻭﺮﮔ
ﺞﻨﮔ: ﺮﻫﺍﻮﺟ
ﻪﻧﺍﺩ: ﻪﻔﻄﻧ, ﻩﺮﻬﻣ, ﻩﺭﺫ, ﯼﺎﻗﺁ
ﺝﺮﺑ: 
ﺏﻮﺒﺤﻣ: ﺏﻮﺒﺤﻣ
ﯽﮔﺯﺎﺗﻪﺑ: ﺮﯿﺧﺍ, ﻩﺯﺎﺗ, ﺍﺮﯿﺧﺍ, ﻩﺯﻭﺮﻣﺍ, ﻥﺁﺯﺍﺪﻌﺑ
ﺭﺍﺪﯿﺑ: ﻪﻧﺎﻫﺎﮔﺁ, ﻪﯿﺣﻭﺭ, ﯼﺭﺍﺪﯿﺑ, ﺭﺎﯿﺷﻮﻫ, ﻥﺩﺮﮐﮏﯾﺮﺤﺗ
ﻪﻧﺎﺧﺏﺎﺒﺳﺍ: 
ﺏﺎﻨﻃ: ﺏﺎﻨﻃ, ﻪﺘﺷﺭ, ﻪﻤﺴﺗ, ﻥﺩﺮﮐﺮﯿﺳﺍﻭﺭﺎﺘﻓﺮﮔ
ﺍﺮﺟﺎﻣ: ﯼﺭﺍﺬﮔﻪﯾﺎﻣﺮﺳ, ﺮﻄﺧ, ﺭﺎﻤﻗ
ﯽﺘﻨﻄﻠﺳﻩﺩﺍﻮﻧﺎﺧﯼﺎﻀﻋﺍ: ﺖﻨﻄﻠﺳ
ﻦﺸﺟ: ﺏﺰﺣ, ﻦﺸﺟ, ﺖﻓﺎﯿﺿ, ﻞﯿﻄﻌﺗﺯﻭﺭ, ﻡﺎﺷ
ﻪﻧﺎﯿﻟﺎﺳ: ﻝﺎﺳ, ﻪﻧﻻﺎﺳ
ﺱﺎﯿﻘﻣ: ﺏﺎﻗ, ﺏﻮﭼﺭﺎﭼ, ﻩﺯﺍﺪﻧﺍ, ﺖﺒﺴﻧ, ﻥﺎﺑﺩﺮﻧ, ﻪﻠﭘﻩﺍﺭ, ﻪﻠﭘ, ﻩﺯﺍﺪﻧﺍ, ﺭﺎﯿﻌﻣ, ﺪﻌﺑ, ﺢﻄﺳ, ﺪﺣ, ﺖﺒﺴﻧﻪﺑ
ﻪﺠﯿﺘﻧﺭﺩ: ﻪﺠﯿﺘﻧ, ﻭﺭﻦﯾﺍﺯﺍ
ﻪﯾﺎﭘ: ﯼﺎﻨﺑﺮﯾﺯ, ﺱﺎﺳﺍ, ﺮﻘﺘﺴﻣ, ﯽﺳﺎﺳﺍ, ﯽﻠﺻﺍ, ﯽﯾﺍﺪﺘﺑﺍ, ﻪﺘﺴﻫ, ﯽﺳﺎﺳﺍ, ﻖﻤﻋﻢﮐ, ﯽﺳﺎﻨﺷﺭﺎﮐ, ﻪﻨﯿﻣﺯ, ﻮﮑﺳ, ﻪﯾﺎﭘ, ﺎﺳﺎﺳﺍ, ﻥﺩﻮﺑﯼﺰﯿﺟﻪﻨﯿﻣﺯ
ﻢﺳﺍﺮﻣ: ﺕﺎﻔﯾﺮﺸﺗ, ﺩﺮﮑﻠﻤﻋ, ﻦﺸﺟ, ﺕﺮﺴﻨﮐ, ﻝﻮﻣﺮﻓ, ﯼﺭﺎﯿﺷﻮﻫ
ﺪﯿﺻ: ﺭﺎﮑﺷ, ﯽﻧﺎﺑﺮﻗ, ﺭﺎﮑﺷ, ﺐﯿﻘﻌﺗ, ﯼﺯﺍﺪﻧﺍﺮﯿﺗ
ﻝﺍﺮﺒﯿﻟ: ﻩﺪﻨﺸﺨﺑ, ﻪﻧﺍﺩﺍﺯﺁ
ﯼﺩﺎﯾﺯﺪﺣﺎﺗ: ﯼﺍﻪﻈﺣﻼﻣﻞﺑﺎﻗ, ﻪﻈﺣﻼﻣﻞﺑﺎﻗﺭﻮﻃﻪﺑ, ﻦﯾﺮﺘﺸﯿﺑ, ﻩﺪﻤﻋﺭﻮﻃﻪﺑ, ﺐﻠﻏﺍ, ﯼﺩﺎﯾﺯﺪﺣﺎﺗ, ﻩﺩﺮﺘﺴﮔﺭﻮﻃﻪﺑ, ﺎﺗﺪﻤﻋ, ﻞﺻﺍﺭﺩ, ﺎﺳﺎﺳﺍ, ﺎﺳﺎﺳﺍ, ﻩﺪﻨﯾﺍﺰﻓﺭﻮﻃﻪﺑ
ﻢﻧﺎﺧﻩﺩﺍﺰﻫﺎﺷ: ﺮﺘﺧﺩﺪﻧﺯﺮﻓ, ﺱﻭﺮﻋﻩﺯﺎﺗ
ﺏﺍﺮﺤﻣ: ﺏﺍﺮﺤﻣ
ﺏﻭ: ﻪﮑﺒﺷ, ﺺﻟﺎﺧ, ﯼﺭﻮﺗ, ﺖﻓﺎﺑ, ﯽﺷﺎﻘﻧﻡﻮﺑ, ﯽﮔﺪﻨﻓﺎﺑ
ﺶﻔﻨﺑﮓﻧﺭ: ﯽﻧﺍﻮﻏﺭﺍ
ﻥﺩﺮﮐﻊﻤﺟ: ﯼﺭﻭﺁﻊﻤﺟ, ﻦﺘﺷﺎﺒﻧﺍ, ﻥﺪﺷﮏﭼﻮﮐ, ﯼﺮﯿﮔﻩﺭﺎﻤﺷ, ﯽﻗﺎﺑ
ﺏﺎﺨﺘﻧﺍ: ﺏﺎﺨﺘﻧﺍ, ﺐﺨﺘﻨﻣ, ﻪﻟﺎﺒﻧﺩ, ﯼﺍﺭ, ﮓﻨﻬﻧ, ﺏﺎﺨﺘﻧﺍ, ﯽﺑﺎﺨﺘﻧﺍ
ﺖﺴﻣ: ﯽﻠﮑﻟﺍ, ﯽﺘﺴﻣ
ﻦﺘﺨﯾﺭ: ﯽﻧﻮﮕﻧﺮﺳ, ﻦﺘﺨﯾﺭ, ﺖﺸﻧ, ﯽﻧﻮﮕﻧﺮﺳ
ﻥﺩﺮﮐﺪﻨﻠﺑ: ﺭﻮﺴﻧﺎﺳﺁ, ﻥﺩﺮﺑﻻﺎﺑ, ﻥﺩﺮﺑﻻﺎﺑ, ﻥﺩﺮﺑﻻﺎﺑ, ﯼﻭﺭﻩﺩﺎﯿﭘ
ﺖﺳﮊ: ﻥﺩﺮﮐﺎﻀﻣﺍ, ﻝﺎﻨﮕﯿﺳ, ﻞﺒﻤﺳ, ﻦﯾﺩﺎﻤﻧ, ﺵﺮﮕﻧ, ﺖﻟﺎﺣ, ﻩﺭﺎﺷﺍ, ﻪﻧﺎﺸﻧ
ﺖﯾﺮﯾﺪﻣ: ﺖﯾﺮﯾﺪﻣ, ﻥﺩﺮﮐﺕﺭﺎﻈﻧ, ﯽﮔﺪﯿﺳﺭ, ﺖﻣﻮﮑﺣ, ﻥﺩﺮﮐﺖﻣﻮﮑﺣ, ﻥﺩﺮﮐﺖﯾﺍﺪﻫ, ﻝﺮﺘﻨﮐ, ﻞﻤﻋ, ﺍﺭ, ﻥﺩﺍﺩﺐﯿﺗﺮﺗ, ﻥﺩﺍﺩﻥﺎﻣﺯﺎﺳ, ﯼﺪﻨﺑﺮﮑﯿﭘ, ﻥﺩﺍﺩﻡﺎﺠﻧﺍ, ﻦﺘﺷﺍﺩﻪﮕﻧ
ﻝﺩﺎﺒﺗ: ﻪﻟﺩﺎﺒﻣ, ﻞﺑﺎﻘﺘﻣ, SWOP, ﯽﻨﯾﺰﮕﯾﺎﺟ, ﯼﺎﻬﻟﺩﺎﺒﻣ, ﻝﻮﭘﺪﺣﺍﻭ, ﯽﻟﻮﭘ, ﺏﻭﺎﻨﺘﻣ, ﺪﻧﻮﯿﭘ
ﯽﻌﻄﻗﻪﻟﺎﻘﻣ: 
ﺭﻮﺗﺍﺮﭙﻣﺍ: ﻩﺎﺷﺩﺎﭘ
ﻥﺎﯾﺎﭘ: ﺪﯿﺳﺭﻥﺎﯾﺎﭘﻪﺑ, ﻥﺎﯾﺎﭘ, ﻥﺎﯾﺎﭘ, ﭻﮔ, ﺮﺑﻎﻟﺎﺑ, ﻦﯿﯾﺰﺗ, ﻪﺠﯿﺘﻧ
ﺖﺷﺯ: ﻩﺪﻨﻧﺯﻭﺪﻨﺗ, ﺭﻭﺁﺵﺪﻨﭼ, ﺵﻮﺧ, ﺶﺨﺑﺕﺬﻟ, ﻩﺪﻨﻨﮐﻡﺮﮔﺮﺳ
ﯽﻌﻗﺍﻭ: ﺖﺳﺭﺩ, ﯽﻌﻗﺍﻭ, ﯽﻌﻗﺍﻭ, ﯼﺯﺎﺠﻣ, ﻖﯿﻗﺩ, ﯽﻠﺻﺍ, ﯽﻣﻮﺑ, ﯽﺗﺍﺫ, ﯽﻣﻮﺑ, ﯽﻀﻌﺑ, ﻦﺌﻤﻄﻣ, ﻥﻮﺘﺳ, ﻕﺩﺎﺻ
ﭻﻨﯾﺍ: ﮎﺮﻤﮔ, ﺖﺴﺷ
ﺶﯾﺭ: ﻪﻧﺎﭼ
ﻥﺩﺍﺩﺮﺟ: ﻥﺩﻮﺑﺭ, ﺶﯾﺎﺳﺮﻓ
ﻥﺩﺮﮐﺖﻣﻭﺎﻘﻣ: ﻒﻟﺎﺨﻣ, ﺖﻔﻟﺎﺨﻣ, ﺩﺎﻀﺗ, ﺽﺍﺮﺘﻋﺍ, ﻒﻟﺎﺨﻣ, ﺖﻔﻟﺎﺨﻣ, ﻥﺩﺮﮐﻊﻄﻗ, ﻒﻟﺎﺨﻣ, ﺩﺭ, ﺩﺭ, ﻒﻟﺎﺨﻣ, ءﯽﺷ, ﻞﻤﺤﺗ, ﺖﻣﻮﺼﺧ, ﺾﻗﺎﻨﺗ
ﺮﺟﺎﺗ: ﻝﻻﺩ, ﺮﺟﺎﺗ, ﻻﺎﮐ
ﻝﻼﻘﺘﺳﺍ: ﻞﻘﺘﺴﻣ, ﯼﺩﺍﺯﺁ, ﻪﻧﺍﺩﺍﺯﺁ, ﯼﺩﺍﺯﺍ, ﯼﺭﺎﺘﺨﻣﺩﻮﺧ, ﯽﯾﺎﻫﺭ
ﻮﺑ: ﺮﻄﻋ, ﻢﻌﻃ, ﻢﻌﻃ
ﻩﺪﺠﻫ: 
ﯽﺨﯾﺭﺎﺗ: ﯽﺨﯾﺭﺎﺗ, ﺦﯾﺭﺎﺗ, ﺱﺎﻨﺷﺦﯾﺭﺎﺗ, ﯽﺨﯾﺭﺎﺗ
ﺖﺷﺭﺩ: ﻊﻤﺟ, ﻉﻮﻤﺠﻣ, ﻒﯿﺜﮐ, ﻡﺎﺧ, ﻡﺎﺧ, ﯽﮕﺘﺨﯿﮕﻧﺍ, ﻭﺮﮐﺎﻣ, ﻕﺎﯿﺘﺷﺍﺎﺑ, ﺪﯾﺪﺷ, ﺪﯾﺪﺷ, ﻪﻄﻘﻧ, ﯽﻠﮐﺭﻮﻃﻪﺑ
ﻪﺸﯾﺭ: ﻪﻗﺎﺳ, ﻩﺯﺎﺗ, ﺮﯿﺴﻣ, ﯽﻠﺻﺍ, ﺐﺴﻧﻭﻞﺻﺍ
ﻞﮔ: ﮎﺎﺧ, ﻞﮔﻭﻦﺠﻟ, ﺱﺭﮎﺎﺧ, ﮎﺎﺧ, ﻞﮔ
ﯽﮔﺩﺎﺳ: ﻩﺩﺎﺳ, ﯽﻨﺗﻭﺮﻓ
ﻪﻧﺎﻧﺯﺭﺩﺎﭼ: ﻩﺩﺮﭘ, ﻥﺎﺑﺩﺎﺑ, ﯽﻧﺍﺮﯿﺘﺸﮐ, ﺶﯾﺎﻤﻧﻪﺤﻔﺻ, ءﺎﺸﻏ
ﺮﺗﺎﺌﺗ: ﺮﺗﺎﺌﺗ
ﻪﺴﯾﺎﻘﻣ: ﻥﺩﺮﻛﻪﺴﻳﺎﻘﻣ, ﯼﺍﻪﺴﯾﺎﻘﻣ, ﻁﺎﺒﺗﺭﺍ, ﺖﺒﺴﻧ, ﻪﻬﺟﺍﻮﻣ, ﻪﺴﯾﺎﻘﻣﻞﺑﺎﻗ
ﯼﺪﻨﺑﺐﯿﮐﺮﺗ: ءﺰﺟ, ﺭﺎﺘﺧﺎﺳ, ﻞﯿﮑﺸﺗ, ﺖﺧﺎﺳ, ﺪﻨﻫﺩﯽﻣﻞﯿﮑﺸﺗﺍﺭ, ﺭﺎﺘﺧﺎﺳ, ﻥﺩﺍﺩﻥﺎﻣﺯﺎﺳ, ﯼﺪﻨﺑﺮﮑﯿﭘ, ﯼﺪﻨﺑﺮﮑﯿﭘ
ﺐﯿﻗﺭ: ﻒﯾﺮﺣ, ﻒﻟﺎﺨﻣ, ﺖﺑﺎﻗﺭ, ﯽﺘﺑﺎﻗﺭ, ﺖﺑﺎﻗﺭ, ﺐﯿﻗﺭ, ﻩﺪﻧﺭﺎﻤﺷ, ﺾﻗﺎﻨﺘﻣ, ﻒﻟﺎﺨﻣ
ﻥﺪﯿﻤﻬﻓ: ﻥﺪﯿﺳﺭ, ﺺﯿﺨﺸﺗ, ﻦﺘﺧﺎﻨﺷﺖﯿﻤﺳﺭﻪﺑ, ﯽﯾﺎﺳﺎﻨﺷ, ﻥﺩﺍﺩﺺﯿﺨﺸﺗ, ﺮﺒﺧﯽﺑ, ﻥﺩﺮﮐﺍﺮﺟﺍ, ﺱﺎﺴﺣﺍ, ﮎﺭﺩ, ﻦﮐﮎﺭﺩ, ﻢﻬﻓ, ﻥﺩﺍﺩﻡﺎﺠﻧﺍ, ﻥﺩﺮﮐﻆﻔﺣ
ﻝﺩﺎﻌﺗ: ﻝﺩﺎﻌﺗ, ﻥﺎﺴﮑﯾﺭﻮﻃﻪﺑ, ﯼﺮﺑﺍﺮﺑ, ﯽﻘﻓﺍ, ﺖﺒﺴﻧﻪﺑ, ﻝﺩﺎﻌﺗ, ﻪﺟﺩﻮﺑ
ﯽﺑﺮﻣ: ﯽﺑﺮﻣ, ﺺﺼﺨﺘﻣ, ﯽﺑﺮﻣ, ﯽﺑﺮﻣ
ﯽﻌﺒﻃﺥﻮﺷ: ﯽﻌﺒﻃﺥﻮﺷ, ﯽﻫﺎﮑﻓ, ﺖﻟﺎﺣ, ﯼﺪﻤﮐ, ﯽﺧﻮﺷ
ﻥﺎﻣﺭ: ﻥﺎﺘﺳﺍﺩ, ﺪﯾﺪﺟ, ﺍﺮﯿﺧﺍ
ﻡﺎﻘﺘﻧﺍ: ﻪﻨﯿﮐ
ﻊﺑﺎﻨﻣ: ﯽﯾﺍﺭﺍﺩ, ﻊﺒﻨﻣ, ﻊﺑﺎﻨﻣ, ﯼﺎﻨﻌﻣﻪﺑ, ﻦﯿﻣﺎﺗ
ﺩﻮﺴﺣ: ﺕﺩﺎﺴﺣ, ﺕﺩﺎﺴﺣ
ﺥﺮﭼ: ﻪﺧﺮﭼﻭﺩ, ﻩﺮﯾﺍﺩ, ﻪﺧﺮﭼ
ﻪﺘﺧﻮﺳ: ﯽﮕﺘﺧﻮﺳ
ﻥﺩﺯﻕﺮﺑ: ﻕﺮﺑ, ﺶﺑﺎﺗ, ﺶﺸﺧﺭﺩ, ﻩﻮﻗﻍﺍﺮﭼ
ﺪﻫﺩﯽﻣﺩﺎﻬﻨﺸﯿﭘ: ﺩﺎﻬﻨﺸﯿﭘ, ﻪﯿﺻﻮﺗ, ﺩﺎﻬﻨﺸﯿﭘ, ﻪﯿﺻﻮﺗ, ﯼﺩﺎﻬﻨﺸﯿﭘﺡﺮﻃ, ﻥﺩﺮﮐﺩﺰﻣﺎﻧ, ﺪﻨﻧﺎﺳﺮﯿﻣﺍﺭﻡﻮﻬﻔﻣﻦﯾﺍ, ﺩﺭﻮﺧﺯﺎﺑ, ﻥﺩﺍﺩﻥﺎﺸﻧ, ﻩﺭﺍﺰﮔ
ﺰﯿﻣﺍﺖﻨﻌﻟﺖﻟﺎﺣ: 
ﻩﺪﻧﺎﻣﺭﺩ: 
ﺎﻫﻩﻭﺮﮔ: ﻩﻭﺮﮔ, ﻪﺷﺮﻋ
ﻩﺎﮕﺷﺎﺑ: ﺵﺎﻔﺧ
ﻞﯿﺳ: ﻥﺩﺮﮐﻝﺎﻤﯾﺎﭘ
ﺕﺬﻟ: ﺪﯾﺮﺒﺑﺕﺬﻟ, ﺕﺬﻟ, ﺕﺬﻟ, ﺕﺬﻟ, ﯼﺩﺎﺷ, ﻝﺎﺤﺷﻮﺧ, ﻝﺎﺤﺷﻮﺧ, ﻝﺎﺤﺷﻮﺧ, ﻥﺩﺮﮐﻖﯾﻮﺸﺗ
ﯽﮕﻗﻼﻋﯽﺑ: ﯽﮕﻗﻼﻋﯽﺑ, ﻁﺎﯿﺘﺣﺍﯽﺑ, ﯽﻬﺟﻮﺗﯽﺑ, ﯽﺷﻮﭘﻢﺸﭼ, ﻥﺩﺮﮐﯽﺷﻮﭘﻢﺸﭼ
ﻖﻓﺍ: 
ﯽﺿﺮﻓﺖﻟﺎﺣ: ﯽﺿﺮﻓﺖﻟﺎﺣ
ﺪﻨﺗﺐﯿﺷ: ﯼﺪﻨﻠﺑ, ﺩﻮﻤﻋ, ﺭﺎﯿﺴﺑ
ﯽﻧﻮﻣﺭﺎﻫ: ﺵﺯﺎﺳ, ﮓﻨﻫﺍ
ﯽﮐﺩﻮﮐﻥﺍﺭﻭﺩ: 
ﻮﻧﺍﺯ: ﻥﺩﺮﮐﭗﻠﺷﭗﻠﺷ
ﻞﺑﺎﻘﺘﻣ: ﺮﮕﯾﺪﮑﯾ, ﻞﺑﺎﻘﺘﻣ, ﺞﯾﺍﺭ, ﮎﺮﺘﺸﻣ, ﻞﺑﺎﻘﺘﻣﺮﺛﺍ, ﯽﻠﻣﺎﻌﺗ
ﺭﺍﺰﻓﺍﻡﺮﻧ: ﺭﺍﺰﻓﺍﻡﺮﻧ, ﻪﻋﻮﻤﺠﻣ
ﯽﮔﺪﯾﺩﺐﯿﺳﺁ: ﻪﻣﺪﺻ, ﻪﻣﺪﺻ, ﻥﺪﻧﺎﺳﺭﺐﯿﺳﺁ, ﻥﺩﺯﺐﯿﺳﺍ, ﻢﺧﺯ, ﻢﺧﺯ, ﺡﻭﺮﺠﻣ, ﺾﻘﻧ
ﻝﻮﺻﻭﻡﻼﻋﺍ: ﻥﺩﺮﻛﺖﻓﺎﻳﺭﺩ, ﺩﻭﺭﻭ, ﺵﺮﯾﺬﭘ, ﺵﺮﯾﺬﭘ, ﺵﺮﯾﺬﭘ, ﺪﻨﺳ
ﻁﺎﺒﻀﻧﺍ: ﻉﻮﺿﻮﻣ
ﺵﺰﻐﻟ: ﻩﺪﻧﺰﻐﻟ, ﺵﺰﻐﻟ, ﻥﺩﺭﻮﺧﺮﺳ, ﻩﺎﺒﺘﺷﺍ
ﺏﻼﻘﻧﺍ: ﯽﺑﻼﻘﻧﺍ, ﺎﺗﺩﻮﮐ, ﺶﺧﺮﭼ, ﺵﺭﻮﺷ, ﺵﺭﻮﺷ
ﺭﺍﺩﻪﻋﺭﺰﻣ: ﯽﻧﺎﻘﻫﺩ
ﻪﺑﺮﺿ: ﻪﺑﺮﺿ, ﺎﺗﺩﻮﮐ, ﻥﺩﺮﺑﻡﻮﺠﻫ, ﺵﻼﺗ
ﺯﺎﯿﺘﻣﺍ: ﺯﺎﺘﻤﻣ, ﺢﯿﺟﺮﺗ, ﻪﯿﻤﻬﺳ, ﻥﺩﺍﺩﯼﺍﺭﻖﺣ, ﺩﺎﻬﻨﺸﯿﭘ, ﺯﺎﯿﺘﻣﺍ
ﻮﺠﺸﻧﺍﺩ: ﺩﺮﮔﺎﺷ, ﻩﻭﮋﭘﺶﻧﺍﺩ, ﯽﺳﺎﻨﺷﺭﺎﮐ, ﯽﻫﺎﮕﺸﻧﺍﺩ
ﺭﺎﻏ: 
ﺖﻨﺳ: ﯽﺘﻨﺳ, ﯽﺘﻨﺳﺭﻮﻃﻪﺑ, ﮎﺮﻤﮔ, ﻢﯿﻠﺴﺗ
ﯼﺩﮊﺍﺮﺗ: ﻥﺪﺷﺮﯿﮔﺍﺮﻓ, ﻪﺼﻏﻭﻢﻏ, ﺩﺍﺪﺿﺍ
ﻪﻧﺎﺧﺮﻓﺎﺴﻣ: ﻪﻧﺎﺨﯿﻣ
ﻩﺮﮐﺎﺑ: ﻥﺯﺖﻣﺪﺨﺸﯿﭘ
ﯽﻈﻓﺎﺣﺍﺪﺧ: ﯽﻈﻓﺎﺣﺍﺪﺧ, ﻆﻓﺎﺣﺍﺪﺧ, ﻆﻓﺎﺣﺍﺪﺧ
ﺩﺎﻘﺘﻧﺍ: ﻥﺩﺮﮐﺩﺎﻘﺘﻧﺍ, ﺩﺎﻘﺘﻧﺍ, ﯽﻨﯿﺑﺯﺎﺑ
ﻪﺒﻨﭘ: ﻢﺸﭘ
ﻥﺎﺘﺳﺭﺎﻤﯿﺑ: ﻩﺎﻨﭘ
ﻥﺩﺮﮐﻩﺭﺎﺟﺍ: ﻪﯾﺍﺮﮐ, ﻡﺍﺪﺨﺘﺳﺍ, ﺕﺎﯿﻟﺎﻣ, ﻡﺍﺮﺘﺣﺍ, ﻩﺭﺎﺟﺍ, ﻡﺍﺪﺨﺘﺳﺍ, ﻥﺩﺮﮐﻝﻮﻐﺸﻣ, ﻩﺭﺎﺟﺍ, ﺭﻮﺸﻨﻣ
ﺭﺎﺨﺑ،ﺯﺎﮔ،ﺩﻭﺩ: 
ﺮﯾﺬﭘﺎﻧﺏﺎﻨﺘﺟﺍ: ﺭﺎﭼﺎﻧﻪﺑ
ﺭﺎﺒﮔﺮﻣ: ﯽﺗﺎﯿﺣ
ﮒﺮﺑ: ﻕﺭﻭ, ﻪﻐﯿﺗ
ﺭﺎﺸﺘﻧﺍ: ﺭﺎﺸﺘﻧﺍ, ﺮﺸﻧﻭﭖﺎﭼ, ﭖﺎﭼ, ﻡﻼﻋﺍ, ﺶﺨﭘ, ﻥﺩﺮﮐﺩﺍﺯﺁ, ﺪﯿﻟﻮﺗ, ﺭﺎﺸﺘﻧﺍ, ﻡﻼﻋﺍ
ﻪﻤﺟﺮﺗ: ﻥﺩﺮﮐﻪﻤﺟﺮﺗ, ﻥﺩﺮﮐﻪﻤﺟﺮﺗ, ﺮﯿﺴﻔﺗ, ﻥﺪﺷﺮﯿﮔﺍﺮﻓ, ﻝﺎﻘﺘﻧﺍ, ﻪﺨﺴﻧ
ﺎﯾﺭﺩﻞﺣﺎﺳ: ﻪﺘﺷﺭ, ﻞﺣﺎﺳ
ﯼﺭﺎﭙﺴﮐﺎﺧ: ﯼﺭﺎﭙﺴﮐﺎﺧ, ﻥﺎﺘﺳﺮﺒﻗ, ﻦﻓﺩ
ﺭﺩﻮﭘ: ﺭﺩﻮﭘ, ﺮﯿﻤﺧ, ﻖﯿﻗﺩ, ﻖﯿﻗﺩ, ﻖﯿﻗﺩ, ﯽﯾﺍﺬﻏﻩﺪﻋﻭ
ﺍﺪﺻﻭﺮﺳ: ﯽﺸﯾﺎﻤﻧ, ﺩﺎﯾﺮﻓ, ﺍﺪﺻﻭﺮﺳ
ﮏﯿﺘﻧﺎﻣﻭﺭ: ﺮﻤﮐﺭﻭﺩ, ﻥﺍﺭﻞﺼﻔﻣ
ﻪﺒﻠﮐ: ﻪﺒﻠﮐ, ﻝﺰﻨﻣ, ﻦﺘﺨﯾﺭ
ﺪﯿﻠﻘﺗﻪﺑﻪﺘﺴﺑﺍﻭ: 
ﺭﻻﺩ: 
ﻩﺩﺰﻧﺎﺷ: ﺖﺼﺷ
ﮊﺎﺘﻧﻮﻣ: ﯼﺭﺎﮐﻪﺴﻠﺟ, ﺲﻧﺍﺮﻔﻨﮐ, ﻩﺮﮕﻨﮐ, ﯼﺪﻨﺑﺮﮑﯿﭘ, ﻊﻤﺠﺗ
ﻩﺮﻤﻌﺘﺴﻣ: 
ﻝﺎﺑ: ﺶﺨﺑ, ﻪﻋﻮﻤﺠﻣ, ﻡﺍﺪﻧﺍ, ﻪﻟﺎﺑ, ﺯﺍﻭﺮﭘ, ﯼﺩﺭﻮﻧﺍﻮﻫ
ﺮﯿﺷﻥﺍﻮﯿﺣ: 
ﯼﺮﮔﻪﻠﯿﺣ: ﺮﯾﻭﺰﺗﻭﻪﻠﯿﺣﯼﻭﺭ, ﻦﻓﻭﺕﻮﻓ, ﺮﻫﺎﻣ, ﺵﻮﻫﺎﺑ, ﮏﯿﺗﺎﻤﻠﭙﯾﺩ
ﻡﺍﺭﺩ: ﺮﻫﺎﻈﺗ, ﯽﺸﯾﺎﻤﻧ
ﺭﺎﺒﻏ: ﻪﻣ
ﻦﺘﻣﺮﺑﺍ: ﮏﻨﯿﻟ
ﻭﺭﺍﺩ: ﻭﺭﺍﺩ, ﻥﺎﻣﺭﺩ, ﻥﺪﯿﺷﺎﭘ, ﻪﺨﺴﻧ
ﻩﺩﺭﺎﻬﭼ: ﻥﻭﺪﺑ, ﯼﺭﺎﺼﺤﻧﺍ, ﯽﺳﻮﻨﯿﺳ
ﺪﯿﺳﺍ: ﺵﺮﺗ, ﯼﺪﯿﺳﺍ, ﻩﻮﮐ, ﻩﻮﮐ
ﯽﻨﻌﯾ: ﺮﻫ, ﻝﺎﺜﻣﻥﺍﻮﻨﻋﻪﺑ
ﻩﺪﻨﻨﮐﻩﺩﺎﻔﺘﺳﺍ: ﻊﻔﻨﯾﺫ, ﻩﺪﻨﻨﻛﻑﺮﺼﻣ
ﻒﻘﺳﺍ: 
ﯽﺠﻧﺭﺎﻧ: 
ﻥﺍﻭ: ﻡﺎﻤﺣ, ﺵﻭﺩ, ﻡﺎﻤﺣﻥﺍﻭ
ﻖﺘﺸﻣ: ﺐﯿﮐﺮﺗ, ﯽﺴﯾﻮﻧﻭﺭ, ﻖﺘﺸﻣ
ﻪﯿﻟﻭﺍ: ﻪﯿﻟﻭﺍ, ﻪﯿﻟﻭﺍ, ﯽﻧﺎﺘﺳﺎﺑ
ﺪﺒﺳ: ﻦﺑ, ﻪﺴﯿﮐ, ﻝﺎﺒﺘﮑﺴﺑ
ﺮﯿﺑﺩ: ﺮﮕﺸﯾﺍﺮﯾﻭ
ﺕﺎﺠﻧ: ﯽﻨﻤﯾﺍ, ﯽﯾﺎﻫﺭ, ﻡﻼﺳ, ﺕﺎﺠﻧﻭﺩﺍﺪﻣﺍ, ﺩﻮﺒﻬﺑ, ﯽﺑﺎﯾﺯﺎﺑ
ﺯﻭﺮﻣﺍ: 
hodiernalﺖﻔﺳ: 
ﺪﺼﻗ: ﻩﺪﺷﻪﺘﻓﺮﮔﺮﻈﻧﺭﺩ, ﺪﺼﻗ, ﺪﻨﻣﻪﻗﻼﻋ, ﻕﺎﺘﺸﻣ, ﻩﺰﯿﮕﻧﺍ, ﻞﯿﻣﯽﺑ, ﻥﺩﺍﺩﺹﺎﺼﺘﺧﺍ, ﻥﺩﺍﺩﺹﺎﺼﺘﺧﺍ, ﻦﯿﯿﻌﺗ
ﺭﺎﺨﺑ: 
ﻢﺳ: ﯽﻤﺳ, ﯽﻤﺳ, ﺶﮐﻒﻠﻋ, ﻥﻮﺳﺍﻮﭘ
ﺩﺍﺪﻌﺘﺳﺍ: ﯽﮔﺪﻨﺸﺧﺭﺩ, ﺪﻌﺘﺴﻣ, ﺖﯿﺣﻼﺻ, ﯽﯾﺎﻧﺍﻮﺗ, ﻪﻋﻮﻤﺠﻣ
ﺭﺍﺬﮔﺮﻴﺛﺎﺗ: ﺮﺒﺘﻌﻣ, ﺮﺛﻮﻣﺭﻮﻃﻪﺑ, ﺪﻣﺁﺭﺎﮐ, ﯽﺸﺨﺑﺮﺛﺍ, ﺫﻮﻔﻧ, ﺪﯿﻔﻣ, ﻝﺎﻌﻓ, ﺱﺮﺘﺳﺩﺭﺩ, ﺮﯿﮕﻤﺸﭼ
ﻮﺸﺘﺴﺷ: ﯽﯾﻮﺸﺳﺎﺒﻟ
ﺭﺍﺮﻗﺍ: ﻥﺎﻋﺫﺍ, ﻩﺪﯿﻘﻋ, ﻦﺘﺧﺎﻨﺷﺖﯿﻤﺳﺭﻪﺑ, ﺵﺮﯾﺬﭘ, ﺎﻋﺩﺍ
ﻑﺮﺧﺰﻣ: ﻪﻟﺎﺑﺯ, ﻞﯿﻟﺩﯽﺑ, ﺲﻧﺎﺠﺘﻣﺎﻧ
ﮓﻨﺳﻝﺎﻏﺯ: ﻦﺑﺮﮐ
ﻥﻭﺎﻌﻣ: ﯽﻨﻤﺠﻧﺍ, ﻆﻓﺎﺣﺍﺪﺧ, ﻡﺎﻘﻣﻢﺋﺎﻗ
ﺖﻗﻮﻣ: ﻩﺯﺎﺑ, ﻥﺎﻣﺯﺕﺪﻣ, ﯽﻧﺎﻣﺯ, ﯽﻗﺎﻔﺗﺍ, ﯽﻓﺩﺎﺼﺗ, ﺞﻨﺳﻥﺎﻣﺯ, ﻦﯿﺣﺭﺩ, ﺮﺻﺎﻌﻣ
delimitativeﻪﺒﻨﺟ: 
ﻥﺍﻮﺨﺘﺳﺍ: ﺎﭘ, ﯽﮕﺘﺴﮑﺷ, ﯼﺪﻨﺑﻥﺍﻮﺨﺘﺳﺍ
ﻪﺒﻨﺷﻭﺩ: 
ﻪﺒﻨﺸﻬﺳ: ﻡﻮﺳ
ﻪﺒﻨﺷﺭﺎﻬﭼ: ﻡﺭﺎﻬﭼ
ﻝﺍﺭﺪﻓ: ﻥﻮﯿﺳﺍﺭﺪﻓ, ﯼﺰﮐﺮﻣ
ﺏﻮﻠﻄﻣ: ﺏﺍﺬﺟ, ﺏﻮﻠﻄﻣ
ﻩﺪﻨﯾﺎﻤﻧ: ﯽﮔﺪﻨﯾﺎﻤﻧ, ﯽﮔﺪﻨﯾﺎﻤﻧ, ﻩﺪﻨﯾﺎﻤﻧ, ﻞﯿﮐﻭ, ﻡﺎﻘﻣﻢﺋﺎﻗ, ﯼﻮﮕﻨﺨﺳ
ﯽﻧﺎﺘﮐﻪﭼﺭﺎﭘ: ﯼﺭﺍﻮﻠﺷﺮﯾﺯ
ﯽﯾﻮﺸﻓﺮﻇﮏﻨﯿﺳ: ﻥﺪﺷﻕﺮﻏ, ﻪﻧﺎﺧﺩﻭﺭﻩﺯﻮﺣ, ﯼﻭﺭﺰﻠﻓ, ﻡﺎﮕﻤﻫ
ﺭﺩﺍﺮﺑﺎﯾﺮﻫﺍﻮﺧﺮﺴﭘ: ﻩﺩﺍﺯﺮﻫﺍﻮﺧ, ﻩﻮﻧ, ﻩﻮﻧ
ﻩﺮﺻﺎﺤﻣ: ﻪﻃﺎﺣﺍ, ﯽﻟﺪﻨﺻ
ﻩﺪﻌﻣ: ﻢﮑﺷ, ﯽﻤﮑﺷ, ﺲﯾﺮﺗﺎﻣ
ﻪﻠﻗ: ﺝﻭﺍ, ﻻﺎﺑ, ﻡﺎﻌﻧﺍ, ﺩﺍﺩﺭﺍﺮﻗ, ﺱﺍﺮﻟﺍﻂﺧ
ﯼﺭﺎﺼﺤﻧﺍﺺﺨﺷ: 
ﻥﺩﺮﮐﺐﺣﺎﺼﺗ: ﺎﺑﺩﺭﻮﺧﺮﺑ, ﻥﺩﺮﮐﺩﻭﺪﺤﻣ, ﺖﺷﺍﺩﺯﺎﺑ, ﻭﺭﺯﺭ, ﻥﺩﻮﺑﺭ, ﻩﺪﺷﻝﺎﻐﺷﺍ, ﻝﺎﻐﺷﺍ, ﻦﺘﺷﺍﺩﻪﮕﻧ, ﻦﺘﻓﺮﮔ, ﻢﻬﻓ, ﮎﺭﺩ, ﻦﺘﻓﺮﮔ, ﺎﻋﺩﺍ, ﻦﺘﺷﺍﺩﺭﺎﯿﺘﺧﺍﺭﺩ
ﺭﺎﺼﺣ: ﻦﯿﭼﺮﭘ
ﻪﻤﺴﺠﻣ: ﯼﺯﺎﺳﻪﻤﺴﺠﻣ
ﺲﮐﻮﻟ: 
ﻪﻧﺎﺨﭘﻮﺗ: ﻥﺪﯿﺷﺍﺮﺗ
ﺖﺷﺍﺩﺯﺎﺑ: ﻦﺘﻓﺮﮔ, ﻦﺘﻓﺮﮔ, ﺖﺷﺍﺩﺯﺎﺑ, ﻥﺩﺮﮐﺖﻔﺳ, ﻒﻗﻮﺗ, ﺭﻮﺼﺗ
ﻪﺘﺴﺑ: ﻪﺘﺴﺑ, ﻪﺘﺴﺑ, ﻪﺘﺴﺑ, ﻥﺩﺮﮐﯼﺪﻨﺑﻪﺘﺴﺑ, ﻪﺘﺴﺑ, ﻪﺘﺴﺑ, ﻪﺘﺴﺑ, ﯼﺪﻨﺑﻪﺘﺴﺑﺬﻏﺎﮐ, ﯼﺪﻨﺑﻪﺘﺴﺑ
ﻑﺍﺮﻃﺍ: ﻑﺍﺮﻃﺍﺭﺩ, ﯽﮕﯾﺎﺴﻤﻫ, ﻪﯾﺎﺴﻤﻫ, ﻪﯾﺎﺴﻤﻫ, ﯽﮕﯾﺎﺴﻤﻫ, ﯽﻧﻮﻣﺍﺮﯿﭘ, ﻑﺍﺮﻃﺍﻂﯿﺤﻣ, ﺭﻭﺎﺠﻣ, ﻊﻣﺎﺟ, ﻂﯿﺤﻣ, ﯽﻄﯿﺤﻣﺖﺴﯾﺯ
ﺍﺪﮐﻮﻣ: ﺖﺨﺳ, ﻢﺠﺴﻨﻣ, ﺖﻗﺩ, ﮓﻨﺗ, ﺪﯾﺪﺷ, ﺎﻌﻄﻗ, ﻼﻣﺎﮐ, ﺎﻌﻄﻗ, ﻢﮑﺤﻣ, ﻦﺸﺧ, ﻢﺸﭼﯼﻭﺭﻪﺑ, ﻼﻣﺎﮐ, ﺎﻘﯿﻗﺩ
ﻩﺪﻧﺎﻣﯽﻗﺎﺑ: ﯽﻗﺎﺑ, ﻩﺪﻧﺎﻣﯽﻗﺎﺑ, ﻩﺪﺷﯼﺮﭙﺳ, ﯽﻗﺎﺑ
ﻥﺯﻮﮔ: 
ﻪﺗﻮﺑ: 
ﻦﻫﺁﻩﺍﺭ: ﻦﻫﺁﻩﺍﺭ, ﻞﯾﺭ
ﻪﯿﻠﺨﺗ: ﯽﯾﺎﻫﺭ, ﻥﺩﺮﮐﯽﻟﺎﺧ, ﻥﺩﺮﮐﺩﺍﺯﺁ, ﻥﺩﺮﮐﮎﺮﺗ, ﻦﺘﺧﺍﺪﻧﺍﻥﻭﺮﯿﺑ, ﻦﺘﺨﯾﺭﻥﻭﺮﯿﺑ
ﺙﺭﺍﻭ: ﻥﺩﺮﺑﺙﺭﺍ, ﯼﺍﺭﺍﺩ
ﻁﻮﻠﺑ: 
ﺪﻨﯾﺎﺷﻮﺧﺎﻧ: ﺕﺬﻟ, ﺵﻮﺧ, ﺏﺮﻄﻀﻣ, ﺖﯾﺫﺍ, ﻩﺪﻨﻨﻛﺖﺣﺍﺭﺎﻧ, ﻩﺪﻨﻧﺯﻭﺪﻨﺗ, ﺖﺣﺍﺭﺎﻧ
ﻮﻧﺎﯿﭘ: 
ﻥﺩﺮﮐﺪﻋﺎﻘﺘﻣ: ﻥﺩﺮﻛﻊﻧﺎﻗ, ﻦﺘﻓﺮﮔﻦﺸﺟ, ﺖﺷﺍﺪﮔﺭﺰﺑ
ﯽﻔﺨﻣ: ﺰﯿﻣﺁﺭﺍﺮﺳﺍ, ﻥﺪﺷﺪﯾﺪﭘﺎﻧ
ﻡﺎﻨﮑﯿﻧ: ﻑﻭﺮﻌﻣ, ﻡﺎﻧﺪﺑ, ﻪﺘﺴﺟﺮﺑ
ﻢﻠﻇ: 
ﻪﺳﻮﺳﻭ: ﻥﺩﺮﮐﺍﻮﻏﺍ
ﯽﯾﺎﻬﻧﻑﺪﻫﯼﺍﺭﺍﺩﻪﺒﻨﺟ: 
ﻲﻠﻠﻤﻟﺍﻦﻴﺑ: ﯽﻧﺎﻬﺟ, ﯽﺘﯿﻠﻣﺪﻨﭼ
ﻥﺩﺮﮐﻪﻠﺧﺍﺪﻣ: ﻞﺧﺍﺪﺗ, ﻪﻠﺧﺍﺪﻣ, ﻪﻠﺧﺍﺪﻣ, ﻥﺪﺷﻢﺣﺍﺰﻣ, ﺖﻤﺣﺯ, ﻥﺍﺮﮕﻧ, ﻥﺩﺮﮐﻊﻄﻗ, ﻥﺩﺮﮐﮏﯾﺮﺤﺗ, ﮏﯾﺮﺤﺗ, ﻥﺩﺮﮐﺖﯾﺫﺍ, ﺩﺭﻮﺧﺮﺑ, ﻩﺪﻨﻫﺩﺭﺍﺯﺁ, ﺪﯿﻫﺩﻩﺯﺎﺟﺍ, ﻝﻼﺘﺧﺍ
ﻒﯿﻄﻟ: ﮏﭼﻮﮐ, ﻦﻓﻭﺕﻮﻓ, ﺕﺭﺎﻬﻣ, ﻒﯾﺮﻇ, ﻑﺎﺻ, ﺰﯾﺭ, ﺏﻮﺧ, ﺮﻏﻻ, ﻁﺎﯿﺘﺣﺍﺎﺑ, ﻢﯾﻼﻣ
ﻑﻮﺴﻠﯿﻓ: ﯽﻔﺴﻠﻓ
ﺎﺒﯾﺯ: ﺯﻭﺭﺪﻣ, ﻒﯾﺮﻇ, ﺰﯿﮕﻧﺍﺖﻔﮕﺷ, ﯽﻟﺎﻋ, ﻪﺟﻮﺗﺐﻟﺎﺟ, ﻩﻮﮑﺷﺎﺑ, ﯽﻧﺩﺮﮑﻧﺭﻭﺎﺑ, ﻩﺩﺎﻌﻟﺍﻕﺭﺎﺧ, ﺪﮐﻮﻣ, ﻩﺩﺎﻌﻟﺍﻕﻮﻓ
ﻩﺎﻓﺭ: ﯽﻫﺍﻮﺧﺮﯿﺧ, ﯽﺑﺎﯿﻣﺎﮐ, ﮎﺭﺍﺪﺗ
ﯽﻫﺎﻣﺪﯿﺻ: 
ﺖﻗﺮﺳ: ﯼﺩﺯﺩ, ﺕﺭﺎﻏ, ﺖﻗﺮﺳ, ﻥﺩﺯﺪﯾﺪﺷﻭﺪﻨﺗﻪﺑﺮﺿ, ﻥﺩﺮﮐﯽﻨﯿﭼﻪﺷﻮﺧ, ﻥﺩﺍﺩﻡﺎﻨﺷﺩ
ﺐﻟ: ﺭﺎﻘﻨﻣ, ﯽﻫﺎﻔﺷ, ﺯﺮﻣ
ﻪﺘﺴﺸﻧﺯﺎﺑ: ﯽﮕﺘﺴﺸﻧﺯﺎﺑ, ﻪﺘﺴﺸﻧﺯﺎﺑ, ﻪﺘﺴﺸﻧﺯﺎﺑ, ﯽﻨﯿﺸﻧﺐﻘﻋ, ﯽﻗﺎﺑ, ﺖﻏﺍﺮﻓ, ﻥﺪﯿﺸﮐﺭﺎﻨﮐ, ﯽﮕﺘﺴﺸﻧﺯﺎﺑﻕﻮﻘﺣ
ﺩﺎﺼﺘﻗﺍ: ﯼﺩﺎﺼﺘﻗﺍ, ﯼﺩﺎﺼﺘﻗﺍﺮﻈﻧﺯﺍ, ﺩﺎﺼﺘﻗﺍﻢﻠﻋ, ﯼﺩﺎﺼﺘﻗﺍﻥﺍﺮﺤﺑ, ﻥﺩﺮﮐﯽﯾﻮﺟﻪﻓﺮﺻ, ﻝﺰﻨﻣﻡﺯﺍﻮﻟ, ﻥﺍﺩﺩﺎﺼﺘﻗﺍ
ﻂﺴﺑ: ﺖﺳﺍﺭ, ﻥﺩﺮﻛﺪﻳﺪﻤﺗ, ﻪﻟﺎﺳﺭ, ﯽﮔﮋﯾﻭ, ﻪﻌﻄﻗ, ﺭﻮﺒﻋ, ﻪﻌﻄﻗ, ﻪﮑﺗ, ﺶﺨﺑ, ﺖﺒﺴﻧ
ﺕﺍﺯﺍﻮﻣﻪﺑ: ﺭﺎﻨﮐﺭﺩ, ﺭﺎﮔﺯﺎﺳ, ﻪﺘﺴﺑﺍﻭ, ﻥﺩﻮﻤﻧﻪﻓﺎﺿﺍ, ﯽﻘﻓﺍ
atelicﻪﺒﻨﺟ: 
ﻥﺍﺮﮔﺖﻟﺎﺣ: ﻥﺍﺮﮔﺖﻟﺎﺣ
ﺕﺍﻭﺍﺮﮐ: ﺏﺎﻘﻋ
ﻍﺮﻣﻢﺨﺗ: 
ﯽﻋﻮﻨﺼﻣ: ﯽﺒﯿﮐﺮﺗ
ﻡﺎﻬﻟﺍ: ﻩﺰﯿﮕﻧﺍ, ﻩﺰﯿﮕﻧﺍ, ﻪﺑﻥﺩﺍﺩﻩﺰﯿﮕﻧﺍ, ﻥﺪﯿﺸﺨﺑﻡﺎﻬﻟﺍ, ﯽﻧﺎﻬﮔﺎﻧﻭﺮﮑﺑﺮﮑﻓ, ﻖﯾﻮﺸﺗ, ءﺎﻘﻟﺍ, ﮏﯾﺮﺤﺗ, ﮎﺮﺤﻣ, ﻩﺰﯿﮕﻧﺍﺩﺎﺠﯾﺍ
ﻦﻤﺿﺭﺩ: ﻥﺎﻣﺰﻤﻫﺭﻮﻄﺑ
ﻥﺍﺮﺤﺑ: ﺮﻄﺧ, ﺩﻮﮐﺭ, ﯼﺭﻭﺍﺩ, ﯼﺭﻭﺍﺩ, ﯼﺭﺍﺮﻄﺿﺍ
ﺏﺩﺍﺎﺑ: ﻊﺿﺍﻮﺗ, ﻩﺩﺮﮐﻞﯿﺼﺤﺗ, ﯽﻗﻼﺧﺍ
ﯽﺑﺍﮎﻮﺧ: ﺮﻬﻣ, ﭖﺎﭼ, ﺱﺎﺴﺣﺍ
ﺭﺎﻫﺎﻧ: ﻪﻧﺎﺤﺒﺻ, ﻡﺎﺷ, ﻪﻋﺭﺰﻣ, ﯽﯾﺍﺬﻏﻩﺪﻋﻭ, ﻥﺩﺭﻮﺧﺭﺎﻫﺎﻧ
ﺩﻮﺟﻭﺎﺑ: ﻪﻨﯿﮐ, ﻪﭼﺮﮔ, ﻪﻜﻨﻳﺍﺎﺑ
ﺯﺍﺪﻧﺍﻢﺸﭼ: ﻮﯾﺭﺎﻨﺳ, ﻑﺍﺮﻃﺍﻂﯿﺤﻣ, ﻂﯿﺤﻣ, ﻪﻨﯿﻣﺯ, ﯽﻄﯿﺤﻣﺖﺴﯾﺯ, ﺮﻬﺷﻪﻣﻮﺣ, ﯽﻌﯿﺒﻃ, ﺯﺍﺪﻧﺍﻢﺸﭼ, ﺯﺍﺪﻧﺍﻢﺸﭼ, ﺯﺍﺪﻧﺍﻢﺸﭼ, ﺯﺍﺪﻧﺍﻢﺸﭼ
ﻪﻧﺍﺪﻨﻣﺮﻨﻫ: ﺮﻨﻫ, ﯼﺮﻨﻫﺮﺛﺍ
ﺩﺎﺤﺗﺍ: ﻪﯾﺩﺎﺤﺗﺍ, ﻪﯾﺩﺎﺤﺗﺍ, ﻑﻼﺘﺋﺍ, ﻦﺘﺨﯿﻣﺁ, ﺖﮐﺭﺎﺸﻣ, ﯽﮑﻠﻓﺕﺭﻮﺻ
ﻦﯾﺮﺘﺸﯿﺑ: ﻦﺘﺧﺎﺳﻪﻨﯿﺸﯿﺑ, ﻁﺮﻔﻣ, ﯽﯾﺎﻬﻧ, ﻦﯾﺮﺘﺸﯿﺑ, ﻪﺑﺖﺒﺴﻧ, ﺮﺑﻎﻟﺎﺑ, ﺯﻭﺎﺠﺗ
ﻩﺰﺠﻌﻣ: ﺐﺠﻌﺗ
ﺲﻣﺰﻠﻓ: ﯼﺰﻧﺮﺑ
ﺹﻮﻠﺧ: ﺖﻔﻋ, ﺖﻗﺩ, ﺖﻗﺩ
ﯼﺭﻮﻬﻤﺟ: ﯽﺳﺍﺮﮐﻮﻣﺩ
ﻦﻔﻠﺗ: ﻦﻔﻠﺗ, ﺭﺎﯿﺳ
ﻕﻼﺷ: ﻪﻤﺴﺗ
ﻦﻫﺍﺮﯿﭘ: ﺕﺮﺷﯽﺗ
ﻥﺩﺮﮐﯽﻓﺮﻌﻣ: ﯽﻓﺮﻌﻣ, ﻪﺋﺍﺭﺍ, ﺩﺎﺠﯾﺍ, ﺯﺎﻏﺁ, ﻪﺋﺍﺭﺍ, ﮎﺭﺍﺪﺗ, ﻪﯿﺻﻮﺗ, ﻪﻌﺟﺍﺮﻣ, ﻖﯾﺭﺰﺗ, ﻪﺋﺍﺭﺍ, ﻞﯾﻮﺤﺗ, ﺪﺸﮐﯽﻣﺮﯾﻮﺼﺗﻪﺑ, ﻥﺪﯿﺸﮐﺮﯾﻮﺼﺗ, ﺱﺎﻤﺗ, ﻥﺩﺍﺩﺭﺍﺮﻗ
ﻪﭘﺎﻧﺎﮐ: ﯽﺘﺣﺍﺭﯽﻟﺪﻨﺻ
ﺖﺸﮔﺮﺑﻭﺖﻓﺭ: ﻥﺩﺮﮐﮎﺎﭘ, ﻦﮑﺳﺍ
ﺩﺯﺩ: 
ﻝﺎﻧﺎﮐ: ﯽﺸﮐﻩﺯ
ﺕﺎﺣﻼﺻﺍ: ﺩﻮﺒﻬﺑ, ﺡﻼﺻﺍ, ﯽﻠﻣﺎﮑﺗﺮﯿﺳ, ﺡﻼﺻﺍ, ﺡﻼﺻﺍ, ﻥﺩﻮﻟﺎﭘ, ﺮﻈﻧﺪﯾﺪﺠﺗ, ﯽﻧﺎﺳﺭﺯﻭﺭﻪﺑ
ﯽﮕﻨﺸﺗ: ﻪﻨﺸﺗ
ﺰﯿﻣﺁﺪﯾﺪﻬﺗ: ﺪﯾﺪﻬﺗ, ﻥﺩﺮﮐﺪﯾﺪﻬﺗ, ﮎﺎﻨﺳﺮﺗ
ﺖﺳﺩﻒﻛ: 
ﻥﺩﺮﻛﻖﻳﻮﺸﺗ: ﻖﯾﻮﺸﺗ, ﻥﺪﯿﺸﺨﺑﻡﺎﻬﻟﺍ, ﻮﯾﺍﺭﺩ, ﺭﺎﺸﻓ, ﺞﯾﻭﺮﺗ, ﻩﺰﯿﮕﻧﺍ, ﻢﯿﻫﺍﻮﺧﯽﻣ, ﻥﺩﺮﮐﻖﯾﻮﺸﺗ
ﻮﮔﺪﻨﻠﺑ: ﯼﻮﮕﻨﺨﺳ, ﺱﺭﺪﻣ
ﻪﻧﺎﺘﺳﺁ: ﺩﻭﺭﻭ, ﺵﺮﯾﺬﭘ
ﻥﺩﺮﮐﺭﺍﺩﺍﻭ: ﻭﺮﻫﺍﺭ, ﻢﯿﻫﺍﻮﺧﯽﻣ, ﺩﻮﺷﯽﻣﺐﺒﺳ, ﻥﺩﺍﺩﺭﺍﺪﺸﻫ, ﻥﺩﺮﮐﮏﯾﺮﺤﺗ, ﺖﻟﺎﺣ, ﻥﺩﺮﮐﺍﻮﻏﺍ, ﻥﺪﯿﺸﮐﻥﻭﺮﯿﺑ, ﻥﺩﺭﻮﺧﺲﯿﺧ, ﻖﺘﺸﻣ, ءﺎﻘﻟﺍ, ﻥﺩﻮﻤﻧﻪﻓﺎﺿﺍ
ﻪﺘﻓﺭﻭﻪﺘﺴﺷ: ﺐﺗﺮﻣ, ﺰﯿﻤﺗ, ﺏﻮﺧ, ﺰﯿﮕﻧﺍﺖﻔﮕﺷ, ﯽﻨﻨﻔﺗ, ﯽﯾﺎﺒﯾﺯ, ﻪﻧﺎﻔﯾﺮﻇ
ﻪﺴﻠﺟ: ﯼﺭﺎﮐﻪﺴﻠﺟ, ﺲﻧﺍﺮﻔﻨﮐ, ﯽﻠﯿﺼﺤﺗﻡﺮﺗ
ﻪﺠﻨﮑﺷ: ﻥﺪﯿﺸﮐﺞﻧﺭ, ﻩﻭﺪﻧﺍﻭﻢﻏ, ﺖﻧﻮﺸﺧ, ﻥﺩﺮﮐﺭﺍﺩﻪﻧﺍﺪﻧﺩ, ﺭﻭﺎﺸﻣ
ﺖﺑﻮﻃﺭ: ﮎﺎﺧ, ﺏﻮﻃﺮﻣ, ﻡﺮﮔ
ﺮﻓﺎﺴﻣ: ﻥﺎﻤﻬﻣ, ﺮﻓﺎﺴﻣ, ﺖﺴﯾﺭﻮﺗ, ﺮﻓﺎﺴﻣ, ﺮﻔﺳ, ﻦﺘﻓﺭﺮﻔﺳ
ﻪﻧﺎﺧﺭﺎﮐ: ﻪﻧﺎﺧﺭﺎﮐ, ﺪﯿﻟﻮﺗ, ﻩﺎﯿﮔ, ﺏﺁﺮﻴﺷ, ﯼﺯﺎﺳﻮﺠﺑﺍ, ﻡﺪﻨﮔﻪﺷﻮﺧ
ﻪﺸﻘﻧ: ﺕﺭﺎﮐ, ﺭﺍﺩﻮﻤﻧ, ﻑﺍﺮﮔ, ﻪﯾﺍﺮﮐ, ﻂﯿﻠﺑ, ﻞﺒﻤﺳ, ﻥﻮﮑﯾﺁ, ﯼﺮﺒﻫﺭ
ﺎﻤﻨﺑﺁ: ﻊﺒﻨﻣ, ﺭﺎﺸﺑﺍ, ﺮﺴﮐ
ﻪﻘﯾ: ﻪﻃﺎﺣﺍ, ﻪﻘﻄﻨﻣ
ﻥﺩﺮﮐﻦﯾﺰﮕﯾﺎﺟ: ﯽﻨﯾﺰﮕﯾﺎﺟ, ﻥﺩﺮﮐﺎﺠﺑﺎﺟ, ﯽﮐﺪﯾ, ﻦﯾﺰﮕﯾﺎﺟ, ﻦﯿﺸﻧﺎﺟ, ﯽﻨﯾﺰﮕﯾﺎﺟ, ﯽﯾﺎﺟﻪﺑﺎﺟ, ﻥﺩﺍﺩﺮﯿﯿﻐﺗ, ﺕﻭﺎﻔﺘﻣ, ﺡﻼﺻﺍ, ﺮﯾﺯ, ﺮﯿﯿﻐﺗ, ﭻﯿﺋﻮﺳ, ﻥﺩﺮﺑﻦﯿﺑﺯﺍ, ﻕﺎﺒﻄﻧﺍ, ﻥﺩﺮﮐﻥﺍﺮﺒﺟ
ﺍﺪﻤﻋ: ﯼﺪﻤﻋ, ﻪﻧﺎﻫﺎﮔﺁ, ﻊﻠﻄﻣ, ﻪﻧﺎﻫﺎﮔﺁ, ﺪﻨﻣﺩﻮﺳ, ﯽﻓﺩﺎﺼﺗ
ﻮﺠﺑﺁ: ﺖﻨﯾﺎﭘ
ﯽﻠﻤﺨﻣ: 
ﺖﺒﺜﻣ: ﺖﺒﺜﻣ, ﻪﻧﻻﺎﻌﻓ, ﻒﻄﻟ, ﻒﻄﻟ, ﻼﻣﺎﮐ, ﻼﻣﺎﮐ
ﻦﯿﻣﺯﻪﺑﺫﺎﺟ: ﻪﺑﺫﺎﺟ, ﻥﺪﺷﻪﻟ, ﯼﺪﺟﺭﻮﻃﻪﺑ
ﻪﺒﻄﺧ: ﻥﺩﺮﮐﺖﺤﯿﺼﻧ, ﻦﺨﺳ, ﯽﻧﺍﺮﻨﺨﺳ
ﮏﯾﺮﺷ: ﺭﺎﮑﻤﻫ, ﻪﺘﺴﺑﺍﻭ, ﺮﺘﺧﺩﺖﺳﻭﺩ, ﺮﺴﭘﺖﺳﻭﺩ, ﺖﻔﺟ, ﺮﺴﻤﻫ, ﺞﯾﺍﺭ, ﮎﺮﺘﺸﻣ, ﻥﺍﺭﺍﺪﻣﺎﻬﺳ, ﺭﺎﮑﻤﻫ, ﺮﺴﻤﻫ
ﻩﺩﺎﻔﺘﺳﺍﻮﺳ: ﻩﺎﺒﺘﺷﺍ, ﻩﺎﺒﺘﺷﺍ, ﯽﺘﻨﻌﻟ
ﻪﻠﮔ: ﻩﻭﺮﮔ, ﻪﻠﮔ, ﻡﺎﺣﺩﺯﺍ, ﻢﻬﻣﯽﻠﯿﺧﺭﺍﺩﻪﯾﺎﻣﺮﺳ
ﻩﺩﺰﯿﺳ: ﯽﺳ
ﻪﯿﺟﻮﺗ: ﻢﮑﺣ, ﻥﺩﺮﮐﻪﺑﻻ, ﻊﻓﺍﺪﻣ, ﻪﯿﺟﻮﺗ, ﻩﺪﺷﻞﯾﺪﻌﺗ, ﻉﻭﺮﺸﻣ, ﻥﺩﺮﮐﻢﯿﻈﻨﺗ
ﯽﻄﺧﻪﺨﺴﻧ: ﻪﺤﯾﻻ, ﻂﺧ, ﯽﮐﺎﺷ
ﻪﻌﻤﺟ: ﻩﺮﻘﻧ, ﻩﺮﻫﺯﻩﺭﺎﯿﺳ
ﻮﻣﻢﻠﻗ: ﻪﻧﺎﺷ
ﺩﻮﻠﻧﺍﺩ: ﯼﺭﺍﺬﮔﺭﺎﺑ
ﻡﺮﮐﮓﻧﺭ: ﯽﻨﺘﺴﺑ
ﻻﻮﯿﻫ: ﻝﻮﻏ, ﻻﻮﯿﻫ
ﻩﺩﺯﺦﯾ: ﯽﮔﺩﺯﺦﯾ
ﻥﺍﺪﻠﮔ: ﻪﺑﺎﺗﯽﻫﺎﻣ, ﻥﺍﺪﻠﮔ, ﻪﺸﯿﺷ, ﻑﺮﻇ, ﺯﺎﮔﻕﺎﺟﺍ, ﻪﺑﻥﺩﺯﺖﺳﺩﻪﺘﺴﻫﺍ, ﯽﺘﺸﮐ
ﺞﻧﺮﺑ: 
ﺭﺎﺘﻓﺭ: ﺭﺎﺘﻓﺭ, ﯼﺭﺎﺘﻓﺭ, ﺖﯿﺼﺨﺷ, ﺕﺩﺎﻋ, ﻪﺼﺨﺸﻣ, ﺶﯾﺍﺮﮔ, ﺭﺎﺘﻓﺭ
ﻪﮑﺳ: ﻝﻮﭘﺪﺣﺍﻭ, ﯽﻨﭘ
ﺪﻣﺍﺭﺩ: ﺪﻣﺁﺭﺩ
ﻥﺩﺮﮐﺭﺍﺮﺻﺍ: ﺪﻨﻠﺑﯼﺍﺪﺻﺎﺑ, ﺭﺎﺸﻓ, ﺎﻋﺩﺍ, ﻂﺧﺭﺍﺩﻂﺧﺮﯾﺯ, ﺪﯿﮐﺎﺗ, ﻪﻣﺍﺩﺍ, ﺭﺍﺮﺻﺍ, ﺯﺎﯿﻧ, ﺪﯿﮐﺎﺗ, ﺶﺸﮐ, ﺪﯿﮐﺎﺗ, ﺚﺤﺑﻭﺮﺟ, ﺎﻋﺩﺍ
ﺵﺮﭘ: 
ﺐﯿﺳ: ﯽﻫﺍﻮﺧﺭﺬﻋ, ﻥﺩﺮﮐﯽﻫﺍﻮﺧﺭﺬﻋ
ﻮﮕﺘﻔﮔﻭﺚﺤﺑ: ﻪﺜﺣﺎﺒﻣ, ﻩﺮﮐﺍﺬﻣ, ﺚﺤﺑﻭﺮﺟ, ﻁﻮﻠﺨﻣ, ﺪﯿﻨﮐﺖﺒﺤﺻ
ﻪﻨﯿﻣﺯﺲﭘ: 
ﻥﺩﺮﮐﯽﺴﯾﻮﻧﻭﺭ: ﻕﺎﺒﻄﻧﺍ, ﯽﺴﯾﻮﻧﺯﺎﺑ, ﯼﺯﺎﺳﻪﯿﺒﺷ
ﯽﻣﺮﮔﺮﺳﻭ​​ﺢﯾﺮﻔﺗ: ﺢﯾﺮﻔﺗ, ﻩﺪﻨﻨﮐﻡﺮﮔﺮﺳ, ﺖﻏﺍﺮﻓ, ﻩﺪﻨﻨﮐﻡﺮﮔﺮﺳ, ﻥﺩﺮﮐﻡﺮﮔﺮﺳ, ﯽﻣﺮﮔﺮﺳ, ﯽﻣﺮﮔﺮﺳ, ﺏﺎﺼﻋﺍﺩﺪﻤﺗ, ﻥﺩﺮﮐﺮﯿﺤﺘﻣﻭﺕﺎﻣ, ﻱﺯﺍﻮﻧﻥﺎﻤﻬﻣ
ﺱﻭﺮﯾﻭ: 
ﻪﻧﺎﮔﻪﭽﺑ: ﮓﻧﺍﺪﺸﺷ
ﺩﺎﺸﮔﻭﺪﻨﻠﺑﺱﺎﺒﻟ: ﮎﺎﺷﻮﭘ, ﺱﺎﺒﻟ, ﺐﺷﺱﺎﺒﻟ, ﻡﺮﻓﺱﺎﺒﻟ, ﮒﺮﺑﻭﺯﺎﺳ, ﯽﺘﺧﺭﺎﺟ
ﻥﺩﺮﮐﺲﮑﻌﻨﻣ: ﺮﮑﻔﺗ, ﻪﺒﻗﺍﺮﻣ, ﻥﺩﺮﮐﺮﮑﻔﺗ, ﻦﺘﺧﺎﺳﺭﺎﮑﺷﺁ, ﺡﺮﻃ, ﺪﺸﮐﯽﻣﺮﯾﻮﺼﺗﻪﺑ
ﻞﯾﺪﺒﺗ: ﻥﺩﺍﺩﺮﯿﯿﻐﺗ, ﻞﯾﺪﺒﺗ, ﭻﯿﺋﻮﺳ, ﺶﻬﺟ, ﻝﺎﻘﺘﻧﺍ, ﯽﻧﻮﮔﺮﮔﺩ
ﯽﻠﮐﺡﺮﻃ: ﻞﯾﺎﻓﻭﺮﭘ, ﻞﺻﺎﻓﺪﺣ, ﻪﺻﻼﺧ, ﺡﺮﻃ, ﻦﺘﺷﺍﺬﮔﺽﺮﻌﻣﺭﺩ, ﯽﻠﮐﺪﯾﺩ, ﺲﯾﻮﻧﺶﯿﭘ
ﺍﺮﭘﺍ: 
ﺞﻧﺭﺁ: ﺏﻼﻗ
ﯽﮕﺘﺴﺒﻟﺩ: ﻪﻤﯿﻤﺿ, ﻝﺎﺼﺗﺍ, ﻪﻠﺻﻭ, ﻥﺩﺍﺩﻁﺎﺒﺗﺭﺍ, ﻝﺎﺼﺗﺍ
ﯼﺯﺎﺳﺯﺎﺑ: ﻢﯿﻣﺮﺗ, ﺩﻮﺒﻬﺑ, ﯼﺯﺎﺳﺯﺎﺑ, ﺡﻼﺻﺍ, ﺡﻼﺻﺍ, ﺡﻼﺻﺍ
ﺖﺸﻣ: ﺖﺸﻣ, ﮓﻨﭼ
ﮎﻮﮑﺸﻣ: ﻦﻇءﻮﺳ, ﻥﻮﻨﻈﻣ
ﺱﺪﻘﻣﺏﺎﺘﮐ: ﺱﺪﻘﻣﺏﺎﺘﮐ, ﻑﻭﺮﺣﮏﺒﺳ, ﻂﺧ
ﻝﺍﺩﻮﮔ: ﺥﺍﺭﻮﺳ, ﯼﺭﺎﻔﺣ, ﺮﺨﺘﺳﺍ, ﻕﺪﻨﺧ, ﺭﻮﺑ
ﻝﻼﺘﺧﺍ: ﺝﺮﻣﻭﺝﺮﻫ, ﺝﺮﻣﻭﺝﺮﻫ, ﻡﺍﺭﺁﺎﻧ, ﻝﻼﺘﺧﺍ, ﯽﮕﺘﺨﯾﺭﻢﻬﺑ, ﻩﺪﻨﻨﻛﺖﺣﺍﺭﺎﻧ, ﻞﺧﺍﺪﺗ, ﺎﻄﺧ, ﻊﻧﺎﻣ
ﺪﯿﺠﻤﺗﻭﻖﯾﻮﺸﺗ: ﻥﺩﺯﻒﮐ, ﻥﺩﺯﻒﮐ, ﺐﯾﻮﺼﺗ
ﯽﯾﺎﺗﻭﺩ: ﯽﯾﺎﺗﻭﺩ
ﻪﻌﻣﻮﺻ: ﻪﻌﻣﻮﺻ
ﻥﺎﮑﯿﭘ: 
ﻞﯾﺎﻤﺗ: ﻝﻮﺌﺴﻣ, ﻻﻮﻤﻌﻣ, ﻝﻮﻤﻌﻣﺭﻮﻃﻪﺑ, ﺖﻬﺟ, ﻥﺍﻭﺍﺮﻓ, ﻞﻣﺎﺷ, ﻉﺎﻓﺩ, ﺪﻧﻭﺭ
ﻩﺪﺷﺖﺳﺭﺩﻪﻧﺍﺩﺎﺘﺳﺍ: ﻖﯿﻗﺩ, ﻥﺩﺮﻛﻒﻳﺮﻌﺗ, ﻥﺩﺮﮐﺢﯾﺮﺼﺗ, ﻪﻌﺳﻮﺗ, ﺞﻧﺮﻐﺑ, ﺮﯾﻭﺰﺗﻭﻪﻠﯿﺣﯼﻭﺭ, ﻥﺩﺮﮐﺭﺎﮐ
ﯼﺭﺍﺩﺎﻓﻭ: ﺭﺎﮐﺍﺪﻓ, ﺭﺍﺩﺎﻓﻭ, ﺩﺎﻤﺘﻋﺍ, ﻪﻧﺎﻗﺩﺎﺻ, ﻪﻧﺎﻗﺩﺎﺻ, ﯼﺩﺎﻤﺘﻋﺍﯽﺑ, ﺭﺎﺒﺘﻋﺍ, ﻥﺎﻤﯾﺍ, ﺭﻭﺎﺑ
ﻩﺯﺮﻟ: ﺯﺮﻟ, ﺵﺎﻌﺗﺭﺍ
ﺪﯿﻌﺒﺗ: ﻦﺘﺨﯾﺭﻥﻭﺮﯿﺑ, ﺭﻮﺸﮐﺯﺍﺝﺭﺎﺧ, ﻩﺎﻨﭘ
ﯽﮑﯿﻧﺎﮑﻣ: ﻩﺎﮕﺘﺳﺩ, ﮏﯿﻧﺎﮑﻣ, ﮏﯿﻧﺎﮑﻣ, ﺱﺪﻨﻬﻣ
ﺖﯿﻘﻓﻮﻣﺎﺑ: ﻪﻧﺎﻔﯾﺮﻇ, ﻥﺪﺷﻖﻓﻮﻣ, ﻖﻓﻮﻣﺎﻧ, ﻪﺠﯿﺘﻧ
ﻡﺍﺩ: ﮓﻨﭼ, ﻡﻮﮑﺤﻣ
ﮏﯿﮐ: ﯽﻨﯾﺮﯿﺷ, ﯼﺎﭘ, ﯽﻨﯾﺮﯿﺷ, ﺮﯿﻤﺧ
ﺎﻗﺁ: ﯼﺎﻗﺁ, ﺎﻗﺁ, ﺪﻧﻭﺍﺪﺧ, ﺎﻗﺁ
ﻎﯾﺭﺩ: ﮓﻧﺭﺩ, ﻥﺩﺯﺭﺩ, ﺩﺎﯾﺯﺪﺷﻭﺪﻣﺍ, ﺲﻧﺎﮐﺮﻓ, ﺭﻭﺎﻨﺷ
ﻩﺪﻔﻫ: 
ﻪﻧﺎﻧﺯ: ﻪﻧﺎﻧﺯ, ﻥﺯ, ﻢﻧﺎﺧ, ﻒﯾﺮﻇ
ﻞﺴﻋ: 
ﻁﺮﺷ: ﻁﺮﺷ, ﺖﺒﺴﻧ, ﻩﺩﻮﺗ, ﻢﻬﺳ, ﺮﺴﮐ, ﻢﻬﺳ, ﺭﺎﻤﻗ, ﻥﺍﺭﺍﺪﻣﺎﻬﺳ
ﺮﺟﺁ: ﯽﺷﺎﮐ
ﻪﻧﺎﺴﻓﺍ: ﻩﺭﻮﻄﺳﺍ
ﻥﺩﺮﮐﻭﺭﺩ: ﻝﻮﺼﺤﻣ, ﯽﻋﺍﺭﺯﺕﻻﻮﺼﺤﻣ
ﻕﺎﺟﺍ: ﺯﺎﮔﻕﺎﺟﺍ, ﮓﻨﺳﻪﺘﺨﺗ, ﺮﻓ, ﯼﺭﺎﺨﺑ
ﯽﺷﺭﻮﺷ: ﺵﺭﻮﺷ, ﺵﺭﻮﺷ, ﺎﺗﺩﻮﮐ
ﻩﺩﺎﺘﻓﺍﺪﻣﺯﺍ: ﯽﻧﺎﺘﺳﺎﺑ
ﻡﺭﻮﺗ: ﻥﺩﺮﮐﺩﺎﺑ, ﻡﺭﻮﺘﻣ, ﻡﺭﻮﺗ, ﻡﺭﻭ, ﻥﺩﺮﮐﮒﺭﺰﺑ
ﻥﺩﺮﮐﺮﺘﻬﺑ: ﻥﺩﺮﺑﻻﺎﺑ, ﻥﺩﺮﺑﻻﺎﺑ, ﺖﺑﺎﺛ, ﻥﺎﻣﺭﺩ, ﻥﺎﻣﺭﺩ, ﺎﻔﺷ, ﺩﻮﺒﻬﺑ, ﻥﺩﺮﮐﻪﻓﺎﺿﺍ, ﻥﺩﺮﮐﻪﻓﺎﺿﺍ, ﻥﺩﺭﻭﺍﺭﺩﺵﺩﺮﮔﻪﺑ
ﻪﺳﺎﮐ: 
ﻩﺮﯿﺧ: ﺖﺑﺎﺛ, ﻥﺩﺮﮐﻩﺎﮕﻧﻝﺯﻝﺯ
ﯽﺘﻌﻨﺻ: ﺪﯿﻟﻮﺗ, ﯼﺯﺎﺳﯽﺘﻌﻨﺻ, ﺖﻌﻨﺻ
ﺲﺳ: ﺏﺭ, ﯼﺪﻨﺑﻢﺧﺯﺭﺍﻮﻧ
ﻉﻮﺿﻮﻣ: ﻉﻮﺿﻮﻣ, ﻒﯿﺗﻮﻣ, ﻉﻮﺿﻮﻣ, ﻪﻟﺎﺴﻣ, ﻩﺰﯿﮕﻧﺍ
ﻪﻧﺍﺪﻫﺍﺯ: 
ﺮﯾﺪﻣ: ﺮﺷﺎﺒﻣ, ﺲﯿﺋﺭ, ﺲﻴﺋﺭ, ﺮﯾﺪﻣ, ﺮﯾﺪﻣ, ﺮﯾﺪﻣ, ﺮﺒﻫﺭ, ﯽﯾﺍﺮﺟﺍ
ﻥﺪﯿﺸﮐ: ﻢﺳﺭ, ﻥﺪﯿﺸﮐ, ﻞﻘﻧﻭﻞﻤﺣ, ﻥﺪﯿﺸﮐﺭﺎﻨﮐ, ﻝﺎﻄﺑﺍ, ﯽﭽﯿﻗ, ﺶﺸﮐ, ﻮﺸﮐ, ﻭﺭﺍﺩ
ﺮﮐﻩﻭﺮﮔ: ﻮﯾﺍﺭﺩ
ﯽﻘﻄﻨﻣ: ﻩﺪﺷﻞﯾﺪﻌﺗ, ﻖﻄﻨﻣ, ﯽﻘﻄﻨﻣ, ﻞﯿﻟﺩﯽﺑ, ﻝﻮﻘﻌﻣ, ﯽﻘﻄﻨﻣ, ﻝﻮﻘﻌﻣ, ﺮﻫﺎﻇ
ﺵﺯﺍﺩﺮﭘﻝﺎﺣﺭﺩ: ﺶﯾﺍﺮﯾﻭ, ﻩﺪﻧﺯﺍﺩﺮﭘ, ﺪﻨﯾﺁﺮﻓ, ﯼﺎﻫﺪﻨﯾﺁﺮﻓ, ﺵﻭﺭ
ﮒﺮﮔ: 
ﺵﺮﻓ: ﻪﭽﯿﻟﺎﻗ
ﺖﻣﺪﻗ: ﯽﻧﺎﺘﺳﺎﺑ, ﺮﺼﻋ
ﺭﻭﺭﺎﺑ: ﻪﯾﺭﻮﻓﻞﯾﺪﺒﺗ
ﺕﻮﺳ: ﺕﻮﻠﻓ
ﺮﯿﻨﭘ: 
ﺶﯿﻧ: ﻥﺩﺮﮐﻪﮑﺗ, ﻥﺩﺮﻛﻚﺣ, ﺶﯿﻧ, ﻪﻤﻘﻟ, ﻪﻋﺮﺟ, ﻪﻣﺪﺻ, ﺖﯿﻣﻭﺮﺤﻣ
ﻊﻣﺎﺟﯼﺎﺴﯿﻠﮐ: 
ﻥﺩﻮﺑﻥﺍﺩﺮﮔﺮﺳ: ﻥﺩﺯﻡﺪﻗ, ﺕﺮﺟﺎﻬﻣ, ﯼﻭﺭﻩﺩﺎﯿﭘ, ﮎﺮﺗ, ﺝﺎﺟﻮﻋﺍ
ﯽﯾﺎﯾﺭﺩﯼﻭﺮﯿﻧ: ﯽﯾﺎﯾﺭﺩ, ﻥﺎﮔﻭﺎﻧ
ﮏﺳﺎﻣ: ﻮﻠﺟ, ﻡﺮﮐ
ﺩﺍﺪﻣ: ﻢﻠﻗ
ﯼﺰﺒﺳ: ﺭﺍﻮﺧﻩﺎﯿﮔ
ﺭﺍﻮﻠﺷ: ﺭﺍﻮﻠﺷ, ﺭﺍﻮﻠﺷ
ﺩﺎﺴﻓ: ﯽﯾﺍﻮﺳﺭ, ﯽﮔﺩﻮﻟﺍ
ﻪﻨﯿﺑﺎﮐ: ﻪﺠﻨﮔ, ﺱﺎﺒﻟﺪﻤﮐ, ﯽﺘﺧﺭﺎﺟ, ﺖﻟﺍﻮﺗ
ﭖﻮﺳ: 
ﺡﺍﺮﺟ: ﻲﺣﺍﺮﺟﻞﻤﻋ, ﯽﺣﺍﺮﺟ, ﺩﺮﮑﻠﻤﻋ, ﺮﮕﻠﯿﻠﺤﺗ
ﯼﺮﻤﺘﺴﻣ: ﯽﻨﯾﺰﮕﯾﺎﺟ, ﻦﯿﺸﻧﺎﺟ, ﻥﺍﺮﺒﺟ, ﻝﺪﺑ, ﺺﯿﺼﺨﺗ, ﻪﻤﯿﻤﺿ
ﺱﻮﺳﺎﺟ: ﮎﺭﺩ
ﺍﻭﺮﭘﯽﺑ: ﻁﺎﯿﺘﺣﺍﯽﺑ, ﻢﻫﺮﺑﻭﻢﻫﺭﺩ, ﯼﺭﺎﮕﻧﺍﻞﻬﺳ, ﻞﯿﻟﺩﯽﺑ
ﺱﺎﺳﺍﯽﺑﺕﺎﻌﯾﺎﺷ: ﻪﻌﯾﺎﺷ, ﻪﻌﯾﺎﺷ, ﻥﺩﺯﭗﮔ
ﯼﺎﻫﻢﺘﺴﯿﺳ: ﻢﺘﺴﯿﺳ
ﺰﻣﺭ: 
ﻩﺪﯿﮑﭼ: ﻪﺻﻼﺧ, ﺱﻭﺭﺩﻞﺼﻓﺮﺳ
ﻪﺠﻬﻟ: ﻆﻔﻠﺗ, ﻆﻔﻠﺗ, ﺶﯾﻮﮔ, ﺪﯿﮐﺎﺗ
ﻪﻧﺎﺼﻟﺎﺧ: ﻪﻧﺎﻗﺩﺎﺻ, ﯼﺪﺟﺭﻮﻃﻪﺑ, ﻕﺩﺎﺻ, ﻪﻧﺎﻗﺩﺎﺻ
ﺪﯿﯾﺎﺗ: ﺫﺎﺨﺗﺍ, ﻥﺩﺍﺩﻩﺯﺎﺟﺍ, ﺐﯾﻮﺼﺗ, ﻥﺩﺮﻛﺪﻴﻳﺎﺗ, ﺪﯿﯾﺄﺗ, ﺖﯾﺎﺿﺭ, ﺐﯾﻮﺼﺗ, ﺪﯿﯾﺎﺗ, ﺪﯿﻨﮐﺪﯿﯾﺎﺗ, ﻥﺩﺮﮐﺎﻄﻋﺍ, ﺏﻮﻠﻄﻣ, ﺐﯾﻮﺼﺗ
ﯼﺭﺎﻤﻌﻣ: ﺭﺎﺘﺧﺎﺳ, ﺖﺧﺎﺳ, ﺖﻓﺎﺑ
ﮎﺮﺗ: ﻑﺎﮑﺷ, ﻩﺩﺭﻮﺧﮎﺮﺗ, ﮎﺮﺗ, ﮎﺮﺗ, ﯽﮕﺘﺴﮑﺷ
ﻭﺭﻩﺩﺎﻴﭘ: ﻥﺩﺮﮐﺩﻭﺪﺤﻣ, ﺮﯿﻗ, ﻞﮔﻭﻦﺠﻟ, ﻭﺭﻩﺩﺎﯿﭘ, ﻩﺎﮕﺷﺩﺮﮔ, ﯼﺪﻨﺑﻪﺘﺴﺑ
ﻊﻃﺎﻗ: ﯽﺗﺎﯿﺣ, ﯽﺗﺎﯿﺣ, ﻥﺪﺷﻦﯿﯿﻌﺗ, ﻦﺘﻓﺮﮔﻢﻴﻤﺼﺗ, ﻩﺪﻨﻨﮐﺭﺎﻬﻇﺍ, ﻥﺩﺍﺩﺹﺎﺼﺘﺧﺍ, ﻥﺩﺮﻛﺺﺨﺸﻣ, ﯽﯾﺎﻬﻧ, ﯽﻧﺍﺮﺤﺑ, ﺎﺗﺩﻮﮐ
ﯽﻔﻨﻣ: ﺮﻀﻣ, ﺭﺎﮑﻧﺍ, ﯽﻔﻧ, ﻥﺩﺮﮐﯽﺜﻨﺧ
ﻩﺭﺍﻮﻨﺸﺟ: ﺕﺮﺴﻨﮐ, ﯽﺴﯿﻋﯽﻠﺠﺗﻭﺭﻮﻬﻇ, ﻦﺸﺟ
ﺖﻧﺎﯿﺧ: 
ﯽﭼﺭﺎﮑﺷ: ﻩﺪﻧﺭﺩ
ﺭﺎﻣ: ﻩﺪﻧﺰﺧ
ﯼﺮﺗﺎﺑ: 
ﻩﺎﮔﺍﺭﺎﮐ: ﺮﺴﮐ, ﻖﻘﺤﻣ
ﺎﻨﺷ: ﺎﻨﺷ
ﻪﻣﺎﻧﺖﻛﺎﭘ: ﯽﮕﻧﻮﮕﭼ, ﺪﯿﻗ
ﺭﺎﮕﯿﺳ: ﻥﺪﯿﺸﮐﺭﺎﮕﯿﺳ, ﺯﺮﻫﻒﻠﻋ
ﺭﻮﺗﻮﻣ: ﻞﯿﺒﻣﻮﺗﺍ, ﺭﻮﺗﻮﻣ, ﻩﺰﯿﮕﻧﺍ, ﺭﻮﺗﻮﻣ, ﺖﻠﻜﻴﺳﺭﻮﺗﻮﻣ
ﺐﻠﻃﻭﺍﺩ: ﻥﺩﺍﺩﺹﺎﺼﺘﺧﺍ, ﻪﻧﺎﺒﻠﻃﻭﺍﺩ, ﻪﻗﺪﺻ
ﻞﻤﻌﻟﺍﺲﻜﻋ: ﯽﺸﻨﮐﺍﻭ, ﺦﺳﺎﭘ, ﺦﺳﺎﭘ, ﻥﺩﺍﺩﻥﺎﺸﻧﺶﻨﮐﺍﻭ, ﺩﺭﻮﺧﺯﺎﺑ, ﻪﺋﺍﺭﺍ, ﺭﻮﺘﮐﺍﺭ
ﻥﺍﺪﻤﭼ: ﻪﺷﻮﺗ, ﺭﺎﺑ, ﻪﻨﺗ, ﻥﺍﺪﻤﭼ, ﯽﻘﻄﻨﻣ
ﺍﻮﻨﺷﺎﻧ: 
ﻩﻮﯿﻤﺑﺁ: ﻥﺩﺮﮐﺝﺍﺮﺨﺘﺳﺍ
ﯽﺴﻨﺟ: ﯽﺴﻨﺟﻁﺎﺒﺗﺭﺍ, ﯽﺴﻨﺟﺕﻼﯾﺎﻤﺗ
ﺱﺎﻤﻟﺍ: ﺮﻫﻮﮔ
ﮎﺍﻭﮋﭘ: 
ﺖﯾﻮﻫ: ﯽﯾﺎﺳﺎﻨﺷ, ﺖﯾﻮﻫﺺﯿﺨﺸﺗ, ﻦﯾﺩﺎﻤﻧ, ﯽﯾﺎﻨﺷﺁ, ﯽﯾﺎﺳﺎﻨﺷﻞﺑﺎﻗ, ﻦﺘﺧﺎﻨﺷﺖﯿﻤﺳﺭﻪﺑ
ﺮﯿﻔﺳ: ﻝﻮﺳﺭ, ﺕﺎﻤﻠﭙﯾﺩ, ﺯﺎﺳﻭﺖﺧﻮﺳ
ﻞﺒﻨﺗ: ﺪﺳﺎﻓ
momentaneﻪﺒﻨﺟ: 
ﯽﮔﺪﻧﺍﺭ: ﺩﺮﮑﻠﻤﻋ, ﻑﺍﺮﺤﻧﺍ, ﺶﯾﺍﺮﮔ, ﺪﻧﻭﺭ, ﻥﺎﯾﺮﺟ, ﺖﻟﺎﺣ
ﯽﻟﺎﯿﺧ: ﯽﻨﻨﻔﺗ, ﻦﮐﺭﻮﺼﺗ, ﻞﯿﺨﺗ, ﻥﺎﺘﺳﺍﺩ, ﯼﺰﺘﻧﺎﻓ, ﯽﻨﻫﺫ
ﻪﻌﺷﺍ: ﻮﺗﺮﭘ, ﻭﺮﻫﺍﺭ, ﻉﺎﻌﺷ, ﻕﻭﺪﻨﺻ
ﯼﺩﺭﻮﻧﮓﻨﺳ: ﻥﺪﻣﺁﻻﺎﺑ, ﻩﺎﯿﮔ, ﻕﺎﭼﻭﻪﺘﺨﻠﺷ, ﻦﺘﻓﺭﻻﺎﺑ, ﻥﺪﯾﺰﺧ
ﺮﻫﻮﺟ: ﺮﻧﻮﺗ
ﻲﻧﺪﻧﺎﻣﺩﺎﻳﻪﺑ: ﻪﺘﺴﺟﺮﺑ
ﺍﺪﺻﻭﺮﺳﺮﭘ: ﺍﺪﺻﻭﺮﺳ, ﺩﺎﯾﺮﻓ, ﺪﻨﻠﺑﯼﺍﺪﺻﺎﺑ, ﺪﻨﻠﺑﯼﺍﺪﺻﺎﺑ
ﺎﻨﺳﺲﻠﺠﻣ: ﺲﻠﺠﻣ
ﻞﻘﻧﻭﻞﻤﺣ: ﻪﮑﺴﻟﺎﮐ, ﻞﻘﻧﻭﻞﻤﺣ, ﻞﻘﻧﻭﻞﻤﺣ, ﮏﯿﻓﺍﺮﺗ, ﻞﺗﺎﺷ, ﻝﺎﻘﺘﻧﺍ, ﻩﺭﺎﻌﺘﺳﺍ, ﻝﺎﻘﺘﻧﺍ
ﺕﻮﺑﺎﺗ: ﻪﻟﺎﺳﺭ
ﻊﻠﺑ: ﻪﻋﺮﺟ, ﺭﺎﯿﺴﺑ
ﻦﺘﺧﺎﺳﺎﻫﺭ: ﻥﺩﺮﮐﻝﺎﺒﻧﺩ, ﻥﺩﺮﮐﻊﻧﺎﻗ, ﻥﺩﺮﮐﺐﯿﮐﺮﺗ, ﻥﺩﺍﺩﺭﺍﺮﻗ, ﺵﺮﺘﺴﮔ
ﯼﺯﺭﻭﺎﺸﮐ: ﯼﺯﺭﻭﺎﺸﮐ, ﯼﺯﺭﻭﺎﺸﮐ, ﻪﻋﺭﺰﻣ
ﻥﺩﺭﻮﺧﺏﺎﺗ: 
ﺭﺍﺰﻔﻠﻋ: ﻥﺪﯾﺮﭼ, ﺶﯿﭘ, ﻦﻤﭼ
ﻩﺪﯿﭽﯿﭘ: ﺞﻧﺮﻐﺑ, ﻥﺩﺮﮐﻩﺪﯿﭽﯿﭘ, ﻪﺘﻓﺮﺸﯿﭘ, ﺐﯿﮐﺮﺗ, ﺮﯾﻭﺰﺗﻭﻪﻠﯿﺣﯼﻭﺭ
ﺎﻔﻌﺘﺳﺍ: ﺎﻔﻌﺘﺳﺍ, ﯽﮕﺘﺴﺸﻧﺯﺎﺑ, ﺐﻘﻋﻪﺑ, ﯽﻨﯿﺸﻧﺐﻘﻋ, ﮎﺮﺗ
ﻦﺗﻭﺮﻓﻡﺎﻧﺖﺒﺛ: 
ﻞﻔﻠﻓ: 
ﻮﺗﺎﺗ: 
ﺩﺰﻣﺎﻧ: ﻩﺪﻨﻨﮐﺖﺳﺍﻮﺧﺭﺩ, ﺮﮕﻧﻩﺪﻨﯾﺁ, ﻥﺩﺮﮐﻡﺍﺪﺨﺘﺳﺍﺯﻮﻣﺍﻮﻧ
ﻩﺎﺑﻭﺭ: 
ﺶﮐﺩﻭﺩ: ﯼﺭﺎﺨﺑ, ﻪﺘﺸﭘ
ﻩﺎﮔﺩﺍﺩﻦﯾﺍﺖﯿﺣﻼﺻ: ﻦﺘﺷﺍﺩﺭﺎﯿﺘﺧﺍ, ﯼﺭﻭﺍﺩ, ﯼﺭﻭﺍﺩ, ﺖﯿﺣﻼﺻ
ﻖﺑﺎﺳﻩﺪﺷﺕﻮﻓ: 
ﮏﯿﺗﺍﺮﮐﻮﻣﺩ: ﯽﺳﺍﺮﮐﻮﻣﺩ
ﻮﺘﭘ: ﻒﻘﺳ, ﺶﺷﻮﭘ, ﻪﭽﯿﻟﺎﻗ, ﺶﺷﻮﭘ
ﮎﻮﺧ: ﻕﺎﭼﻭﻪﺘﺨﻠﺷ
ﺝﺎﻋ: ﻞﯿﻓ
ﺮﺗﮏﺒﺳ: ﻩﺪﻨﺴﯾﻮﻧ
ﻩﺪﻨﻨﮐﻩﺪﻫﺎﺸﻣ: ﺖﺳﺮﭘﺮﺳ, ﻥﺎﻤﻬﻣ, ﺱﺭﺯﺎﺑ
ﻦﺧﺎﻧ: ﻦﺧﺎﻧ, ﻪﺠﻨﭘ
ﺭﻮﺒﻧﺯ: 
ﺮﮕﯾﺯﺎﺑ: ﺮﮕﯾﺯﺎﺑ, ﺮﮕﯾﺯﺎﺑ, ﯽﮐﺎﺷ
ﻕﺮﻋ: ﻥﺩﺯﻪﯿﺨﺑ
ﯽﻧﺎﺘﺴﻬﻟ: ﺶﯾﻮﮔ, ﺶﺸﺧﺭﺩ
ﻝﺎﯿﺧ: ﺐﻠﻘﺗ
ﺪﯾﺩﺮﺗ: ﯽﻌﻄﻗﺮﯿﻏ, ﻡﺎﻬﺑﺍ
ﻡﻭﺩ: ﯽﺋﺰﺟ
ﯽﯾﺎﺘﺳﻭﺭ: ﯽﻧﺎﺘﺳﺍ, ﺮﻬﺷﻪﻣﻮﺣ, ﯽﯾﺎﺘﺳﻭﺭ
ﺵﺩﺮﮔ: ﻪﻘﻠﺣ, ﻱﺭﺍﻮﺳﻪﺧﺮﭼﻭﺩ, ﯼﺎﻬﺧﺮﭼ, ﻉﻮﯿﺷ, ﺭﺎﺸﺘﻧﺍ, ﻩﺮﯾﺍﺩ, ﻪﺧﺮﭼ, ﺲﻧﺎﮐﺮﻓ, ﺶﺧﺮﭼ, ﻥﺪﻧﺎﺧﺮﭼ, ﮏﯿﻓﺍﺮﺗ, ﺵﺩﺮﮔ, ﻝﺎﻘﺘﻧﺍ
ﻪﻟﺎﻧ: 
ﻪﯿﺒﺷ: ﻢﻫﻪﯿﺒﺷ, ﻪﺑﺎﺸﺗ, ﯼﺭﻭﺁﺩﺎﯾ, ﺮﻇﺎﻨﺘﻣ, ﺪﻨﻧﺎﻣ
ﻝﻮﻗﻞﻘﻧ: ﻥﺩﺮﮐﺝﺍﺮﺨﺘﺳﺍ, ﻝﻮﻗﻞﻘﻧ, ﻥﺩﺮﮐﻡﺎﻤﺗﺍﺭﻝﻮﻗﻞﻘﻧ, ﻥﺩﺍﺩﺽﺮﻗ, ﻦﺘﻓﺮﮔﺖﻧﺎﻣﺍ, ﻡﺍﻭ, ﻊﺟﺮﻣ, ﻥﺩﺯﻦﯿﻤﺨﺗ, ﺩﺎﻨﺘﺳﺍ
ﻪﺴﯿﮐ: ﺩﺭ, ﺝﺍﺮﺧﺍ, ﻪﺴﯿﮐ
ﯼﺭﻮﺨﻟﺩ: ﻝﻼﺘﺧﺍ, ﻞﺧﺍﺪﺗ, ﻪﻔﻗﻭ, ﯽﺘﺨﺳ, ﯽﮕﺘﺴﺧ, ﺖﻤﺣﺯ, ﺍﺪﺻﻭﺮﺳ, ﻥﺍﺮﮕﻧ
ﻥﺯﻮﺳ: ﻖﯾﺭﺰﺗ, ﻕﺎﺠﻨﺳ, ﺮﮕﻫﺭﺎﺷﺍ
ﻝﺮﺘﻨﮐ: ﻝﺮﺘﻨﮐ
ﻊﻧﺎﻣ: ﺖﯾﺩﻭﺪﺤﻣ, ﺖﯾﺩﻭﺪﺤﻣ, ﺮﺼﺤﻨﻣ, ﻥﺩﺮﮐﻊﻨﻣ, ﺖﺳﺍﻩﺩﺮﮐﻉﻮﻨﻤﻣ, ﻊﻧﺎﻣ, ﻥﺩﺮﮐﺩﻭﺪﺴﻣ, ﻪﻔﻗﻭ, ﺺﻘﻧ, ﻥﺪﺷﻢﺣﺍﺰﻣ
ﻪﯿﮑﺗ: ﻥﺩﺮﻤﺷ, ﻥﺩﺮﮐﺏﺎﺴﺣﯼﺰﯿﭼﯼﻭﺭ, ﺩﺭﺍﺩﯽﮕﺘﺴﺑ, ﺩﺎﻤﺘﻋﺍ, ﻦﯿﻤﻀﺗ, ﺩﺎﻤﺘﻋﺍ, ﻪﺘﺴﺑﺍﻭ, ﯽﮕﺘﺴﺑﺍﻭ
ﻪﺟﻮﺟ: ﻍﺮﻣ
ﻪﮑﺸﺑ: ﻞﻄﺳ
ﯽﮕﺸﯿﻤﻫﻪﺒﻨﺟ: 
ﺱﺎﻨﺷﺭﺎﮐ: ﺺﺼﺨﺘﻣ, ﻪﺑﺮﺠﺗﺎﺑ, ﻩﮋﯾﻭ, ﺹﺎﺧ, ﺺﺼﺨﺗ
ﻦﺘﺷﺍﺬﮔﺮﯿﺛﺎﺗ: ﺩﺭﺍﺬﮔﯽﻣﺮﯿﺛﺎﺗ, ﺱﺎﺴﺣﺍ, ﻥﺩﺮﻛﺏﺬﺟ, ﺭﺍﺮﻗﺮﯿﺛﺎﺗﺖﺤﺗ
ﻥﻭ: ﻪﮑﻠﻓﺮﯿﺷ
ﻥﺩﺮﮐﻩﺭﺎﺷﺍﺮﺳﺎﺑ: ﻥﺩﺯﺕﺮﭼ
ﻒﯾﺮﻌﺗ: ﺮﯿﺴﻔﺗ, ﺖﯾﻮﻫﺺﯿﺨﺸﺗ, ﺕﺎﺤﯿﺿﻮﺗ, ﻦﯿﯿﻌﺗ, ﯽﻨﻤﺿﺖﻟﻻﺩ, ﺖﻟﺍﺪﻋ
ﺪﻟﻮﺗﺯﻭﺭ: ﺩﺮﮕﻟﺎﺳ
ﺶﮑﭼ: 
ﺮﻄﻌﻣ: ﺮﻄﻋ
ﯽﻬﯾﺪﺑ: ﺩﺮﺧ, ﺖﯿﻤﻫﺍﯽﺑ, ﮎﺪﻧﺍ, ﯼﺍﻪﯿﺷﺎﺣ
ﯼﺭﺎﻔﺣ: ﻥﺪﯾﻭﺎﮐ, ﻪﺘﻣ, ﯼﺭﺎﻔﺣ
ﯽﮕﻧﺎﺧﻥﺍﻮﯿﺣ: ﺖﯿﻫﺎﻣ, ﺮﺘﺳﺎﻓ
ﻪﻤﺠﻤﺟ: 
ﻪﻨﻨﻘﻣﻩﻮﻗ: ﺲﻠﺠﻣ, ﻥﻮﻧﺎﻗ, ﻪﻨﻨﻘﻣ
ﻪﻨﺷﺎﭘ: ﺵﺮﭘ, ﺎﭘﭻﻣ
ﻢﺧﺍ: 
ﻉﺍﺮﺘﺧﺍﺖﺒﺛ: ﺯﻮﺠﻣ, ﺯﻮﺠﻣ
ﻥﻮﯿﻠﯿﺑ: 
ﯽﯾﺎﯿﻤﯿﺷ: ﯽﻤﯿﺷﻢﻠﻋ, ﯽﯾﺎﯿﻤﯿﺷﺩﺍﻮﻣ, ﻥﺍﺩﯽﻤﯿﺷ, ﯽﻧﺎﻣﺭﺩﯽﻤﯿﺷ
ﺾﺒﻧ: ﻪﺑﻥﺩﺍﺩﻩﺰﯿﮕﻧﺍ, ﺖﺳﺩﭻﻣ, ﺖﮐﺮﺣ, ﯼﺭﻮﺗ
ﻥﺎﺒﻠﺧ: ﻪﺑﺮﺠﺗ, ﯽﺑﺮﺠﺗ, ﻩﺪﻨﻧﺍﺭ
ﻩﺮﮔ: ﻩﺩﻮﺗ, ﻩﺮﮔ, ﻦﺘﺷﺍﺩﻪﮕﻧ, ﯼﺭﺎﮐﺩﺍﺩﺭﺍﺮﻗ, ﻦﺘﻓﺮﮔﻪﺠﯿﺘﻧ, ﻪﻫﺩ, ﻩﺮﮔ, ﻝﺎﺼﺗﺍ, ﻡﺎﺧ, ﻡﺎﺧ, ﺐﺼﻌﺗ
ﻦﻣﺍﺩ: ﮓﻨﺳ
ﯽﮔﺩﺮﺴﻓﺍ: ﯼﺩﺎﺼﺘﻗﺍﻥﺍﺮﺤﺑ, ﺩﻮﮐﺭ, ﻩﻭﺪﻧﺍﻭﻢﻏ, ﻢﻏ, ﻪﺼﻏﻭﻢﻏ, ﻩﺩﺮﺴﻓﺍ, ﺱﺮﺘﺳﺍ
ﯽﻨﻓ: ﮏﯿﻨﮑﺗ, ﯼﮊﻮﻟﻮﻨﮑﺗ, ﯽﻨﻓﻅﺎﺤﻟﺯﺍ, ﯼﮊﻮﻟﻮﻨﮑﺗ, ﻪﺘﻓﺮﺸﯿﭘ
ﻪﯿﻠﻘﻧﻪﻠﯿﺳﻭ: ﻮﯾﺍﺭﺩ, ﻭﺭﺩﻮﺧ, ﯼﺭﺎﮔ, ﯼﺎﻨﻌﻣﻪﺑ, ﻞﯿﺒﻣﻮﺗﺍ
ﻩﺩﻭﺪﺤﻣ: ﺵﺮﺘﺴﮔ, ﻪﻨﻣﺍﺩ, ﻩﺯﻮﺣ, ﻩﺩﻭﺪﺤﻣ, ﻪﺑﻥﺪﯿﺳﺭ, ﺪﺣ
ﯽﻫﺎﯿﮔﯽﮔﺪﻧﺯ: ﻩﺎﯿﮔ
ﺏﺎﺘﻓﺁﻉﻮﻠﻃ: 
ﺖﮐﺭﺎﺸﻣ: ﻢﻬﺳ, ﻥﺩﺮﮐﺍﺪﻫﺍ, ﺖﮐﺭﺎﺸﻣ
ﺏﻼﻗ: ﻁﺎﺒﺗﺭﺍ, ﻝﺎﺼﺗﺍ, ﻥﺩﺮﮐﻂﺒﺗﺮﻣ, ﺏﻼﻗ
ﺮﺒﺑ: 
ﻦﯿﺘﺳﺍ: ﻭﺯﺎﺑ, ﯽﺷﻭﺮﻓﻩﺩﺮﺧ
ﻩﺍﺮﮔﺭﺰﺑ: ﻩﺩﺎﺟ
ﯽﻣﺎﻈﻧﻪﺒﺷ: 
ﺖﯿﻣﺎﻤﺗ: ﺰﮐﺮﻤﺗ
ﻑﺎﻔﺷ: ﺖﯿﻓﺎﻔﺷ, ﺢﺿﺍﻭ, ﯽﻨﺷﻭﺭﻪﺑ, ﺩﻮﻬﺸﻣ, ﺢﺿﺍﻭ, ﺺﺨﺸﻣﺭﻮﻃﻪﺑ, ﺢﺿﺍﻭﺮﯿﻏ, ﺢﯾﺮﺻ, ﺖﺳﺍﺭﺮﺳ
ﻩﺩﺯﻮﻧ: 
ﺏﺎﺴﺘﺣﺍﺎﺑ: ﻥﺩﺮﻤﺷ, ﻉﻮﻤﺠﻣ, ﻪﺒﺳﺎﺤﻣ, ﻪﺒﺳﺎﺤﻣ
ﻂﯾﺍﺮﺷﺪﺟﺍﻭ: ﻂﯾﺍﺮﺷﺪﺟﺍﻭ, ﺖﯿﺣﻼﺻ, ﺭﺩﺎﻗ, ﯽﮕﺘﺴﯾﺎﺷ, ﻦﺘﺷﺍﺩﻕﺎﻘﺤﺘﺳﺍ, ﻥﺪﺷﻂﯾﺍﺮﺷﺪﺟﺍﻭ, ﺮﻫﺎﻣ, ﻪﺘﺴﯾﺎﺷ, ﺮﺒﺘﻌﻣ, ﺖﯿﺣﻼﺻ
ﯽﻟﺍ: ﻞﯿﺴﻓ, ﯼﺭﻭﺮﺿ
ﺕﺎﯿﻬﻟﺍ: 
ﺭﻭﺎﻨﺷ: ﻖﯾﺎﻗ, ﺭﻭﺎﻨﺷ, ﻥﺎﮔﻭﺎﻧ
ﻩﺮﺣﺎﺳ: 
ﻩﺎﮔﺭﺎﮐ: ﺐﺴﭼﺮﺑ, ﻩﺎﮔﺭﺎﮐ, ﻥﺩﺮﮐﻞﯿﺼﺤﺗ
ﻦﯾﺎﭙﻣﺎﺷ: 
ﻢﭼﺮﭘ: ﻢﭼﺮﭘ, ﺮﺘﺳﻮﭘ, ﻂﯿﻠﺑ
ﻕﻼﻃ: ﻩﺪﺷﺍﺪﺟ
ﭻﯿﭘ: ﻕﺮﺑ, ﻦﺧﺎﻧ, ﭻﯿﭘ, ﭻﯿﭘ
ﺪﯾﺭﻭ: ﺐﺼﻋ
ﻝﺎﻌﻓﺮﯿﻏ: ﺭﺎﻀﺣ, ﻝﺎﻌﻓﺮﯿﻏ
ﻩﺰﯾﺭﮓﻨﺳ: ﻉﻮﻤﺠﻣ
ﻩﺭﺎﯿﺳ: ﯽﻠﺻﺍ, ﯽﮑﻠﻓﺕﺭﻮﺻ
ﻪﭽﻗﺎﺗ: ﻥﺩﺮﮐﺭﺍﺩﻪﻧﺍﺪﻧﺩ, ﻪﺠﻨﮔ
ﻪﮑﻨﭘ: 
ﯼﺮﯿﺴﻣﺮﮔ: ﯽﺗﺎﺳﺎﺴﺣﺍ
ﺯﺎﻓ: ﯽﺴﮑﻋ, ﻪﻨﺤﺻ, ﯽﻧﺎﻣﺯﻩﺭﻭﺩ, ﺭﺎﺘﺧﺎﺳ, ﻡﺎﮔ
ﻩﺍﻮﺨﻟﺩ: ﺩﻮﺨﺑﺩﻮﺧ, ﯼﺭﺎﯿﺘﺧﺍ, ﻩﺪﻫﺎﻌﻣ, ﻖﻓﺍﻮﺗ, ﻩﺪﺸﻧﻝﺮﺘﻨﮐ
ﺪﺟﻭ: ﯽﺷﻮﻬﯿﺑ, ﻕﺎﯿﺘﺷﺍ, ﺕﺬﻟ, ﯼﺩﺎﺷ
ﻩﻮﯿﺟ: ﺕﺭﺍﺮﺣﻪﺟﺭﺩ
ﺭﺎﺤﺘﻧﺍ: 
ﺭﺎﮕﻧﺮﺒﺧ: ﺭﺎﮕﻧﻪﻣﺎﻧﺯﻭﺭ
ﻥﺩﺮﮐﻡﻭﺮﺤﻣ: ﺖﯿﻣﻭﺮﺤﻣ, ﻝﺎﻄﺑﺍ, ﻥﺩﺮﮐﻡﻭﺮﺤﻣ, ﻥﺩﺮﮐﻖﯾﺮﻔﺗ, ﻥﺩﺮﮐﯽﺜﻨﺧ, ﺕﺭﺎﻏ
ﻦﮑﻟﺎﺑ: ﺱﺍﺮﺗ, ﯽﻧﺍﻭﺮﯿﺷﺮﯾﺯﻕﺎﺗﺍ
ﻝﺎﮕﻨﭼ: ﻡﺩﺮﻣ
ﺪﻨﻣﺭﺎﮐ: ﺮﮔﺭﺎﮐ, ﺮﮔﺭﺎﮐ, ﻥﺩﺮﮐﺭﺎﮐ, ﻞﻣﺎﻋ, ﻪﺘﺴﺑﺍﻭ, ﯽﺸﻨﻣ, ﻞﻨﺳﺮﭘ, ﺭﺎﮐ, ﺭﺎﮐ, ﻥﺎﻨﮐﺭﺎﮐ
ﺎﻣﺮﻓﺭﺎﮐ: ﺲﻴﺋﺭ, ﻪﻧﺎﺧﺐﺣﺎﺻ, ﮏﻟﺎﻣ
ﺽﺮﻋ: ﻩﺩﺮﺘﺴﮔﺭﻮﻃﻪﺑ, ﻦﯿﻣﺎﺗ, ﻊﯿﺳﻭ, ﻪﻤﯿﻧ
ﺭﻭﻪﻠﻌﺷ: 
ﮏﯾﺮﺤﺗ: ﺖﯾﺫﺍ, ﻪﺘﺨﯿﮕﻧﺍﺮﺑ, ﮏﯾﺮﺤﺗ, ﮏﯾﺮﺤﺗ, ﮏﯾﺮﺤﺗ, ﻪﻠﺻﻮﺣﯽﺑ, ﮎﺮﺤﻣ, ﮏﯾﺮﺤﺗ, ﻩﺰﯿﮕﻧﺍ, ﻩﺰﯿﮕﻧﺍ
ﮏﯿﺳﻼﮐ: ﮏﯿﺳﻼﮐ, ﻪﻨﯿﻬﺑ
ﻥﻮﻤﯿﻣ: ﻩﺰﻧﺎﭙﻤﺷ
ﻝﻮﺒﻗﻞﺑﺎﻗ: ﺪﯿﻨﮐﺪﯿﯾﺎﺗ, ﺵﺮﯾﺬﭘ, ﻞﻤﺘﺤﻣ
ﺎﻀﻣﺍ: 
ﻩﺪﻨﻧﺍﻮﺧ: ﻩﺪﻨﻧﺍﻮﺧ
ﺲﮐﻭﺪﺗﺭﺍ: ﺭﺎﮐﻪﻈﻓﺎﺤﻣ, ﯽﻟﻮﻤﻌﻣ, ﯽﺘﻨﺳ
ﻪﻧﺎﺨﻠﮔ: ﻉﺭﺯﻭﺖﺸﮐ
ﺫﺎﺨﺗﺍ: ﻡﺍﺪﺨﺘﺳﺍ, ﺫﺎﺨﺗﺍ, ﺵﺮﯾﺬﭘ, ﺽﺮﻓ, ﺐﯾﻮﺼﺗ, ﺏﺰﺣ, ﺵﺮﯾﺬﭘ, ﺵﺮﯾﺬﭘ, ﻥﺩﺮﮐﭗﻠﺷﭗﻠﺷ, ﯽﻣﻮﺘﻧﺍﻮﮐ
ﯽﻠﯿﻣﯽﺑ: ﮓﻧﺭﺩ, ﻦﺘﺷﺍﺪﻧﺖﺳﻭﺩ
ﻥﺩﺮﻛﺩﺭﺍﻭ: ﯽﻓﺮﻌﻣ, ﺪﻣﺁﺭﺩ
ﻞﻌﺸﻣ: 
ﻥﺎﺑﺯﺭﻮﺘﺳﺩ: ﯼﺭﻮﺘﺳﺩ
ﯽﮑﻧﺎﺑﻩﺩﺮﭙﺳ: ﻦﺘﺷﺎﺒﻧﺍ
ﯽﺗﺍﺮﻤﻌﺘﺴﻣ: ﺮﺟﺎﻬﻣ
ﯽﻧﺎﺑﺩﺎﺑﻖﯾﺎﻗ: ﯽﺘﺸﮐ, ﻖﯾﺎﻗ
ﻥﺪﻧﺎﺳﺮﺗ: ﻥﺪﻧﺎﺳﺮﺗ, ﻥﺩﺮﮐﻩﺩﺯﺖﺸﺣﻭ, ﻥﺪﻧﺎﺳﺮﺗ, ﺮﻄﺧﮓﻧﺯ, ﺏﺮﻄﻀﻣ, ﺩﺎﯾﺯﺪﺷﻭﺪﻣﺍ
ﻢﻬﻣ: ﻪﺠﯿﺘﻧ, ﺖﻤﺴﻗ, ﺖﯿﻤﻫﺍﺎﺑ, ﻪﺟﻮﺗﻞﺑﺎﻗ, ﻥﺪﺷﯽﻬﺘﻨﻣ, ﻪﺘﺴﺟﺮﺑ, ﯽﻬﺟﻮﺗﻞﺑﺎﻗﺭﻮﻄﺑ, ﻪﺟﻮﺗﻞﺑﺎﻗ, ﻪﺟﻮﺗﻞﺑﺎﻗ, ﺭﺍﺩﺎﻨﻌﻣ, ﻢﯿﻘﺘﺴﻣﺮﯿﻏ
ﻩﺪﺷﺽﺮﻘﻨﻣ: ﻢﮔ, ﻥﺪﺷﺪﯾﺪﭘﺎﻧ, ﻥﺎﺟﯽﺑ
ﺪﺒﻨﮔ: 
ﺖﻣﺎﺨﺿ: 
ﻖﺷﻪﻠﮐ: ﻩﺪﻨﻨﮐﺭﺎﻬﻇﺍ
ﻪﻠﻀﻋ: 
ﻩﺯﺍﺪﻧﺍ: ﻩﺯﺍﺪﻧﺍ, ﻢﺠﺣ, ﻪﻨﻣﺍﺩ, ﻩﺯﺍﺪﻧﺍ, ﺭﺍﺪﻘﻣ, ﺕﺪﺷ
ﻥﺪﯿﻟﺎﻣ: 
ﺖﺴﺗﻥﺎﻧ: ﺮﺼﺘﺨﻣﮎﺍﺭﻮﺧ
ﺱﻭﺎﻣ: ﺵﻮﻣ
ﺎﺠﻫ: ﻑﻭﺮﺣﮏﺒﺳ, ﺎﺒﻔﻟﺍ
ﯽﺜﻨﺧ: ﯽﺜﻨﺧ, ﻪﻧﻻﺩﺎﻋ, ﺭﻻﻮﮑﺳ
ﺺﯿﺨﺸﺗ: ﯽﺑﺎﯾﺯﺭﺍ, ﺖﯾﻮﻫﺺﯿﺨﺸﺗ, ﺺﯿﺨﺸﺗ, ﯽﯾﺎﺳﺎﻨﺷ, ﻒﺸﮐ, ﻥﺩﺍﺩﺭﺍﺮﻗ, ﯽﺑﺎﯾﺯﺎﺑ, ﻥﺩﺮﮐﺍﺪﯿﭘ
ﻥﺪﺷﺎﻓﻮﮑﺷ: ﯽﺑﺎﯿﻣﺎﮐ, ﻖﻧﻭﺭ, ﺵﺮﻏ, ﺮﻫﺍﻮﺟ, ﺮﻫﻮﮔ, ﻞﮔ
ﻞﯿﻤﺤﺗ: ﻥﺩﺮﻛﺭﻮﺒﺠﻣ, ﯼﺍﺮﺟﺍ, ﻥﺪﺷﻦﯿﯿﻌﺗ
ﺱﺎﻨﺷﺎﻧ: 
ﯽﻤﺳﺭﻡﺎﻧﺖﺒﺛ: 
ﻪﻟﺎﺳﻮﮔ: ﻪﻠﺠﻋ
ﯼﺎﻤﻨﻫﺍﺭﻪﭽﺑﺎﺘﮐ: ﺎﻤﻨﻫﺍﺭ, ﺡﺮﻃ, ﺎﻤﻨﻫﺍﺭ, ﻪﭽﺑﺎﺘﮐ, ﮎﺭﺎﻣ, ﯼﺮﺒﻫﺭ, ﯽﺳﺭﺩﺏﺎﺘﮐ, ﻞﻤﻌﻟﺍﺭﻮﺘﺳﺩ, ﺮﺒﻫﺭ, ﺖﺳﺮﭘﺮﺳ, ﺪﻨﺳ, ﺕﺍﺪﻨﺘﺴﻣ, ﺩﺮﮑﻠﻤﻋ, ﺪﯿﻟﻮﺗ
ﯽﻨﯿﺑﺶﯿﭘ: ﺩﻭﺭﯽﻣﺭﺎﻈﺘﻧﺍ, ﺮﮕﻧﻩﺪﻨﯾﺁ, ﺭﺎﻈﺘﻧﺍ, ﺭﺎﻈﺘﻧﺍ, ﯽﻨﯿﺑﺶﯿﭘ, ﯽﻨﯿﺑﺶﯿﭘ, ﯽﻨﯿﺑﺶﯿﭘ, ﯽﻨﯿﺑﺶﯿﭘ, ﮎﺭﺍﺪﺗ
ﻥﺪﺷﺏﻭﺫ: ﻥﺪﺷﺭﺎﺨﺑ, ﻥﺪﺷﻡﺮﮔ, ﻡﺎﻏﺩﺍ, ﻥﺩﺮﮐﺪﺤﺘﻣ, ﻝﻮﻠﺤﻣ
ﺮﺘﭼ: ﺕﺎﺠﻧﺮﺘﭼ, ﭺﺭﺎﻗ
ﻦﯿﺗﻮﭘ: ﺶﻔﮐ, ﻪﻨﺗ
ﯽﻧﺪﻌﻣ: ﺪﯾ, ﯼﺬﻐﻣﻩﺩﺎﻣ, ﺰﻠﻓ, ﺰﻨﮕﻨﻣ
ﻪﮐﺭﺎﺘﻣ: ﺲﺑﺶﺗﺁ
ﮎﺩﺭﺍ: 
ﻥﻮﺑﺎﺻ: 
ﮏﺳﻭﺮﻋ: ﮎﺩﻮﮐ, ﯼﺯﺎﺑﺏﺎﺒﺳﺍ
ﻼﯾﻭ: ﯼﺮﭘﻭﻦﺟ, ﻝﺰﻨﻣ
ﯽﮔﺪﻧﺯﻭﺩ: ﻥﺩﺯﻪﯿﺨﺑ, ﻦﺘﺧﻭﺩ
ﻥﺩﺍﺩﯽﺘﺷﺁ: ﻥﺩﺮﮐﺖﻃﺎﺳﻭ, ﻥﺩﺮﮐﺪﺤﺘﻣ, ﻥﺩﺮﮐﺪﺤﺘﻣ, ﻥﺩﺮﮐﻢﯿﻈﻨﺗ, ﻢﯿﻈﻨﺗ
ﯼﺮﺘﮐ: 
ﺵﻮﮔﺮﺧ: 
ﺮﺘﺴﮐﺭﺍﺮﺒﻫﺭ: ﻥﺎﺑﺩﺮﻧ, ﺖﺳﺮﭘﺮﺳ, ﻩﺪﻨﻧﺍﺭ, ﺮﺒﻫﺭ
ﻦﮑﯾﺯﺎﺑ: ﺮﮕﯾﺯﺎﺑ
ﻩﺮﺸﺣ: ﺕﺎﻓﺁ, ﻡﺮﮐ, ﻩﺮﺸﺣ
ﻥﺍﺭﻮﺘﺳﺭ: 
ﻝﺎﮑﯾﺩﺍﺭ: ﺐﻠﻃﮓﻨﺟ, ﯽﻃﺍﺮﻓﺍ, ﯽﻗﺮﺘﻣ, ﯽﺑﻼﻘﻧﺍ, ﻁﺮﻔﻣ, ﻡﺎﻤﺗ, ﺮﺳﺍﺮﺳ, ﻡﺎﻤﺗ, ﻖﻠﻄﻣ, ﻡﺎﻏﺩﺍ
ﻦﮐﺎﺳ: ﻦﮐﺎﺳ, ﯽﻣﻮﺑ, ﯽﮕﻧﺎﺧ, ﯽﻣﻮﺑ, ﺮﺟﺎﺘﺴﻣ, ﯽﻧﻮﮑﺴﻣ
ﺎﻫﺩﮊﺍ: ﮎﺩﺎﺑﺩﺎﺑ
ﯽﻌﻤﺳﯽﮐﺭﺪﻣ: 
ﻥﺪﻧﺎﻣﺮﻈﺘﻨﻣ: ﺕﺪﻣﯽﻧﻻﻮﻃ
ﮏﻫﻼﮐ: ﺶﺷﻮﭘ, ﺭﺍﺩﻪﺒﻟﻩﻼﮐ, ﻪﺷﺮﻋ, ﻪﮑﻠﻓﺮﯿﺷ
ﺭﺍﺩﺮﻬﺷ: ﺭﺍﺯﺎﺑ
ﺭﺍﺰﻓﺍﺖﺨﺳ: ﻩﺩﺎﻣ
ﻖﻟﺎﺧ: 
ﺖﯿﻠﻗﺍ: ﺭﺎﻤﺷﺖﺸﮕﻧﺍ, ﯼﺭﺎﺸﻋﺍ
ﺮﮕﻨﺳ: ﻕﺪﻨﺧ, ﯼﺭﺎﻔﺣ
ﺮﺘﺴﮐﺭﺍ: 
ﻦﮑﯿﺑ: 
ﯽﻧﻮﻧﺎﻗﺩﺮﮕﯿﭘ: ﺭﺍﺮﻗﯽﻧﻮﻧﺎﻗﺩﺮﮕﯿﭘﺖﺤﺗ, ﺩﺭﻮﻣ, ﺖﺳﺍﻮﺧﺩﺍﺩ, ﯽﯾﺎﻀﻗﯼﻮﻋﺩ, ﺐﯿﻘﻌﺗ, ﺎﻋﺩﺍ, ﯽﮐﺎﺷ
ﺭﺮﺿ: ﻥﺎﯾﺯ, ﺖﯿﻣﻭﺮﺤﻣ, ﺮﻀﻣ, ﺐﯿﻋ, ﺺﻘﻧ, ﻞﮑﺸﻣ
ﻪﭼﺭﺎﭘ: ﻪﭼﺭﺎﭘ, ﺵﻮﭘﻦﺗ, ﻪﻟﻮﺣ, ﯽﺷﺎﻘﻧﻡﻮﺑ, ﺖﻓﺎﺑ, ﻦﯿﮑﺴﺗ, ﺭﺎﺘﺧﺎﺳ
ﻥﺍﺩﯽﻘﯿﺳﻮﻣ: ﺯﺎﺴﮕﻨﻫﺁ, ﯽﻘﯿﺳﻮﻣ
ﯽﻨﻫﺫ: ﯽﻧﺎﺣﻭﺭ, ﯽﻧﺍﻭﺭ, ﻪﯿﺣﻭﺭ, ﺎﻧﺎﻣ, ﯽﻨﻫﺫ, ﯽﺳﺎﻨﺸﻧﺍﻭﺭ, ﯽﺘﺧﺎﻨﺷ, ﯽﻧﺍﻭﺭ
ﺐﺳﺎﻨﻣﺎﻧ: ﻩﺎﺒﺘﺷﺍ, ﻝﻮﺒﻗﻞﺑﺎﻗﺮﯿﻏ, ﺺﻗﺎﻧ, ﺲﻧﺎﺠﺘﻣﺎﻧ, ﺩﻭﺭﯽﻣﺭﺎﻈﺘﻧﺍ, ﯽﻧﻮﻧﺎﻗﺮﯿﻏ, ﻩﺪﻨﺴﺑﺎﻧ, ﺐﺳﺎﻨﻣﺎﻧ, ﻪﻧﺎﻔﺼﻨﻣﺮﯿﻏ
ﺭﺎﻤﻌﻣ: 
ﻥﺩﺭﻭﺍﺭﺩﺡﺎﮑﻧﻪﻟﺎﺒﺤﺑ: 
ﻮﻤﯿﻟ: 
ﻥﺩﺮﮐﻪﻓﺮﺳ: ﻪﻓﺮﺳ
ﯼﺭﻭﺭﺎﺑ: ﻞﺜﻣﺪﯿﻟﻮﺗ, ﺩﺍﮋﻧﺡﻼﺻﺍﻭﺵﺭﻭﺮﭘ, ﯽﻠﺳﺎﻨﺗﻩﺎﮕﺘﺳﺩ
ﯽﻓﺩﺎﺼﺗ: ﯽﻓﺩﺎﺼﺗﺕﺭﻮﺻﻪﺑ, ﻥﺩﺮﮐﯽﻓﺩﺎﺼﺗ, ﯽﻓﺩﺎﺼﺗ, ﯽﻗﺎﻔﺗﺍ, ﺩﻮﺨﺑﺩﻮﺧ, ﯽﻗﺎﻔﺗﺍ
ﻖﺷﺎﻗ: ﻞﻄﺳ
ﺕﺍﺮﻃﺎﺧﺮﺘﻓﺩ: ﻪﻧﺍﺯﻭﺭ, ﻪﻣﺎﻧﺯﻭﺭ, ﻪﻠﺠﻣ, ﻢﯾﻮﻘﺗ
ﻥﻮﻟﺎﺑ: 
ﯽﻃﺎﺒﻨﺘﺳﺍﯽﮐﺭﺪﻣ: 
ﺮﺷﺎﻧ: ﺮﮕﺸﯾﺍﺮﯾﻭ, ﺮﺸﻧﻭﭖﺎﭼ
ﺮﺘﺴﮐﺎﺧ: ﯼﺮﺘﺴﮐﺎﺧ, ﯼﺮﺘﺴﮐﺎﺧ
ﺮﯿﮕﯾﺎﺟ: ﻥﺩﺭﻮﺧﻢﺴﻗ
ﯼﺎﯿﺣﺍ: ﺎﯿﺣﺍ
ﺱﺎﺴﺣ: ﺮﯾﺬﭘﺐﯿﺳﺁ, ﺱﺎﺴﺣ, ﻝﻮﻘﻌﻣ, ﯽﻔﻃﺎﻋ, ﻝﻮﺌﺴﻣ
ﻞﻧﻮﺗ: ﻭﺮﺘﻣ
ﻝﺯﺎﭘ: ﻥﺩﺮﮐﺞﯿﮔ, ﻩﺪﻨﻨﮐﺞﯿﮔ
ﻡﺰﯿﻧﺎﮑﻣ: ﺵﻭﺭ, ﻝﺍﻭﺭ, ﯽﻟﻮﺻﺍ, ﻩﺎﮕﺘﺳﺩ, ﻩﺎﮕﺘﺳﺩ, ﺵﻭﺭ, ﺖﺳﺎﯿﺳ
ﺕﺎﯿﺿﺎﯾﺭ: ﯽﺿﺎﯾﺭ, ﯽﺿﺎﯾﺭ, ﺖﯾﺎﻬﻧﯽﺑ
ﻥﺪﺷﻮﺤﻣ: 
ﻝﺩﺎﻌﺘﻣ: ﺖﺒﺴﻧ, ﻁﺎﺒﺗﺭﺍ, ﺖﺒﺴﻧ, ﺭﺍﻮﺘﺳﺍ, ﺭﺍﺪﯾﺎﭘ
sublativeﺩﺭﻮﻣ: 
ﺐﯿﺷ: ﻪﺟﺮﯿﺷ, ﻥﺩﺍﺩﺭﺍﺮﻗ, ﻥﺩﺮﮐﺎﻫﺭ, ﻥﺩﺮﮐﺰﯿﺧﻭﺖﺴﺟ, ﻉﻮﻗﻭ, ﺐﯿﺷ, ﺐﯿﺷ, ﺐﯿﺷ, ﻥﺩﺭﻮﺧﺲﯿﺧ, ﺶﻫﺎﮐ, ﺩﻮﮐﺭ, ﺞﮐ
ﺪﺣﺍﻭ: ﺕﺪﺣﻭ, ﺩﻮﺟﻭ, ﺪﺣﺍﻭ, ﺭﺎﻘﻨﻣ, ﺩﺮﻔﻣ
ﺭﺎﺼﺤﻧﺍ: ﯼﺭﺎﺼﺤﻧﺍ
ﺭﺎﻤﻗ: ﺭﺎﻤﻗ, ﯼﺯﺎﺑ, ﻦﺘﺷﺍﺩﯽﻧﺍﻮﺨﻤﻫ, ﮎﺮﻤﮔﺯﺍﻻﺎﮐﺺﯿﺧﺮﺗ, ﯼﺪﻨﺑﻁﺮﺷ
ﯽﯾﺎﯾﺭﺩﺮﯾﺯ: 
ﻦﺘﻓﺮﮔﺮﻈﻧﺭﺩﻥﻭﺪﺑ: 
ﻪﻟﺰﻟﺯ: ﺞﻨﺸﺗ
ﻩﺎﮕﺸﯾﺎﻣﺯﺁ: ﻩﺎﮕﺸﯾﺎﻣﺯﺁ
ﺕﺍﺮﻈﻧ: ﺢﯿﺿﻮﺗ, ﺭﺎﻬﻇﺍ, ﺮﯿﺴﻔﺗ, ﺦﺳﺎﭘ
ﺖﺤﺗ: ﻥﺩﺮﮐﯽﻃ, ﻪﺑﺮﺠﺗﺎﺑ, ﻥﺩﺮﻛﺖﻓﺎﻳﺭﺩ
ﺩﻮﺧﻝﺮﺘﻨﮐ: 
ﺕﺭﺎﻔﺳ: 
ﺲﻴﺋﺭ: ﺲﯿﺋﺭ, ﺭﻮﻬﻤﺟﺲﯿﺋﺭ
ﻥﺩﺮﮐﻉﺍﺮﺘﺧﺍ: ﻉﺍﺮﺘﺧﺍ
ﯽﻧﻼﻋﺍﺖﻟﺎﺣ: 
ﺶﮑﺘﺳﺩ: 
ﻥﺩﺯﻮﻧﺍﺯ: 
ﺎﯿﻓﺍﺮﻐﺟ: 
ﯼﺭﺍﺬﮔﻪﯾﺎﻣﺮﺳ: ﯼﺭﺍﺬﮔﻪﯾﺎﻣﺮﺳ, ﯼﺭﺍﺬﮔﻪﯾﺎﻣﺮﺳ
ﺱﺎﯿﻗ: ﯼﺮﺑﺍﺮﺑ, ﻪﺑﺎﺸﺗ, ﯽﮕﺘﺴﺑﺍﻭ, ﯼﺪﻧﻭﺎﺸﯾﻮﺧ, ﺖﺒﺴﻧ
ﻦﯿﻫﺎﺷ: ﺏﺎﻘﻋ, ﺭﻭﺩﺰﻣ
ﯽﺳﺎﻨﺷﻥﺍﻭﺭ: ﯽﮑﯾﮊﻮﻟﻮﯾﺰﯿﻓ, ﯽﺳﺎﻨﺸﻧﺍﻭﺭ
ﻪﺿﺍﺮﻗ: ﻥﺩﺮﮐﻮﻐﻟ, ﻪﻟﺎﺑﺯ, ﻪﻟﺎﺑﺯ, ﻪﻌﻄﻗ, ﻥﺩﺮﮐﺕﺮﭘ, ﺏﺎﺗﺮﭘ
ﯽﯾﺎﯾﺭﺩﺩﺯﺩ: ﺮﮑﻫ
ﺶﻘﻧ: ﻢﻬﺳ, ﺱﺭﻮﺑﻥﺎﻣﺯﺎﺳ, ﻩﺪﻨﻨﮐﺖﮐﺮﺷ, ﯽﻓﺮﻌﻣ, ﺖﯿﺼﺨﺷ, ﺖﻟﺎﺣ
ﺭﺍﺪﻘﻣ: ﺭﺍﺪﻘﻣ, ﯽﯾﺍﺬﻏﻢﯾﮊﺭ, ﺖﻤﺴﻗﺝﺭﺎﺧ, ﻩﺮﯿﺟ
ﺩﺍﺯﺁﯽﻫﺎﻣ: 
ﮓﻨﯾﺩﻮﭘ: ﺮﺳﺩ
ﯽﺴﯿﻃﺎﻨﻐﻣ: ﺏﺍﺬﺟ, ﻡﺩﻮﺧ
ﻪﺒﻤﻠﺗ: ﺐﻤﺑ, ءﻼﺧ
ﻥﮋﯿﺴﮐﺍ: 
ﻪﯿﺷﺎﺣ: ﻪﺒﻟ, ﺯﺮﻣ, ﯼﺍﻪﯿﺷﺎﺣ, ﻪﯿﺷﺎﺣ, ﯽﻧﻮﻣﺍﺮﯿﭘ, ﺯﺮﻣ, ﺯﺮﻣ
ﻪﻣﺎﻧﯽﻫﺍﻮﮔ: ﻪﯾﺪﯿﺋﺎﺗ
ﻝﺍﺪﻣ: 
ﯽﻇﺎﻔﻟ: 
ﻪﻠﭘ: ﻪﻠﭘ, ﺝﺁ, ﻡﺎﮔ
ﺵﺍﺮﺧ: ﺵﺍﺮﺧ, ﻥﺪﻧﺍﺮﭼ, ﻥﺩﺮﮐﺖﯾﺫﺍ
ﺩﻭﺭﻭ: ﻢﺟﺎﻬﺗ, ﻢﺘﺴﯿﺳﻪﺑﺩﻭﺭﻭ
ﭖﻮﮑﺴﻠﺗ: ﭗﮑﺳﻭﺮﮑﯿﻣ
ﺪﻨﺑﻥﺩﺮﮔ: ﺖﺴﮑﺷ, ﺮﯿﻤﺧ, ﺮﯿﺠﻧﺯ
ﯽﺠﻫ: ﻥﺩﺮﮐﯽﺠﻫ
ﺭﺎﻨﮐﺎﯾﺭﺩﺏﺍﺰﯿﺧ: 
ﯽﮑﺴﯾﻭ: 
ﺮﺘﺷ: 
ﺭﻮﺗﺎﻣﺁ: 
ﻎﻟﺎﺑ: ﻎﻟﺎﺑ, ﻦﺳ, ﻦﺴﻣ
ﻪﻣﺎﻨﯿﮔﺪﻧﺯ: ﻕﺮﺑ
ﺮﺧ: 
ﺯﺍﺪﻧﺍﻢﺸﭼ: ﺯﺍﺪﻧﺍﻢﺸﭼ
ﺭﺍﺰﻓﺍﻡﺮﻧ: ﯽﺼﺼﺨﺗ, ﺖﺒﺜﻣ, ﯽﻗﺎﺒﻄﻧﺍ
ﻪﻧﺎﯿﻫﺎﻣ: ﻪﻠﺠﻣ
ﺕﻼﯿﻄﻌﺗ: ﻥﺩﺮﮐﮎﺮﺗ, ﻞﯿﻄﻌﺗﺯﻭﺭ, ﯽﻗﺎﺑ
ﮏﯿﻠﮐ: ﻪﺘﺳﺩ, ﯽﻧﺎﻬﮔﺎﻧﻭﻢﮑﺤﻣﻪﺑﺮﺿ, ﻥﺩﺯﺭﺩ
ﯽﻀﯿﺑ: 
ﻥﺎﺴﺸﮐ: ﮏﯿﺘﺳﻻ, ﺮﯾﺬﭘﻑﺎﻄﻌﻧﺍ
ﺖﻐﻟﮓﻨﻫﺮﻓ: ﯼﻮﻐﻟ, ﻥﺎﮔﮊﺍﻭ, ﺶﯿﭘ
ﻢﯿﺴﻘﺗ: ﻥﺩﺮﮐﻢﯿﺴﻘﺗ, ﺶﺨﺑ, ﻦﺘﺴﮑﺷﻢﻫﺭﺩ, ﮏﯿﮑﻔﺗ, ﻥﺩﺮﻤﺷ, ﻪﭘﻮﮐ, ﺶﺨﺑ, ﻪﻌﻄﻗ, ءﺰﺟ, ءﺍﺰﺟﺍ
ﻥﻮﺒﻣﺍﮊ: ﻥﺍﺭ
ﻥﺎﻤﻛﻦﻴﮕﻧﺭ: 
ﻢﺴﯿﻧﺎﮔﺭﺍ: ﺩﻮﺟﻮﻣ, ﺩﺎﺠﯾﺍ
ﻦﻫﺩﺏﺁ: ﺮﺴﻤﻫ, ﻥﺎﺑﺯ
ﺰﯾﺮﭘ: ﺝﻭﺮﺧ, ﺰﯾﺮﭘ, ﺪﯿﻟﻮﺗ, ﺖﻤﯾﺰﻋ, ﮓﻨﭼ, ﻑﺎﮑﺷ
ﻥﺰﺨﻣ: ﻥﺰﺨﻣ, ﻑﺮﻇ, ﻩﺮﻤﺧ
ﻪﻧﺍﻭﺮﭘ: 
ﯽﻧﺎﻣﺯﺎﺳﺕﺭﺎﭼ: ﺭﺍﺩﻮﻤﻧ, ﻑﺍﺮﮔ, ﮏﯿﻓﺍﺮﮔ, ﮏﯿﻓﺍﺮﮔ, ﺡﺮﻃ, ﺖﺳﺮﻬﻓ, ﺖﺳﺮﻬﻓ
ﻮﻠﻗﻭﺩ: ﺮﺑﺍﺮﺑﻭﺩ, ﻭﺩ, ﺮﻫﻮﺷﻭﻥﺯ, ﺖﻔﺟ
ﻦﯿﻫﻮﺗ: ﻥﺩﺮﻛﻦﻴﻫﻮﺗ, ﯽﯾﺍﻮﺳﺭ, ﻡﺮﺟ, ﻥﺩﺮﮐﺖﯾﺫﺍ, ﻦﯿﻫﻮﺗ, ﯽﻫﺎﻔﺷ, ﻪﻠﻤﺣ
ﻞﻘﺘﺴﻣﺭﻮﻃﻪﺑ: ﻞﻘﺘﺴﻣ, ﻪﻧﺍﺩﺍﺯﺁ, ﺍﺪﺟ, ﻪﻧﺍﺩﺍﺯﺁ, ﻪﻧﺎﮔﺍﺪﺟﺕﺭﻮﺼﺑ
ﺏﺍﺩﺮﻣ: 
ﺱﻮﺑﺎﮐ: ﺏﺍﻮﺧ
ﺎﺑﺮﻣ: ﻪﻟﮊ, ﻥﺩﺮﮐﻩﺩﺮﺸﻓ
ﻩﺪﻧﻮﻨﺷ: ﻩﺪﺑﺵﻮﮔ
ﻩﺯﻮﻣ: 
ﺕﺎﺒﺛ: ﻥﺩﺮﮐﺖﯿﺒﺜﺗ
ﻥﺩﺮﮐﺵﺎﻓ: ﻡﻼﻋﺍ, ﻦﺘﺧﺎﺳﺭﺎﮑﺷﺁ, ﻒﺸﮐ, ﻦﺘﺷﺍﺬﮔﺽﺮﻌﻣﺭﺩ, ﻥﺩﺮﮐﻞﻃﺎﺑ, ﺭﺎﺸﺘﻧﺍ, ﻥﺩﺮﻛﻒﺸﻛ, ﻥﺩﺍﺩﺰﯿﻤﺗ, ﺮﻫﺎﻇ
ﺰﯿﻣﺁﺖﻧﻮﺸﺧ: ﻥﺪﺷﻢﺣﺍﺰﻣ, ﯽﮕﺘﺨﯾﺭﻢﻬﺑ, ﻝﺎﻐﺘﺷﺍ, ﺯﻭﺎﺠﺗ, ﻪﻠﻤﺣ, ﺯﺍﺪﻧﺍﺐﻤﺑ
ﮎﺎﮑﻄﺻﺍ: ﻪﻬﺟﺍﻮﻣ
ﺖﮐﺭﺎﺸﻣ: ﺭﻮﻀﺣ, ﻥﺩﺮﮐﺖﮐﺮﺷ, ﯼﺮﯿﮔﺭﺩ
ﻪﻠﮑﺳﺍ: ﻩﺎﮔﺭﺬﮔ
ﺕﻮﺒﮑﻨﻋ: ﺮﺸﯿﻓ
ﯽﻨﯿﻣﺯﺐﯿﺳ: 
ﻩﺪﻧﺯﺎﺳ: ﻩﺪﻧﺯﺎﺳ, ﻩﺪﻨﻨﻛﻪﻴﻬﺗ, ﯼﺯﺎﺳﻩﺩﺎﻣﺁ, ﺪﯿﻟﻮﺗ, ﺪﯿﻟﻮﺗ
ﺯﺁﻭﺹﺮﺣ: ﯽﮕﻨﺳﺮﮔ, ﺎﻬﺘﺷﺍ
ﺱﺭﺎﻧ: ﻪﯿﻟﻭﺍ
ﻥﺩﺮﮐﺮﯿﺜﮑﺗ: ﺖﺑﺎﺻﺍ, ﺩﺍﮋﻧﺡﻼﺻﺍﻭﺵﺭﻭﺮﭘ, ﺏﺮﺿ, ﺮﺑﺍﺮﺑﻭﺩ
ﻡﺎﻗﺭﺍ: ﯼﺭﺎﻣﺁ, ﻞﮑﺷ, ﺭﺎﻣﺁ
ﯼﺩﺰﻣﺎﻧ: ﻥﺩﺮﮐﺩﺰﻣﺎﻧ, ﺏﺎﺼﺘﻧﺍ, ﺏﺎﺨﺘﻧﺍ, ﯼﺩﺰﻣﺎﻧ
ﻥﻮﯿﻠﯾﺮﺗ: 
ﺖﺒﺜﻣﺖﻟﺎﺣ: 
ﯼﺩﺮﺑﺭﺎﮐﯼﺎﻫﻪﻣﺎﻧﺮﺑ: ﻪﻣﺎﻧﺮﺑ, ﯼﺎﻫﺪﻨﯾﺁﺮﻓ, ﺖﺳﺍﻮﺧﺭﺩ, ﺭﺍﺰﻓﺍﻡﺮﻧ
ﯽﻤﺳﺍ: ﻥﺪﻧﺍﺮﭼ, ﻩﺪﺷﻦﯿﯿﻌﺗ, ﻝﺩﺎﻌﺗ
ﯽﺘﯾﺎﺿﺭﺎﻧ: 
ﺖﻧﻮﻔﻋ: ﻩﺩﻮﻟﺁ, ﯽﻧﻮﻔﻋ, ﻝﺎﻘﺘﻧﺍ, ﻝﺎﻘﺘﻧﺍ, ﯽﻧﻮﻔﻋ
ﻦﺘﺧﺍﺪﻧﺍﻻﺎﺑﺍﺭﻪﻧﺎﺷ: ﯽﻧﺎﻬﮔﺎﻧﺶﺸﮐﺎﯾﺖﮐﺮﺣ
ﻝﺎﺒﺗﻮﻓ: ﻝﺎﺒﺗﻮﻓ, ﻥﺩﺯﺪﮕﻟ, ﻢﯿﺴﻠﮐ
ﻡﺎﮕﺸﯿﭘ: ﮒﺭﺰﺑ, ﺪﺟﻮﻣﻭﻭﺮﺸﯿﭘ
ﯽﻌﯿﺒﻃﺮﯿﻏ: ﻝﻮﻤﻌﻣﺮﯿﻏ, ﻩﺮﻈﺘﻨﻣﺮﯿﻏ, ﻞﺧ, ﻩﺩﺎﻌﻟﺍﻕﺭﺎﺧ, ﺰﯿﻣﺁﻕﺍﺮﻏﺍ, ﻩﺩﺎﻌﻟﺍﻕﻮﻓ, ﻝﺁﻩﺪﯾﺍ, ﺩﺮﻔﻣ
ﻑﺬﺣ: ﺽﺮﻓﺶﯿﭘﺭﻮﻃﻪﺑ, ﻩﺎﺒﺘﺷﺍ, ﺩﻮﺒﻤﮐ, ﯼﺭﺎﮕﻧﺍﻞﻬﺳ, ﯽﻬﺟﻮﺗﯽﺑ, ﻑﺬﺣ
ﺭﺎﺸﻓ: ﻍﻮﻠﺷ, ﺭﺎﺸﻓ, ﻥﺩﺮﮐﻁﻮﻠﺨﻣ, ﺶﻫﺎﮐ, ﺭﺎﺸﻓ, ﺭﺎﺸﻓ, ﻥﺪﺷﻪﻟ, ﻢﻬﻓ, ﮓﻨﭼ
ﺪﺻﺭﺩ: ﺪﺻﺭﺩ, ﺪﺻﺭﺩ
ﺎﻫﺍﺪﺻﺩﻮﺧ: 
ﻡﺮﻫﺍ: 
ﺏﺎﺴﺣﺯﺍﺖﺷﺍﺩﺮﺑ: ﺖﺸﮔﺮﺑ, ﺖﻓﺮﺴﭘ, ﯽﻨﯿﺸﻧﺐﻘﻋ, ﺰﯾﺮﭘ, ﻥﺍﻮﺧﺍﺮﻓ, ﻪﺠﯿﺘﻧ, ﺝﺎﺘﻨﺘﺳﺍ, ﺪﯿﻟﻮﺗ, ﻡﻮﻬﻔﻣ, ﻥﺪﯿﺸﮐﺭﺎﻨﮐ, ﻊﻤﺟ
ﺭﻮﺗﺎﻨﺳ: 
ﻪﭼﺭﻮﻣ: 
ﻪﻠﻣﺎﺣ: ﯼﺭﺩﺎﻣ, ﺭﻮﺼﺗ
ﺯﻭﺭﺮﻫ: ﻪﻧﺍﺯﻭﺭ
ﻥﺩﺮﮐﻊﯾﺮﺴﺗ: ﺵﺭﺎﺑ, ﺏﻮﺳﺭ, ﺖﻋﺮﺳ, ﯼﺭﻮﻓ, ﻥﺪﯿﺸﺨﺑﺖﻋﺮﺳ
ﺮﯿﻐﺘﻣ: ﺕﻭﺎﻔﺘﻣ, ﯼﺎﻫﺮﯿﻐﺘﻣ, ﯽﻧﺎﻬﺟ, ﺭﺎﯿﺳ
ﺪﻌﺠﻣ: ﻪﻘﻠﺣ, ﺏﺎﺗﺮﭘ, ﺭﺎﻣﻮﻃ, ﭻﯿﭘﺭﺎﻣ
ﺩﺮﮔﻮﮔ: ﺩﺮﮔﻮﮔ, ﻪﺘﺴﮑﺷ
ﯼﺎﻫﺭﺎﻗ: ﻩﺭﺎﻗ
ﻥﺩﺮﮐﻪﺘﮑﯾﺩ: ﻞﻤﻌﻟﺍﺭﻮﺘﺳﺩ, ﻥﺎﻣﺮﻓ
ﻪﻏﺎﺑﺭﻮﻗ: 
ﻩﺯﺍﺪﻧﺍﺯﺍﺶﯿﺑﺩﺭﻮﻣ: 
ﻥﺩﺮﮐﺏﺎﯿﺳﺁ: ﻢﯿﻧ, ﻪﻤﯿﻧ
irrealisﺖﻟﺎﺣ: 
ﻪﻧﺎﺧﻞﺧﺍﺩﺭﺩ: ﯽﻠﺧﺍﺩ, ﻞﺧﺍﺩ, ﺩﻭﺪﺣﺭﺩ،ﻞﺧﺍﺩﺭﺩ
ﯼﺭﺍﺩﺮﺑﻩﺮﻬﺑ: ﻩﺩﺎﻔﺘﺳﺍ, ﻥﺪﺷﺏﺬﺟ, ﺖﯿﻘﻓﻮﻣ, ﻒﺸﮐ, ﺖﻗﺮﺳ, ﺏﺬﺟ
ﯽﺳﺎﻨﺷﻦﯿﻣﺯ: ﻦﯿﻣﺯﺮﯾﺯ
ﻪﻣﺎﻧﺭﺬﮔ: 
ﺪﺳﺎﻓ: ﺮﯾﺮﺷ, ﺪﺳﺎﻓ
ﺖﯾﻮﮑﺴﯿﺑ: ﯽﻨﯾﺮﯿﺷ
ﯼﺭﺎﮑﻤﻫ: ﻥﺩﺮﮐﯼﺭﺎﮑﻤﻫ, ﺖﮐﺭﺎﺸﻣ, ﻡﺎﻏﺩﺍ, ﯼﺭﺎﮑﻤﻫ, ﻢﻬﺳ
ﻞﻌﺟ: ﻦﺘﺧﺎﺳ, ﻖﻠﻄﻣ, ﻞﯿﮑﺸﺗ, ﻥﺩﺭﻭﺁﺩﻮﺟﻭﻪﺑ, ﻥﺩﻭﺮﺳ, ﺪﯿﻟﻮﺗ, ﺭﺩﻥﺩﺮﺑﺖﺳﺩ, ﺖﻧﻮﻓ, ﺭﺍﺮﮑﺗ
ﻢﺗﺍ: ﯽﻤﺗﺍ, ﻩﺭﺫ, ﯼﺩﺮﻓ
ﺯﺪﯾﺍ: ﮏﻤﮐ, ﻦﯿﮑﺴﺗ
ﺪﻨﺴﭘﻞﮑﺸﻣ: ﻒﯾﺮﻇ, ﻩﺪﻨﻫﺩﺭﺍﺯﺁ
ﻡﺮﻫ: 
ﯽﻧﻮﻧﺎﻗﺮﯿﻏ: ﯽﻧﻮﻧﺎﻗﺮﯿﻏ, ﺮﯿﻏ
ﯽﯾﻭﺮﻤﮐ: ﯽﺘﻟﺎﺠﺧ, ﺽﺎﺒﻘﻧﺍ
ﺩﻮﻋ: ﺞﮐ
ﯽﺳﺎﻨﺷﻩﺭﺎﺘﺳ: 
ﻢﺧﻭﭻﯿﭘ: ﻡﺎﻬﺑﺍ
ﯽﻠﯿﺼﺤﺗﺱﺭﻮﺑ: ﺖﯾﺎﻤﺣ, ﻩﺰﯾﺎﺟ
ﺮﺒﯿﻓ: ﺮﺒﯿﻓ, ﻪﺘﺴﺑ, ﺐﺼﻌﺗ
ﮎﺮﯿﺟﺮﯿﺟ: 
ﺮﺗﻮﺒﮐ: 
ﻕﺎﺒﻄﻧﺍ: ﻕﺎﺒﻄﻧﺍ, ﯽﻧﺩﺮﮐﺐﺼﻧﻡﺯﺍﻮﻟ, ﻕﺎﺒﻄﻧﺍ, ﺡﻼﺻﺍ, ﻥﺩﺮﮐﻢﯿﻈﻨﺗ, ﻱﺯﺎﺳﻪﻨﻴﻬﺑ, ﯽﻗﺎﺒﻄﻧﺍ, ﺖﻣﺎﻗﺍﻞﺤﻣ
ﺩﺭ: ﻥﺩﺮﮐﺩﺭ, ﻥﺎﺷﺩﻮﻨﺸﺧﺎﻧ, ﺖﻔﻟﺎﺨﻣ, ﻒﻟﺎﺨﻣ, ﺽﺍﺮﺘﻋﺍ, ﻩﺪﻧﺭﺎﻤﺷ, ﻒﯾﺮﺣ, ﻒﻟﺎﺨﻣ, ﺩﺭ, ﺩﺭ, ﺩﺭ, ﺩﺭ, ﺩﺭ, ﻥﺩﺮﮐﺖﯾﺫﺍ, ﯽﺑﺮﻣ, ﻥﺩﺮﮐﻝﻮﺒﻗ, ﻥﺩﻮﺑﻒﻟﺎﺨﻣ
ﺭﻮﺗﺍﺮﭘﺍ: ﻞﻣﺎﺣ
ﺵﻮﮔﻪﺳ: 
ﺭﺍﺩﻪﻧﺍﺰﺧ: ﺭﺍﺪﻗﻭﺪﻨﺻ
ﻥﮊﻭﺭﺪﯿﻫ: 
ﺮﮕﭘﺎﭼ: 
ﻥﺩﺮﮐﻪﻔﺧ: ﭻﮔ
ﻦﻣﺰﻣ: ﻡﻭﺎﻘﻣ, ﯼﺪﺟ, ﺪﯾﺪﺷ, ﯼﺩﺎﯾﺯﺪﺣﺎﺗ, ﻁﺮﻔﻣ, ﺩﺎﺣ, ﺪﯾﺪﺸﺗ
ﻪﻠﺑﺎﻘﻣ: ﺩﺭﻮﺧﺮﺑ, ﻕﺎﺒﻄﻧﺍ, ﺎﺑﻥﺪﺷﻭﺮﺑﻭﺭ, ﻑﺍﺮﺤﻧﺍ, ﺮﺑﻪﺒﻠﻏ, ﺎﺑﺩﺭﻮﺧﺮﺑ, ﻪﻠﺑﺎﻘﻣ, ﻪﻣﺎﻧﻢﻫﺎﻔﺗ, ﻥﺩﺍﺩﻡﺎﺠﻧﺍ
ﯽﻫﺍﺭﻭﺩ: ﻢﮔﺭﺩﺮﺳ, ﻩﺪﻨﻨﮐﺞﯿﮔ
ﻪﻧﺎﺸﻧ: ﻪﻧﺎﺸﻧ, ﺩﺎﻬﻨﺸﯿﭘ, ﻥﺩﺍﺩﺶﯾﺎﻤﻧ, ﻩﺎﮕﺸﯾﺎﻤﻧ, ﻪﺋﺍﺭﺍ, ﻩﺪﯾﺪﭘ, ﯽﺼﯿﺨﺸﺗ, ﻡﺭﺪﻨﺳ, ﻪﺼﺨﺸﻣ
ﻪﺧﺮﭼﻭﺩ: ﻪﺧﺮﭼﻭﺩ, ﻱﺭﺍﻮﺳﻪﺧﺮﭼﻭﺩ, ﻪﺧﺮﭼ, ﻥﺪﺷﺭﺍﻮﺳ
ﯽﺳﺪﻨﻬﻣ: ﮏﯿﻨﮑﺗ, ﯽﻨﻓﻅﺎﺤﻟﺯﺍ, ﮏﯿﻧﺎﮑﻣ
ﭻﯿﭘﺭﺎﻣ: ﭻﯿﭘﺭﺎﻣ, ﺶﺧﺮﭼ
ﻦﯿﺑﺭﻭﺩ: ﻕﺎﺗﺍ
ﺹﺎﻗﺭ: 
ﭺﻮﮐ: ﺕﺮﺟﺎﻬﻣ, ﺕﺮﺟﺎﻬﻣ
ﺲﯿﻨﺗ: 
ﺩﺎﺘﻌﻣ: ﻪﺘﺴﺑﺍﻭ, ﯽﮕﺘﺴﺑﺍﻭ, ﺩﺎﻤﺘﻋﺍ, ﻩﺩﺮﺑ
ﺖﻓﺎﺑ: ﻦﺘﻓﺎﺑﻭﻥﺪﯿﺑﺎﺗﻢﻬﺑ, ﻩﺮﮔ, ﯽﮔﺪﻨﻓﺎﺑ, ﺖﻓﺎﺑ, ﺖﻓﺎﺑ
ﺕﺍﺮﻘﻓﻥﻮﺘﺳ: 
ﻥﺩﺮﮐﺥﺮﺳ: ﺵﻮﺟ
ﻥﺩﺮﮐﻞﯿﻬﺴﺗ: ﺞﯾﻭﺮﺗ, ﮏﯾﺮﺤﺗ, ﺏﺎﺘﺷ, ﺮﺘﺳﺎﻓ, ﺖﻟﻮﻬﺳ, ﻥﺩﺮﮐﻩﺩﺎﺳ, ﻥﺎﮑﻣﺍ, ﺭﺍﺰﺑﺍ, ﻥﺩﺮﺑﻦﯿﺑﺯﺍ
ﻥﺩﺯﻢﺧﺯ: ﺶﯿﻧ, ﻥﺩﺮﮐﺥﺍﺭﻮﺳ, ﻦﺘﻓﺮﮔ, ﺶﺷﻮﮐ, ﺵﻼﺗ
ﺭﻮﺒﻋﺰﻣﺭ: ﻝﺎﻨﮕﯿﺳ, ﻒﺻ, ﺭﺎﻌﺷ, ﻦﻣ, ﺪﮐ
ﻩﺮﮑﻤﯿﻧ: ﻥﺎﺸﻧﺮﻃﺎﺧ, ﻡﺎﻌﻧﺍ
ﻩﺩﺮﺴﻓﺍ: ﻩﺪﻨﻨﮐﺪﯿﻣﺍﺎﻧ, ﻩﺩﺮﺴﻓﺍ, ﻥﺩﺮﮐﺩﺮﺴﻟﺩ, ﻢﻏ, ﮏﯾﺮﺤﺗ
ﯼﮋﺗﺍﺮﺘﺳﺍ: ﮏﯾﮋﺗﺍﺮﺘﺳﺍ, ﺎﻫﯼﮋﺗﺍﺮﺘﺳﺍ, ﺖﺳﺎﯿﺳ
ﺖﺸﮔ: ﻪﻣﺎﻨﻫﺎﮔ, ﻦﯾﺰﻨﺑ
ﯽﻌﯿﺒﻃﻝﺎﭽﺨﯾ: 
ﻩﺍﺭﻪﻤﯿﻧ: ﻢﯿﻧ, ﯼﺪﺣﺎﺗ, ﻪﻤﯿﻧ
ﺖﺷﺍﺩﺩﺎﯾ: ﻩﺪﻫﺎﻌﻣ, ﯼﺭﺎﮐﺩﺍﺩﺭﺍﺮﻗ, ﺩﺍﺩﺭﺍﺮﻗ, ﻖﻓﺍﻮﺗ, ﻢﮑﺣ, ﯽﮔﺪﻨﯾﺎﻤﻧ
ﻁﻭﺮﺨﻣ: 
ﻥﺭﺎﻘﺗ: 
ﻊﻓﺍﺪﻣ: ﻊﻓﺍﺪﻣ, ﻒﻟﺎﺨﻣ
ﺪﺠﺴﻣ: 
ﺯﻭﺰﮔﺍ: ﺮﺸﻧ, ﻦﺘﺧﺍﺪﻧﺍﻥﻭﺮﯿﺑ
ﺞﻧﺮﻄﺷ: 
ﻪﺘﺴﻫ: ﯽﻤﺗﺍ, ﻝﻮﻠﺳ, ﺖﯿﻫﺎﻣ, ﻪﺘﺴﻫ, ﯼﺰﮐﺮﻣ, ﻦﯿﻨﺟ, ﯽﻨﯿﻨﺟ, ﻪﺘﺴﻫ, ﻩﺩﺎﻣ
ﺱﻼﯿﮔ: 
ﻥﺩﺭﻮﺧﻮﻠﺗﻮﻠﺗ: ﻥﺩﺮﮐﺰﯿﺧﻭﺖﺴﺟ
ﻥﻮﯿﻣﺎﮐ: ﻥﻮﯿﻣﺎﮐ, ﯼﺭﺎﺑ, ﺮﯿﺴﻣ
ﻢﻴﺳﻲﺑ: ﻮﯾﺩﺍﺭ
ﺝﺍﺮﺣ: ﺵﻭﺮﻓ
ﻝﺎﺑﺮﻏ: ﯽﯾﺍﺩﺯﻝﺎﮑﺷﺍ
ﻥﺍﺯﺮﻟ: ﺕﺎﺒﺛﯽﺑ, ﯽﺗﺎﺒﺛﯽﺑ, ﯽﻌﻄﻗﺮﯿﻏ, ﺏﺮﻄﻀﻣ, ﺭﺍﺮﻗﻲﺑ
ﻥﺩﺯﮏﻣ: ﻥﺪﺷﺏﺬﺟ, ﻥﺩﺭﻮﺧﺲﯿﺧ
ﻪﻧﺎﺘﺳﻭﺩﺮﯿﻏ: ﻥﺎﺑﺮﻬﻣﺎﻧ, ﻢﺻﺎﺨﺘﻣ, ﺮﻀﻣ, ﺭﻭﺁﻥﺎﯾﺯ
ﯼﺭﺎﻤﺷﺮﺳ: ﻪﺒﺳﺎﺤﻣ
ﻪﺠﻨﭘﮎﻮﻧ: ﻪﺠﻨﭘ, ﻥﺩﻮﺑﻩﺩﺎﻣﺁ, ﻞﯾﺎﻣ
ﺵﺎﺑﻡﻭﺭﺁ: ﺶﺨﺑﺶﻣﺍﺭﺁ, ﻡﺍﺭﺁ, ﺏﺎﺼﻋﺍﺩﺪﻤﺗ, ﺖﻏﺍﺮﻓ, ﻥﺩﺮﺑﻦﯿﺑﺯﺍ
ﯽﮕﺘﺳﻮﯿﭘ: ﻡﻭﺍﺪﻣﺭﻮﻃﻪﺑ, ﻪﻣﺍﺩﺍ, ﯽﮕﺘﺳﻮﯿﭘ
ﺏﺎﺒﺣ: 
ﺭﺎﺘﯿﮔ: .ﻩﺮﯿﻏﻭ
ﺐﺼﻌﺗ: ﺢﯿﺟﺮﺗ, ﺐﺼﻌﺗ, ﻑﺍﺮﺤﻧﺍ
ﻕﺍﺮﺑ: ﻦﺷﻭﺭ, .ﺢﺒﺻ, ﻥﺎﺸﺧﺭﺩ
ﻪﮐﻡﺍﺪﮐﺮﻫ: ﺮﻫ, ﻪﭼﺮﻫ, ﻪﮐ, ﻪﮐﯽﺴﮐﺮﻫ, ﻥﺎﯿﻣﺭﺩ, ﺏﺁﺮﯾﺯ
ﯽﻨﺘﻓﺎﺑ: ﯽﮔﺪﻨﻓﺎﺑ, ﻩﺮﮔ, ﻦﺘﻓﺎﺑﻭﻥﺪﯿﺑﺎﺗﻢﻬﺑ
ﻦﺘﻓﺮﮔﺝﻭﺍ: ﯼﻭﺭﻩﺩﺎﯿﭘ, ﺭﻭﺎﻨﺷ, ﻮﻠﮔ, ﺯﺍﻭﺮﭘ, ﻑﻭﺮﻌﻣ, ﺢﻄﺳ, ﺎﻤﯿﭘﺍﻮﻫ, ﺎﻤﯿﭘﺍﻮﻫ, ﯽﯾﺎﻤﯿﭘﺍﻮﻫ
ﺮﯿﻤﺿﺮﮕﻧﺎﺸﻧ: 
ﻪﯾﻭﺩﺍ: ﻩﺰﻣ
ﺖﻧﺎﻤﺿ: ﻪﺿﺮﻗﻕﺍﺭﻭﺍ, ﻦﯿﻤﻀﺗ, ﻭﺮﮔ, ﺖﻧﺎﻤﺿ, ﻦﻣﺎﺿ, ﺮﻫﺍﻮﺟ, ﺮﻫﻮﮔ
ﻦﺘﺧﺍﺪﻧﺍﺖﺳﺩﺍﺭﯽﺴﮐ: ﻥﺩﺮﮐﺍﻮﻏﺍ, ﻥﺩﺮﮐﮏﯾﺮﺤﺗ, ﮏﯾﺮﺤﺗ, ﻥﺩﺮﮐﺏﻭﺬﺠﻣ
ﻩﻭﺎﺟ: 
ﻞﻤﻌﻟﺍﺭﻮﺘﺳﺩ: ﺵﻭﺭ, ﮎﺮﺤﻣ, ﻪﺨﺴﻧ, ﻝﻮﻣﺮﻓ, ﻞﻤﻌﻟﺍﺭﻮﺘﺳﺩ, ﻥﺍﻮﺨﻤﻫ
ﻥﺩﺯﻢﺨﺷ: ﻥﺩﺮﻛﻞﺣ, ﻥﺩﻮﺑﺭ
ﻥﺪﺷﻩﺮﻄﻗﻩﺮﻄﻗ: ﯽﺸﮐﻩﺯ
ﺭﺍﺩﻪﻟﺎﺒﻧﺩﻩﺭﺎﺘﺳ: ﻒﻠﺨﺘﻣ
ﯼﺭﻭﺁﻮﻧ: ﻒﺸﮐ, ﻉﺍﺮﺘﺧﺍ
ﯽﻄﺳﻭﻥﻭﺮﻗ: ﻪﻤﯿﻧ
ﯽﺘﻨﯾﺯ: ﻦﯿﯾﺰﺗ, ﻥﺩﺮﮐﻦﯿﺋﺰﺗ, ﯽﺘﺷﺍﺪﻬﺑﻭﯽﺸﯾﺍﺭﺁﻡﺯﺍﻮﻟ
ﮏﯿﺘﺳﻼﭘ: 
ﯽﻗﺭﻭﺎﭘ: 
ﺕﺎﯿﻨﺒﻟ: ﺮﯿﺷ, ﯽﻟﻮﻤﻌﻣ, ﻢﻈﻨﻣ
ﻒﻠﮔ: 
ﺮﻔﺻ: nullﺭﺍﺪﻘﻣ, ﯽﻟﺎﺧ
ﭗﯾﺯ: ﻥﺩﺮﮐﻩﺩﺮﺸﻓ
ﻪﺷﺎﻣ: 
ﻪﺷﺍﺮﺗ: ﻪﻌﻄﻗ, ﻪﻌﻄﻗ, ﻪﮑﺗ, ﻪﮑﺗ
ﻥﺩﺮﮐﻢﺘﺳ: ﻥﺩﺮﮐﺏﻮﮐﺮﺳ, ﻥﺩﺮﮐﺏﻮﮐﺮﺳ, ﻥﺩﺮﮐﻩﺩﺮﺴﻓﺍ, ﻥﺩﺮﮐﻝﺎﻤﯾﺎﭘ, ﻥﺩﺍﺩﻡﺎﻨﺷﺩ
ﻩﺯﺎﯿﻤﺧ: ﻥﺪﺷﺭﺎﺨﺑ
ﯼﺮﺑﺍﺮﺑﺎﻧ: 
ﻝﺎﺧ: ﺱﺭﮎﺎﺧ
ﯼﺮﮕﻟﺎﻔﺳ: ﮎﺎﺧ, ﺱﺭﮎﺎﺧ
ﺭﺍﺩﻪﻧﺎﺧﻢﻧﺎﺧ: 
ﯽﻘﻄﻨﻣﺮﯿﻏ: ﻞﯿﻟﺩﯽﺑ
ﺶﯿﺧ: ﯽﺋﺰﺟ
ﺮﻤﺨﻣ: ﻢﯾﺰﻧﺁ, ﺮﯿﻤﺧ, ﯽﻨﯾﺮﯿﺷ
ﻥﺩﺮﮐﻊﻄﻗ: ﺭﺎﻬﻣ, ﺎﺑﺩﺭﻮﺧﺮﺑ
ﻪﻤﯿﺑﻖﺣ: ﻩﺰﯾﺎﺟ, ﻩﺰﯾﺎﺟ, ﻩﺰﯾﺎﺟ
ﻪﻨﯾﺰﮔ: ﻦﯾﺰﮕﯾﺎﺟ, ﻦﯿﺸﻧﺎﺟ, ﺏﻭﺎﻨﺘﻣ, ﺭﺎﯿﺧ, ﺏﺎﺨﺘﻧﺍ, ﺏﺎﺨﺘﻧﺍ, ﺮﮕﯾﺩﻉﻮﻧ, ﻢﻫﺩﯽﻣﺢﯿﺟﺮﺗ, ﺢﯿﺟﺮﺗ, ﯼﺭﺎﯿﺘﺧﺍ, ﯽﻨﯾﺰﮕﯾﺎﺟ, ﻝﺎﺤﺷﻮﺧ
ﻞﯿﺼﺤﺘﻟﺍﻍﺭﺎﻓ: ﻥﺎﺤﺘﻣﺍ, ﻥﺩﺮﮐﯽﻃ
ﯽﮕﺘﺴﮑﺷﺭﻭ: ﺖﺴﮑﺷ
ﯼﺭﺎﯿﺑﺍ: 
ﺭﺍﺩﻪﯾﺎﻣﺮﺳ: ﯼﺭﺍﺩﻪﯾﺎﻣﺮﺳ
ﯽﻋﺎﺠﺗﺭﺍﺖﯿﻠﺑﺎﻗ: ﯼﺮﯾﺬﭘﻑﺎﻄﻌﻧﺍ
ﻪﺳﺪﻨﻫ: ﯽﺳﺪﻨﻫ
ﯽﻫﺎﻣﻪﺳﻮﮐ: 
ﯼﺯﺎﺳﻩﺮﯿﺧﺫ: ﻆﻔﺣ, ﻭﺮﺴﻨﮐ, ﻩﺎﮕﺷﻭﺮﻓ, ﻥﺩﺮﮐﯽﯾﻮﺟﻪﻓﺮﺻ
ﻪﻧﺎﺘﺨﺒﺷﻮﺧ: ﺯﺍﺪﻧﺍﻢﺸﭼ, ﺭﺎﻈﺘﻧﺍ, ﯽﻨﯿﺑﺵﻮﺧ
ﯽﯾﺍﺮﮔﻊﻗﺍﻭ: 
ﺲﻧﻻﻮﺒﻣﺍ: 
ﻝﻮﭘﻒﯿﮐ: ﻝﻮﭘﻒﯿﮐ, ﻡﺎﻘﻣ
ﻝﻮﺻﺍﻭﺍﺩﺍ: ﻥﺍﻮﯿﻟ, ﺪﻨﺧﺯﻮﭘ, ﻥﺩﺭﻮﺧﻝﻮﻟ
ﺪﻨﻤﺸﻧﺍﺩ: ﯽﻤﻠﻋ, ﻩﻭﮋﭘﺶﻧﺍﺩ, ﻩﻭﮋﭘﺶﻧﺍﺩ, ﻖﻘﺤﻣ, ﺱﺎﻨﺷﺖﺴﯾﺯ
ﻩﺩﻭﺭﻭﻝﺩ: ﻩﺩﻭﺭ
ﺖﻧﺎﺘﻣ: 
ﻦﯿﺑﻊﻗﺍﻭ: ﯽﻌﻗﺍﻭ, ﺖﺳﺭﺩ, ﺎﻌﻗﺍﻭ, ﻊﻗﺍﻭﺭﺩ, ﯽﺘﺳﺍﺮﺑ, ﻕﺩﺎﺻ, ﯽﻠﻤﻋ, ﯽﻌﻗﺍﻭ, ﺢﯾﺮﺻ
ﻂﺒﺗﺮﻣﺮﯿﻏ: ﺾﻗﺎﻨﺘﻣ, ﺐﺳﺎﻨﻣﺎﻧ, ﺲﻧﺎﺠﺘﻣﺎﻧ, ﺖﯿﻤﻫﺍﯽﺑ
ﺕﺎﺑﻮﺒﺣ: ﻩﺮﻬﻣ, ﻲﻨﻴﻣﺯﻡﺍﺩﺎﺑ, ﺕﺎﺑﻮﺒﺣ
ﯽﻤﺳﺭﺮﯿﻏ: ﯽﻤﺳﺭ, ﯽﻤﺳﺭﺭﻮﻃﻪﺑ
ﻩﻮﻧ: ﻩﻮﻧ, ﻩﻮﻧ, ﻩﺩﺍﺯﺮﻫﺍﻮﺧ, ﻞﺴﻧ
ﮏﯿﺘﺳﺍ: ﻥﺩﺮﮐﻪﮑﺗ
ﻥﮊﻭﺮﺘﯿﻧ: 
ﺮﻏﺮﻏ: ﻥﺩﺮﮐﻪﻣﺰﻣﺯ
ﺕﻮﺗ: ﺕﺍﺮﺟﻭﻝﺩ, ﺰﻣﺮﻗﻪﺑﻞﯾﺎﻣﺥﺮﺳ
ﻞﯿﻠﺤﺗﻭﻪﯾﺰﺠﺗ: ﻪﯾﺰﺠﺗ, ﯽﻠﯿﻠﺤﺗ, ﻞﯿﻠﺤﺗﻭﻪﯾﺰﺠﺗ, ﻞﯿﻠﺤﺗ
ﺩﺎﻀﺘﻣ: ﺩﺎﻀﺗ, ﻪﻠﺑﺎﻘﻣ, ﺾﻗﺎﻨﺘﻣ, ﻒﻟﺎﺨﻣ, ﻒﻟﺎﺨﻣ, ﻥﺩﺍﺩﺰﯿﻤﺗ, ﻥﺪﺷﻞﺋﺎﻗﺾﯿﻌﺒﺗ, ﻕﺍﺮﺘﻓﺍ, ﺰﯾﺎﻤﺘﻣ, ﻉﻮﻨﺘﻣ
ﯼﺯﺎﺑﺶﺗﺁ: ﻁﺮﺷ, ﯼﺪﻨﺑﻁﺮﺷ, ﻪﻠﻌﺷ
ﭖﺎﭘ: ﯽﻧﺎﻬﮔﺎﻧﻭﻢﮑﺤﻣﻪﺑﺮﺿ, ﺭﺎﺠﻔﻧﺍ
ﻥﺩﺮﮐﻥﺎﯾﺮﻋ: ﺭﺍﻮﻧ, ﺎﻫﺱﺎﺒﻟ
ﻩﺪﻨﻨﮐﻞﯿﻤﮑﺗ: ﻞﻤﮑﻣ, ﻥﺩﺮﮐﺰﻬﺠﻣ, ﻪﻓﺎﺿﺍ, ﻞﻤﮑﻣ
pegativeﺩﺭﻮﻣ: 
ﻥﺎﻃﺮﺳ: 
ﻭﺮﮔ: ﻦﻫﺭ, ﺯﺎﺑﺮﺳ, ﻭﺮﮔ
ﺖﺸﻧ: ﺖﺸﻧ, ﻥﺎﯾﺯ, ﻥﺩﺮﮐﺎﻫﺭ
ﻢﮐﺍﺮﺗ: ﻍﻮﻠﺷ, ﺕﺪﺷ
ﻥﺪﯾﻮﺟ: 
ﯽﮔﺪﯿﭽﯿﭘ: ﺽﺭﺍﻮﻋ
ﻑﺮﺣﺮﭘ: ﯽﻃﺎﺒﺗﺭﺍ, ﺯﺮﻓ
ﻥﺩﺮﮐﻪﺋﺮﺒﺗ: ﻑﺎﻌﻣ, ﯽﯾﺎﻫﺭ, ﺮﺷﺯﺍﻥﺪﺷﺹﻼﺧ, ﻥﺩﺮﺑﻦﯿﺑﺯﺍ, ﯽﮕﺘﺴﯾﺎﺷ
ﯽﺒﻄﻗ: ﻁﺮﻔﻣ, ﺐﻄﻗ
ﻒﯿﻔﺨﺗ: ﺖﯿﻓﺎﻌﻣ, ﺵﻭﺮﻓ, ﺯﺎﯿﺘﻣﺍ, ﺽﺮﻓ
ﯽﺴﮐﺎﺗ: ﯽﺴﮐﺎﺗ
ﺐﺗﺍﺮﻣﻪﻠﺴﻠﺳ: ﯼﺮﺒﻫﺭ, ﻢﺘﺴﯿﺳ, ﺖﺸﮔﺯﺎﺑ
ﻥﺩﺮﮐﻪﭼﻭﺮﻗﻥﺍﺪﻧﺩ: 
ﻩﺩﺎﺳﻡﺩﺁ: ﯽﻄﺧ, ﻩﺩﺎﺳ
ﺖﺳﺎﯾﺭ: ﯼﺭﻮﻬﻤﺟﺖﺳﺎﯾﺭ
ﺭﺍﺪﯾﺮﺧ: ﯼﺮﺘﺸﻣ
ﻦﻟﺎﮔ: 
ﻪﺸﭘ: 
ﺮﺑﻥﺩﺮﮐﯼﺯﻮﺴﻟﺩ: ﻥﺩﺮﮐﻪﯾﺮﮔ, ﻥﺩﺮﮐﻡﻮﮑﺤﻣ, ﻥﺪﺷﻥﺎﻤﻴﺸﭘ
ﻑﺍﺮﺤﻧﺍ: ﻑﺍﺮﺤﻧﺍ, ﺝﺎﺟﻮﻋﺍ, ﻑﺍﺮﺤﻧﺍ, ﯼﺰﯿﭼﻪﯾ
ﮏﯿﯾﺍﺯﻮﻣ: ﻉﻮﻨﺘﻣ
ﻦﯿﮔﻼﭘ: ﻝﺎﺼﺗﺍ, ﺪﻨﺳ
ﯼﺭﺍﺩﺭﺎﺑ: ﺭﻮﺼﺗ, ﺭﻮﺼﺗ, ﻞﻤﺣ, ﺭﺎﺑ
ﺭﺎﺑﺭﺍﻮﺧ: 
ﺖﺴﯿﻧﻮﻤﮐ: 
ﻥﺩﺮﮐﺕﺎﻣ: ﻩﺪﻨﻨﮐﺮﯿﮕﻠﻓﺎﻏ, ﺭﻭﺁﺖﻔﮕﺷ, ﻩﺪﻨﻨﮐﻩﺮﯿﺧ, ﻥﺩﺮﮐﻩﺍﺮﻤﮔ, ﻥﺩﺮﮐﺞﯿﮔ, ﻥﺩﺮﮐﺲﺣﯽﺑ, ﻥﺩﺮﮐﺕﺎﻣ, ﺐﺠﻌﺘﻣ
prosecutiveﺩﺭﻮﻣ: 
ﺭﻮﺗﺎﺘﮑﯾﺩ: 
ﯽﮕﺘﻔﯿﺷ: ﻡﺍﺪﺨﺘﺳﺍ, ﺏﺍﺮﻄﺿﺍ, ﻥﺩﻮﺑﻥﺍﺮﮕﻧ, ﻪﻗﻼﻋ
ﻩﺭﺍﻮﻫﺎﻣ: ﺮﮕﺷﻭﺎﮐ
ﯽﺒﯾﺮﻘﺗ: ﺐﯾﺮﻘﺗ, ﺎﺒﯾﺮﻘﺗ, ﯽﺒﯾﺮﻘﺗ, ﺎﺒﯾﺮﻘﺗ, ﻼﻤﻋ, ﺩﻭﺪﺣﺭﺩ, ﺎﺒﯾﺮﻘﺗ
ﺭﺎﮐﯽﺑ: ﻡﺍﺪﺨﺘﺳﺍ
ﯼﺯﺎﺳﻩﺩﺎﯿﭘ: ﯼﺯﺎﺳﻩﺩﺎﯿﭘ, ﯼﺍﺮﺟﺍ, ءﺍﺮﺟﺍ, ﺍﺮﺟﺍ, ﻥﺩﺮﮐﺍﺮﺟﺍ
ﺯﺎﯿﭘ: ﺯﺎﯿﭘ, ﻪﮑﻠﻓﺮﯿﺷ
ﯽﻣﺎﺣ: ﺭﺎﯿﺘﺳﺩ, ﻞﻤﺤﺗ, ﺏﻼﻗ
ﺭﺪﺳﺖﺧﺭﺩ: ﻖﺒﻧﺯ
ﺪﯾﺮﻠﮐ: 
ﯼﺮﺘﮐﺎﺑ: ﭺﺭﺎﻗ, ﯼﺮﺘﮐﺎﺑ
ﻪﮑﺒﺷ: ﻮﮕﻟﺍ
ﯽﺘﺴﯾﺯ: ﺩﻮﺟﻮﻣ, ﯽﺳﺎﻨﺷﺖﺴﯾﺯ
ﻥﺩﺮﮐﻞﻌﺟ: ﺮﻫﺎﻈﺗ, ﯼﺯﺎﺳﻪﯿﺒﺷ
ﺖﯾﺎﺑ: 
ﺢﺷﺮﺗ: ﻥﺩﺮﮐﻥﺎﻬﻨﭘ
ﻪﻟﺎﺑ: ﻪﻟﺎﺑ, ﯼﺍﺭﻪﻗﺭﻭ
ﺭﺍﺭﺩﺍ: ﺵﺎﺷ
ﺮﯿﺳ: 
ﻂﺳﻮﺘﻣﻪﻘﺒﻃ: 
ﯽﯾﻮﺸﮑﺸﺧ: ﯽﯾﻮﺸﺳﺎﺒﻟ
ﻥﺩﺮﮐﺺﺨﺸﻣ: ﻥﺩﺍﺩﺰﯿﻤﺗ, ﺕﺎﯿﺻﻮﺼﺧ
ﯽﮕﻧﺮﻓﺕﻮﺗ: 
ﮎﻮﺑﺕﻮﻧ: ﭖﺎﺗﭗﻟ
ﯽﻟﺎﻌﺘﻣ: 
ﻡﻮﺒﻟﺍ: 
ﻝﺎﺑﺲﯿﺑﯼﺯﺎﺑ: 
ﯽﯾﺎﯾﺭﺩﯼﺩﺯﺩ: 
ﻪﻓﻮﺑ: 
ﯽﻔﺻﻭﻪﺟﻭ: ﻩﺪﻨﻨﮐﺖﮐﺮﺷ, ﻩﺪﻧﻮﺷﺩﺭﺍﻭ
ﮊﺍﺭﺎﮔ: 
ﺺﯿﺨﺸﺗ: ﯽﺼﯿﺨﺸﺗ, ﻥﺩﺍﺩﺺﯿﺨﺸﺗ, ﯽﺘﺧﺎﻨﺷ, ﺺﯿﺨﺸﺗ
ﻥﺩﺮﮐﯼﺫﺎﺧﺍ: ﺪﯾﺪﻬﺗ, ﺕﺍﺮﺟﻭﻝﺩ, ﺩﻭﺪﺤﻣ, ﻥﺩﺮﮐﺮﯾﺰﮔﺎﻧ
ﺮﻔﺴﻓ: 
ﯼﺭﺎﺘﺧﺎﺳ: ﺭﺎﺘﺧﺎﺳ, ﯼﺪﻨﺑﺮﮑﯿﭘ, ﯼﺪﻨﺑﺮﮑﯿﭘ, ﯼﺩﺎﻬﻧ
ﺐﺴﭼ: ﺲﻣﺍﺩﺁ
ﻪﻣﺎﻧﻥﺎﯾﺎﭘ: ﻪﻣﺎﻧﻥﺎﯾﺎﭘ
ﺮﮔﺖﻌﻨﺻ: ﮏﯿﻧﺎﮑﻣ, ﺶﮐﻪﻟﻮﻟ
ﺯﻮﻣ: ﺖﻓﺎﺑ
ﻩﺪﻧﺩ: ﻩﺪﻧﺩ
ﻞﮑﯿﻧ: 
ﺮﺿﺎﺣﻝﺎﺣﺭﺩ: ﻥﻮﻨﮐﺍ, ﺮﺿﺎﺣ, ﯼﺭﺎﺟ, ﻩﺯﻭﺮﻣﺍ, ﻒﺻ
ﺱﻮﺑﻮﺗﺍ: ﺪﯿﻫﺩﻩﺯﺎﺟﺍ
ﯽﭼﺭﻮﺴﻧﺎﺳ: ﺭﻮﺴﻧﺎﺳ, ﺪﻘﺘﻨﻣ
ﮏﺷﻮﻣ: ﮏﺷﻮﻣ
ﺲﯿﺳﻮﺳ: ﮒﺍﺩﺕﺎﻫ
ﯼﺭﺎﮐﺖﺳﺩ: ﻞﻤﻋ, ﻥﺩﺮﮐﯼﺭﺎﮑﺘﺳﺩ, ﯽﺗﺎﯿﻠﻤﻋ, ﻦﻓﻭﺕﻮﻓ, ﻥﺩﺍﺩﺐﯾﺮﻓ, ﯽﮔﺪﯿﺳﺭ, ﺩﺮﮑﻠﻤﻋ, ﺐﻠﻘﺗ
ﻲﮕﻧﺮﻓﻪﺟﻮﮔ: 
ﺖﯾﻮﻘﺗ: ﻥﺩﺮﮐﯽﮑﯾ, ﺪﯾﺪﺸﺗ, ﻥﺩﺮﻛﺪﻴﻳﺎﺗ, ﯼﻮﻗ, ﺖﯾﻮﻘﺗ
ﺏﺪﺤﻣ: 
ﻢﯿﺳﺎﺘﭘ: 
ﺮﺒﺟ: ﯼﺮﺒﺟ
ﺕﺍﺮﻫﺍﻮﺟ: 
ﯼﺮﺼﺑ: ﯼﺮﺼﺑ
ﯼﺭﺎﮑﯿﺑ: ﯽﯾﺍﻮﻧﺎﻧ
ﻥﺩﺮﮐﺡﻼﺳﻊﻠﺧ: ﺡﻼﺳ, ﺡﻼﺳ, ﺢﻠﺴﻣ
ﮏﺗ: ﻪﻧﺎﮔﺍﺪﺟ, ﻩﺩﺎﻌﻟﺍﻕﻮﻓ, ﻪﺘﺴﺴﮔ, ﮎﺎﺧ, ﺲﮐﯽﺑ
ﺮﮔﺭﻭﺮﻣ: ﺮﻨﮑﺳﺍ
ﯽﺨﯾﺭﺎﺗﺖﻔﺳ: 
ﺖﯿﻠﺑﺎﻗ: ﯼﺭﻭﻩﺮﻬﺑ, ﻩﻮﻘﻟﺎﺑﺭﻮﻃﻪﺑ, ﺖﯿﻓﺮﻇ, ﺖﻤﺴﻗﺝﺭﺎﺧ, ﯽﯾﺎﻧﺍﻮﺗ, ﺖﯿﺣﻼﺻ, ﺩﺍﻮﺳ
ﻒﯿﻃ: 
ﻢﯾﺪﺳ: 
ﯼﺮﺘﺴﯿﻫ: ﺞﻨﺸﺗ
ﯽﻟﻮﺘﻣ: ﺮﯾﺪﻣ, ﺭﺍﺩﺎﻓﻭ
ﻥﺎﮔﻭﺮﮔ: ﻦﻫﺭ, ﻭﺮﮔ
ﺭﺎﮑﺷﺯﺭﻭ: ﯽﺿﺎﯾﺭ, ﯽﺷﺯﺭﻭ
ﮎﻭﺮﭼﻭﻦﯿﭼ: ﺺﻘﻧ, ﺐﮑﺗﺮﻣ
ﻞﻣﺎﺷ: ﻥﺩﺮﮐﺐﯿﮐﺮﺗ, ﺖﺳﺮﻬﻓ, ﺪﻨﻫﺩﯽﻣﻞﯿﮑﺸﺗﺍﺭ, ﺭﺎﺘﺧﺎﺳ, ﺭﺎﮐﺭﺪﻧﺍﺖﺳﺩ, ﻥﺩﺮﮐﻝﻮﻐﺸﻣ, ﻞﻣﺎﺷ, ﻝﻮﻤﺷ, ﻞﻣﺎﺷ, ﯼﻭﺎﺣ, ﻥﺪﯿﺳﺭ, ﻞﻣﺎﺷ
ﭗﯿﻠﮐ: ﯼﺰﯿﭼﺮﻫﯽﻠﺻﺍءﺰﺟ, ﺏﻼﻗ, ﻪﻨﮕﻨﻣ
ﺖﯾﻮﻟﻭﺍ: ﻪﺟﻮﺗ, ﺢﯿﺟﺮﺗ, ﻢﻫﺩﯽﻣﺢﯿﺟﺮﺗ
ﺯﻭﺎﺠﺗ: ﺖﻣﺮﺣﮏﺘﻫ, ﺯﻭﺎﺠﺗ, ﺯﻭﺎﺠﺗ
ﺭﻮﺘﯿﻧﺎﻣ: ﺮﯿﺴﻣ, ﻥﺩﺮﮐﺕﺭﺎﻈﻧ, ﻥﺩﺮﮐﺎﺷﺎﻤﺗ, ﻥﺩﺮﮐﻝﺎﺒﻧﺩ
ﯽﺗﺎﺑﺎﺨﺘﻧﺍﻩﺯﻮﺣ: ﻩﺪﻨﻫﺩﯼﺍﺭ, ﻪﯿﺑﺎﺨﺘﻧﺍﻩﺯﻮﺣ, ﻢﯾﻼﻣ
ﯽﮕﻨﻫﺮﻓ: ﮓﻨﻫﺮﻓ
ﺲﻨﺟ: ﻥﺩﺮﮐﻪﺒﺳﺎﺤﻣ, ﯽﺴﻨﺟﻁﺎﺒﺗﺭﺍ, ﺩﺮﻣﯽﻠﺳﺎﻨﺗﺖﻟﺁ, ﺎﻫﻪﻧﻮﮔ, ﯽﺴﻨﺟﺕﻼﯾﺎﻤﺗ
ﻦﯿﺗﻼﭘ: 
ﯽﯾﺎﺗﻭﺩﺩﺪﻋ: 
ﺺﺼﺨﺗ: ﯼﺍﻪﻓﺮﺣﻭﯽﻨﻓ, ﻪﺼﺨﺸﻣ, ﯽﮔﮋﯾﻭ, ﺹﺎﺧ, ﻩﮋﯾﻭ, ﺺﺼﺨﺗ, ﺺﺼﺨﺘﻣ, ﻪﻧﺎﮔﺍﺪﺟ, ﯼﺭﺎﺼﺤﻧﺍ, ﺺﺼﺨﺗ
ﻪﯾﺭ: 
ﻩﺩﺎﻌﻟﺍﻕﻮﻓ: ﻩﺩﺎﻌﻟﺍﻕﻮﻓ, ﻩﺩﺎﻌﻟﺍﻕﻮﻓ, ﻩﺩﺎﻌﻟﺍﻕﻮﻓ, ﺖﺳﺮﭘﺮﺳ
ﯽﻗﺮﺑﻦﮔﺍﻭ: ﻪﮑﺴﻟﺎﮐ, ﯼﺭﺎﮔ, ﻦﮔﺍﻭ
ﯽﮐﺍﺭﻮﺧﭺﺭﺎﻗ: ﭺﺭﺎﻗ, ﺐﻟﺎﻗ
ﯽﻠﺤﻣﺕﺭﻮﺻﻪﺑ: ﯽﻠﺤﻣ
ﻥﺩﺮﮐﮏﯾﺮﺤﺗ: ﻥﺩﺮﮐﮏﯾﺮﺤﺗ, ﻥﺩﺮﮐﮏﯾﺮﺤﺗ
ﻞﯿﺋﻭﺯﺎﮔ: ﻦﯾﺰﻨﺑ
ﻲﻳﺍﻮﻠﺣﻭﺪﻛ: ﺵﺍﻮﮑﺳﺍ, ﺰﻐﻣ
ﻪﯿﻠﮐ: ﻉﺎﻔﺗﺭﺍ, ﺵﺮﺘﺴﮔ
ﺕﺭﺎﻏ: ﺖﻗﺮﺳ, ﺕﺭﺎﻏ, ﺭﺎﮑﺷ, ﻥﺩﺮﺑﻦﯿﺑﺯﺍ, ﺕﺭﺎﻏ, ﻞﻘﻧﻭﻞﻤﺣ
ﮏﯿﻨﺳﺭﺁ: 
ﻥﻭﺰﻠﺣ: ﭻﯿﭘﺭﺎﻣ
ﮏﭼﻮﮐﺖﯾﺎﻬﻨﯿﺑ: 
ﺖﺴﯿﻟﺎﯿﺳﻮﺳ: ﯼﺪﻧﻭﺎﺸﯾﻮﺧ
ﯽﻓﺎﺻ: 
ﻥﺩﺮﮐﻦﻬﭘ: ﻥﺩﺍﺩﻪﻌﺳﻮﺗ, ﻊﯿﺳﻭ, ﻥﺩﺮﮐﻪﻓﺎﺿﺍ, ﻥﺩﺮﺑﻻﺎﺑ, ﻥﺩﺮﺑﻻﺎﺑ, ﻥﺩﺮﻛﺪﻳﺪﻤﺗ, ﻩﺩﺮﺘﺴﮔﺭﻮﻃﻪﺑ, ﻪﻌﺳﻮﺗ
ﺰﯿﮕﻧﺍﺮﺑﺚﺤﺑ: ﻝﺍﺪﺟ, ﺾﻗﺎﻨﺗ, ﻢﻬﺒﻣ, ﻩﺪﻨﻨﮐﺞﯿﮔ, ﻡﺎﻬﺑﺍ, ﺾﻗﺎﻨﺘﻣ
ﯽﯾﺎﺗﻪﺳﻪﺘﺳﺩ: ﻩﺭﺎﺟﺍ, ﻪﻤﺴﺗ
ﻥﺪﺷﯽﻧﺍﻭﺩﺐﺳﺍﺭﺎﮐﺭﺍﻮﺳ: 
ﻪﯾﺮﻟﺍﺕﺍﺫ: 
ﻦﺘﻓﺮﮔﺎﺟ: ﻥﺩﺍﺩﺭﺍﺮﻗ
ﻊﻃﺎﻘﺗ: ﺭﻮﺒﻋ, ﻝﺎﺼﺗﺍ, ﯽﺒﯿﺗﺮﺗ
ﯽﮕﺘﺴﺒﻤﻫ: ﻥﺩﺮﮐﺪﺤﺘﻣ, ﻊﻤﺠﺗ, ﯽﮕﺘﺴﺑﺍﻭ, ﺕﺪﺣﻭ, ﻪﺑﺎﺸﺗ, ﺮﺼﻋ
ﻻﻮﻟ: ﻖﯿﻗﺩ, ﻪﻘﻠﺣ, ﺭﻮﺤﻣ
ﯽﻟﻮﻃ: ﯼﺩﻮﻤﻋ, ﺕﺪﻣﯽﻧﻻﻮﻃ, ﺎﻫﻪﻧﻮﮔ
ﻡﺎﻬﺳﺩﻮﺳ: ﺺﯿﺼﺨﺗ
ﻪﺟﺮﻔﻨﻣ: ﻡﺍﺭﺁ
ﻥﺩﺮﮐﯼﺯﺎﺑﺖﯿﮑﺳﺍ: ﯽﮑﺳﺍ
ﻥﺪﺷﻻﻭﺩ: ﻢﺧ
ﻥﺍﻮﺗ: ﺺﺧﺎﺷ, ﯽﯾﺎﻤﻧ, ﻪﻌﻄﻗ
ﯽﻧﺍﻮﺗﺎﻧ: ﺺﻘﻧ, ﺰﺠﻋ, ﺺﻘﻧ, ﺺﻗﺎﻧ, ﻝﺎﻌﻓﺮﯿﻏ, ﺐﯿﻋ
ﯽﻧﺎﻣﺮﻬﻗ: ﻥﺎﻣﺮﻬﻗ, ﻩﺪﻧﺮﺑ, ﻪﻘﺑﺎﺴﻣ
ﺱﺎﮑﻋ: ﯽﺴﮑﻋ
ﻝﺎﺘﯿﺠﯾﺩ: ﻞﮑﺷ, ﺩﺪﻋ, ﯼﺩﺪﻋ
ﻩﺩﺎﻣﮓﺳ: 
ﮏﻠﭘ: 
ﺭﺎﯿﺸﻫﻪﻤﯿﻧ: 
ﻭﺮﺑﺍﻂﺧ: 
ﻪﺴﻄﻋ: 
ﺭﺍﺩﻩﺪﻨﺧ: ﺵﻮﺧ, ﯽﻣﺮﮔﺮﺳ, ﻝﺎﺤﺷﻮﺧ, ﺭﺍﺩﻩﺪﻨﺧ, ﻝﺎﺤﺷﻮﺧ, ﻩﺪﻨﻨﮐﻡﺮﮔﺮﺳ, ﻩﺪﻨﻨﮐﻡﺮﮔﺮﺳ, ﯽﻫﺎﮑﻓ, ﮏﺤﻀﻣ, ﺵﻮﺧ
ﺮﺟﺎﻬﻣ: ﺮﺟﺎﻬﻣ
ﻦﻴﺌﺗﻭﺮﭘ: ﻍﺮﻣﻢﺨﺗﻩﺪﯿﻔﺳ
ﻪﻟﺎﺑﺯ: ﻩﺩﻮﺗ, ﻪﺘﺸﭘ, ﻥﺩﺮﮐﺩﺮﻃ, ﻪﻟﺎﺑﺯ, ﻪﻟﺎﺑﺯ, ﺏﺎﺗﺮﭘ
ﺪﺑﺎﯾﻞﻣﺎﮑﺗ: ﯽﻠﻣﺎﮑﺗﺮﯿﺳ, ﻪﻌﺳﻮﺗ
ﻥﺩﺮﮐﻍﺍﺮﻔﺘﺳﺍ: 
ﻥﮊ: ﯽﮑﯿﺘﻧﮊ, ﮏﯿﺘﻧﮊ
ﻩﺪﮑﺸﻧﺍﺩﻝﻭﺍﻝﺎﺳﯼﻮﺠﺸﻧﺍﺩ: 
ﻡﺎﻏﺩﺍ: ﻡﺎﻏﺩﺍ, ﻥﺩﺮﮐﺪﺤﺘﻣ, ﻥﺩﺮﮐﺪﺤﺘﻣ, ﻦﺘﺨﯿﻣﺁ, ﻥﺩﺮﮐﯽﮑﯾ, ﻡﺎﻏﺩﺍ, ﺍﺮﮕﻤﻫ, ﻝﺎﺼﺗﺍ
ﯽﺳﺎﻨﺷﻪﻌﻣﺎﺟ: 
ﮎﺮﺤﺗ: ﺭﺎﯿﺳ, ﻞﻤﺣﻞﺑﺎﻗ, ﯽﯾﺎﺠﺑﺎﺟ, ﺖﮐﺮﺣ
ﯼﺍﻪﻘﻄﻨﻣ: ﻥﺎﺘﺳﺮﻬﺷ, ﻪﻘﻄﻨﻣ, ﻪﻘﻄﻨﻣ, ﺶﺨﺑ, ﻩﺮﮐ, ﺶﺨﺑ, ﯽﻧﻮﻣﺍﺮﯿﭘ, ﯽﻧﺎﺘﺳﺍ
ﺖﮐﺮﺣﺭﺍﻮﺷﺩ: 
ﻥﺩﺮﮐﻖﯿﻗﺭ: ﺮﻏﻻ, ﻢﯾﻼﻣ
ﺮﮕﻧﻪﺘﺷﺬﮔ: ﻪﺘﺷﺬﮔ, ﯽﯾﺍﺮﮔﻥﻭﺭﺩ
ﯽﮕﻧﻭﺭﺍﻭ: ﻥﺩﺮﮐﺱﻮﮑﻌﻣ, ﻒﻟﺎﺨﻣ, ﻞﺑﺎﻘﺘﻣ, ﺱﻮﮑﻌﻣ, ﻪﻌﺟﺎﻓ, ﻝﺎﻘﺘﻧﺍ
ﻥﻮﯾﺰﯾﻮﻠﺗ: ﻥﻮﯾﺰﯾﻮﻠﺗ, ﻢﻠﯿﻓ
ﺐﻌﮑﻣ: ﺪﻣﺎﺟ
ﻮﺤﻧ: ﯼﻮﺤﻧ, ﯽﮕﺘﺴﺸﻧﺯﺎﺑﻕﻮﻘﺣ, ﺡﺮﻃ
ﯼﺭﻭﻩﺮﻬﺑ: ﺩﺮﮑﻠﻤﻋ, ﺪﯿﻟﻮﺗ
ﺞﯾﻮﻫ: 
ﯽﻟﻮﮑﻟﻮﻣ: ﻝﻮﮑﻟﻮﻣ, ﺮﺴﮐﺕﺭﻮﺻ, ﻪﯾﻻ, ﯽﻤﺗﺍ, ﯽﻤﺗﺍ
ﻁﻼﺘﺧﺍ: ﻪﺘﺳﺩ, ﻩﻭﺮﮔ, ﻪﺷﻮﺧ
ﺐﺳﺎﺤﻣ: ﺰﯿﻤﻣ
ﮏﯿﮑﻔﺗ: ﺾﯿﻌﺒﺗ, ﻥﺪﺷﻞﺋﺎﻗﺾﯿﻌﺒﺗ, ﻥﺩﺍﺩﺰﯿﻤﺗ, ﻕﺍﺮﺘﻓﺍ, ﮏﯿﮑﻔﺗ, ﺕﻭﺎﻔﺗ, ﺩﺎﻀﺗ, ﺕﺍﺮﯿﯿﻐﺗ, ﺲﻧﺎﯾﺭﺍﻭ
ﯽﺳﺮﺘﺳﺩ: ﯽﺳﺮﺘﺳﺩ, ﺏﺎﺴﺘﮐﺍ, ﻦﺘﻓﺮﮔ, ﺱﺮﺘﺳﺩﺭﺩ, ﺭﻮﻀﺣ, ﯽﺸﺨﺑﺮﺛﺍ
ﯽﺷﺎﯿﻋ: 
ﻝﻼﺣ: ﻥﺩﺮﮐﻞﺣ
ﺕﺎﻔﺴﻓ: 
ﺮﮔﺯﺎﻏﺁ: ﻪﻤﻌﻃ, ﯽﯾﺎﻨﺷﺁ, ﯽﻓﺮﻌﻣ, ﻻﻭﺍ
ﻝﻮﮔﺮﯾﻭ: ءﺎﻤﻏﺍ, ﺏﺰﺣ
ﺽﺮﻓ: 
ﺖﮐﺮﺣﯽﺒﯿﺷﺍﺮﺳ: 
ﻩﺪﻨﻫﺩ: ﻩﺪﻨﻨﮐﻪﺋﺍﺭﺍ
ﺱﺎﻨﺸﻧﺍﻭﺭ: 
ﻦﯾﺮﻠﮐ: ﺰﺑ
ﺪﯿﻠﮐﻪﺤﻔﺻ: 
ﻪﺒﺨﻧ: ﺮﺗﺮﺑ
ﺰﺘﻧﺍﺮﭘ: ﺏﻼﻗ
ﯽﺒﮔﺭ: 
ﻢﺧﺯ: ﻢﺧﺯ, ﻢﺧﺯ, ﻢﺧﺯ, ﺵﻮﺟ
ﻑﺮﺻ: 
ﻥﺩﺭﻮﺧﮎﺪﻧﺍﮎﺪﻧﺍ: 
ﻦﯿﻨﺟﻂﻘﺳ: ﻦﯿﻨﺟﻂﻘﺳ
ﺖﮐﺍﮊ: ﺖﮐﺍﮊ
ﯽﻠﻣﺎﮑﺗ: ﻪﻌﺳﻮﺗ, ﯽﻠﻣﺎﮑﺗﺮﯿﺳ, ﻪﻌﺳﻮﺗ, ﺖﻓﺮﺸﯿﭘ
ﯼﺭﺍﺬﮔﻥﺎﺸﻧ: ﻥﺩﺮﮐﺎﻀﻣﺍ, ﻞﺒﻤﺳ, ﺪﯿﺷﺎﺑﻪﺘﺷﺍﺩﻪﺟﻮﺗ
ﯽﯾﻮﮔﻑﺍﺰﮔ: ﺵﺮﻏ, ﺵﺮﭘ
ﯽﻓﺎﮑﺷﺪﺒﻟﺎﮐ: ﻥﺩﺍﺩﺹﺎﺼﺘﺧﺍ, ﺶﺨﺑ, ﺶﺨﺑ, ﻥﺩﺮﮐﻢﯿﺴﻘﺗ
ﻩﺎﮕﻧﺎﻬﻧ: ﻦﯿﻤﮐ
ﻪﻣﺮﺳﮓﻨﺳ: 
superessiveﺩﺭﻮﻣ: 
ﺭﻮﻣﻮﺗ: ﺭﻮﻣﻮﺗ, ﻢﺠﺣ
ﺎﻔﻟﺁ: 
ﻑﺎﻧ: ﻢﮑﺷ, ﺐﻄﻗ
ﻥﻮﺼﻣ: ﺲﻔﻨﺗ, ﻡﻭﺎﻘﻣ
ﻥﺩﺮﮐﻩﺎﺗﻮﮐ: ﺪﺣ, ﻥﺩﺮﮐﺩﻭﺪﺤﻣ, ﻥﺩﺮﮐﺩﻭﺪﺤﻣ, ﻥﺩﺮﮐﻪﺻﻼﺧ, ﺭﻮﺟﻭﻊﻤﺟ
ﻥﺩﺮﮐﺮﯿﺳﺍ: ﻦﺘﻓﺮﮔ, ﻥﺩﺮﮐﺏﻭﺬﺠﻣ, ﺭﺎﮑﺷ, ﻥﺩﺮﻛﺏﺬﺟ
ﺏﺍﺭﻮﺟ: 
ﺎﻤﻨﯿﺳﻢﻠﯿﻓ: ﻢﻠﯿﻓ, ﺎﻤﻨﯿﺳ, ﻥﺎﺑﻭﺭ, ﺭﺍﻮﻧ, ﻩﺍﺭﻩﺍﺭﻪﭼﺭﺎﭘ
ﻥﺎﻬﯿﮐ: ﻥﺎﻬﺟ
ﻩﺩﻮﻟﺁ: ﯽﮔﺩﻮﻟﺍ, ﻩﺩﻮﻟﺁ
ﻪﺷﻮﺧﻪﺷﻮﺧ: 
ﻡﻮﯿﻨﯿﻣﻮﻟﺁ: ﻡﻮﯿﻨﯿﻣﻮﻟﺁ
ﻥﺎﺳﻮﻧ: ﻥﺎﺳﻮﻧ, ﺵﺎﻌﺗﺭﺍ
ﯽﯾﺎﺒﻔﻟﺍ: ﺎﺒﻔﻟﺍ
ﻪﭽﯾﺍﺯ: 
ﺱﺎﻤﻣ: 
ﯽﯾﺎﯾﺭﺩﺯﺍﺮﮔ: 
ﻞﺗﺎﻗ: 
ﺪﯾﺪﺸﺗ: ﺵﺎﻌﺗﺭﺍ
ﺺﺧﺎﺷ: ﺖﻟﺎﺣ, ﺺﺧﺎﺷ, ﺺﺧﺎﺷ, ﺖﺸﮕﻧﺍﺺﺧﺎﺷ, ﻩﺯﺍﺪﻧﺍ
ﺪﯿﺴﮐﺍﯼﺩ: 
ﯼﺭﻻﺎﺳﻥﺍﻮﯾﺩ: ﮏﯿﺗﺍﺮﮐﻭﺭﻮﺑ
ﻒﯾﺮﺤﺗ: ﻥﺩﺮﮐﻩﺍﺮﻤﮔ, ﺵﻼﺗ, ﻥﺪﺷﺪﺳﺎﻓ, ﺭﺩﻥﺩﺮﺑﺖﺳﺩ, ﻑﺍﺮﺤﻧﺍ, ﺝﺎﺟﻮﻋﺍ
ﻥﺎﺸﮑﻬﮐ: ﯽﮑﻠﻓﺕﺭﻮﺻ
ﯽﻨﯿﻟﺎﺑ: 
ﻡﻮﯾﺩﺍﺭ: ﻮﯾﺩﺍﺭ
ﻝﺎﭽﺨﯾ: ﻪﻧﺎﺧﺩﺮﺳ
ﮏﯿﻧﻮﻣﺭﺎﻫ: ﯽﻘﯿﺳﻮﻣ, ﻕﺎﺒﻄﻧﺍ
ﯽﺳﺎﻨﺷﻥﺎﺘﺳﺎﺑ: ﯽﺳﺎﻨﺷﻥﺎﺘﺳﺎﺑ, ﯽﺳﺎﻨﺷﻥﺎﺘﺳﺎﺑ, ﻞﯿﺴﻓ
ﺕﺎﺼﺨﺸﻣ: ﺭﺎﺠﻨﻫ, ﺩﺭﺍﺪﻧﺎﺘﺳﺍ, ﺕﺎﯿﺋﺰﺟ
ﻕﺎﺤﻟﺍ: 
ﻩﻭﺰﺟ: ﻪﭽﺑﺎﺘﮐ, ﻪﻣﺎﻨﺸﻫﻭﮋﭘ, ﻩﻭﺰﺟ, ﻕﺭﻭ
ﺖﯿﻣﺎﻤﺗﺎﻧ: ﺺﻗﺎﻧ
ﯽﺳﺎﻨﺷﻡﺩﺮﻣ: 
ﻢﻌﻃﺵﻮﺧ: ﺬﯾﺬﻟ-ﻩﺰﻤﺷﻮﺧ
ﯼﺪﻌﺘﻣ: ﻪﻧﺎﻬﺑ
ﻥﺪﺷﻻﻭﺩﺱﺮﺗﺯﺍ: 
ﯼﺯﺎﺳﻪﯿﺒﺷ: ﯼﺯﺎﺳﻪﯿﺒﺷ, ﻥﺎﺸﻧ
ﻞﺒﻬﻣ: ﺰﻣﺮﻗﻪﺑﻞﯾﺎﻣﺥﺮﺳ, ﻝﻮﻠﺳ
ﻥﻮﯾ: 
ﯼﺩﺮﮕﻧﺎﻬﺟ: ﺖﺴﯾﺭﻮﺗ, ﻦﺘﻓﺭﺮﻔﺳ, ﮏﯿﻧﮏﯿﭘ
ﺕﺎﺜﻠﺜﻣ: 
ﯽﯾﺎﺑﺭﻡﺩﺁ: ﻥﺩﻮﺑﺭ, ﻝﺎﻘﺘﻧﺍ, ﻥﺩﻮﺑﺭ
ﻭﻒﮐ: ﻞﺑﺎﻘﺘﻣﺮﺛﺍ, ﯽﻠﻣﺎﻌﺗ
ﻩﺪﻨﺑﺎﯾ: 
ﻥﺩﺮﮐﺭﺎﻨﮐﺮﺑ: ﻥﺩﺮﮐﺎﺠﺑﺎﺟ, ﻦﺘﺧﺍﺪﻧﺍﻥﻭﺮﯿﺑ, ﻦﺘﺧﺍﺪﻧﺍﻥﻭﺮﯿﺑ, ﻥﺩﺮﮐﺝﺍﺮﺧﺍ, ﻥﺩﺮﮐﺩﺮﻃ
ﻥﺎﻤﻠﺳ: 
ﻪﻣﺎﻋﮓﻨﻫﺮﻓ: ﻡﺪﻨﮔﻪﺷﻮﺧ, ﻡﺩﺮﻣ
ﮒﺮﯾﻮﻣ: 
ﻡﺰﯿﻟﺎﻧﻮﯿﺳﺎﻧ: ﺖﯿﻠﻣ
ﻦﯾﺮﺳ: ﻥﺍﺭﻞﺼﻔﻣ
ﻥﺩﺮﮐﻪﯿﻔﺼﺗ: ﺺﻟﺎﺧ, ﻥﺩﻮﻟﺎﭘ
ﻞﺋﺎﺣ: 
ﯼﺪﯿﻣﺍﺎﻧ: ﺱﺎﯾ, ﯼﺪﯿﻣﺍﺎﻧ, ﻢﮔﺭﺩﺮﺳ, ﻥﺩﺮﮐﻮﻐﻟ, ﺖﺴﮑﺷ, ﺪﯿﻣﺍﺎﻧ, ﺪﯿﻣﺍﺎﻧ, ﻩﺪﻨﻨﮐﺪﯿﻣﺍﺎﻧ
ﺖﻟﺎﺒﮐ: 
ﻥﺩﺮﮐﺎﻬﻨﻣ: ﻥﺩﺮﮐﻖﯾﺮﻔﺗ
ﺖﮐﺮﺣﻪﻧﺎﺧﺩﻭﺭﯼﻻﺎﺑ: 
ﺕﺎﺼﺘﺨﻣ: ﻢﺋﺎﻗﺪﻌﺑ, ﻥﺩﺮﻛﮓﻨﻫﺎﻤﻫ, ﯽﮕﻨﻫﺎﻤﻫ
ﺪﻌﻘﻣ: 
ﯽﮕﻧﻭﺰﻓﺍ: ﻥﺍﻭﺍﺮﻓ, ﻩﺪﻧﺎﻣﯽﻗﺎﺑ, ﺩﺍﺯﺎﻣ, ﺩﺭ, ﺝﺍﺮﺧﺍ, ﺖﯿﻓﺎﻌﻣ, ﺩﺍﺯﺎﻣ
ﯼﺮﯾﻮﺼﺗ: 
ﻢﯾﺮﺤﺗ: ﻥﺎﺘﺳﺮﻬﺷ, ﺩﺮﻃ, ﯽﻬﺟﻮﺗﯽﺑ
ﻥﺎﺤﺘﻣﺍ: ﺶﺷﻮﮐ, ﻥﺎﺤﺘﻣﺍ, ﻪﻣﺎﻨﺸﺳﺮﭘ
ﻥﺍﺰﯿﺗﺭﺎﭘ: 
ﻢﯾﺰﯿﻨﻣ: 
ﺭﺍﺩﺍﺭ: 
ﯽﻔﯿﮐ: ﺖﯿﻔﯿﮐ, ﻪﺼﺨﺸﻣ
ﻥﺎﻨﯿﻤﻃﺍﺖﯿﻠﺑﺎﻗ: ﺭﺎﺒﺘﻋﺍ
ﻞﯿﻄﺘﺴﻣﻊﺑﺮﻣ: 
ﻥﺩﺍﺩﻢﯿﻤﻌﺗ: ﻢﯿﻤﻌﺗ, ﻦﺘﺧﺎﺳ, ﻥﺩﺭﻭﺁﺩﻮﺟﻭﻪﺑ, ﻥﺩﻭﺮﺳ
ﺮﮕﯾﺩ: ﻥﻮﻨﮐﺍ, ﻮﻧﺯﺍ
ﺐﺷﻦﯿﻌﻣﺖﻋﺎﺳﺭﺩﯽﺷﻮﻣﺎﺧﻭﯽﻣﺎﻈﻧﺖﻣﻮﮑﺣﺕﺍﺭﺮﻘﻣ: 
ﯼﺪﻨﺑﻝﻮﻣﺮﻓ: ﻦﺘﺧﺎﺳ, ﺭﺎﺘﺧﺎﺳ, ﻩﺪﻧﺯﺎﺳ, ﯼﺪﻨﺑﻪﻠﻤﺟ, ﺩﺎﺠﯾﺍ, ﻞﯿﮑﺸﺗ, ﻪﻟﻮﻣﺮﻓﻭﻦﯾﻭﺪﺗ, ﺭﺍﺮﻘﺘﺳﺍ
ﻩﺯﺎﺗﻢﺴﺟﺭﺩﺦﺳﺎﻨﺗ: ﺕﺎﯿﺣﺪﯾﺪﺠﺗ
ﻥﺩﺮﮐﻦﺷﻭﺭ: 
ﻡﻮﯿﻧﺍﺭﻭﺍ: 
ﻩﺪﻨﻫﺩﺕﺎﯿﻟﺎﻣ: ﺕﺎﯿﻟﺎﻣ
ﻪﭼﺭﺎﭙﮑﯾ: ﻝﺍﺮﮕﺘﻧﺍ
ﺭﺎﻬﻇﺍ: ﺯﺍﺪﻧﺍﻢﺸﭼ, ﺮﻈﻧ, ﺭﺎﻬﻇﺍ
ﺎﻣﺎﮔ: 
ﺭﻭﺮﺳ: 
ﺖﮐﺮﺣﻪﻧﺎﺧﺩﻭﺭ: 
ﺐﯾﺮﺿ: ﻪﺟﺭﺩ, ﻞﻣﺎﻋ, ﻪﻧﺎﻤﯿﭘ
ﺕﻮﻤﺴﯿﺑ: 
ﻝﺎﺘﺴﭘﺕﺭﺎﮐ: ﺖﺴﭘ, ﺪﺷﺭﺍﯽﺳﺎﻨﺷﺭﺎﮐ
ﻥﺪﺷﺕﺮﭘ: ﯽﻨﯿﺸﻧﺐﻘﻋ, ﮎﺮﺗ
ﯽﮑﯾﮊﻮﻟﻮﻓﺭﻮﻣ: ﮏﯿﺘﻧﮊ, ﯽﺳﺎﻨﺷﺖﺨﯾﺭ
ﯽﺑﺎﯾﺯﺭﺍ: ﯽﺑﺎﯾﺯﺭﺍ, ﯽﺑﺎﯾﺯﺭﺍ, ﯽﺑﺎﯾﺯﺭﺍ, ﻮﺟﻭﺱﺮﭘ, ﯽﺳﺭﺮﺑ, ﻮﺟﻭﺱﺮﭘ, ﺮﮕﺷﻭﺎﮐ, ﻝﺩﺎﻌﺗ
ﻦﯿﺟﺭﺍﻮﻠﺷ: 
ﻩﺩﺍﺩﻩﺎﮕﯾﺎﭘ: 
ﺏﺎﺴﺣﻦﯿﺷﺎﻣ: ﻪﺒﺳﺎﺤﻣ
ﺭﺍﺬﮔﻪﯾﺎﻣﺮﺳ: 
ﺲﮑﯾﺍﻪﻌﺷﺍ: 
ﻪﺴﻠﺟﺭﻮﺘﺳﺩ: ﻪﻣﺎﻧﺮﺑ, ﻪﻣﺎﻧﺮﺑ, ﯽﻠﯿﺼﺤﺗﻪﻣﺎﻧﺮﺑ
ﺍﺰﯾﻭ: 
ﺖﺧﺎﺳﺮﯾﺯ: ﯽﺳﺎﺳﺍ, ﯽﺳﺎﺳﺍ, ﺎﺳﺎﺳﺍ
ﺏﺎﯾﺩﺭ: 
ﻥﺩﺮﮐﻞﺼﺘﻣﻢﻫﺎﺑ: ﻥﺩﻮﻤﻧﻪﻓﺎﺿﺍ, ﺡﻼﺻﺍ, ﻪﻤﯿﻤﺿ, ﻝﺎﺼﺗﺍ
ﻡﺮﺑ: 
ﻥﻮﮑﯿﻠﯿﺳ: PI
ﻪﮑﺴﮑﺳ: 
ﯽﮕﻧﺭﺩﺍﺪﻣﺎﺑﯽﺷﺎﻘﻧ: ﻩﺪﯾﺮﭘﮓﻧﺭ
ﺶﺣﻭﻍﺎﺑ: 
ﻩﺎﮕﻧﺎﻣﺭﺩ: 
ﺎﮔﻮﯾ: ﻉﻮﻤﺠﻣ
ﯽﺷﻭﺮﻔﺑﺎﺘﮐ: ﺏﺎﺘﮐﻪﺴﻔﻗ, ﻩﺎﮕﺷﻭﺮﻓ
ﺵﻭﺮﻓﻩﺩﺮﺧ: ﻝﻻﺩ, ﻩﺪﻨﺷﻭﺮﻓ, ﻩﺎﮕﺷﻭﺮﻓ, ﮏﯾﺩﺰﻧ
ﻥﺪﯾﺮﺑﺮﺳ: ﻊﻗﻮﻤﺑ
ﻩﺭﺁ: ﻪﻠﺑ, ﻪﻠﺑ, ﻕﺩﺎﺻ
ﺯﺎﺟ: 
ﻦﺘﺴﮕﻨﺗ: 
ﯽﺘﺴﯾﺭﻭﺮﺗ: ﺐﻠﻃﮓﻨﺟ, ﺖﺸﺣﻭ, ﯽﻃﺍﺮﻓﺍ
ﯽﮐﺍﺭﺩﺍ: ﯽﻨﻨﻔﺗ, ﻡﻮﻬﻔﻣ, ﻡﻮﻬﻔﻣ, ﺽﺮﻓ, ﻮﮕﻟﺍ, ﺭﻮﺼﺗ, ﺲﯾﻮﻧﺶﯿﭘ
ﯽﺗﺭﺎﮐﺩ: 
ﻥﺪﯿﻧﺎﮑﭼ: ﻞﮔﻭﻦﺠﻟ
ﻪﻘﻔﻧ: 
ﺲﯾﻮﻧﻪﻣﺎﻧﺮﺑ: ﻪﻣﺎﻧﺮﺑ
ﯼﺩﻭﺭﻭ: 
ﺶﯾﺍﺭﺁ: ﺶﯾﺍﺭﺁ, ﯽﺘﺷﺍﺪﻬﺑﻭﯽﺸﯾﺍﺭﺁﻡﺯﺍﻮﻟ, ﻦﻓﻭﺕﻮﻓ, ﻥﺩﺮﮐﻥﺍﺮﺒﺟ
ﻦﺴﮐﺍﻭ: ﺮﯿﺴﻔﺗ, ﺶﺷﻮﭘ, ﻖﯾﺭﺰﺗ
ﯽﻬﯾﺪﺑ: 
ﻦﻴﺋﻭﺮﻫ: 
ﻪﺷﻮﭘ: 
ﺪﺗﺎﮐ: 
ﺍﺰﻧﻻﻮﻔﻧﺁ: ﺐﺗ, ﺮﯿﺛﺎﺗ
ﻱﮊﻮﻟﻮﺋﺪﻳﺍ: ﺮﮑﻓ
ﮓﻨﯿﮐﺭﺎﭘ: 
ﯼﺭﻮﻓﺲﮑﻋ: 
ﺝﻭﺍﺩﺎﭘ: ﯼﺪﯿﻣﺍﺎﻧ
ﻡﻮﯿﻨﻠﺳ: 
ﺮﺸﻗ: ﮓﺳﺱﺭﺎﭘ, ﻪﺘﺳﻮﭘ, ﻥﺪﻨﮐﺖﺳﻮﭘ
ﯼﺯﺭﺍﻢﻫ: ﯼﺮﺑﺍﺮﺑ
ﺱﺍﺭ: 
ﻩﺎﮔﺩﻭﺮﻓ: 
ﻥﺩﺮﮐﺍﺪﺟ: ﻥﺩﺮﮐﻊﻄﻗ
ﺯﺎﺑﻞﻏﺩ: 
ﻡﻭﺮﮐ: 
ﺮﺘﯿﻟ: ﺮﺘﯿﻟ
ﺩﺭﻮﺒﺷﺍﺩ: ﻮﻠﺑﺎﺗ, ﻩﺮﯿﺗﻂﺧ
ﻥﻮﻣﺭﻮﻫ: 
ﻥﺩﺮﮐﺥﺍﺭﻮﺳ: ﻥﺩﺮﮐﺥﺍﺭﻮﺳ
ﯽﯾﺍﺮﮔﻥﺎﺟ: 
ﯽﻌﻠﺿﺪﻨﭼ: ﻪﯾﻭﺍﺯ
ﻥﺎﻧﺯﻕﻮﻘﺣﺭﺍﺪﻓﺮﻃ: 
ﺝﻭﺩﺰﻣ: ﺐﯿﺷ, ﻞﺼﺘﻣ, ﻥﺩﺮﮐﺖﯾﺍﺪﻫ
ﻭﺭﻮﯾ: 
ﻢﺘﯾﺭﻮﮕﻟﺍ: 
ﺭﺰﯿﻟ: 
ﻪﻧﺎﺧﻭﺭﺍﺩ: 
ﺮﺘﻤﯿﻠﯿﻣ: ﺮﺘﻤﯿﻠﯿﻣ
ﻥﺩﺮﮐﻢﺧ: ﻢﺧ, ﯽﻨﺤﻨﻣ, ﺮﯾﺬﭘﻑﺎﻄﻌﻧﺍ, ﺏﻮﻠﻄﻣ, ﻞﺑﺎﮐ
ﺪﻧﺁ: 
ﻒﯾﺮﻇﻭﻖﯿﻗﺩﺕﺎﮑﻧ: ﻪﯾﺎﺳ
ﻥﺪﺷﻊﻤﺟ: ﻦﺘﻓﺮﯾﺬﭘ
ﺖﻗﻭﻩﺭﺎﭘ: 
ﺖﯿﺳﺎﺴﺣ: 
ﯼﺰﮐﺮﻣﻩﺪﻧﺯﺍﺩﺮﭘ: 
ﻩﺪﻨﻫﺩﻥﺎﺸﻧ: ﯼﺮﻫﺎﻇﻞﮑﺷ, ﻥﺩﺍﺩﺶﯾﺎﻤﻧ, ﺩﺮﮑﻠﻤﻋ, ﺕﺍﺮﻫﺎﻈﺗ, ﻪﺋﺍﺭﺍ
ﻡﻮﯿﻠﻫﺯﺎﮔ: 
ﻪﻧﺎﺑﺯﻭﺩ: 
ﺭﺪﺼﻣﻢﺳﺍ: 
ﺎﻤﺳﻼﭘ: 
ﻡﻭﺯﻮﻣﻭﺮﮐ: 
ﺢﯿﺤﺻﺩﺪﻋ: ﻢﻗﺭ, ﺩﺪﻋ
ﺮﺘﻣﻮﻠﯿﮐ: ﺮﺘﻣﻮﻠﯿﮐ
ﺲﮑﻓ: 
ﮏﯿﺘﻧﮊ: ﮏﯿﺘﻧﮊ, ﯽﮑﯿﺘﻧﮊ
ﮏﻣﮏﮐ: 
ﯽﻠﮐﻭﺮﺑﻢﻠﮐ: 
ﺖﺸﮕﯾﺎﺟ: ﺐﻟﺎﻗ, ﻪﯾﺍﺭﺁ, ﺡﺮﻃ, ﻝﺪﺑ
ﺎﻫﻪﻣﺎﻧﺯﺮﻫ: 
ﺭﺍﺩﺮﺑ: ﻞﻣﺎﺣ
ﮏﯿﺘﮐﺎﺗ: ﻩﺎﮕﺘﺳﺩ, ﺵﻭﺭ, ﮏﯿﻨﮑﺗ, ﯽﺳﺎﻨﺷﺵﻭﺭ, ﯽﺸﮐﺍﻭ
ﺏﻮﺧﺭﺎﻴﺴﺑ: ﻦﺘﻓﺎﯾﺩﻮﺒﻬﺑ, ﺖﺳﺭﺩ, ﻥﺩﺮﮐﺖﻔﺳ, ﺮﺒﺘﻌﻣ, ﻪﺷﺎﺑ
ﻦﯿﻣﺎﺘﯾﻭ: 
ﻡﻮﯿﻣﺩﺎﮐ: 
ﯽﮑﯿﻓﺍﺮﮔ: ﮏﯿﻓﺍﺮﮔ, ﮏﯿﻓﺍﺮﮔ
ﯽﺘﺳﺩﺕﺭﻮﺼﺑ: ﺩﻮﺧ
ﻡﻮﯿﻧﺎﺘﯿﺗ: 
ﺵﺎﭘﻭﺖﺨﯾﺭ: ﻥﺩﺯﻑﻻ
ﺮﺘﭘﻮﮐﯽﻠﻫ: 
ﻢﯾﺭﻮﻠﺗ: ﻢﯾﺪﻧﺎﮑﺳﺍ, ﻢﯿﻧﺎﺘﻧﻻ
ﻞﺟﻻﺍﺏﺮﺿ: ﺕﺪﻣ
ﻦﯿﭼ: ﺭﺍﻮﺘﺳﺍ, ﻪﯾﺍﺭﺁ
ﯽﺳﺎﯿﻗ: 
ﺮﺘﻣﯽﺘﻧﺎﺳ: ﺮﺘﻣﯽﺘﻧﺎﺳ
ﻡﻮﻧﺪﺒﯿﻟﻮﻣ: 
ﻡﻮﯿﺘﯿﻟ: 
ﯼﺮﯾﻮﺼﺗﯽﺗﻮﺻ: 
ﯼﺮﻟﺎﮐ: 
ﺕﺎﺑﺭ: 
ﻒﯿﻠﮑﺗ: ﺎﺘﻤﻫ
ﻢﺘﯾﺭﺎﮕﻟ: 
ﻥﺩﺮﮐﺐﺼﻧ: ﻩﻮﮐ, ﺐﺼﻧ, ﺰﺘﻨﺳ
ﻩﺪﺷﯼﺭﺎﺠﺣﻥﺎﺸﻧﺎﯾﺖﻣﻼﻋ: ﻦﯿﮑﺴﺗ
ﯽﺳﺎﻨﺷﻡﻮﺑ: ﺖﺴﯾﺯﻂﯿﺤﻣ, ﯽﻄﯿﺤﻣﺖﺴﯾﺯ
ﻥﺩﺮﮐﻪﻄﺴﻔﺳ: ﻥﺩﺮﺑﻦﯿﺑﺯﺍ
ﺐﻟﺎﻗ: ﺐﻟﺎﻗ
ﯽﺳﺪﯿﻠﻗﺍ: 
ﻮﻠﯿﮐ: 
ﻥﺩﺭﻮﺧﺮﭘ: 
ﻪﯿﻠﻋﻡﻮﺴﻘﻣ: 
ﻥﺎﮕﯾﺍﺭﺭﺍﺰﻓﺍﻡﺮﻧ: 
ﻥﺩﺮﮐﻊﻤﺳﻕﺍﺮﺘﺳﺍ: 
ﻮﻣﺡﻼﺻﺍ: 
ﻡﻮﯾﺪﯾﺮﯾﺍ: 
ﯽﺘﺳﺮﭘﺩﺍﮋﻧ: ﯼﺩﺍﮋﻧ
ﺪﻧﺎﺑﯼﺎﻨﻬﭘ: ﺪﻧﺎﺑﯼﺎﻨﻬﭘ
ﻪﻨﯿﻬﺑ: ﻻﺎﺑ, ﻪﻨﯿﻬﺑ, ﺏﻮﻠﻄﻣ, ﺐﺳﺎﻨﻣ, ﻥﺩﺮﮐﻢﯿﻈﻨﺗ, ﻕﺎﺒﻄﻧﺍ, ﺭﺎﮔﺯﺎﺳ, ﯽﻗﺎﺒﻄﻧﺍ, ﺐﺳﺎﻨﻣ, ﺖﺳﺭﺩ, ﻝﻮﻘﻌﻣ
ﺮﺗﻭ: ﺮﺗﻭ, ﺞﮐ
ﭖﺎﺘﮑﺳﺩ: 
ﺩﺎﺘﺳ: ﯽﻫﺪﻧﺎﻣﺮﻓﺰﮐﺮﻣ, ﯽﻟﺪﻨﺻ
ﻦﺘﺷﺍﺬﮔﺎﺟ: ﻞﺠﺧ, ﻥﺩﺍﺩﺖﺳﺩﺯﺍ
ﻢﯾﺮﺳ: 
ءﺰﺟﻪﺑﻪﺘﺴﺑﺍﻭﺩﺭﻮﻣ: 
ﺖﺳﺎﮐ: ﺭﺍﻮﻧ
ﺖﮐﺭﺎﻣﺮﭘﻮﺳ: ﺪﯾﺮﺧﺰﮐﺮﻣ
ﻩﺩﺍﺭﺍﯼﻭﺮﯿﻧ: ﻩﺩﺍﺭﺍ, ﻩﺩﺍﺭﺍ
ﯼﺪﻌﺑ: ﻩﺯﺍﺪﻧﺍ, ﻞﮑﺷ, ﺪﻌﺑ, ﯽﯾﺎﻀﻓ
ﻦﯾﻼﻓﺁ: 
ﯼﺭﺍﺬﮔﺰﻣﺭ: ﯼﺭﺎﮕﻧﺰﻣﺭ, ﻥﺩﺮﮐﯽﻧﺎﻬﻨﭘ, ﯽﺴﯾﻮﻧﻪﻣﺎﻧﺮﺑ
ﯼﺯﺎﺳﻡﺎﮕﻤﻫ: ﻡﺎﮕﻤﻫ, ﻡﺎﻏﺩﺍ, ﺮﺻﺎﻌﻣ
ﺭﺎﻨﯿﻤﺳ: 
ﯽﯾﺎﻨﻌﻣ: ﯽﻨﻌﻣ, ﯽﻨﻤﺿﺖﻟﻻﺩ, ﻉﻮﺿﻮﻣ, ءﯽﺷ, ﻩﺩﺎﻣ, ﻩﺩﺎﻣ, ﺲﺣ, ﺭﺍﺩﺎﻨﻌﻣ
ﻮﮑﺴﯾﺩ: 
ﻥﻮﺌﻧ: 
ﯽﻌﻗﺍﻭﻥﺎﻣﺯ: 
ﺪﯿﻔﺴﺑﻞﯾﺎﻣﯽﺑﺍﻭﺖﺨﺳﯼﺰﻠﻓﺮﺼﻨﻋ: 
ﯽﮔﺪﻧﺯﮏﺒﺳ: ﯽﮔﺪﻧﺯ, ﺮﻤﻋﻝﻮﻃ, ءﺎﻘﺑ, ﻥﺩﺮﻛﻲﮔﺪﻧﺯ, ﯼﺍﻪﻓﺮﺣ
ﻝﺍﻭﺮﯾﺎﻓ: 
ﺱﻮﻨﯿﺴﮐ: ﻪﺒﺳﺎﺤﻣ, ﻪﺒﺳﺎﺤﻣ
ﻉﻮﻨﺼﻣ: 
ﻡﻮﯿﻧﻮﺗﻮﻠﭘ: 
ﯼﺭﺎﮐﯼﺎﻫﻩﺎﮕﺘﺴﯾﺍ: 
ﻢﯾﺮﺘﯾﺍ: 
ﻩﺪﻧﻮﺷﻢﮐﺍﺮﺘﻣ: 
ﯼﺮﺑﺭﺎﮐﻡﺎﻧ: 
ﺖﺳﺍﺭﺖﻤﺳﻝﺎﺑ: 
ﻥﻮﮔﺭﺁ: 
ﻥﺩﺮﮐﯽﻋﺎﻤﺘﺟﺍ: ﻥﺩﺮﻛﺭﺍﺮﻗﺮﺑﻁﺎﺒﺗﺭﺍ, ﻞﻣﺎﻌﺗ
ﻥﺪﺷﯽﻧﺎﻬﺟ: 
ﻊﻃﺎﻗ: 
ﺝﻮﻣﻝﻮﻃ: ﻥﺩﺍﺩﻥﺎﮑﺗﺖﺳﺩ
ﻥﺩﺭﻭﺍﺭﺩﺰﻣﺭﺕﺭﻮﺼﺑ: ﺪﮐ
ﺖﻓﺎﯾﺯﺎﺑ: 
ﺐﻧﺎﺠﻣﻂﺧ: 
ﻥﺩﺮﮐﻒﺸﮐ: ﻥﺩﺮﮐﻊﻧﺎﻗ, ﻥﺩﺮﻛﻞﺣ
ﻩﺭﺎﺑﻭﺩﻉﻭﺮﺷ: ﺩﺪﺠﻣﯼﺯﺍﺪﻧﺍﻩﺍﺭ, ﯽﺗﺎﯿﻠﻤﻋ
ﺖﯿﺗﺎﭙﻫ: 
ﻥﻮﺗﻭﺮﭘ: 
ﮏﭼﻮﮐﻩﺩﺮﮔ: ﮏﺴﯾﺩ
ﻡﺮﮔﻡﺭﺍﺰﻫﮏﯾ: 
ﻞﺴﮑﯿﭘ: 
ﻢﻟﺎﺘﻧﺎﺗ: 
ﻝﻮﻠﺤﻣﺭﺩﺩﻮﺟﻮﻣ: 
ﻡﺎﻋﻞﺘﻗ: 
ﻡﻮﯿﻟﺎﮔ: 
ﭖﺎﭘﻻﺎﺑ: 
ﻡﻮﯿﻧﻮﮐﺮﯾﺯ: 
ﯽﻄﺧﺮﯿﻏ: 
ﺕﺍﺮﺸﺣﻩﺪﻨﺸﮐ: 
ﯼﺎﻬﻠﻤﺟﺪﻨﭼ: 
ﻡﻮﯿﻠﯾﺮﺑ: 
ﯽﺒﺼﻋﻪﺘﺧﺎﯾ: 
ﯼﺪﻨﺴﻣ: ﻩﺪﻨﻨﮐﺭﺎﻬﻇﺍ
ﺮﺗﻭﺭ: 
ﻞﯾﺭﻮﺘﮐﺎﻓ: ﻩﺪﮑﺸﻧﺍﺩ
ﺖﺟﺪﯾﻭ: ﻞﻤﮑﻣ
ﻥﻭﺮﺗﻮﻧ: 
ﻢﯿﺑﻮﯿﻧ: 
ﻡﻮﯿﻧﺎﻣﺭﮊ: 
ﺰﻠﻓﻪﺒﺷ: ﺰﻠﻓﺮﯿﻏ
prolativeﺩﺭﻮﻣ: 
ﯽﺘﺴﯾﺯﻉﻮﻨﺗ: 
ﻥﺩﺮﮐﯽﺘﻌﻨﺻ: ﯼﺯﺎﺳﯽﺘﻌﻨﺻ, ﺖﻌﻨﺻ
ﮏﯿﺘﺳﺍﯼﻮﺟ: 
ﮏﯿﺗﻮﯿﺑﯽﺘﻧﺁ: 
ﻢﯿﻨﯿﺘﮐﺍ: 
ﺩﺭﻮﻧﺎﻀﻓ: ﺎﻀﻓ
ﺝﺭﺎﺧﻩﺩﺮﺸﻓﺖﻟﺎﺣﺯﺍ: ﻥﺩﺍﺩﻪﻌﺳﻮﺗ, ﻥﺩﺮﺑﻻﺎﺑ
ﯽﺑﺎﯾﻥﻭﺮﺑ: 
ﻦﯿﻣﺯﻂﯿﺤﻣﺯﺍﻥﻭﺮﯿﺑ: ﻪﻧﺎﮕﯿﺑ
ﯽﯾﺎﺘﺸﻫ: 
ﻦﮐﺯﺎﺑﻊﺒﻨﻣ: 
ﻥﻮﺗﺍﺭﺎﻣﻭﺩﻪﻘﺑﺎﺴﻣ: 
ﻪﺧﺎﺷﻭﺩﺭﺩﻪﮐ: 
ﯼﮊﻮﻟﻮﭘﻮﺗ: 
ﺖﯾﺎﺑﺎﮕﯿﮔ: 
ﻥﺩﺮﮐﻥﻮﯾﻪﺑﻞﯾﺪﺒﺗ: 
SIﺪﺣﺍﻭ: 
ﻥﺩﺯﺭﺩﺎﭼ: ﻩﺎﮔﻭﺩﺭﺍ
ﺩﻭﺪﺤﻣﻞﻌﻓ: 
ﻥﻮﺘﭙﯾﺮﮐ: 
ﯽﻠﺜﻤﻟﺍﺏﺮﺿﺖﻟﺎﺣ: 
ﻥﺎﮑﻣﺮﯿﯿﻐﺗﺪﯿﻠﮐ: 
ﻊﺑﺮﻣ: ﻊﺑﺮﻣ
ﻩﺪﻨﺷﻭﺮﻓ: ﻝﻻﺩ, ﻩﺪﻨﺷﻭﺮﻓ, ﯽﺸﻨﻣ
ﻢﯿﻧﺭ: 
ﻩﺍﺮﻤﻫﻦﻔﻠﺗ: ﻩﺍﺮﻤﻫﻦﻔﻠﺗ, ﻩﺍﺮﻤﻫﻦﻔﻠﺗ, ﻞﻤﺣﻞﺑﺎﻗ, ﭖﺎﺗﭗﻟ, ﻝﻮﻠﺳ
ﯼﺭﻭﮏﯾ: ﺯﺍﻪﺘﺷﺬﮔ
ﯽﺘﯿﻔﯿﮐﺩﺭﻮﻣ: 
ﻪﺘﺴﮑﺷﻭﻕﺍﺭﻭﺍﺲﻨﺟﺖﺴﭘ: 
railcarﺖﻌﻨﺻ: 
ﭗﯿﻠﮐﺮﻨﻫ: 
ﻒﻟﺍﺏﻮﭼ: 
ﻢﯿﻨﻓﺎﻫ: 
ﻪﻧﺎﺧﻪﺤﻔﺻ: 
lativeﺩﺭﻮﻣ: 
ﻡﺍnﻪﺸﯾﺭ: 
ﯽﺷﺩﺮﮔﺭﺍﺩﻮﻤﻧ: 
ﻂﺳﻭﺍﺪﺻ: 
ﻝﺎﺴﻨﻬﮐ: ﻦﺴﻣﺩﺍﺮﻓﺍ
ﻥﺩﺮﮐﺩﺮﮔ: ﻩﺪﺷﺩﺮﮔ
ﻡﻮﯾﺩﻭﺭﻢﺗﺍ: ﻡﻮﯿﺑﺮﺗﻢﺗﺍ, ﻢﯿﻟﻮﺗﻢﺗﺍ, ﻢﯾﺭﻮﺗﻢﺗﺍ, ﻦﯾﺭﻮﻠﻓﻢﺗﺍ, ﻡﻮﯾﺪﯿﺑﻭﺭﻢﺗﺍ, ﻡﻮﯿﻟﺎﺗﻢﺗﺍ, ﻡﻮﯾﺩﺎﻧﺍﻭﻢﺗﺍ, ﻡﻮﯿﻧﻮﻠﭘﻢﺗﺍ, ﻡﻮﯿﺘﻧﻭﺮﺘﺳﺍﻢﺗﺍ, ﻢﯿﻨﺗﻭﺭﻢﺗﺍ
ﻕﻼﺧﺍﺪﺑ: ﻦﺸﺧ
ﺏﺭﻮﻣﺩﺭﻮﻣ: 
ﺭﻮﺒﺻﺩﺭﻮﻣ: 
hodiernalﺶﯿﭘ: 
ﻮﻣﻥﻭﺪﺑ: ﺖﺨﻟ, ﻡﺎﺧ
ﻑﺪﻫﻪﺷﺎﻣ: 
ﻡﻮﯿﻤﯾﺩﻮﺌﺳﺍﺮﭘ: 
ﺞﻠﻓ: 
ﻥﺩﺮﻛﺖﻳﺎﻜﺷ: ﺖﯾﺎﮑﺷ
ﻪﺑﺩﺭﻮﻣ: ﺭﺩﺩﺭﻮﻣ, ﯽﻓﺩﺎﺼﺗﺕﺭﻮﺻﻪﺑ, ﺐﻧﺎﺟﺯﺍﺩﺭﻮﻣ
ﺶﺑﺎﺗ: ﺶﺑﺎﺗ, ﺮﺸﻧ
ﻢﯾﺪﻨﯾﺍ: 
ﺮﮕﯾﺯﺎﺑﺶﻘﻧ: 
ﺖﯾﺎﺿﺭ: ﻕﺎﯿﺘﺷﺍ, ﺐﺼﻌﺗ, ﺖﯾﺎﺿﺭ, ﺖﯾﺎﺿﺭ, ﺕﺬﻟ, ﺕﺬﻟ, ﯼﺩﺎﺷ, ﺕﺬﻟ
ﻩﻼﮐﻥﺩﺮﮐﻞﻔﻗ: 
ﺪﯿﻔﺳﯼﺎﻀﻓ: 
ﯼﺮﯿﮕﻤﺸﭼﺭﻮﻃﻪﺑ: ﯽﺸﯾﺎﻤﻧ
ﺐﺼﻌﺘﻣﺖﺳﺮﭘﻦﻬﯿﻣ: 
ﯽﺘﻧﺮﺘﻨﯾﺍﺖﯾﺎﺳ: ﯽﺘﻧﺮﺘﻨﯾﺍﺖﯾﺎﺳ, ﻞﺤﻣ
ﯽﮕﻧﺎﺧﻩﺎﯿﮔ: 
ﯼﺪﻧﻭﺮﻬﺷﻕﻮﻘﺣ: 
ﻢﯿﻨﯿﺘﮐﺎﺗﻭﺮﭘ: 
ﯼﺮﯾﻮﺼﺗ: 
ﺵﺯﺭﺍﯽﯾﻭﺩﻭﺩ: 
ﺮﻠﮔ: 
ﯽﺷﻭﺮﻓﻩﺩﺮﺧﻩﺎﮕﺷﻭﺮﻓ: 
ﺖﯿﻌﺿﻭﺭﺎﺑ: 
ﻦﻓﻭﺮﮑﯿﻣ: ﮏﭼﻮﮐ
ﻥﺎﺴﻧﺍﻥﺪﺑ: 
ﺭﺩﻡﺭﻮﺧﯽﻣﻢﺴﻗ: 
ﻥﺎﺳﺭﻪﻣﺎﻧ: 
ﯽﻧﺎﯿﻣﺩﺭﻮﻣ: 
ﻥﺎﺟﻭﺮﺗﺐﺳﺍ: 
ﺭﺎﻣﻮﻃﺭﺎﺑ: 
ﻪﻄﻘﻧﻪﺳ: 
ﻥﺪﻧﺍﻮﺧﻂﻘﻓ: 
ﺰﻐﻟ: ﯽﺧﻮﺷ, ﯽﻫﺎﻔﺷ
ﯼﺭﺍﺪﯾﺎﭘﺎﻧ: ﺕﺎﺒﺛﯽﺑ, ﯽﺗﺎﺒﺛﯽﺑ
ﺮﻋﺎﺷ: 
ﯽﺟﺍﻭ: 
ﻥﺩﺮﮐﻡﺰﯿﺗﻮﻨﭙﯿﻫﺏﺍﻮﺧ: 
ﺶﯾﺎﻣﺯﺁﺩﺪﻋ: 
ﻩﺪﻧﺮﯿﮔ: ﺵﺮﯾﺬﭘﻝﻮﺌﺴﻣ
ﺪﻧﻮﺴﭘﻞﻌﻓ: 
ﺮﯿﻏﻥﺎﺴﻧﺍ: 
ﯽﻠﻌﻓﻥﺎﯾﺮﺟ: 
ﻪﮐ: ﻪﮐ, ﻪﮐ, ﻪﮐ, ﻪﮐ
ﻡﺩﺪﻨﺑ: 
ﺲﮑﻋﺮﺑ: ﺱﻮﮑﻌﻣ, ﺱﻮﮑﻌﻣ
ﻝﺎﺜﻣﯼﺍﺮﺑ: 
IPﯽﻧﺎﺸﻧ: 
ﻥﺎﺑﺯﺭﺩ: 
ﻪﻧﺎﮔﺍﺪﺟﺭﻮﻃﻪﺑ: ﺎﺼﺨﺷ, ﯼﺩﺮﻓ, ﯽﺼﺨﺷ, ﻪﻧﺎﮔﺍﺪﺟﺕﺭﻮﺼﺑ, ﻪﻧﺎﮔﺍﺪﺟ, ﺰﯾﺎﻤﺘﻣ, ﻦﺘﺷﺍﺩﺕﻭﺎﻔﺗ, ﺕﻭﺎﻔﺘﻣﺭﻮﻄﺑ, ﯽﯾﺎﻀﻓ
ﺭﺍﺰﻓﺍﻡﺮﻧﻪﻠﻤﺟ: ﺭﺍﺰﻓﺍﻡﺮﻧﺕﺭﺎﺒﻋ
ﯽﺳﺎﻨﺷﺮﯿﮕﻬﻤﻫ: ﮏﯿﻧﺎﮑﻣ, ﮏﯿﻣﺎﻨﯾﺩ
ﻥﺩﺮﮐﯽﻧﻮﻧﺎﻗ: ﻥﻮﻧﺎﻗ, ﻪﻨﻨﻘﻣ, ﻥﺩﺍﺩﺐﯿﺗﺮﺗ, ﻥﺩﺍﺩﻥﺎﻣﺯﺎﺳ
ﻩﺍﺭﻩﺍﺭ: ﻩﺍﺭﻩﺍﺭﻪﭼﺭﺎﭘ, ﺡﺮﻃ, ﺶﮐﻪﺸﻘﻧ, ﺡﺮﻃ
ﺎﻬﺑﺎﺼﺘﻋﺍ: 
ﻦﯿﺗﺎﺘﺳﺍ: 
ﻥﺩﺮﮐﻮﻠﻏ: 
ﯼﺮﮕﯾﺩﺮﮔﺍ: 
ﻪﯾﻭﺍﺯ: ﻪﯾﻭﺍﺯ, ﻥﺎﺸﻧﺮﻃﺎﺧ
ﻥﺩﺮﮐﺱﺎﺒﻟ: 
ﻝﻮﻗﻞﻘﻧﻡﺮﻓ: 
ergativeﺩﺭﻮﻣ: 
ﺮﻬﺷﻪﻣﻮﺣ: ﻩﺪﮑﻫﺩ, ﺪﻣﺁﻭﺖﻓﺭ, ﺮﻬﺷﻪﻣﻮﺣ
ﮎﺮﺘﺸﻣﺲﻨﺟ: 
ﻪﻧﺎﯾﺍﺭﺮﺑﺍ: 
ﻢﯿﻘﺘﺴﻣﻑﺪﻫ: ﻢﯿﻘﺘﺴﻣﺮﯿﻏﻑﺪﻫ
ﻥﺎﮔﺪﻨﻧﺍﺭ: ﻩﺪﻨﻧﺍﺭ
ﯼﺭﺎﻣﺁ: ﯼﺭﺎﻣﺁ, ﯼﺩﺪﻋ
ﻢﺘﯿﺗﻮﻟ: 
ﺖﯿﻧﻼﻘﻋ: ﯼﺭﺎﯿﺷﻮﻫ, ﻖﻄﻨﻣ
ﻝﺎﻌﻓﺮﯿﻏﺍﺪﺻ: 
ﻩﺪﻧﻮﺷﺐﺒﺳ: 
ﻢﯾﺰﺳ: 
ﻥﺩﺮﮐﻮﺠﺘﺴﺟﺭﻮﺗﻮﻣ: 
ﺭﺍﺰﺑﺍﺭﺍﻮﻧ: 
ﺭﺎﮐﺩﻮﺧﺭﻮﻄﺑ: ﮏﯿﺗﺎﻣﻮﺗﺍ
ﻢﯿﻧﺮﻔﯿﻟﺎﮐ: 
ﻢﯾﻮﻟﺪﻨﻣ: 
ﻞﻣﺎﻋﻪﺷﺎﻣ: 
ﯽﮕﻧﺭﺭﻮﮐ: 
ﻥﻮﺗﺭﺎﮐ: 
ﻪﻧﺎﯾﺎﭘ: ﻪﻧﺎﯾﺎﭘ
ﻪﻄﻘﻧﺲﯾﺮﺗﺎﻣ: 
ﻡﻮﯾﺭﺎﻣﺎﺳ: 
ﻩﺎﺗﻮﮐﺭﺍﺪﻣ: 
ﯼﺭﻭﺁﺩﺮﮔ: ﯼﺭﻭﺁﻊﻤﺟ
agentiveﺩﺭﻮﻣ: 
ﻑﺩﺎﺼﺗ: ﻁﻮﻘﺳ, ﻪﺤﻧﺎﺳ, ﯽﻓﺩﺎﺼﺗ, ﻪﺛﺩﺎﺣ, ﻥﺩﺮﮐﺏﺍﺮﺧ
ﻝﺎﺘﮐﺮﻓ: 
multalﺩﺪﻋ: 
ﻦﺘﺴﺑ: ﻪﺘﺴﺑ, ﻪﺘﺴﺑ, ﻦﺘﺴﺑ, ﻥﺩﺮﮐﻡﻭﺮﺤﻣ
ﻦﻬﭘ: ﻊﯿﺳﻭ, ﻊﯿﺳﻭ, ﻊﻣﺎﺟ, ﻊﯿﺳﻭ, ﻩﺩﺮﺘﺴﮔﺭﻮﻃﻪﺑ, ﻥﺍﻭﺍﺮﻓ, ﻩﺩﺮﺘﺴﮔﺭﻮﻃﻪﺑ, ﻩﺩﺮﺘﺴﮔ, ﮒﺭﺰﺑ, ﻪﯾﻭﺍﺯ
adessiveﺩﺭﻮﻣ: 
ﯽﻧﻭﺎﻌﺗ: ﺭﺎﮑﻤﻫ, ﻥﺩﺮﮐﯼﺭﺎﮑﻤﻫ, ﺭﺎﮑﻤﻫ, ﻪﺘﺴﺑﺍﻭ
euler'sﻩﺭﺎﻤﺷ: 
ﺭﺰﯿﻟﺮﮕﭘﺎﭼ: 
ﺲﻧﺍﺮﺗﯼﺩﺪﻋ: 
ﮒﻼﺑﻭ: ﺲﯾﻮﻧﮒﻼﺑﻭ
ﯽﺒﯿﮐﺮﺗ: ﺕﺎﯿﺒﯿﮐﺮﺗ
ﺱﺭﻮﻏﺎﺜﯿﻓ: 
abessiveﺩﺭﻮﻣ: 
ﯽﻧﺎﮑﻣﺩﺭﻮﻣ: 
ﺮﺨﺘﺳﺍ: ﺮﺨﺘﺳﺍ, ﻪﻧﺎﺧﺩﻭﺭﻩﺯﻮﺣ
ﯽﺘﻧﺮﺘﻨﯾﺍﻢﯾﺍﺮﺟ: ﮎﺎﻧﺮﻄﺧ, ﺭﻭﺁﻥﺎﯾﺯ
ﺖﺴﭘﻩﺭﺍﺩﺍ: ﺖﺴﭘ, ﻞﯿﻤﯾﺍ
ﺭﺍﺰﻓﺍﺪﺑ: 
ﯼﺭﺍﺩﺯﺎﺑ: ﻥﺩﺮﮐﺭﺎﻬﻣ, ﻥﺩﺮﮐﺩﻭﺪﺤﻣ, ﺭﺎﻬﻣ, ﺖﺳﺍﻩﺩﺮﮐﻉﻮﻨﻤﻣ, ﺩﺭ, ﻥﺪﻧﺎﺳﺮﺗ, ﻉﻮﻨﻤﻣ
ﯽﺳﻮﺳﺎﺟﯼﺎﻫﺭﺍﺰﻓﺍﻡﺮﻧ: 
ﻂﺒﺿ: ﺩﺭﻮﮐﺭ, ﻝﻮﻤﺷ, ﻡﺎﻧﺖﺒﺛ, ﺖﺒﺛ, ﺩﻭﺭﻭ, ﻢﺘﺴﯿﺳﻪﺑﺩﻭﺭﻭ
ﻪﺒﺣﺎﺼﻣ: ﻪﺒﺣﺎﺼﻣ
ﭗﯿﻠﮐﻪﺘﺨﺗ: 
ﻥﻮﻧﺰﮔ: 
ﻩﺩﺮﺘﺴﮔﻪﺤﻔﺻ: 
ﺪﻨﭼﻪﻠﺣﺮﻣﺭﺩﺕﺭﺪﻗ: 
ﺎﻤﻨﯿﺳ: ﺎﻤﻨﯿﺳ
ﻕﻭﺪﻨﺻ: 
ﯼﺪﺻﺭﺩ: ﺪﺻﺭﺩ, ﺪﺻﺭﺩ
ﻞﺳﻭﺮﺋﺁ: ﻥﺪﯿﺷﺎﭘ
ﻩﺪﻨﻨﮐﻊﯾﺯﻮﺗ: 
ﯽﮑﯿﻣﺎﻨﯾﺩ: ﮏﯿﻣﺎﻨﯾﺩ, ﮏﯿﻧﺎﮑﻣ, ﺎﯾﻮﭘ
ﻪﯿﻧﺎﺛﮏﯾ: 
ﻥﺩﻮﺑﻞﻣﺎﺷ: ﻥﺩﻮﺑﯼﺰﯿﺟﻪﻨﯿﻣﺯ
ﯽﻧﻭﺍﺮﺑ: 
ﻩﺭﺎﺘﺳﺲﻨﺟ: 
ﻥﺎﺸﮑﻬﮐﺲﻨﺟ: 
ﺍﻮﻘﻣ: ﺕﺭﺎﮐ, ﻦﺗﺭﺎﮐ
ﯼﺮﯾﺬﭘﻩﺭﺎﻤﺷ: 
ﺮﮕﯾﺩﯽﮑﯾ: ﺮﮕﯾﺩ, ﺮﮕﯾﺪﮑﯾ, ﯼﺮﮕﯾﺩ
ﺲﯿﻠﭘﺮﺴﻓﺍ: 
ﻪﯿﻟﻭﺍﻑﺪﻫ: 
ﻥﺩﺮﮐﻊﯿﺠﺸﺗﻭﮏﯾﺮﺤﺗﺲﻨﺟ: 
evitativeﺩﺭﻮﻣ: 
ﻪﯿﻠﻘﻧﻪﻠﯿﺳﻭﺲﻨﺟ: 
ﺎﻫﻩﺩﺍﺩﻥﺪﻌﻣﺝﺍﺮﺨﺘﺳﺍ: 
ﺏﻭﺬﺠﻣﺩﺭﻮﻣ: 
ﻡﻮﯿﮑﯾﺮﻣﺁ: 
ﯽﻧﺪﻌﻣﺲﻨﺟ: 
ﻪﻨﻣﺍﺩﻡﺎﻧ: 
ﺪﺣﺍﻭﯽﻟﺎﯿﺧ: 
ﻡﻮﯿﻧﻮﺘﭙﻧ: 
ﯽﻫﺎﻔﺷﻢﺳﺍ: 
ﻥﺎﻧﺍﺪﯿﺿﺎﯾﺭ: 
ﻪﯿﻟﺎﻓﺎﻀﻣﺩﺭﻮﻣ: ﻪﯿﻟﺎﻓﺎﻀﻣﺩﺭﻮﻣ
ﯼﺯﺎﺳﻝﺪﻣ: 
ﯽﯾﺎﻬﻧﻩﺭﺫ: 
ﺵﻼﻓﻥﺪﻧﺍﺭ: 
ﺖﺴﺳﮏﺴﯾﺩ: 
ﯽﻧﺎﺸﻧﺶﺗﺍﺭﻮﻣﺎﻣ: 
ﯽﻧﺍﺮﺤﺑﻪﻄﻘﻧ: 
ﻪﻧﻻﺪﻤﻫﺕﺬﻟ: 
ﻪﻤﻠﮐﻩﺪﻧﺯﺍﺩﺮﭘ: 
ﺮﯾﺯﻭﺖﺴﺨﻧ: 
ﯼﺯﺎﺠﻣﻪﻈﻓﺎﺣ: 
ﯼﺪﯿﻗﺩﺭﻮﻣ: 
ﻡﻮﯾﺪﯿﺗﺍ: 
ﻩﺎﺗﻮﮐﺭﺍﻮﻠﺷ: 
ﻑﺍﺮﻃﺍﺭﺩﻖﻤﺣﺍ: 
ﺕﻻﺩﺎﻌﻣ: ﻪﻟﺩﺎﻌﻣ
subessiveﺩﺭﻮﻣ: 
ﻢﺘﺴﯿﺳﻪﺑﺩﻭﺭﻭﺝﺭﺎﺧ: 
ﺩﺯﺩ: 
antessiveﺩﺭﻮﻣ: 
ﻩﺩﺎﯿﭘﺮﺑﺎﻋﻂﺧ: ﻩﺎﮔﺭﺬﮔ, ﻩﺎﮕﺷﺩﺮﮔ
ﺮﺑﺭﺎﮐﻂﺑﺍﺭ: 
ﺪﺴﯾﻮﻨﯿﻣﺰﯿﭼﻥﺍﺮﮕﯾﺩﯼﺎﺠﺑﻪﮑﯿﺴﮐ: 
ﯼﺮﺗﻮﯿﭙﻣﺎﮐﺱﻭﺮﯾﻭ: 
ﻩﺪﻨﻨﮐﻞﯿﻬﺴﺗ: ﻩﺪﻨﻨﮐﻪﺋﺍﺭﺍ, ﺮﯾﺪﻣ
ﯽﺸﺨﺒﻧﺍﻮﺗ: 
ﯽﮑﻤﮐﻞﻌﻓ: 
ﻝﻭﺍﺖﺳﺩ: ﻢﯿﻘﺘﺴﻣ
ﺩﺮﺑﺭﺩﺎﻣ: ﻪﭼ
ﺭﻮﺒﺻﻪﺷﺎﻣ: 
ﺍﺮﺟﺍﻥﺎﻣﺯ: 
ﯽﻌﻤﺟﻢﺳﺍ: 
ﻥﺍﺮﻗ: ﻪﻣﺎﻧﺯﻭﺭ
ﺕﺭﺎﺠﺗﺺﺨﺷ: ﺮﺟﺎﺗ
ﯼﺪﻌﺘﻣﻞﻌﻓ: 
ﺮﺑﺍﻪﺒﺳﺎﺤﻣ: 
ﯼﺯﺎﺠﻣﻩﺎﮕﺘﺳﺩ: 
absolutiveﺩﺭﻮﻣ: 
ﯼﺯﺎﺠﻣﺖﯿﻌﻗﺍﻭ: 
ﻪﺘﺷﺬﮔperfective: 
ﯽﺼﺨﺷﺮﯿﻏﻞﻌﻓ: 
crastinalﺖﻔﺳ: 
ﯽﺑﺎﺗﺯﺎﺑﺍﺪﺻ: 
ﻩﺪﯿﮑﭼﺲﻨﺟ: 
ﻥﺎﺴﻤﻫﺎﻧﻪﻌﻗﺍﻭ: 
exocentricﺩﺭﻮﻣ: 
ﻦﯿﻣﻭﺩﻥﺎﺑﺯ: 
ﻪﻧﺍﺪﻨﻣﺮﻨﻫﺲﻨﺟ: 
ﺩﻮﺧﺲﻔﻧﻪﺑﺩﺎﻤﺘﻋﺍ: 
ﺶﻫﻭﮋﭘﺲﻨﺟ: 
ﻢﯿﻘﺘﺴﻣﺮﯿﻏﯽﻧﺍﺮﻨﺨﺳ: 
ﻞﺤﻣﺲﻨﺟ: 
ﮏﯾﺰﯿﻓ: ﯽﮑﯾﺰﯿﻓ, ﯽﻤﺴﺟﻅﺎﺤﻟﺯﺍ
ﻥﺎﻬﺟﺲﻨﺟ: 
ﻥﺪﺷﻪﺘﺴﺑ: ﻦﺘﺴﺑ, ﻪﺘﺴﺑ, ﻪﺘﺴﺑ, ﺵﻮﻣﺎﺧ, ﻒﻗﻮﺗ, ﮎﺮﺗ, ﻒﻗﻮﺗ
ﯽﻟﺎﻋﺩﺭﻮﻣ: 
ﻖﺑﺎﻄﺗ: ﻦﺘﺷﺍﺩﯽﻧﺍﻮﺨﻤﻫ, ﯼﺍﺭ, ﯼﺍﺭﻪﻗﺭﻭ, ﺖﺳﺍﻮﺧﺩﺍﺩ, ﺐﺳﺎﻨﻣ, ﻖﻓﺍﻮﺗ, ﻥﺩﻮﺑﻖﺑﺎﻄﻣ, ﺐﺳﺎﻨﻣ, ﺐﺳﺎﻨﻣ, ﻥﺪﺷﻑﺩﺎﺼﻣ, ﻞﯿﻤﯾﺍ, ﺮﻇﺎﻨﺘﻣ, ﺭﺎﮔﺯﺎﺳ
ﺮﺗﻮﯿﭙﻣﺎﮐﻪﻣﺎﻧﺮﺑ: 
ﻦﺗﺩﺎﭘ: 
ﺖﻗﻭﻡﺎﻤﺗ: 
propositiveﺖﻟﺎﺣ: 
ﯽﻨﻤﺠﻧﺍﺩﺭﻮﻣ: 
ﻥﺎﺟﯽﺑﺲﻨﺟ: 
ﻦﺘﻣﺮﮕﺸﯾﺍﺮﯾﻭ: 
ﯽﻧﺎﻬﺟﺲﻨﺟ: 
ﯽﺗﺎﯿﻠﻤﻋﻢﺘﺴﯿﺳ: 
ﺩﺭﻮﻣﯼﺭﻮﺘﺳﺩ: 
ﯽﻗﺮﺑﯼﺭﺎﺟ: 
ﻞﺑﺎﻘﺘﻣﺍﺪﺻ: 
ﺖﺨﺗﺐﻟﻑﻭﺮﻇ: 
ﻪﺘﺴﻫbenefactive: 
ﺏﻭﻥﺎﺑﺰﯿﻣ: 
ﻥﺎﯾﺩﺍﺭ: 
ﯽﻠﻤﻋﺍﺪﺻ: 
ﺝﺍﻭ: 
ﯽﭘﺭﺩﯽﭘﺪﻨﺑ: 
ﮎﻮﺑﺕﻮﻧﺮﺗﻮﯿﭙﻣﺎﮐ: 
ﺯﺎﮔﻝﺍﺪﭘ: 
antipassiveﺍﺪﺻ: 
ﯽﻠﺤﻣﯽﻘﯿﺳﻮﻣ: 
ﺖﯾﺎﺑﺍﺮﺗ: 
ﯽﻋﺎﻤﺘﺟﺍﻪﮑﺒﺷ: 
ﻩﺮﮐﺍﺬﻣ: ﻩﺮﮐﺍﺬﻣ, ﺪﯿﻨﮐﺖﺒﺤﺻ, ﻮﮕﺘﻔﮔ, ﻥﺩﺯﭗﮔ, ﻞﺑﺎﻘﺘﻣﺮﺛﺍ, ﻞﻣﺎﻌﺗ, ﻩﺭﻭﺎﺸﻣ, ﻥﺩﺮﻛﺭﺍﺮﻗﺮﺑﻁﺎﺒﺗﺭﺍ, ﺩﻮﻨﺷﻭﺖﻔﮔ
ﻪﻧﺎﻓﺮﻃ: ﺖﺨﺗ, ﻢﻬﺒﻣ, ﻢﻬﺒﻣ
ﮎﮊﺍﻭ: 
ﺮﮑﻨﯿﻟ: ﻥﺩﺍﺩﻁﺎﺒﺗﺭﺍ, ﯽﮕﺘﺳﻮﯿﭘ
ﻢﯿﻤﯾﺩﻮﺌﻧ: 
ﯼﺭﺎﻤﯿﺑﺶﺑﺎﺗ: 
ﺮﺿﺎﺣﯽﻔﺻﻭﻪﺟﻭ: 
necessitativeﺖﻟﺎﺣ: 
ﯼﺩﻮﺟﻭﺪﻨﺑ: 
ﻩﺯﺍﺪﻧﺍﺯﺍﺶﯿﺑﻥﺎﻣﺯﺕﺪﻣ: 
ﻝﺎﻌﻓﺮﯿﻏﯽﻔﺻﻭﻪﺟﻭ: 
ﯽﺷﯼﺭﻮﺘﺳﺩ: 
ﻡﻭﺍﺪﺗﻪﺒﻨﺟ: 
ﺩﺮﻔﻨﻣﺩﺪﻋ: 
ﻥﺎﺸﺧﺭﺩﺕﺪﺷ: 
ﯽﻟﺎﻋﻪﺟﺭﺩ: 
ﯽﺑﺁﻦﯿﺟﺭﺍﻮﻠﺷ: 
ﯽﺑﺎﺨﺘﻧﺍﺞﻨﺳﺖﯿﻤﮐ: 
ﻝﺎﯿﺳﯽﻧﺍﺮﺤﺑﻕﻮﻓ: 
epentheticﮎﮊﺍﻭ: 
postpositionalﺩﺭﻮﻣ: 
ﻩﺪﻨﻨﮐﯽﺜﻨﺧﺞﻨﺳﺖﯿﻤﮐ: 
ﯼﺪﻧﻮﯿﭘﻩﺭﺫ: 
nerium: 
ﯽﻧﺎﻬﺟﺞﻨﺳﺖﯿﻤﮐ: 
ﯽﯾﺍﻮﻫﯼﻭﺮﯿﻧ: 
ﻪﺑﺎﻄﺧﻖﻓﺍﻮﺗ: 
ﺮﺗﻮﯿﭙﻣﺎﮐﻲﺴﻳﻮﻧﻪﻣﺎﻧﺮﺑ: 
ﻩﺪﻨﻨﮐﺭﺎﻬﻇﺍﺞﻨﺳﺖﯿﻤﮐ: 
ﺭﺮﮑﻣﻪﺒﻨﺟ: 
ﯽﻌﯾﺯﻮﺗﺮﯿﻤﺿ: 
ﻦﯾﺰﮕﯾﺎﺟﺞﻨﺳﺖﯿﻤﮐ: 
ﮓﻨﯿﺸﯿﻓ: 
ﯼﺩﺪﻋ: 
ﻑﻼﺧﻁﻭﺮﺸﻣ: 
