ﻆﻓﺎﺣﺍﺪﺧ: ﺩﻭﺭﺩ, ﯽﻈﻓﺎﺣﺍﺪﺧ, ﻥﻭﺎﻌﻣ
: 
ﺯﺍ: ﻦﯿﺑ, ﻩﺭﺎﺑﺭﺩ, ﻥﺁ
ﻪﺑ: ﺎﯿﺑ, ﺩﻼﯿﻣﺯﺍﺪﻌﺑ, ﺎﻬﻧﺁ
ﺭﺩﻪﮐ: ﻦﯿﺑ
:Firstperson: 
ﻦﻣ: ﻦﻣﻪﺑ
:Thirdperson: 
ﻪﮐ: IT, ﻪﮐ, ﯽﺴﮐﻪﭼ, ﺪﯿﻠﮐ
ﺩﻮﺧ: ﻥﺁ, ﺩﻮﺧ
ﻭﺍ: IT
ﺎﺑ: 
ﯼﺍﺮﺑ: ﻩﺭﺎﺑﺭﺩ, ﺩﻼﯿﻣﺯﺍﺪﻌﺑ, ﺍﺮﯾﺯ
ﻪﻟﺰﻨﻣﻪﺑ: ﯽﺴﮐﻪﭼ, ﻝﺎﺜﻣ
:Secondperson: 
ﻥﺩﻮﺑ: ﻦﺘﺳﻮﯿﭘﻉﻮﻗﻭﻪﺑ, ﻥﺩﺎﺘﺴﯾﺍ
ﻭﺍ: ﻥﺁ
ﺮﺑ: ﻥﺩﺯﮓﻧﺯ, ﻩﺭﺎﺑﺭﺩ, ﻻﺎﺑ
ﺭﺩ: ﺐﺳﺍ, ﺎﺠﻨﯾﺍ
ﻂﺳﻮﺗ: ﺭﻮﺒﻋ, ﻭ, ﻩﺭﺎﺑﺭﺩ
ﻪﮐ: ﯽﺴﮐﻪﭼ, ﻪﮐ, ﻪﮐﻡﺍﺪﮐﺮﻫ, IT
ﺪﻧﺭﺍﺩ: ﻥﺩﺭﻭﺁﺖﺳﺩﻪﺑ, ﻞﻤﺤﺗ
ﺎﯾ: 
ﺐﻧﺎﺟﺯﺍ: 
ﻦﯾﺍ: IT, ﺎﻬﻧﺍﺪﻧﺩ
ﺍﺭﻭﺍ: ﻥﺁ, ﺺﺨﺷ
ﻭﺍ: ﺎﻬﻧﺁ, IT
ﻦﻣ: ﻡﺩﻮﺧﻝﺎﻣ, ﻦﻣﻪﺑ, ﺭﻮﺒﻋﺰﻣﺭ
ﻥﺎﺷ: ﻥﺁ, ﺎﻬﻧﺁ, ﯽﺴﮐﻪﭼ
ﻦﯾﺍﺮﺑﺎﻨﺑ: ﺐﯿﺗﺮﺗﻦﯾﺪﺑ, ﯼﺩﻭﺯﻪﺑ, ﺐﯿﺗﺮﺗ
: , ﮏﯾ, ﻭ
ﺎﻬﻧﺁ: ﺎﻬﻧﺁ, ﺎﻤﺷ, ﺺﺨﺷ
ﺎﻣ: ﺎﻣ, ﻦﻣﻪﺑ
ﺍﺭ: ﺮﮑﻓ, ﺖﯾﺮﯾﺪﻣ
ﻩﺩﺍﺭﺍ: ﻩﺩﺍﺭﺍﯼﻭﺮﯿﻧ
ﺮﯿﺧ: ﻪﻧ
ﺮﮔﺍ: ﻩﺪﺷﻪﺋﺍﺭﺍ
ﺝﺭﺎﺧ: ﯽﻧﻭﺮﯿﺑ, ﻻﺎﺑ, ﺝﻭﺮﺧ, ﯽﺴﮐﻪﭼ
ﻪﺑ: ﮏﯾ, ﻦﯿﺑ
ﺮﻫ: ﻪﮐﻡﺍﺪﮐﺮﻫ, ﯽﻨﻌﯾ, ﻪﻤﻫ, ﮏﺗﮏﺗ
ﺍﺭﺩﻮﺧ: ﺎﻤﺷﻝﺎﻣ
ﯽﭼ: ﻦﺘﺳﻮﯿﭘﻉﻮﻗﻭﻪﺑ, ﻡﺎﺠﻧﺍ
ﻂﺑﺍﺭﻮﻀﻋ: 
ﻩﺪﻨﻫﺩﻥﺎﺸﻧﺖﻟﺎﺣ: ﺩﻮﻤﻨﻫﺭﺖﻟﺎﺣ
ﻥﺎﺴﻧﺍ: ﺺﺨﺷ, ﺮﻫﻮﺷ, ﺮﻧ
ﺮﮕﯾﺩ: ﻦﯿﻣﻭﺩ, ﻒﻠﺘﺨﻣ, ﺶﯿﺑ
ﻪﺑﺖﺒﺴﻧ: ﺶﯿﺑ, ﻩﺭﺎﺑﺭﺩ, ﻦﯾﺮﺘﺸﯿﺑ
ﺎﻣ: ﺭﺎﻬﺑ, ﺎﻣ
ﺯﺍﯽﺧﺮﺑ: ﯽﭼﭻﯿﻫ
ﺮﺑ: ﻻﺎﺑ
ﺖﺳﺍﻦﮑﻤﻣ: ﺖﺳﺍﻪﺘﺴﻧﺍﻮﺗ
ﻥﻮﻨﮐﺍ: ﺮﺿﺎﺣﻝﺎﺣﺭﺩ, ﺮﮕﯾﺩ
ﺪﻨﻧﺎﻣ: ﻖﺸﻋ, ﻦﺘﺷﺍﺩﻪﮕﻧ, ﻪﯿﺒﺷ
ﻥﺍﻮﺗﯽﻣ: ﺖﺳﺍﻪﺘﺴﻧﺍﻮﺗ, ﻪﺒﻌﺟ, ﻦﺘﺴﻧﺍﺩ
ﺪﯾﺎﺑ: ﺪﯾﺎﺑ, ﻝﺎﺳﺭﺍ
ﺩﺍﺩﻡﺎﺠﻧﺍ: ﻡﺎﺠﻧﺍ, ﺖﯿﻌﻗﺍﻭ
ﻦﯿﻨﭼ: ﺐﯿﺗﺮﺗﻦﯾﺪﺑ
: ﮏﯾ, 
ﺎﻬﻨﯾﺍ: ﺎﻬﻧﺁ, IT
ﺮﺑﻎﻟﺎﺑ: ﻻﺎﺑ, ﺶﯿﺑ, ﻦﯾﺮﺘﺸﯿﺑ
ﺭﺎﯿﺴﺑ: ﺭﺎﯿﺴﺑ, ﻢﺠﺣ, ﺖﯿﻌﻤﺟ, ﺪﻨﺗﺐﯿﺷ
ﺯﺍﺪﻌﺑ: ﺪﻌﺑ, ﻊﻗﻮﻣﻥﻭﺍ
ﯼﺎﻗﺁ: ﺎﻗﺁ, ﺩﺎﺘﺳﺍ, ﻪﻧﺍﺩ
ﺏﻮﺧ: ﻞﮕﺷﻮﺧ, ﯽﻟﺎﻋ, ﻪﺘﻓﺭﻭﻪﺘﺴﺷ, ﺮﺘﻬﺑ
ﺰﮔﺮﻫ: ﻪﻧ
ﻦﯾﺮﺘﺸﯿﺑ: ﺶﯿﺑ, ﯼﺩﺎﯾﺯﺪﺣﺎﺗ, ﺖﯾﺮﺜﮐﺍ, ﺭﺎﯿﺴﺑ, ﻦﯾﺮﺘﺸﯿﺑ, ﻦﯾﺮﺗﺪﺑ, ﻦﯾﺮﺘﻤﮐ
ﺪﯾﺎﺑ: ﺪﯾﺎﺑ
ﻥﺁ: ﺎﻬﻧﺁ, ﻥﺁ, ﯽﺴﮐﻪﭼ
ﺩﻮﺧ: ﺩﻮﺧ, ﻥﺎﺷﺩﻮﺧ
ﯽﮔﺪﻧﺯ: ﻩﺪﻧﺯ, ﯽﮔﺪﻧﺯﮏﺒﺳ, ﺭﺍﺩﺍﺪﺻﻑﺮﺣ
ﻥﻭﺪﺑ: ﺰﺠﺑ, ﻩﺩﺭﺎﻬﭼ
ﻦﺘﺧﺎﺳ: ﻞﻌﺟ, ﻡﺎﺠﻧﺍ
ﻲﺑﻮﺧﻪﺑ: ﻞﻣﺎﮐﺭﻮﻄﺑ, ﮎﻼﻣﺍ, ﺖﺳﺭﺩ
ﻦﺨﺳﺮﮕﻧﺎﺸﻧ: 
ﻖﯾﺮﻃﺯﺍ: ﺭﻮﺒﻋ
ﻦﮑﻤﻣ: ﺕﺭﺪﻗ, ﺪﯾﺎﺷ, ﺖﺳﺍﻪﺘﺴﻧﺍﻮﺗ
ﻪﻧﻮﮕﭼ: ﺮﯿﺴﻣ
ﻢﻫ: ﺭﺎﯿﺴﺑ, ﯽﺘﺣ
ﻮﻧﺯﺍ: ﻊﻗﻮﻣﻥﻭﺍ, ﺖﺸﮔﺯﺎﺑ, ﺮﮕﯾﺩ
ﯼﺭﺎﯿﺴﺑ: ﺖﯾﺮﺜﮐﺍ, ﺖﯿﻌﻤﺟ
ﺮﻫ: ﮏﺗﮏﺗ, ﺝﺮﺨﻣ, ﻪﻤﻫ
ﺎﻫﻥﺎﺴﻧﺍ: ﺺﺨﺷ, ﻉﺎﻤﺘﺟﺍ
ﻥﺎﺴﮑﯾ: ﺮﺑﺍﺮﺑ, ﺎﻬﻧﺁ
ﺮﮑﻓ: ﻱﮊﻮﻟﻮﺋﺪﻳﺍ, ﻪﺸﯾﺪﻧﺍ, ﺮﮑﻓ
ﺭﻭﺩ: ﺭﻭﺩ, ﺩﺮﮐﮎﺮﺗ, ﯽﻧﻻﻮﻃ
ﺮﯾﺯ: ﻦﯿﯾﺎﭘ
ﺯﻮﻨﻫ: ﺶﯿﺑ
ﻥﺩﺍﺩﯼﺎﺟ: ﻪﻄﻘﻧ, ﺖﯿﻌﻗﻮﻣ, ﻪﮐﯽﯾﺎﺟ
ﻦﯿﺣﺭﺩ: ﻥﺎﻣﺯ, ﺖﻗﻮﻣ, ﻪﮑﯿﻟﺎﺣﺭﺩ
ﻂﻘﻓ: ﻂﻘﻓ
ﻦﯿﻨﭽﻤﻫ: ﯽﺘﺣ, ﺶﯿﺑ
ﻥﻮﻨﮐﺎﺗ: ﺎﻣﺍ, ﺶﯿﺑ, ﯽﺘﺣ
ﻪﭼﺮﮔ: ﺩﻮﺟﻭﺎﺑ, ﺎﻣﺍ, ﻪﮑﯿﻟﺎﺣﺭﺩ
ﺮﺑﺍﺮﺑﺭﺩ: ﺯﺍﻞﺒﻗ, ﻞﺑﺎﻘﻣ
ﻦﺘﻓﺮﮔ: ﻥﺩﺭﻭﺁﺖﺳﺩﻪﺑ, ﻦﺘﻓﺮﮔ, ﯽﺳﺮﺘﺳﺩ, ﻩﺪﺷﺍﺪﯿﭘ, ﻪﺘﻓﺮﮔﺕﺎﺸﻧ, ﻥﺩﺮﮐﺐﺣﺎﺼﺗ
ﻪﺸﯿﻤﻫ: ﯼﺪﺑﺍ, ﻪﺸﯿﻤﻫ, ﯽﻧﺎﻣﺯﻪﭼ
ﺵﻮﻣﺎﺧ: ﺭﻭﺩ, ﻩﺪﺷﻩﺩﺍﺩﺶﺷﻮﭘ, ﻥﺪﺷﻪﺘﺴﺑ, ﻥﺩﺮﻣ, ﯽﺴﮐﻪﭼ
ﺕﺭﻮﺻ: ﺢﻄﺳ, ﺪﺻ, ﺺﺨﺷ, ﻥﺎﻫﺩ
ﺮﮕﯾﺩ: ﺮﮕﯾﺩﯽﮑﯾ, ﻪﺘﺷﺬﮔ, ﻒﻠﺘﺨﻣ, ﻦﯿﻣﻭﺩ, ﺶﯿﺑ
ﺪﯾﺪﺟ: ﻥﺎﻣﺭ, ﺕﻭﺍﺮﻃﺎﺑ, ﺮﻔﻧﻪﻧ, ﻥﺍﻮﺟ
ﻮﺌﻧ: 
ﻢﻧﺎﺧ: 
ﻥﺩﺍﺩﺭﺍﺮﻗ: ﻢﯿﻈﻨﺗ, ﻥﺩﺍﺩ, ﻡﺎﺠﻧﺍ, ﻦﺘﻓﺮﮔﺎﺟ, ﯽﻓﺎﮐ
ﻪﺑ: ﻦﺘﻔﮔ
ﻦﻫﺫ: ﯼﺮﮑﻓ, ﺮﮑﻓ
ﺭﺎﻤﺷﺖﺸﮕﻧﺍ: ﯽﻤﮐﺭﺍﺪﻘﻣ, ﯽﭼﭻﯿﻫ, ﺖﯿﻠﻗﺍ
ﺰﯿﭼ: ﻩﺩﺎﻣ, ﻩﺭﺎﺑﺭﺩ
ﻪﮐ: ﯽﺴﮐﻪﭼ, ﻪﮐ
ﺭﺎﯿﺴﺑ: ﺭﻭﺩ, ﺭﺎﯿﺴﺑ
ﺪﻧﻮﺷﯽﻣﻩﺪﯿﻣﺎﻧ: ﺮﮑﻓ, ﻦﺘﻔﮔ
ﻡﺎﻤﺗ: ﻩﺪﺷﺮﭘ, ﻪﻤﻫ, ﻝﺎﮑﯾﺩﺍﺭ
ﻭﺩﺮﻫ: ﻦﯿﻣﻭﺩ, ﻭﺩ
ﻥﺩﺮﮐﺍﺪﯿﭘ: ﻩﺪﺷﺍﺪﯿﭘ, ﻥﺩﺮﮐﻮﺠﺘﺴﺟ, ﻥﺩﺭﻭﺁﺖﺳﺩﻪﺑ, ﯽﻧﺎﺸﻧ, ﺺﯿﺨﺸﺗ
ﻦﮐﻩﺎﮕﻧ: ﻥﺪﯾﺩ, ﯽﺳﺭﺮﺑ, ﻩﺎﮕﻧ, ﺪﺳﺭﯽﻣﺮﻈﻧﻪﺑ
ﺪﯿﻫﺩﻩﺯﺎﺟﺍ: ﺱﻮﺑﻮﺗﺍ, ﻥﺩﺍﺩ, ﺯﻭﺭ, ﺐﯿﺗﺮﺗ, ﻥﺩﺮﮐﻪﻠﺧﺍﺪﻣ, ﺖﺧﺍﺩﺮﭘ
ﺰﯿﻣﺍﺖﺤﯿﺼﻧ: 
ﺪﻧﻭﺍﺪﺧ: ﺩﺎﺘﺳﺍ, ﺎﻗﺁ, ﻩﺎﺷﺩﺎﭘ
ﻪﻧﺎﺧ: ﻪﻧﺎﺧ
ﯼﺰﯿﭼﻪﯾ: ﯽﭼﭻﯿﻫ, ﻑﺍﺮﺤﻧﺍ, ﯼﻮﺤﻧﻪﺑ
ﻪﻈﺤﻟ: ﻥﺎﻣﺯ
ﺭﺪﭘ: ﺭﺪﭘ
ﻥﺎﯿﻣﺭﺩ: ﻦﯿﺑ, ﻪﮐﻡﺍﺪﮐﺮﻫ
ﻥﺯ: ﻪﻧﺎﻧﺯ, ﺮﺘﺧﺩ, ﻥﺯ, ﺮﻧ
ﺎﻫﻥﺯ: 
ﺭﺩﺎﻣ: ﺭﺩﺎﻣ
ﻥﺎﯾﺎﭘ: ﻪﺘﺷﺬﮔ, ﺖﯾﺎﻬﻧﺭﺩ, ﻪﺠﯿﺘﻧ
ﺎﺒﯾﺮﻘﺗ: ﮏﯾﺩﺰﻧ, ﻩﺭﺎﺑﺭﺩ, ﯽﺒﯾﺮﻘﺗ
ﮏﭼﻮﮐ: ﯽﻤﮐﺭﺍﺪﻘﻣ
ﻮﺗ: ﺎﻤﺷ
ﻥﺍﻮﺗﯽﻤﻧ: ﻪﻧ
ﺪﯿﻫﺍﻮﺧﯽﻣ: ﺪﯾﺎﺑ
ﺎﻣﺍ: ﺎﻣﺍ, ﻪﮑﯿﻟﺎﺣﺭﺩ, ﮏﯾ
ﻼﻣﺎﮐ: ﻞﻣﺎﮐﺭﻮﻄﺑ, ﺭﺎﯿﺴﺑ, ﻼﻣﺎﮐ, ﯽﻓﺎﮐ
ﻪﻧﻭ: ﻦﺘﺳﻮﯿﭘﻉﻮﻗﻭﻪﺑ, ﻪﻧ
ﻪﮐ: ﯽﺴﮐﻪﭼ, ﻪﮐ, ﻥﺁ
ﻦﯾﺮﺘﻬﺑ: ﺮﺘﻬﺑ, ﻦﯾﺮﺘﻤﮐ
ﻡﺩﻮﺧ: ﻦﻣﻪﺑ, ﻥﺎﺷﺩﻮﺧ, ﯽﺴﯿﻃﺎﻨﻐﻣ
ﻪﮑﻨﯾﺍﺎﺗ: ﯽﺘﺣ, ﺯﺍﻞﺒﻗ, ﻻﺎﺑ
ﻥﻮﭼ: ﻊﻗﻮﻣﻥﻭﺍ, ﻝﻭﺍ, ﺍﺮﯾﺯ
ﺪﺷﻩﺩﺎﻔﺘﺳﺍ: ﯽﻤﯾﺪﻗ, ﺎﻨﺷﺁ
ﺎﺘﺒﺴﻧ: ﯼﺎﺠﺑ, ﺶﯿﺑ, ﻪﻧ
ﺮﺿﺎﺣ: ﺮﺿﺎﺣﻝﺎﺣﺭﺩ
ﺮﺘﻤﮐ: ﻢﮐ, ﻦﯿﯾﺎﭘ, ﻦﯾﺮﺘﻤﮐ
ﺩﻭﺪﺣﺭﺩ،ﻞﺧﺍﺩﺭﺩ: ﯽﻠﺧﺍﺩ, ﻖﯿﻤﻋ, ﻦﯿﺑ
ﺮﮕﯾﺪﮑﯾﺎﺑ: ﯽﻌﻤﺟ, ﻢﯿﻈﻨﺗ, ﯽﮕﺘﺳﻮﯿﭘ
ﺎﺗ: ﯽﺘﺣ, ﺎﯿﺑ, ﺯﺍﻞﺒﻗ, ﻻﺎﺑ
ﮒﺭﺰﺑ: ﯽﻟﺎﻋ
ﻉﻮﻧ: ﺱﻼﮐ, ﯼﺯﺎﺳﺐﺗﺮﻣ, ﻪﻧﺎﺘﺳﻭﺩ, ﺮﯾﺬﭙﻟﺩ
ﯽﻀﻌﺑ: ﺺﺨﺸﻣ, ﺖﺳﺭﺩ, ﯽﻌﻗﺍﻭ, ﯽﭼﭻﯿﻫ
ﺵﺩﻮﺧ: ﻥﺎﺷﺩﻮﺧ
ﻢﯿﻧ: ﻩﺍﺭﻪﻤﯿﻧ, ﻥﺩﺮﮐﺏﺎﯿﺳﺁ, ﺖﻤﺳ
ﺖﺳﺭﺩ: ﯽﻌﻗﺍﻭ, ﻦﯿﺑﻊﻗﺍﻭ, ﺖﯿﻌﻗﺍﻭ, ﺖﺳﺭﺩ
ﻱﺰﻴﭼﺮﻫ: ﯽﭼﭻﯿﻫ, ﯽﺴﮐﻪﭼ, ﻡﺎﺠﻧﺍ
ﻦﺘﺷﺍﺩﻩﺎﮕﻧ: ﻦﺘﺷﺍﺩﻪﮕﻧ, ﻢﯿﻈﻨﺗ, ﻆﻔﺣ
ﯼﺎﻨﻌﻣﻪﺑ: ﺮﯿﺴﻣ, ﻪﯿﻠﻘﻧﻪﻠﯿﺳﻭ, ﻊﺑﺎﻨﻣ
ﻥﺩﺍﺩﺡﺮﺷءﺰﺟﻪﺑءﺰﺟ: ﺖﯿﻌﺿﻭ, ﻥﺪﺷﻞﺧﺍﺩ, ﺭﻮﺸﮐ, ﺖﻟﻭﺩ, ﻥﻮﻧﺎﻗ
ﺲﮐﯽﺑ: ﺎﻬﻨﺗ, ﮏﯾ, ﺮﺘﺧﺩ, ﻥﺎﺷﺩﻮﺧ, ﻂﻘﻓ
ﻻﺎﺑﺭﺩ: ﻻﺎﺑ
ﺩﺭﻮﻣ: ﻩﺩﺎﻣ, ﻁﻮﻘﺳ, ﻝﺎﺜﻣ, ﯽﻧﻮﻧﺎﻗﺩﺮﮕﯿﭘ, ﺍﺮﯾﺯ
ﻮﺗ: ﺎﻤﺷ
ﻻﺎﺑ: ﻻﺎﺑ, ﻪﻘﺒﻃ
ﻢﺸﭼﯼﻭﺭﻪﺑ: ﻥﺩﺍﺩﻥﺎﻨﯿﻤﻃﺍ, ﺖﺳﺭﺩ, ﺮﻄﺧﯽﺑ, ﺍﺪﮐﻮﻣ
ﻊﻗﺍﻭﺭﺩ: ﺖﯿﻌﻗﺍﻭ
ﺩﻮﺧ: ﻥﺎﺷﺩﻮﺧ, ﺩﻮﺧ, ﯽﺘﺣ, ﯽﺘﺳﺩﺕﺭﻮﺼﺑ
ﻩﺍﺮﻤﻫ: ﯽﻌﻤﺟ, ﯽﻧﻻﻮﻃ, ﻝﻮﻃ
ﻦﯿﻣﺯ: ﺭﻮﺸﮐ, ﮎﻼﻣﺍ
ﺖﺸﮔﺮﺑ: ﺖﻓﺮﺴﭘ, ﺖﺸﮔﺯﺎﺑ
ﻥﺩﺮﮐﮎﺮﺗ: ﺕﻼﯿﻄﻌﺗ, ﻪﮐﻭﺮﺘﻣ, ﺩﺮﮐﮎﺮﺗ, ﻩﺯﺎﺟﺍ
ﻢﻫ: ﯽﺘﺣ, ﻪﮐﻡﺍﺪﮐﺮﻫ
ﻥﻮﻧﺎﻗ: ﺖﺳﺭﺩ, ﯽﻧﻮﻧﺎﻗ, ﻥﻮﻧﺎﻗ
ﯽﻧﺎﺣﻭﺭﺮﯿﻏ: ﻢﯿﻈﻨﺗ, ﮏﻤﮐ, ﻦﺘﺷﺍﺩﻪﮕﻧ, ﺪﯿﻨﮐﺽﺮﻓ, ﺖﯿﻌﻗﻮﻣ
ﻥﺩﺮﻛﻩﺭﺎﺷﺍ: ﻪﻄﻘﻧ, ﻞﻤﻋ, ﻂﻘﻓ, ﺪﻨﺑ
ﻞﻔﻃ: ﺎﻫﻪﭽﺑ
ﻥﺩﺮﮐﻭﺯﺭﺁ: ﺪﯿﻣﺍ, ﻦﺘﺷﺍﺩﻞﻳﺎﻤﺗ, ﻥﺩﺮﮐﺎﺿﺎﻘﺗ
ﻦﺘﻔﮔﻦﺨﺳ: ﻦﺘﻔﮔ
ﻭﺭﻦﯾﺍﺯﺍ: ﺐﯿﺗﺮﺗﻦﯾﺪﺑ, ﻪﺠﯿﺘﻧﺭﺩ
ﺖﻋﺎﺳ: ﺱﻮﻗﺎﻧ, ﻥﺎﻣﺯ
ﻥﺎﯾﺮﺟﺭﺩ: ﻥﺎﻣﺯ, ﻦﯿﺑ
ﺪﻨﭼ: ﺶﯿﺑ, ﻒﻠﺘﺨﻣ
ﺕﺭﺎﺠﺗ: ﺕﺭﺎﺠﺗ, ﺖﮐﺮﺷ, ﺭﺎﮐ, ﻪﻓﺮﺣ
ﻪﭼ: ﺩﺮﺑﺭﺩﺎﻣ, ﻡﺎﺠﻧﺍ
ﺵﻭﺭ: ﺮﯿﺴﻣ, ﺵﻭﺭ, ﻦﺘﻓﺭﺶﯿﭘ
ﻞﯿﻟﺩ: ﺏﺎﺴﺣ, ﺍﺮﯾﺯ
ﯽﻣﻮﻤﻋ: ﻝﻮﻤﻌﻣ, ﻡﺩﺮﻣﻡﻮﻤﻋ
ﺖﺸﭘ: ﺖﺸﮔﺯﺎﺑ
ﻥﺪﺷ: ﺎﯿﺑ
ﻥﺎﺟﯽﺑ: ﻥﺩﺮﻣ, ﮒﺮﻣ, ﻩﺪﺷﺽﺮﻘﻨﻣ
ﻦﯿﻣﺯ: ﺭﻮﺸﮐ
ﺮﺴﭘ: ﺮﺴﭘﺪﻧﺯﺮﻓ
ﻮﻠﺟ: ﺪﻌﺑ
ﺱﺎﺴﺣﺍ: ﺱﺎﺴﺣﺍ, ﻥﺪﯿﻤﻬﻓ, ﻥﺪﯿﻨﺷ, ﺮﮑﻓ
ﺡﻭﺭ: ﺡﻭﺭ
ﻝﺍﻮﺳ: ﻩﺩﺎﻣ, ﻝﺪﺟﻭﺚﺤﺑ
ﺖﻘﯿﻘﺣ: ﺖﯿﻌﻗﺍﻭ
ﻦﯿﻣﺯ: ﻪﻘﺒﻃ, ﺭﻮﺸﮐ
ﺎﻌﻗﺍﻭ: ﻦﯿﺑﻊﻗﺍﻭ, ﺭﺎﯿﺴﺑ, ﺖﯿﻌﻗﺍﻭ
ﯽﻗﺎﺑ: ﯽﺘﺣﺍﺭ, ﻪﺘﺴﺸﻧﺯﺎﺑ, ﯽﻗﺎﺑ, ﺕﻼﯿﻄﻌﺗ, ﻩﺪﻧﺎﻣﯽﻗﺎﺑ, ﺶﯿﺑ
ﻦﮑﻤﻣ: ﺪﯾﺎﺷ, ﺖﺳﺍﻪﺘﺴﻧﺍﻮﺗ
ﯼﻮﺳﻪﺑ: ﮏﺗﮏﺗ, ﺖﻤﺳ
ﻥﺎﺴﻧﺍ: ﺺﺨﺷ, ﺖﯾﺮﺸﺑ
ﻩﺎﺗﻮﮐﺪﻗ: ﻢﮐ, ﺮﺼﺘﺨﻣ, ﮏﯾﺭﺎﺑ, ﯽﻤﮐﺭﺍﺪﻘﻣ
ﺮﻬﺷ: ﻥﺎﺘﺳﺮﻬﺷ
ﻥﺩﺮﮐﻝﺎﺒﻧﺩ: ﺪﻌﺑ, ﻥﺩﺮﮐﻝﺎﺒﻧﺩ
ﻦﺘﺷﺍﺩﻡﺯﻻ: ﻡﺯﻻ, ﺪﯾﺎﺑ
ﺩﻮﺷﯽﻣﺐﺒﺳ: ﺏﺎﺴﺣ, ﻥﺩﺮﮐﺭﺍﺩﺍﻭ, ﺍﺮﯾﺯ
ﺐﺷ: ﺐﺷ, ﺮﻬﻇﺯﺍﺪﻌﺑ
ﺞﻨﭘ: ﻢﺠﻨﭘ, ﻝﺎﺳ
ﯼﻮﻗ: ﺕﺭﺪﻗ, ﺪﯾﺪﺷ, ﺖﯾﻮﻘﺗ, ﯽﺒﺼﻋ
ﺭﺩﺎﻗ: ﻂﯾﺍﺮﺷﺪﺟﺍﻭ, ﻪﺑﺭﺩﺎﻗ, ﺖﺳﺍﻪﺘﺴﻧﺍﻮﺗ
ﻢﻧﺎﺧ: ﻪﻧﺎﻧﺯ, ﺮﺘﺧﺩ
ﻉﻮﺿﻮﻣ: ﻁﺎﺒﻀﻧﺍ, ﻉﻮﺿﻮﻣ, ﯽﯾﺎﻨﻌﻣ, ﻩﺩﺎﻣ, ﻖﺑﺎﻄﻣ
ﻥﺎﺴﮑﯾﻉﻮﺿﻮﻣﺮﮕﻧﺎﺸﻧ: 
ﻦﮐﮎﺭﺩ: ﻥﺩﺮﻛﻙﺭﺩ, ﻥﺪﯿﻤﻬﻓ, ﻦﺘﺴﻧﺍﺩ, ﻦﺘﺷﺍﺩﺭﻮﻈﻨﻣ, ﻥﺩﺮﻛﺖﺑﺎﺛ
ﻑﺍﺮﻃﺍﺭﺩ: ﻑﺍﺮﻃﺍ, ﮏﯾﺩﺰﻧ, ﻩﺭﺎﺑﺭﺩ, ﻢﺸﭼ
ﻥﺪﯿﺳﺮﭘ: ﻥﺩﺮﮐﺎﻋﺩ, ﻢﻨﻛﻰﻣﺶﻫﺍﻮﺧ, ﻪﺘﺳﺍﻮﺧ
ﺡﻼﺳ: ﻥﺩﺮﮐﺡﻼﺳﻊﻠﺧ, ﺖﺳﺩ
ﻥﺩﺯﺭﻭﺩ: ﺖﻤﺳ, ﻢﯿﻈﻨﺗ, ﺐﯿﺗﺮﺗ, ﮏﯾ
ﺲﺣ: ﻥﺩﺮﻛﻙﺭﺩ, ﻦﺘﺷﺍﺩﺭﻮﻈﻨﻣ, ﺱﺎﺴﺣﺍ, ﯽﯾﺎﻨﻌﻣ
ﺍﺭ: ﯼﺮﺒﻫﺭ, ﻦﺘﻓﺮﮔ
ﻦﺘﺴﺑ: ﻥﺪﺷﻪﺘﺴﺑ, ﮏﯾﺩﺰﻧ, ﻦﺘﺴﺑ
ﺖﯿﺼﺨﺷ: ﺭﺎﺘﻓﺭ, ﺖﻣﻼﻋ, ﺖﻌﯿﺒﻃ, ﺶﻘﻧ
ﻩﺮﻈﻨﻣ: ﻪﻨﺤﺻ, ﻥﺪﯾﺩ, ﻩﺎﮕﻧ, ﺭﻮﻀﺣ, ﻥﺎﻣﺯ
ﺏﺰﺣ: ﻦﺸﺟ, ﻝﻮﮔﺮﯾﻭ, ﺫﺎﺨﺗﺍ, ﺭﻮﺸﮐ
ﺏﻮﺧ: ﯽﻟﺎﻋ, ﻒﯿﻄﻟ
ﻥﺩﻮﺑﻩﺩﺎﻣﺁ: ﻥﺩﺮﮐﻩﺩﺎﻣﺁ, ﻼﺒﻗ, ﻪﺠﻨﭘﮎﻮﻧ
ﺞﯾﺍﺭ: ﻝﻮﻤﻌﻣ, ﮏﯾﺮﺷ, ﻞﺑﺎﻘﺘﻣ, ﻡﺩﺮﻣﻡﻮﻤﻋ
ﺪﯿﻨﮐﺖﺒﺤﺻ: ﻩﺮﮐﺍﺬﻣ, ﯽﻧﺍﺮﻨﺨﺳ, ﻥﺎﺘﺳﺍﺩ, ﻮﮕﺘﻔﮔﻭﺚﺤﺑ
ﺖﺳﺍﻩﺪﺷﻪﺘﺷﻮﻧ: ﻦﺘﺷﻮﻧ, ﺦﻠﺗ
ﻦﺳ: ﻎﻟﺎﺑ, ﯽﻤﯾﺪﻗ
ﯼﺮﮕﯾﺩ: ﻪﺘﺷﺬﮔ, ﻒﻠﺘﺨﻣ, ﺮﮕﯾﺩﯽﮑﯾ, ﺶﯿﺑ
ﻥﺩﺮﻛﺭﻮﺒﺠﻣ: ﺕﺭﺪﻗ, ﻞﯿﻤﺤﺗ, ﭖﻮﺗ
ﺮﻨﻫ: ﻪﻧﺍﺪﻨﻣﺮﻨﻫ, ﺶﯾﺎﻤﻧ
ﻥﺎﯿﻣﺭﺩ: ﺐﯿﻠﺻ, ﻞﺑﺎﻘﻣ, ﺖﺳﺭﺩ
ﻪﯿﻟﻭﺍ: ﺱﺭﺎﻧ, ﻉﻭﺮﺷ, ﻪﯿﻟﻭﺍ, ﯼﺩﻭﺯﻪﺑ, ﺡﺎﺘﺘﻓﺍ
ﺪﯾﺎﺑ: ﺪﯾﺎﺑ
ﺏﺎﺘﻓﺁ: ﺯﻭﺭ
ﺪﻌﺑ: ﻩﺪﻨﯾﺁ, ﻊﻗﻮﻣﻥﻭﺍ, ﺪﻌﺑ
ﯼﺰﯿﭼﺮﻫ: ﻪﻤﻫ
ﻪﺘﺷﺬﮔ: ﺮﮕﻧﻪﺘﺷﺬﮔ, ﻪﺘﺷﺬﮔ
ﻞﻤﻋ: ﻞﻤﻋ, ﺭﺎﮐ
ﺕﺎﻗﻼﻣ: ﻖﺑﺎﻄﻣ, ﻩﺪﺷﺍﺪﯿﭘ, ﻥﺪﯾﺩ
ﺮﺘﺸﯿﺑ: ﺶﯿﺑ, ﯽﻓﺎﺿﺍ, ﯽﺘﺣ, ﺮﺘﻬﺑ
ﺪﺳﺭﯽﻣﺮﻈﻧﻪﺑ: ﺪﺳﺭﯽﻣﺮﻈﻧﻪﺑ, ﺮﮑﻓ
ﺮﺗﺍﺮﻓ: ﺶﯿﺑ, ﯽﻧﻭﺮﯿﺑ
ﮏﯾﭻﯿﻫ: ﻦﺘﺳﻮﯿﭘﻉﻮﻗﻭﻪﺑ, ﻪﻧ
ﻮﻠﺟﻪﺑ: ﺯﺍﻞﺒﻗ, ﺪﻌﺑ
ﺯﺍﺪﻧﺍﻢﺸﭼ: ﺭﺎﻬﻇﺍ, ﻩﺎﮕﻧ, ﻥﺪﯾﺩ, ﺯﺍﺪﻧﺍﻢﺸﭼ, ﻪﻨﺤﺻ
ﺍﺪﺻ: ﺍﺪﺻ, ﻩﮊﺍﻭ, ﻦﺤﻟ
ﭻﯿﻫ: ﯽﭼﭻﯿﻫ, ﻪﻧ
ﺢﺿﺍﻭ: ﻦﮐﺯﺎﺑ, ﻑﺎﻔﺷ, ﺍﺮﻫﺎﻇ, ﮏﺒﺳ
ﻩﺩﺎﺟ: ﻩﺍﺮﮔﺭﺰﺑ, ﺮﯿﺴﻣ
ﺮﯾﺩ: ﯽﻣﺍﺭﺁﻪﺑ, ﻪﺘﺷﺬﮔ, ﻦﺘﺧﺍﺪﻧﺍﺮﯿﺧﺎﺗ
ﺮﺘﺧﺩﺪﻧﺯﺮﻓ: ﺮﺘﺧﺩ, ﻢﻧﺎﺧﻩﺩﺍﺰﻫﺎﺷ
ﯽﻌﻗﺍﻭ: ﯽﻌﻗﺍﻭ, ﺖﯿﻌﻗﺍﻭ, ﯽﺘﻨﻄﻠﺳ, ﯽﻈﻔﻠﻟﺍﺖﺤﺗ, ﻦﯿﺑﻊﻗﺍﻭ
ﺎﺒﯾﺮﻘﺗ: ﮏﯾﺩﺰﻧ, ﻩﺭﺎﺑﺭﺩ
ﺶﻧﺍﺩ: ﻥﺩﺮﻛﻙﺭﺩ, ﺕﺎﻋﻼﻃﺍ
ﻪﺑﺖﺒﺴﻧ: 
ﺪﺑ: ﻦﯾﺮﺗﺪﺑ, ﺪﺑ, ﺮﯿﻘﻓ, ﻩﺎﺒﺘﺷﺍ
ﻥﺩﺮﻛﻲﮔﺪﻧﺯ: ﻩﺪﻧﺯ, ﯽﮔﺪﻧﺯﮏﺒﺳ
ﺢﻠﺻ: ﻕﺎﺗﺍ, ﺕﻮﮑﺳ
ﻝﺎﻤﺷ: ﻩﺪﺑﺏﺍﻮﺟ, ﺐﺷﻪﻤﯿﻧ
ﯽﻌﯿﺒﻃ: ﺖﻌﯿﺒﻃ, ﺯﺍﺪﻧﺍﻢﺸﭼ
ﺭﺎﯿﺴﺑ: ﻞﮕﺷﻮﺧ, ﺭﺎﯿﺴﺑ, ﯽﻓﺎﮐ
ﻪﻧﻻﺩﺎﻋ: ﺖﺳﺭﺩ, ﺵﺭﺍﺰﮔ, ﻩﺩ, ﯽﺜﻨﺧ, ﺎﻬﻧﺁ, ﻕﺩﺎﺻ
ﯽﻧﺎﺳﺭﺖﻣﺪﺧ: ﺖﻣﺪﺧ, ﻥﺩﺍﺩﺖﻴﻤﻫﺍ
ﺮﯾﺯﺭﺩ: ﻦﯿﯾﺎﭘ
ﻮﻣ: ﺮﺳ
ﻥﺩﺮﮐﯽﻃ: ﺭﻮﺒﻋ, ﮏﯾﺩﺰﻧ, ﻞﯿﺼﺤﺘﻟﺍﻍﺭﺎﻓ, ﺐﯿﻠﺻ, ﺖﺤﺗ
ﺕﺬﻟ: ﻝﺎﺤﺷﻮﺧ, ﺪﺟﻭ, ﺖﯾﺎﺿﺭ
ﺦﯾﺭﺎﺗ: ﻥﺎﺘﺳﺍﺩ, ﺦﯾﺭﺎﺗ, ﯽﺨﯾﺭﺎﺗ
ﺪﯿﺷﺎﺑﻪﺘﺷﺍﺩﻪﺟﻮﺗ: ﻥﺩﺭﻭﺁﺩﺎﻳﻪﺑ
ﻪﻜﻨﻳﺍﺎﺑ: ﺩﻮﺟﻭﺎﺑ, ﺎﻣﺍ, ﻪﮑﯿﻟﺎﺣﺭﺩ
ﻮﻠﺟ: ﻞﺑﺎﻘﻣ, ﺯﺍﻞﺒﻗ
ﮒﺭﺰﺑ: ﯽﻟﺎﻋ, ﻦﻬﭘ
ﺎﻌﻄﻗ: ﺍﺪﮐﻮﻣ, ﻩﺭﻭﺩ
ﺩﺎﺑ: ﺍﻮﻫ
ﻥﺩﺮﻛﺖﻓﺎﻳﺭﺩ: ﻥﺩﺭﻭﺁﺖﺳﺩﻪﺑ, ﻝﻮﺻﻭﻡﻼﻋﺍ, ﻦﺘﻓﺮﮔ, ﻪﺘﻓﺮﮔﺕﺎﺸﻧ, ﺖﺤﺗ
ﻪﺟﻮﺗ: ﻥﺩﺍﺩﺖﻴﻤﻫﺍ, ﺖﯾﻮﻟﻭﺍ, ﺰﮐﺮﻤﺗ, ﻪﺟﻮﺗ
ﻡﺎﮑﺤﺘﺳﺍ: ﺕﺪﺷ, ﺕﺭﺪﻗ
ﺪﯾﺎﺷ: ﺪﯾﺎﺷ
ﻝﺎﺤﺷﻮﺧ: ﻝﺎﺤﺷﻮﺧ, ﺭﺍﺩﻩﺪﻨﺧ, ﯽﺿﺍﺭ
ﺖﯿﻤﻫﺍﺎﺑ: ﻡﺯﻻ, ﻢﻬﻣ
ﺕﺩﻮﺧ: ﺩﻮﺧ, ﻥﺎﺷﺩﻮﺧ
ﺭﺎﮑﻤﻫ: ﮏﯾﺮﺷ, ﺖﺳﻭﺩ, ﺺﺨﺷ, ﯽﻧﻭﺎﻌﺗ
ﺮﻈﻧ: ﺭﺎﻬﻇﺍ, ﻪﺸﯾﺪﻧﺍ
ﻥﺎﻤﯾﺍ: ﻦﺘﺷﺍﺩﺩﺎﻘﺘﻋﺍ, ﯼﺭﺍﺩﺎﻓﻭ
ﺶﯿﭘ: ﻕﺮﺷ, ﻊﻗﻮﻣﻥﻭﺍ, ﺯﺍﻞﺒﻗ, ﺖﺸﮔﺯﺎﺑ
ﮊﺭﺎﺷ: ﻪﻨﯾﺰﻫ, ﻦﺘﻓﺮﮔ
ﻭﺯﺎﺑ: ﺖﺳﺩ, ﺮﯿﻘﻓ, ﻪﻧﺎﺷ
ﯽﻣﻭﺩ: ﻪﺘﺷﺬﮔ, ﻥﺭﺪﻣ
ءﯽﺷ: ﻑﺪﻫ, ﯽﭼﭻﯿﻫ, ﯽﯾﺎﻨﻌﻣ, ﻥﺩﺮﮐﺖﻣﻭﺎﻘﻣ
ﺎﻗﺁ: ﺮﻧ, ﺎﻗﺁ, ﺩﺎﺘﺳﺍ
ﻒﻠﺘﺨﻣ: ﻒﻠﺘﺨﻣ
ﺹﺎﺧ: ﺹﻮﺼﺨﺑ, ﺺﺼﺨﺗ
ﯽﺘﺨﺳﻪﺑ: ﻪﻧ, ﺭﺩﺎﻧ
ﺲﯿﺋﺭ: ﺮﯾﺪﻣ, ﺮﺳ, ﯽﻠﺻﺍ
ﺲﻧﺎﺷ: ﺖﯿﻌﻗﻮﻣ, ﺖﺒﺳﺎﻨﻣ, ﺲﻧﺎﺷ, ﻝﺎﻤﺘﺣﺍ, ﯽﻓﺩﺎﺼﺗ
ﻪﻣﺎﻧﻢﻫﺎﻔﺗ: ﺡﺮﻃ, ﯼﺭﺎﮑﻤﻫﺩﺍﺩﺭﺍﺮﻗ, ﻥﺎﻣﺭﺩ, ﻪﻠﺑﺎﻘﻣ
ﺮﮑﻔﺗ: ﺮﮑﻓ, ﻪﺸﯾﺪﻧﺍ
ﻩﺩﺎﺳ: ﻦﮐﺯﺎﺑ, ﯽﻟﺎﺧﻮﺗ, ﻝﻮﻤﻌﻣ, ﻩﺩﺎﺳﻡﺩﺁ
ﻪﻠﺻﺎﻓﻼﺑ: ﺭﺎﺑﮏﯾ, ﯼﺩﻭﺯﻪﺑ, ﻢﯿﻘﺘﺴﻣﺭﻮﻃﻪﺑ
ﻩﺪﯿﺳﺮﺗ: ﺱﺮﺗ, ﺲﭘﺍﻮﻟﺩ
ﺎﻬﻨﺗ: ﮏﯾ, ﺎﻬﻨﺗ
ﺕﺬﻟ: ﻝﺎﺤﺷﻮﺧ, ﻥﺎﺠﯿﻫ, ﺖﯾﺎﺿﺭ
ﻪﺘﺴﮑﺷ: ﺩﺮﮔﻮﮔ, ﺵﺮﺑ
ﻪﮑﻨﯾﺍﺮﮕﻣ: ﺰﺠﺑ, ﻻﺎﺑ
ﻞﻤﺣ: ﻞﻤﺤﺗ, ﻥﺪﯿﺷﻮﭘ, ﯼﺭﺍﺩﺭﺎﺑ, ﻦﺘﻓﺮﮔ
ﺮﯿﺛﺎﺗ: ﺮﺛﺍ, ﺍﺰﻧﻻﻮﻔﻧﺁ
ﺯﺍﺝﺭﺎﺧ: ﯽﻧﻭﺮﯿﺑ, ﺰﺠﺑ
ﯼﺮﻫﺎﻇﻞﮑﺷ: ﺪﺳﺭﯽﻣﺮﻈﻧﻪﺑ, ﻩﺪﻨﻫﺩﻥﺎﺸﻧ, ﻪﻨﺤﺻ
ﻪﭼﺮﻫ: ﻪﮐﻡﺍﺪﮐﺮﻫ, ﻡﺎﺠﻧﺍ
ﻥﺩﺮﮐﺖﻣﺎﻗﺍ: ﻦﺘﺴﺸﻧ, ﻥﺩﺎﺘﺴﯾﺍ
ﯽﻧﺎﻣﺯﻩﺭﻭﺩ: ﺯﺎﻓ, ﻥﺎﻣﺯ, ﯽﻧﻻﻮﻃ
ﺮﻫﺍﻮﺧ: ﺭﺩﺍﺮﺑ, ﺭﺎﺘﺳﺮﭘ
ﺩﺮﺒﻧ: ﮓﻨﺟ
ﻖﺑﺎﺳ: ﯽﻤﯾﺪﻗ, ﮏﯿﻧﻭﺮﺘﮑﻟﺍ
ﻥﺎﻧﺍﻮﺟ: ﻥﺍﻮﺟ
ﺎﻬﻨﺗ: ﻂﻘﻓ, ﺎﻬﻨﺗ
ﻪﺑﻥﺪﯿﺳﺭ: ﺎﯿﺑ, ﻩﺩﻭﺪﺤﻣ
ﻢﺘﺴﯿﺳ: ﺐﯿﺗﺮﺗ, ﺐﺗﺍﺮﻣﻪﻠﺴﻠﺳ, ﻥﺎﻣﺯﺎﺳ, ﯼﺎﻫﻢﺘﺴﯿﺳ
ﻡﺎﺷ: ﺐﺷ, ﺭﺎﻫﺎﻧ, ﻦﺸﺟ
ﻡﺍﺭﺁ: ﻡﺍﺭﺁ, ﺕﻮﮑﺳ, ﺎﻬﻨﺗ
ﻥﺁﺯﺍﺪﻌﺑ: ﻩﺪﻨﯾﺁ, ﻊﻗﻮﻣﻥﻭﺍ, ﺪﻌﺑ
ﻦﺘﻓﺭﻩﺍﺭ: ﯼﻭﺭﻩﺩﺎﯿﭘ, ﻦﺘﻓﺭ, ﻪﻘﺒﻃ
ﯽﮔﮋﯾﻭ: ﮎﻼﻣﺍ, ﺕﺎﺣﻼﻄﺻﺍ
ﺐﺠﻌﺗ: ﻩﺰﺠﻌﻣ, ﺐﻳﺮﻏﻭﺐﻴﺠﻋ, ﻥﺩﺮﮐﺮﯿﮕﻠﻓﺎﻏ
ﻞﮑﺷ: ﻝﺎﺘﯿﺠﯾﺩ, ﻡﺎﻗﺭﺍ, ﺩﺪﻋ, ﺮﯾﻮﺼﺗ
ﯽﻠﮐﺭﻮﻄﺑ: ﻝﻮﻤﻌﻣ
ﯽﻧﺎﺘﺳﺎﺑ: ﯽﻤﯾﺪﻗ, ﻩﺩﺎﺘﻓﺍﺪﻣﺯﺍ, ﺖﻣﺪﻗ, ﻪﯿﻟﻭﺍ
ﻡﺍﺮﺘﺣﺍ: ﻪﺟﻮﺗ, ﺭﺎﺨﺘﻓﺍ, ﺮﻄﺧ, ﻩﺭﺎﺑﺭﺩ
ﻡﻮﺳ: ﻪﺳ, ﻪﺒﻨﺸﻬﺳ
ﻩﺩﺎﺳ: ﯽﮔﺩﺎﺳ, ﻝﻮﻤﻌﻣ
ﻥﺪﻧﺎﻣ: ﻥﺩﺎﺘﺴﯾﺍ
ﻪﻌﻣﺎﺟ: ﯽﻋﺎﻤﺘﺟﺍ, ﻉﺎﻤﺘﺟﺍ, ﺖﮐﺮﺷ
ﻥﺩﺮﮐﻩﺯﺭﺎﺒﻣ: ﻉﺍﺰﻧ, ﮓﻨﺟ
ﻪﺠﯿﺘﻧ: ﻪﺠﯿﺘﻧ, ﺮﺛﺍ, ﻩﻮﯿﻣ
ﻥﺎﻣﺮﻓ: ﺐﯿﺗﺮﺗ, ﻥﺩﺮﮐﻪﺘﮑﯾﺩ
ﺩﻭﺭﯽﻣﺭﺎﻈﺘﻧﺍ: ﯽﻨﯿﺑﺶﯿﭘ, ﺪﯿﻣﺍ, ﺐﺳﺎﻨﻣﺎﻧ, ﻥﺰﺑﺱﺪﺣ
ﺾﺤﻣ: ﻂﻘﻓ, ﻪﭼﺎﯾﺭﺩ
ﺭﺎﻨﻛﺭﺩ: ﮏﯾﺩﺰﻧ, ﺪﻌﺑ, ﺖﻤﺳ
ﺍﺪﺻﯽﺑ: ﻡﺍﺭﺁ, ﺕﻮﮑﺳ
ﻞﻣﺎﮐ: ﻼﻣﺎﮐ, ﯽﻟﺎﻋ
ﻥﺎﺑﺎﯿﺧ: ﺮﯿﺴﻣ, ﮓﻧﺭ, ﻪﻠﺻﺎﻓ
ﻪﺘﺷﻮﻧ: ﻦﺘﺷﻮﻧ, ﻪﻣﺎﻧ
ﻼﻣﺎﮐ: ﻼﻣﺎﮐ, ﻞﻣﺎﮐﺭﻮﻄﺑ, ﻩﺪﺷﺮﭘ, ﺖﺒﺜﻣ
ﺏﻮﭼ: ﺖﺧﺭﺩ, ﺏﻮﭼ
ﺖﻋﺮﺳﻪﺑ: ﯼﺩﻭﺯﻪﺑ, ﻝﺎﺣﺭﺩﺖﻋﺮﺳﻪﺑ
ﻉﻼﻃﺍ: ﻥﺪﯾﺩ, ﺩﻼﯿﻣﺯﺍﺪﻌﺑ, ﻁﺎﺒﺗﺭﺍ, ﺭﺍﺪﺸﻫ
ﻦﺷﻭﺭ: ﺰﯿﺗ, ﮏﺒﺳ, ﻕﺍﺮﺑ
ﻖﯾﺎﻗ: ﯽﺘﺸﮐ, ﺭﻭﺎﻨﺷ, ﯽﻧﺎﺑﺩﺎﺑﻖﯾﺎﻗ
ﺐﯿﺠﻧ: ﯽﻟﺎﻋ
ﯼﺪﺣﺎﺗ: ﯼﻮﺤﻧﻪﺑ, ﯽﭼﭻﯿﻫ
ﻩﺮﻈﺘﻨﻣﺮﻴﻏ: ﻩﺭﺎﺒﮑﯾﻪﺑ
ﺵﺯﺭﺍ: ﺵﺯﺭﺍ
ﺯﺍﯽﺷﺎﻧ: ﺍﺮﯾﺯ, ﺖﺳﺭﺩ
ﺖﺋﺍﺮﻗ: ﻥﺪﻧﺍﻮﺧ
ﻥﺩﺮﮐﻝﻮﺒﻗ: ﯼﺭﺎﮑﻤﻫﺩﺍﺩﺭﺍﺮﻗ, ﺩﺭ
ﻁﻮﻄﺧ: ﻂﺧ
ﻦﻛﺮﺒﺻ: ﻦﺘﺷﺍﺩﻪﮕﻧ
ﻪﻌﻄﻗ: ﻪﺷﺍﺮﺗ, ﺶﺨﺑ, ﻂﺴﺑ
ﻖﺑﺎﺳ: ﯽﻤﯾﺪﻗ
ﻮﮕﺘﻔﮔ: ﻩﺮﮐﺍﺬﻣ, ﯽﻧﺍﺮﻨﺨﺳ, ﻥﺩﺯﮓﻧﺯ
ﺐﺳﺎﻨﻣ: ﻥﺪﺷﺎﺟ, ﻪﻨﯿﻬﺑ, ﺖﺳﺭﺩ
ﺖﺻﺮﻓ: ﺖﺒﺳﺎﻨﻣ, ﺖﯿﻌﻗﻮﻣ
ﻪﻨﯾﺰﻫ: ﻪﻨﯾﺰﻫ, ﺖﺧﺍﺩﺮﭘ, ﺵﺯﺭﺍ
ﻪﺟﻮﺗﻞﺑﺎﻗ: ﯽﻟﺎﻋ, ﻢﻬﻣ, ﻪﺟﻮﺗﻞﺑﺎﻗ, ﯽﻓﺎﮐ
ﺖﻔﻫ: ﻪﺘﻔﻫ
ﻻﺎﺑ: ﻪﻨﯿﻬﺑ, ﻪﻠﻗ, ﻻﺎﺑ
ﺝﺍﻭﺩﺯﺍ: ﻩﺩﺮﮐﺝﺍﻭﺩﺯﺍ
ﻡﺎﮔ: ﻞﻤﻋ, ﺯﺎﻓ, ﻪﻠﭘ, ﺎﭘ
ﺯﺎﻏﺁ: ﻉﻭﺮﺷ, ﻪﻣﺍﺩﺍ
ﺮﻫﺭﺩ: ﮏﺗﮏﺗ
ﯼﺩﺮﻓ: ﺺﺨﺷ, ﻪﻧﺎﮔﺍﺪﺟﺭﻮﻃﻪﺑ
ﺭﺍﻮﺷﺩ: ﺖﺨﺳ, ﻦﯿﮕﻨﺳ
ﻩﺭﺫ: ﺶﺨﺑ, ﯽﻤﮐﺭﺍﺪﻘﻣ, ﻢﺘﺷﻭﺏﺮﺿ
ﻦﺘﺷﺍﺩﺭﺎﯿﺘﺧﺍ: ﻩﺎﮔﺩﺍﺩﻦﯾﺍﺖﯿﺣﻼﺻ, ﺕﺭﺪﻗ
ﺭﺎﻤﯿﺑ: ﺭﺎﻤﯿﺑ, ﺪﺑ
ﯽﻠﺻﺍ: ﯽﻌﻗﺍﻭ, ﯽﻈﻔﻠﻟﺍﺖﺤﺗ, ﻪﺸﯾﺭ
ﯼﺩﺎﺷ: ﻝﺎﺤﺷﻮﺧ, ﺲﻧﺎﺷ, ﺪﺟﻭ, ﺖﯾﺎﺿﺭ
ﺪﻨﮐﯽﻣﻢﻫﺍﺮﻓ: ﻩﺪﺷﻪﺋﺍﺭﺍ, ﻥﺩﺍﺩ, ﻥﺩﺍﺩﻥﺎﻨﯿﻤﻃﺍ
ﻥﺩﺮﮐﻞﯿﺼﺤﺗ: ﺮﯿﮕﺑﺩﺎﯾ, ﻞﯿﻠﺤﺗ
ﯽﺼﺨﺷ: ﯽﺻﻮﺼﺧ, ﻪﻧﺎﮔﺍﺪﺟﺭﻮﻃﻪﺑ, ﺩﻮﺧ
ﻥﺩﺮﮐﺎﺷﺎﻤﺗ: ﯽﺳﺭﺮﺑ, ﺭﻮﺘﯿﻧﺎﻣ, ﻥﺪﯾﺩ
ﻝﺎﺤﺷﻮﺧ: ﯽﺿﺍﺭ, ﻝﺎﺤﺷﻮﺧ
ﻡﺮﮔ: ﻡﺮﮔ, ﯼﺯﻮﺳﺶﺗﺁ, ﻥﺎﺘﺴﺑﺎﺗ
ﺵﻼﺗ: ﻥﺩﺮﻛﺵﻼﺗ
ﻩﺪﺷﻩﺩﺎﻣﺁ: ﻥﺩﺮﮐﻩﺩﺎﻣﺁ, ﻼﺒﻗ
ﺶﺷﻮﮐ: ﻥﺩﺮﻛﺵﻼﺗ, ﻥﺎﺤﺘﻣﺍ, ﻥﺩﺯﻢﺧﺯ
ﻊﯾﺮﺳ: ﯼﺩﻭﺯﻪﺑ, ﻝﺎﺣﺭﺩﺖﻋﺮﺳﻪﺑ
ﺮﯾﺯﺭﺩ: ﻦﯿﯾﺎﭘ
ﻥﺮﻗ: ﺪﺻ
ﻩﺪﺷﻪﺘﻓﺮﮔﺮﻈﻧﺭﺩ: ﺪﺼﻗ, ﺰﮐﺮﻤﺗ, ﻑﺪﻫ, ﻥﺩﺮﮐﻩﺩﺎﻣﺁ
ﺖﺳﺍﺭﺮﺳ: ﻢﯿﻘﺘﺴﻣﺭﻮﻃﻪﺑ, ﻩﺪﻧﺯ, ﻕﺩﺎﺻ
ﺩﺭﺍﺩﻝﺎﻤﺘﺣﺍ: ﯽﻧﺎﺳﺁﻪﺑ, ﻝﺎﻤﺘﺣﺍ, ﺪﯾﺎﺷ
ﺖﻟﺍﺪﻋ: ﺖﺳﺭﺩ, ﻒﯾﺮﻌﺗ, ﻩﺎﮔﺩﺍﺩﻦﯾﺍﺖﯿﺣﻼﺻ
ﻩﺩﺎﺳﻥﺎﺑﺯﻪﺑ: ﻂﻘﻓ
ﺩﺎﻤﺘﻋﺍ: ﻦﺘﺷﺍﺩﺩﺎﻘﺘﻋﺍ, ﯼﺭﺍﺩﺎﻓﻭ, ﻪﯿﮑﺗ
ﺭﻮﺒﻋ: ﺶﺨﺑ, ﺭﻮﺒﻋ, ﻂﺴﺑ
ﻪﺘﺴﺑ: ﻥﺪﺷﻪﺘﺴﺑ, ﻦﺘﺴﺑ, ﻩﺪﺷﻩﺩﺍﺩﺶﺷﻮﭘ, ﻪﺘﺴﺑ
ﻥﺎﻣﺩﻮﺧ: ﻥﺎﺷﺩﻮﺧ, ﺎﻣ
ﺱﺎﺒﻟ: ﺩﺎﺸﮔﻭﺪﻨﻠﺑﺱﺎﺒﻟ, ﻩﺪﯿﺷﻮﭘﺱﺎﺒﻟ, ﺪﻨﻤﺗﻭﺮﺛ
ﯼﺭﻭﺮﺿ: ﻡﺯﻻ
ﻂﺳﻮﺘﻣ: ﻦﺘﺷﺍﺩﺭﻮﻈﻨﻣ
ﻦﺘﺷﺍﺩﺭﺎﯿﺘﺧﺍﺭﺩ: ﻩﺯﺎﺟﺍ, ﻥﺩﺮﮐﺐﺣﺎﺼﺗ
ﻻﻮﻤﻌﻣ: ﻝﻮﻤﻌﻣ, ﻞﯾﺎﻤﺗ
ﺪﺷﺖﺳﺭﺩ: ﺖﺑﺎﺛ, ﺺﺨﺸﻣ
ﯼﺎﻫﻭﺮﯿﻧ: ﺶﺗﺭﺍ
ﻥﺪﻣﺁﻻﺎﺑ: ﯼﺩﺭﻮﻧﮓﻨﺳ, ﻻﺎﺑ, ﻥﺩﺮﮐﺪﺷﺭ
ﯼﺭﺎﮐﻪﺴﻠﺟ: ﻪﺴﻠﺟ, ﮊﺎﺘﻧﻮﻣ, ﺪﯾﺩﺯﺎﺑ
ﻩﺎﮔﻭﺩﺭﺍ: ﻥﺩﺯﺭﺩﺎﭼ, ﻩﺯﻮﺣ
ﺖﻠﻣ: ﺭﻮﺸﮐ, ﯽﻠﻣ, ﻪﻘﺑﺎﺴﻣ
ﺩﻮﺟﻭ: ﺭﻮﻀﺣ
ﺦﺳﺎﭘ: ﻩﺪﺑﺏﺍﻮﺟ, ﺩﺍﺩﺮﺘﺳﺍ, ﺕﺍﺮﻈﻧ
ﻥﺎﻤﺳﺁ: ﻮﺟ, ﻥﺎﻤﺳﺁ
ﺕﻭﺮﺛ: ﺲﻧﺎﺷ, ﺖﯿﻌﺿﻭ, ﮎﻼﻣﺍ
ﻪﻨﻣﺍﺩ: ﻩﺯﻮﺣ, ﻩﺩﻭﺪﺤﻣ
ﺖﯿﻌﺿﻭ: ﺖﯿﻌﻗﻮﻣ, ﺖﯿﻌﺿﻭ, ﺖﯿﻌﻗﻮﻣ
ﻪﺟﺭﺩ: ﺮﺑﺍﺮﺑ
ﻂﺳﻮﺘﻣ: ﻦﺘﺷﺍﺩﺭﻮﻈﻨﻣ, ﺰﮐﺮﻣ, ﻦﯿﺑ
ﻥﺎﺘﺴﻣﺯ: ﺩﺮﺳ, ﻩﺪﻨﯾﺁ
ﻥﺩﺍﺩﻩﺯﺎﺟﺍ: ﻩﺯﺎﺟﺍ
ﻩﺪﯾﺮﭘﮓﻧﺭ: ﺩﺭﺯﮓﻧﺭ, ﮓﻧﺭ, ﻦﺘﻓﺭﻝﺎﺣﺯﺍ, ﮏﺒﺳ
ﺭﺎﺘﻓﺭ: ﺭﺎﺘﻓﺭ, ﻞﻤﻋ
ﺍﺮﺟﺍﻝﺎﺣﺭﺩ: ﻪﻘﺑﺎﺴﻣ, ﻥﺪﯾﻭﺩ, ﺎﭘ
ﯽﻨﯾﺩ: ﻦﯾﺩ
ﺖﮐﺮﺣ: ﯽﺸﮐﺙﺎﺛﺍ, ﻝﺪﺟﻭﺚﺤﺑ, ﻞﻤﻋ
ﻥﺩﺮﮐﻒﻗﻮﺘﻣ: ﺢﻳﺮﻔﺗﮓﻧﺯ, ﻥﺩﺎﺘﺴﯾﺍ
ﺮﺗﺪﺑ: ﻦﯾﺮﺗﺪﺑ, ﻻﺎﺑ, ﺪﺑ
ﯼﺭﺎﺘﻔﮔ: ﻦﺘﻔﮔ, ﯽﻧﺍﺮﻨﺨﺳ
ﻪﺘﺨﺗ: ﻻﺎﺑ, ﺖﺤﯿﺼﻧ, ﻪﺒﻟ, ﻥﻮﯿﺴﯿﻤﮐ, ﺹﺮﻗ
ﻩﺩﻮﻬﯿﺑ: ﻥﺩﺮﮐﺩﺍﺯﺁ, ﯽﻟﺎﺧ
ﻥﺎﯾﺯ: ﺭﺮﺿ, ﻩﺪﺷﻢﮐ, ﺖﺸﻧ
ﺩﺎﻬﻨﺸﯿﭘ: ﻩﺪﺷﻪﺋﺍﺭﺍ, ﻥﺩﺍﺩ, ﻪﻧﺎﺸﻧ, ﺖﻣﺪﺧ, ﺯﺎﯿﺘﻣﺍ
ﻞﯿﻤﮑﺗ: ﻩﺪﺷﺮﭘ
ﯽﺳﺮﺘﺳﺩ: ﺪﯾﺩﺯﺎﺑ, ﯽﺳﺮﺘﺳﺩ
ﯽﮑﯾﺭﺎﺗ: ﮏﯾﺭﺎﺗ
ﺭﻮﺷ: ﺱﺎﺴﺣﺍ
ﯽﮑﯾﺰﯿﻓ: ﮏﯾﺰﯿﻓ, ﻥﺪﺑ
ﻝﺎﺜﻣ: ﻝﺎﺜﻣ
ﺶﺳﺮﭘ: ﻝﺪﺟﻭﺚﺤﺑ, ﻪﺘﺳﺍﻮﺧ
ﻉﻭﺮﺷ: ﻉﻭﺮﺷ
ﻪﻨﯿﮐ: ﺩﻮﺟﻭﺎﺑ, ﻦﯾﺮﺗﺪﺑ, ﻢﺸﺧ
ﯼﺪﺟ: ﺮﺒﻗ, ﯽﻟﺎﻋ, ﻦﻣﺰﻣ
ﻩﺮﻘﻧ: ﻝﻮﭘ, ﻪﻌﻤﺟ
ﯽﻓﺎﮐ: ﯽﻓﺎﮐ, ﻩﻮﻬﻗ
ﯽﻠﺻﺍ: ﺮﺳ, ﺩﺎﺘﺳﺍ, ﺪﯿﻠﮐ, ﯽﻠﺧﺍﺩ, ﯽﻠﺻﺍ
ﺰﯿﮕﻧﺍﺖﻔﮕﺷ: ﺐﻳﺮﻏﻭﺐﻴﺠﻋ, ﺪﯾﺪﺷ, ﯽﻟﺎﻋ, ﺎﺒﯾﺯ, ﻪﺘﻓﺭﻭﻪﺘﺴﺷ
ﻩﺍﺮﻤﻫ: ﻪﺟﻮﺗ
ﺮﯿﺴﻣ: ﺮﯿﺴﻣ, ﻩﺭﻭﺩ
ﯽﻨﻌﻣ: ﯽﯾﺎﻨﻌﻣ, ﻦﺘﺷﺍﺩﺭﻮﻈﻨﻣ, ﺖﯿﻤﻫﺍ, ﺵﺭﺍﺰﮔ
ﺭﺎﯿﺴﺑ: ﺭﺎﯿﺴﺑ, ﻊﻠﺑ
ﯽﻟﺪﻨﺻ: ﯽﻟﺪﻨﺻ, ﻩﺮﺻﺎﺤﻣ, ﺩﺎﺘﺳ, ﻪﺴﻠﺟ
ﯼﺯﺎﺑ: ﺭﺎﻤﻗ, ﯼﺯﺎﺑ
ﻪﯿﻧﺎﯿﺑ: ﻥﺎﯿﺑ, ﺵﺭﺍﺰﮔ, ﺩﻼﯿﻣﺯﺍﺪﻌﺑ
ﺖﻓﺍﺮﻇ: ﻢﻨﻛﻰﻣﺶﻫﺍﻮﺧ
ﺏﺍﻮﺧ: ﺱﻮﺑﺎﮐ, ﺏﺍﻮﺧ
ﮓﻨﺳ: ﻦﻣﺍﺩ, ﮓﻨﺳ
ﻩﮋﯾﻭ: ﺹﻮﺼﺨﺑ, ﯽﺻﻮﺼﺧ, ﺺﺼﺨﺗ, ﺱﺎﻨﺷﺭﺎﮐ
ﯽﯾﺎﺠﺑﺎﺟ: ﮎﺮﺤﺗ, ﯽﺸﮐﺙﺎﺛﺍ, ﺭﺍﺩﺍﺪﺻﻑﺮﺣ, ﻦﯾﺮﻤﺗ
ﺖﺧﺍﺩﺮﭘ: ﻪﻨﯾﺰﻫ, ﺖﺧﺍﺩﺮﭘ
ﻢﻬﺳ: ﺶﺨﺑ, ﻁﺮﺷ, ﺶﻘﻧ, ﻊﯾﺯﻮﺗ
ﺭﺎﻈﺘﻧﺍ: ﯽﻨﯿﺑﺶﯿﭘ, ﺪﯿﻣﺍ
ﻩﻮﮑﺷ: ﺕﺮﻬﺷ, ﺭﺎﺨﺘﻓﺍ
ﺎﻀﻓ: ﺖﯿﻌﻗﻮﻣ, ﻦﻟﺎﺳ, ﻩﺯﻮﺣ, ﺩﺭﻮﻧﺎﻀﻓ
ﯽﻟﻮﻤﻌﻣ: ﻝﻮﻤﻌﻣ, ﺕﺎﯿﻨﺒﻟ
ﻦﺘﻓﺮﮔﺮﻈﻧﺭﺩ: ﺮﮑﻓ, ﻥﺎﻣﺭﺩ, ﻪﺟﻮﺗ
ﯼﺩﺎﯾﺯﺪﺣﺎﺗ: ﺭﺎﯿﺴﺑ, ﯼﺩﺎﯾﺯﺪﺣﺎﺗ, ﻦﻣﺰﻣ
ﺖﯾﺰﻣ: ﺩﻮﺳ, ﻑﺪﻫ
ﺮﺴﻓﺍ: ﯽﻤﺳﺭ
ﺥﺮﻧ: ﺭﺎﺨﺘﻓﺍ, ﻩﺭﻭﺩ
ﺎﻫﺱﺎﺒﻟ: ﻥﺩﺮﮐﻥﺎﯾﺮﻋ, ﺭﺍﺰﻫ, ﻩﺪﯿﺷﻮﭘﺱﺎﺒﻟ
ﻥﺩﺮﮐﺎﻀﻣﺍ: ﺖﺳﮊ, ﺖﻣﻼﻋ, ﻪﻄﻘﻧ
ﯽﻣﻮﺑ: ﺖﻌﯿﺒﻃ, ﯽﻌﻗﺍﻭ, ﻦﮐﺎﺳ
ﺕﻭﺎﻔﺗ: ﻒﻠﺘﺨﻣ, ﮏﯿﮑﻔﺗ, ﻕﺮﻓ
ﻥﺩﺮﮐﺭﺎﮐ: ﺪﻨﻣﺭﺎﮐ, ﺭﺎﮐ, ﻡﺎﺠﻧﺍ, ﺯﻭﺭ
ﻥﺩﺮﮐﺝﺍﻭﺩﺯﺍ: ﻩﺩﺮﮐﺝﺍﻭﺩﺯﺍ, ﻥﺩﺭﻭﺁﺖﺳﺩﻪﺑ
ﺪﯿﺳﺭﻥﺎﯾﺎﭘﻪﺑ: ﻩﺪﺷﺮﭘ
ﺪﺣ: ﻥﺍﺮﮐ, ﻢﺠﺣ, ﻩﺩﻭﺪﺤﻣ, ﺱﺎﯿﻘﻣ
ﻭﺎﮑﺠﻨﮐ: ﺖﺴﻫﺐﻟﺎﺟ, ﺐﻳﺮﻏﻭﺐﻴﺠﻋ
ﺭﺎﻨﮐﺭﺩ: ﯼﺎﺠﺑ, ﺰﺠﺑ
ﺵﻭﺭ: ﺮﯿﺴﻣ, ﻞﻤﻌﻟﺍﺭﻮﺘﺳﺩ, ﺭﺎﺑﮏﯾ, ﺵﻭﺭ
ﯽﻟﺎﻋ: ﺮﺘﻬﺑ, ﯽﻟﺎﻋ, ﺎﺒﯾﺯ, ﺭﺎﯿﺴﺑ
ﺲﻔﻧﻪﺑﺩﺎﻤﺘﻋﺍ: ﻦﺘﺷﺍﺩﺩﺎﻘﺘﻋﺍ
ﻼﻣﺎﮐ: ﺹﻮﺼﺨﺑ, ﻩﺪﺷﺮﭘ, ﻼﻣﺎﮐ, ﻞﻣﺎﮐﺭﻮﻄﺑ, ﺍﺪﮐﻮﻣ
ﻩﺪﻨﻨﮐﺪﯾﺪﺸﺗ: 
ﻪﺤﯾﻻ: ﯽﻄﺧﻪﺨﺴﻧ, ﺏﺎﺴﺣ
ﻊﯿﺳﻭ: ﻦﻬﭘ, ﯽﻟﺎﻋ
ﯽﻨﻨﻔﺗ: ﯽﮐﺍﺭﺩﺍ, ﻞﮕﺷﻮﺧ, ﯽﻟﺎﯿﺧ, ﻪﺘﻓﺭﻭﻪﺘﺴﺷ
ﻊﯾﺮﺳ: ﯼﺩﻭﺯﻪﺑ, ﻝﺎﺣﺭﺩﺖﻋﺮﺳﻪﺑ
ﻪﻠﺑ: ﻩﺭﺁ, ﺐﯿﺗﺮﺗﻦﯾﺪﺑ, ﻝﺎﺜﻣ
ﯼﺩﺍﺯﺁ: ﻥﺩﺮﮐﺩﺍﺯﺁ, ﻝﻼﻘﺘﺳﺍ
ﺯﺍﻪﺘﺷﺬﮔ: ﻢﻫﺯﺍﺍﺪﺟ, ﯼﺭﻭﮏﯾ, ﺖﻤﺳ
ﺺﻟﺎﺧ: ﺕﻭﺍﺮﻃﺎﺑ, ﻥﺩﺮﮐﻪﯿﻔﺼﺗ, ﻪﺘﻓﺭﻭﻪﺘﺴﺷ
ﻩﺭﺎﺑﺭﺩ: ﻩﺭﺎﺑﺭﺩ
ﻥﺩﺍﺩﺖﺳﺩﺯﺍ: ﻦﺘﺷﺍﺬﮔﺎﺟ, ﻩﺪﺷﻢﮐ
ﯽﮐﺭﺪﻣ: ﮎﺭﺪﻣ
ﻢﻫﻪﯿﺒﺷ: ﻪﯿﺒﺷ, ﺮﺑﺍﺮﺑ, ﯽﭼﻪﺳﺍﻭ, ﺎﻬﻧﺁ
ﻉﻮﻤﺠﻣ: ﻞﻣﺎﮐﺭﻮﻄﺑ, ﻼﻣﺎﮐ, ﻪﻤﻫ
ﻪﺤﻔﺻ: ﺖﻤﺳ, ﻁﺎﯿﺣ, ﻪﺸﯿﺷ
ﺹﻮﺼﺧﻪﺑ: ﺹﻮﺼﺨﺑ
ﻩﻮﮐ: ﻪﭙﺗ, ﺪﯿﺳﺍ
ﺭﻭﺮﻐﻣ: ﺭﻭﺮﻏ
ﯽﻨﺷﻭﺭﻪﺑ: ﻦﮐﺯﺎﺑ, ﻑﺎﻔﺷ, ﺍﺮﻫﺎﻇ, ﺰﯿﺗ
ﺖﻤﯿﻗ: ﺭﺎﺨﺘﻓﺍ, ﺵﺯﺭﺍ
ﻪﺘﺴﺑ: ﻥﺪﺷﻪﺘﺴﺑ, ﻦﺘﺴﺑ, ﻪﺘﺴﺑ, ﻥﺩﺮﻣ
ﺖﺷﻮﻧﺮﺳ: ﺲﻧﺎﺷ, ﻪﻔﯿﻇﻭ
ﯼﺭﻭﺍﺩ: ﻪﻠﻤﺟ, ﻥﻮﻧﺎﻗ, ﯽﺿﺎﻗ, ﻩﺎﮔﺩﺍﺩﻦﯾﺍﺖﯿﺣﻼﺻ, ﻥﺍﺮﺤﺑ
ﺪﯿﻨﮐﺪﯿﯾﺎﺗ: ﻝﻮﺒﻗﻞﺑﺎﻗ, ﺪﯿﯾﺎﺗ, ﻦﺘﻓﺮﮔ
ﺎﻫﻪﻧﻮﮔ: ﯼﺯﺎﺳﺐﺗﺮﻣ, ﯽﻟﻮﻃ
ﻝﺎﺒﻧﺩﻪﺑ: ﻥﺩﺮﮐﻮﺠﺘﺴﺟ
ﻦﯾﺮﺗﻻﺎﺑ: ﻦﯾﺮﺗﺪﺑ, ﻦﯾﺮﺘﻤﮐ
ﺕﺭﻮﺻﻦﯾﺍﺮﯿﻏﺭﺩ: ﺶﯿﺑ
ﺭﺎﺨﺘﻓﺍ: ﺭﺎﺨﺘﻓﺍ
ﺵﻮﮔ: ﻩﺯﺎﺟﺍ
ﻦﯿﯾﺎﭘ: ﻦﯿﯾﺎﭘ, ﻪﻘﺒﻃ, ﻢﮐ
ﮏﻤﮐ: ﮏﻤﮐ, ﻥﺩﺮﮐﺖﯾﺎﻤﺣ, ﻥﺎﻣﺭﺩ
ﻥﺎﺴﮑﯾﻪﻌﻗﺍﻭﺮﮕﻧﺎﺸﻧ: 
ﻼﻣﺎﮐ: ﻩﺪﺷﺮﭘ, ﻼﻣﺎﮐ, ﻞﻣﺎﮐﺭﻮﻄﺑ, ﯽﻓﺎﮐ
ﺕﺬﻟ: ﻝﺎﺤﺷﻮﺧ, ﺪﻨﯾﺎﺷﻮﺧﺎﻧ, ﺖﯾﺎﺿﺭ, ﻥﺎﻣﺭﺩ
ﻥﺍﺰﯿﻣ: ﻢﺠﺣ, ﺖﯿﻌﻤﺟ, ﺩﺪﻋ, ﺪﻨﻔﺳﻮﮔ
ﺕﺎﯿﻟﺎﻣ: ﻥﺩﺮﮐﻩﺭﺎﺟﺍ, ﻂﺧ, ﻩﺪﻨﻫﺩﺕﺎﯿﻟﺎﻣ, ﻪﺳ
ﻪﻧﺎﮕﯿﺑ: ﻥﺎﻤﻬﻣ, ﺐﻳﺮﻏﻭﺐﻴﺠﻋ, ﯽﺟﺭﺎﺧ, ﻪﺘﺧﺎﻨﺷﺎﻧ
ﺖﻣﺎﻬﺷ: ﺖﻋﺎﺠﺷ
ﺩﻮﺟﻮﻣ: ﯽﺘﺴﯾﺯ, ﻥﺍﻮﯿﺣ
ﻂﻠﻏ: ﻍﻭﺭﺩ, ﻩﺎﺒﺘﺷﺍ
ﺪﻨﻠﺑ: ﯽﻧﻻﻮﻃ, ﻪﻘﺒﻃ, ﻝﻮﻃ
ﯼﺩﻭﺭﻭﺭﺩ: ﺏﺭﺩ
ﻪﻧﺍﺩﺍﺯﺁ: ﻝﻼﻘﺘﺳﺍ, ﻥﺩﺮﮐﺩﺍﺯﺁ, ﻝﺍﺮﺒﯿﻟ, ﻞﻘﺘﺴﻣﺭﻮﻃﻪﺑ, ﻞﺷ
ﻪﺑﺮﺿ: ﻥﺪﺷﻪﮐﻮﺷ, ﻪﺑﺮﺿ, ﺲﮑﻋ
ﻞﺣﺎﺳ: ﺎﯾﺭﺩﻞﺣﺎﺳ, ﻞﺣﺎﺳ
ﻪﻧﺍﺯﻭﺭ: ﺯﻭﺭ, ﺕﺍﺮﻃﺎﺧﺮﺘﻓﺩ, ﺯﻭﺭﺮﻫ
ﻥﺪﺷﺮﯿﮕﻠﻓﺎﻏ: ﻥﺩﺮﮐﺮﯿﮕﻠﻓﺎﻏ
ﻊﯾﺯﻮﺗ: ﻊﯾﺯﻮﺗ
ﺕﻭﺮﺛ: ﻝﻮﭘ, ﮎﻼﻣﺍ, ﻪﺨﺴﻧ, ﻩﺎﻓﺭ
ﯼﺩﺍﺯﺍ: ﻥﺩﺮﮐﺩﺍﺯﺁ, ﻝﻼﻘﺘﺳﺍ
ﻥﺩﺮﺑﺶﯿﭘ: ﻦﺘﻓﺭﺶﯿﭘ, ﺯﺍﻞﺒﻗ
ﻢﯾﻼﻣ: ﻡﺮﻧ, ﻦﯾﺮﯿﺷ, ﻒﯿﻄﻟ, ﺮﻧ, ﺰﯾﺰﻋ
ﺎﻤﻠﺴﻣ: ﻩﺭﻭﺩ
ﻦﻣﺍ: ﺮﻄﺧﯽﺑ, ﻥﺩﺭﻭﺁﺖﺳﺩﻪﺑ, ﺖﻈﻓﺎﺤﻣ, ﻥﺩﺍﺩﻥﺎﻨﯿﻤﻃﺍ
ﻩﺪﺷﻝﺎﻐﺷﺍ: ﻥﺩﺮﮐﺐﺣﺎﺼﺗ, ﻝﻮﻐﺸﻣ
ﻢﺳﺭ: ﺖﺴﻫﺐﻟﺎﺟ, ﻦﺘﺷﺍﺩﺮﺑ
ﻪﻨﺤﺻ: ﻞﻤﻋ, ﺯﺎﻓ, ﺖﯿﻌﺿﻭ, ﻪﻨﺤﺻ
ﺶﺨﺑ: ﺶﺨﺑ
ﻥﺎﺑﺯ: ﻥﺎﺑﺯ, ﻦﻫﺩﺏﺁ
ﻦﯿﮕﻤﺸﺧ: ﻢﺸﺧ
ﻪﮑﺴﻟﺎﮐ: ﻞﻘﻧﻭﻞﻤﺣ, ﺭﺎﻄﻗ, ﯽﻗﺮﺑﻦﮔﺍﻭ
ﺍﻮﻫ: ﺍﻮﻫ, ﻥﺎﻣﺯ
ﻑﺮﺑ: ﺦﯾ, ﻢﺸﭼ
ﺕﺭﻭﺮﺿ: ﺖﯿﻤﻫﺍ, ﻡﺯﻻ
ﻞﻤﻋ: ﻦﯾﺮﻤﺗ, ﻞﻤﻋ, ﯽﺷﺭﺎﻔﺳ
ﺎﻋﺩﺍ: ﻥﺩﺮﮐﺎﺿﺎﻘﺗ, ﯽﻧﻮﻧﺎﻗﺩﺮﮕﯿﭘ, ﺭﺍﺮﻗﺍ
ﻩﺩﺍﺰﻫﺎﺷ: ﮎﻭﺩ, ﻩﺎﺷﺩﺎﭘ
ﻩﻭﺮﮔ: ﻢﯿﻈﻨﺗ, ﻁﻼﺘﺧﺍ, ﻪﻠﮔ, ﺪﻧﺎﺑ, ﺎﻫﻩﻭﺮﮔ
ﺮﺳﺍﺮﺳ: ﺎﺟﻪﻤﻫﺭﺩ, ﻝﺎﮑﯾﺩﺍﺭ
ﻢﺣﺮﺗ: ﯼﺩﺭﺪﻤﻫﺯﺍﺮﺑﺍ, ﻒﺳﺎﺘﻣ
ﻥﺩﺮﮐﻪﻓﺎﺿﺍ: ﻥﺩﺮﮐﻦﻬﭘ, ﯽﻓﺎﺿﺍ, ﻥﺩﺍﺩﺶﯾﺍﺰﻓﺍ, ﻥﺩﺮﮐﺮﺘﻬﺑ
ﻥﺪﺷﯽﻬﺘﻨﻣ: ﯼﺮﺒﻫﺭ, ﻢﻬﻣ, ﺩﺎﺘﺳﺍ, ﺪﻨﺴﭘﻪﻣﺎﻋ, ﯽﻠﺻﺍ
ﻥﺯﻭ: ﻦﯿﮕﻨﺳ, ﻦﯿﻣﺯﻪﺑﺫﺎﺟ
ﻡﺮﺟ: ﺖﯿﻔﯿﮐ, ﯽﻌﻤﺟ, ﻊﻤﺟ, ﻩﺩﻮﺗ, ﺖﯿﻌﻤﺟ
ﯼﺮﺘﺴﮐﺎﺧ: ﻱﺍﻩﻮﻬﻗ, ﺮﺘﺴﮐﺎﺧ
ﻉﺎﺠﺷ: ﺖﻋﺎﺠﺷ
ﺮﻏﻻ: ﻥﺩﺮﮐﻖﯿﻗﺭ, ﮏﯾﺭﺎﺑ, ﻒﯿﻄﻟ
ﺩﺪﻌﺘﻣ: ﻊﻤﺟ, ﺖﯿﻌﻤﺟ
ﺎﺒﻟﺎﻏ: ﻊﻗﺍﻮﻣﺮﺘﺸﯿﺑ, ﺭﺮﮑﻣ, ﻝﺎﺤﺷﻮﺧ
ﻑﻭﺮﻌﻣ: ﺪﻨﺴﭘﻪﻣﺎﻋ, ﻡﺎﻨﮑﯿﻧ, ﺭﺍﺩﺍﺪﺻﻑﺮﺣ, ﻦﺘﻓﺮﮔﺝﻭﺍ
ﺪﻨﻤﺗﺭﺪﻗ: ﺕﺭﺪﻗ, ﯽﺒﺼﻋ
ﻩﺪﻧﺯ: ﻩﺪﻧﺯ
ﻒﯿﻌﺿ: ﻦﺘﻓﺭﻝﺎﺣﺯﺍ, ﺮﯿﻘﻓ, ﺭﺎﯿﺴﺑ
ﯽﻬﻟﺍ: ﻥﺰﺑﺱﺪﺣ, ﺍﺪﺧ
ﻩﺩﺎﻣ: ﺭﺍﺰﻓﺍﺖﺨﺳ, ﯽﯾﺎﻨﻌﻣ, ﻩﺩﺎﻣ, ﺕﺎﯿﺑﺩﺍ
ﺢﯾﺮﺻ: ﻕﺩﺎﺻ
ﺕﺭﺍﺮﺣ: ﻥﺎﺘﺴﺑﺎﺗ, ﻡﺮﮔ
ﻥﺩﺮﮐﺖﻈﻓﺎﺤﻣ: ﺖﻈﻓﺎﺤﻣ, ﻥﺩﺍﺩﺖﻴﻤﻫﺍ
ﻥﺎﺴﮑﯾﺭﻮﻃﻪﺑ: ﻝﺩﺎﻌﺗ, ﺮﺑﺍﺮﺑ
ﯽﻌﯿﺒﻃﺭﻮﻃﻪﺑ: ﺖﻌﯿﺒﻃ
ﻪﺟﻮﺗﺐﻟﺎﺟ: ﺐﻳﺮﻏﻭﺐﻴﺠﻋ, ﯽﻟﺎﻋ, ﺎﺒﯾﺯ, ﻪﺟﻮﺗﻞﺑﺎﻗ
ﻩﺎﻣ: ﻩﺎﻣ
ﮎﺪﻧﺍ: ﯽﻤﮐﺭﺍﺪﻘﻣ, ﯽﻧﺎﺳﺁﻪﺑ, ﮏﺒﺳ, ﯽﻬﯾﺪﺑ
ﮏﺒﺳ: ﮏﺒﺳ
ﻥﺎﺸﻧﺮﻃﺎﺧ: ﻩﺮﮑﻤﯿﻧ, ﺰﯿﺗ, ﻪﯾﻭﺍﺯ
ﻞﺻﺍ: ﻪﯾﺮﻈﻧ, ﻉﻭﺮﺷ
ﯼﺭﻮﻓ: ﯼﺩﻭﺯﻪﺑ, ﻢﯿﻘﺘﺴﻣﺭﻮﻃﻪﺑ
ﻞﯾﺎﻣ: ﻼﺒﻗ, ﻪﺠﻨﭘﮎﻮﻧ, ﻞﯾﺎﻣ, ﻥﺩﺮﮐﻩﺩﺎﻣﺁ
ﻪﺠﯿﺘﻧ: ﻢﻬﻣ, ﺮﺛﺍ, ﻪﺠﯿﺘﻧ, ﻩﻮﯿﻣ, ﻪﺠﯿﺘﻧﺭﺩ
ﻪﺼﻗﺎﻨﻣ: ﻡﺮﻧ, ﯼﺭﺎﮑﻤﻫﺩﺍﺩﺭﺍﺮﻗ, ﻪﻘﺑﺎﺴﻣ
ﺪﻨﻣﻪﻗﻼﻋ: ﺪﺼﻗ, ﻪﻗﻼﻋ
ﻊﺑﺭ: ﺎﭘ
ﻪﺘﻓﺮﺸﯿﭘ: ﯽﻨﻓ, ﻥﺭﺪﻣ
ﻝﺎﻌﻓ: ﺭﺎﮐ, ﻞﻤﻋ, ﺭﺍﺬﮔﺮﻴﺛﺎﺗ
ﻊﻠﻄﻣ: ﺍﺪﻤﻋ, ﻦﺘﺴﻧﺍﺩ, ﮎﺭﺩ
ﮎﺎﻧﺮﻄﺧ: ﺮﻄﺧ, ﯽﺘﻧﺮﺘﻨﯾﺍﻢﯾﺍﺮﺟ
ﺱﺪﻘﻣ: ﺱﺪﻘﻣ
ﯽﻫﺎﺷﺩﺎﭘ: ﯽﺘﻨﻄﻠﺳ
ﻡﺎﻤﺗ: ﻪﻤﻫ, ﻩﺪﺷﺮﭘ, ﻝﺎﮑﯾﺩﺍﺭ
ﺏﻮﺧ: ﻞﮕﺷﻮﺧ, ﺮﯾﺬﭙﻟﺩ
ﺕﺩﺎﻋ: ﺭﺎﺘﻓﺭ, ﺮﯿﺴﻣ, ﯽﺷﺭﺎﻔﺳ
ﻩﺪﻨﻧﺍﻮﺧ: ﻩﺪﻨﻧﺍﻮﺧ, ﻥﺪﻧﺍﻮﺧ
ﻢﯿﻘﺘﺴﻣ: ﻢﯿﻘﺘﺴﻣﺭﻮﻃﻪﺑ, ﻝﻭﺍﺖﺳﺩ, ﻩﺪﻧﺯ
ﻊﻗﺍﻭﺭﺩ: ﻦﯿﺑﻊﻗﺍﻭ, ﺖﯿﻌﻗﺍﻭ
ﺵﻭﺭ: ﮏﯿﺘﮐﺎﺗ, ﺵﻭﺭ, ﻡﺰﯿﻧﺎﮑﻣ
ﯽﯾﺍﻮﻨﺷ: ﻥﺪﯿﻨﺷ
ﻥﺩﺮﻛﺕﺮﭘ: ﺐﻟﺎﻗ, ﺲﮑﻋ
ﺩﺮﺧ: ﯼﺮﮑﻓ
ﯽﺘﺳﺍﺮﺑ: ﻦﯿﺑﻊﻗﺍﻭ, ﻼﻣﺎﮐ
ﻩﺭﺎﻤﺷ: ﺩﺪﻋ
ﻩﻭﺪﻧﺍﻭﻢﻏ: ﻒﺳﺎﺘﻣ
ﻮﯾﺍﺭﺩ: ﯽﮔﺪﻨﻧﺍﺭ, ﻪﯿﻠﻘﻧﻪﻠﯿﺳﻭ, ﺮﮐﻩﻭﺮﮔ, ﺮﻔﺳ, ﻥﺩﺮﻛﻖﻳﻮﺸﺗ, ﯼﺮﺒﻫﺭ, ﻥﺪﯾﻭﺩ
ﺎﻄﺧ: ﺶﻧﺯﺮﺳ, ﻩﺎﺒﺘﺷﺍ, ﻝﻼﺘﺧﺍ
ﺮﻣﺍ: ﻩﺩﺎﻣ, ﺯﻭﺭ
ﺱﺎﻤﺗ: ﻁﺎﺒﺗﺭﺍ, ﻪﺑﻥﺩﺯﺖﺳﺩ, ﻥﺩﺮﮐﯽﻓﺮﻌﻣ
ﻩﺎﮕﺘﺴﯾﺍ: ﻥﺩﺎﺘﺴﯾﺍ, ﺰﮐﺮﻣ, ﻞﺼﻓ
E: 
؟ﯽﻤﯾﻼﻣﺪﻨﮔﻮﺳ: 
ﻩﺪﺑﺵﻮﮔ: ﻥﺪﯿﻨﺷ, ﻩﺪﻧﻮﻨﺷ
ﻪﻣﺪﺻ: ﯽﮔﺪﯾﺩﺐﯿﺳﺁ, ﺩﺭﺩ, ﺡﻭﺮﺠﻣ
ﻥﺎﯿﺑ: ﻥﺎﯿﺑ, ﺢﯿﺿﻮﺗ, ﯽﺸﯾﺎﻤﻧ
ﻒﻄﻟ: ﺖﻤﺳ, ﺖﺒﺜﻣ, ﺭﻮﻈﻨﻣ
ﻉﺎﻔﺗﺭﺍ: ﻝﻮﻃ, ﻪﯿﻠﮐ
ﻩﺯﺍﺪﻧﺍ: ﯼﺪﻌﺑ, ﻩﺪﺷﺮﭘ, ﻢﺠﺣ, ﺱﺎﯿﻘﻣ
ﻪﻔﯿﻇﻭ: ﻞﻤﻋ, ﺭﺎﮐ, ﻪﻔﯿﻇﻭ
ﻥﺩﺮﺑﺞﻧﺭ: ﯽﺘﺨﺑﺪﺑ, ﻒﺳﺎﺘﻣ
ﺍﺪﺻﻭﺮﺳ: ﺍﺪﺻﻭﺮﺳﺮﭘ, ﺍﺪﺻﻭﺮﺳ, ﯼﺭﻮﺨﻟﺩ, ﺍﺪﺻ
ﺮﺗﺭﻭﺩ: ﺯﺍﻞﺒﻗ, ﺮﺘﻬﺑ, ﺪﻌﺑ
ﯽﺘﺸﮐ: ﺭﺍﺰﺑﺍ, ﯽﺘﺸﮐ, ﺖﻋﺎﺠﺷ, ﻥﺍﺪﻠﮔ
ﺖﺒﺤﻣ: ﻖﺸﻋ
ﻥﺪﯿﺸﮐﺞﻧﺭ: ﻪﺠﻨﮑﺷ, ﯽﺘﺨﺑﺪﺑ, ﺦﻠﺗ, ﻞﮑﺸﻣ, ﻒﺳﺎﺘﻣ
ﺖﺷﻮﮔ: ﺖﺷﻮﮔ, ﻥﺪﺑ
ﮒﺭﺰﺑ: ﯽﻟﺎﻋ
ﺖﺴﭘ: ﺖﺴﭘﻩﺭﺍﺩﺍ, ﻝﺎﺳﺭﺍ, ﺖﯿﻌﻗﻮﻣ, ﻝﺎﺘﺴﭘﺕﺭﺎﮐ
ﻪﻋﻮﻤﺠﻣ: ﯽﮕﺘﺷﺎﺒﻧﺍ, ﻢﯿﻈﻨﺗ, ﺲﮑﻋﻡﻮﺒﻟﺁ, ﻪﺠﯿﺘﻧ
ﻪﺒﺗﺭ: ﺱﻼﮐ, ﺕﺎﻋﻼﻃﺍ
ﻦﮐﺭﻮﺼﺗ: ﯽﻟﺎﯿﺧ, ﺮﮑﻓ, ﻪﺸﯾﺪﻧﺍ
ﺩﻭﺭﻭ: ﺎﯿﺑ
ﻞﯿﺨﺗ: ﯽﻟﺎﯿﺧ, ﺱﺎﮑﻌﻧﺍ, ﻪﺸﯾﺪﻧﺍ
ﺪﻨﻠﺑﯼﺍﺪﺻﺎﺑ: ﻥﺩﺮﮐﺭﺍﺮﺻﺍ, ﯽﻟﺎﻋ, ﺍﺪﺻﻭﺮﺳﺮﭘ, ﺖﺨﺳ
ﻲﻨﺘﺷﺍﺩﺖﺳﻭﺩ: ﻞﮕﺷﻮﺧ
ﻩﺩﺎﻌﻟﺍﻕﺭﺎﺧ: ﺐﻳﺮﻏﻭﺐﻴﺠﻋ, ﯽﻌﯿﺒﻃﺮﯿﻏ
ﻪﻧﺎﺤﺒﺻ: ﺢﺒﺻ, ﺭﺎﻫﺎﻧ
ﺖﯿﻌﻤﺟ: ﺖﯿﻌﻤﺟ
ﻪﻠﺴﻠﺳ: ﺮﯿﺠﻧﺯ, ﻢﯿﻈﻨﺗ
ﻦﯿﮑﺴﺗ: ﯽﺘﺣﺍﺭ, ﻪﭼﺭﺎﭘ, ﮏﻤﮐ
ﮏﻟﺎﻣ: ﺩﺎﺘﺳﺍ, ﺎﻣﺮﻓﺭﺎﮐ
ﺱﺎﺴﺣﺍ: ﺮﺛﺍ, ﺱﺎﺴﺣﺍ, ﻦﺘﺷﺍﺬﮔﺮﯿﺛﺎﺗ, ﭖﺎﭼ, ﺖﻣﻼﻋ, ﯽﺑﺍﮎﻮﺧ
ﺖﯾﺎﺿﺭ: ﯽﺿﺍﺭ, ﺖﯾﺎﺿﺭ
ﻂﺑﺍﻭﺭ: ﻪﺟﻮﺗ
ﻞﮑﺷ: ﯼﺪﻌﺑ, ﻥﺪﺷﻞﻴﻜﺸﺗ
ﺪﻟﻮﺗ: ﻥﺪﻣﺁﺎﯿﻧﺪﺑ
ﺍﻮﺘﺤﻣ: ﻖﺑﺎﻄﻣ, ﯽﺿﺍﺭ, ﻥﺩﺮﮐﺮﭘ
ﻪﺟﻮﺗ: ﻪﺸﯾﺪﻧﺍ, ﻪﺟﻮﺗ, ﺮﮑﻓ
ﻢﻈﻨﻣ: ﺖﺑﺎﺛ, ﺭﺮﮑﻣ, ﻝﻮﻤﻌﻣ, ﺕﺎﯿﻨﺒﻟ
ﻝﻮﻐﺸﻣ: ﻝﻮﻐﺸﻣ
ﺰﻣﺮﻗﻪﺑﻞﯾﺎﻣﺥﺮﺳ: ﺕﻮﺗ, ﻞﺒﻬﻣ, ﻂﻘﻓ
ﻥﺩﺮﻛﻒﺸﻛ: ﻩﺪﺷﺍﺪﯿﭘ, ﻥﺩﺮﮐﻮﺠﺘﺴﺟ, ﻥﺩﺮﮐﺵﺎﻓ
ﻞﺧﺍﺩ: ﯽﻠﺧﺍﺩ, ﻖﯿﻤﻋ
ﮎﺎﺧ: ﻞﮔ, ﻪﻘﺒﻃ, ﺭﻮﺸﮐ, ﯼﺮﮕﻟﺎﻔﺳ
ﻞﻣﺎﮐﺕﺭﻮﺻﻪﺑ: ﻼﻣﺎﮐ, ﻞﻣﺎﮐﺭﻮﻄﺑ, ﻩﺪﺷﺮﭘ
ﻡﺎﯿﭘ: ﺕﺎﻋﻼﻃﺍ, ﺭﺎﺒﺧﺍ
ﺕﺭﺎﺒﻋ: ﻥﺎﯿﺑ, ﻪﻠﻤﺟ, ﻩﮊﺍﻭ
ﻩﺭﺎﺷﺍ: ﺮﻧ
ﻊﺑﺮﻣ: ﻊﺑﺮﻣ, ﻪﺒﻌﺟ
ﺖﻔﺟ: ﺖﺳﺭﺩ, ﮏﯾﺮﺷ, ﻪﺘﺴﺑﺍﻭ, ﻮﻠﻗﻭﺩ
ﻥﺍﻮﻨﻋ: ﺮﺳ
ﻪﺒﻨﺸﮑﯾ: ﻪﺘﻔﻫ
ﻪﻧﺍﻮﯾﺩ: ﻖﻤﺣﺍ
ﻼﻣﺎﮐ: ﺍﺪﮐﻮﻣ, ﻞﻣﺎﮐﺭﻮﻄﺑ, ﻼﻣﺎﮐ
ﻡﺍﺭﺁ: ﯽﻣﺍﺭﺁﻪﺑ, ﻡﺍﺭﺁ, ﻪﺟﺮﻔﻨﻣ
ﺖﻤﺣﺭ: ﯼﺩﺭﺪﻤﻫﺯﺍﺮﺑﺍ
ﯼﻭﺎﺣ: ﻪﻠﻤﺟﺯﺍ, ﻞﻣﺎﺷ
ﻢﻏ: ﻩﺩﺮﺴﻓﺍ, ﺩﺭﺩ, ﯽﺘﺨﺑﺪﺑ, ﻒﺳﺎﺘﻣ
ﺯﺎﺑﺮﺳ: ﺶﺗﺭﺍ, ﻭﺮﮔ
ﯽﻠﺒﻗ: ﻕﺮﺷ, ﻪﺘﺷﺬﮔ, ﺯﺍﻞﺒﻗ
ﺢﯿﺿﻮﺗ: ﺢﯿﺿﻮﺗ, ﺕﺎﻋﻼﻃﺍ
ﺯﺎﻤﻧ: ﻥﺩﺮﮐﺎﺿﺎﻘﺗ, ﻥﺩﺮﮐﺎﻋﺩ
ﺭﻭﺎﺑ: ﻦﺘﺷﺍﺩﺩﺎﻘﺘﻋﺍ, ﯼﺭﺍﺩﺎﻓﻭ
ﺖﺑﺎﺛ: ﺭﺮﮑﻣ, ﺖﺑﺎﺛ, ﻡﻭﺍﺪﻣ
ﯽﯾﺎﻬﻧ: ﻪﺘﺷﺬﮔ, ﺖﯾﺎﻬﻧﺭﺩ, ﻊﻃﺎﻗ
ﻥﺪﺷﺭﺍﻮﺳ: ﯼﺭﺍﻮﺳ, ﻻﺎﺑ, ﯽﮔﺪﻨﻧﺍﺭ, ﻪﺧﺮﭼﻭﺩ
ﺖﺳﺎﯿﺳ: ﯽﺳﺎﯿﺳ, ﻡﺰﯿﻧﺎﮑﻣ, ﯼﮋﺗﺍﺮﺘﺳﺍ
ﻢﺳﺭ: ﺮﯾﻮﺼﺗ, ﺡﺮﻃ
ﮒﺮﻣﻝﺎﺣﺭﺩ: ﮒﺮﻣ, ﻥﺩﺮﻣ
ﺎﺿﺎﻘﺗ: ﻥﺩﺮﮐﺎﺿﺎﻘﺗ
ﻻﺎﺑ: ﻻﺎﺑ
ﻉﻮﻤﺠﻣ: ﻭ, ﺩﺪﻋ
ﺖﮐﺮﺣ: ﮎﺮﺤﺗ, ﯽﺸﮐﺙﺎﺛﺍ, ﺭﺍﺩﺍﺪﺻﻑﺮﺣ, ﻦﯾﺮﻤﺗ, ﺖﻋﺮﺳ
ﺖﻧﻭﺎﻌﻣ: ﻥﺩﺮﮐﺖﯾﺎﻤﺣ, ﮏﻤﮐ
ﺰﯿﻣﺁﺖﺒﺤﻣ: ﻢﻨﻛﻰﻣﺶﻫﺍﻮﺧ, ﻪﻧﺎﺘﺳﻭﺩ
ﺭﺎﻗﻭ: ﺭﺎﺨﺘﻓﺍ
ﻦﺘﻓﺮﮔ: ﻦﺘﺷﺍﺩﻪﮕﻧ, ﺖﺷﺍﺩﺯﺎﺑ, ﻦﺘﻓﺮﮔ
ﻥﺎﯿﻣﺭﺩ: ﻦﯿﺑ
ﯼﺭﺎﺟ: ﺮﺿﺎﺣﻝﺎﺣﺭﺩ, ﻥﺎﯾﺮﺟ
ﻻﺎﻤﺘﺣﺍ: ﻝﺎﻤﺘﺣﺍ, ﺪﯾﺎﺷ, ﺖﺳﺍﻪﺘﺴﻧﺍﻮﺗ
ﻩﺩﺮﺑ: ﯽﮔﺩﺮﺑ, ﺭﺍﺰﮕﺘﻣﺪﺧ, ﺩﺎﺘﻌﻣ
ﻪﻧﺎﮔﺍﺪﺟ: ﻢﻫﺯﺍﺍﺪﺟ, ﻒﻠﺘﺨﻣ, ﻪﻧﺎﮔﺍﺪﺟﺭﻮﻃﻪﺑ, ﺺﺼﺨﺗ
ﺖﺸﺣﻭ: ﺱﺮﺗ, ﯽﺘﺴﯾﺭﻭﺮﺗ
ﻝﺮﺘﻨﮐ: ﻝﺮﺘﻨﮐ, ﯽﺳﺭﺮﺑ, ﺖﯾﺮﯾﺪﻣ, ﺩﺎﺘﺳﺍ
ﺖﮐﺮﺷ: ﺖﮐﺮﺷ, ﻥﺎﻣﺯﺎﺳ
ﺮﺗﺮﺑ: ﺮﺘﻬﺑ, ﻪﺒﺨﻧ
ﯽﻧﺎﺣﻭﺭ: ﯽﻨﻫﺫ, ﯽﻗﻼﺧﺍ, ﯼﺮﮑﻓ
ﺕﺎﺒﺛﺍ: ﻥﺩﺮﻛﺖﺑﺎﺛ, ﮎﺭﺪﻣ
ﺪﻨﯾﺁﺮﻓ: ﻥﺎﻣﺭﺩ, ﻦﺘﻓﺭﺶﯿﭘ, ﺮﯿﺴﻣ, ﺵﺯﺍﺩﺮﭘﻝﺎﺣﺭﺩ
ﻩﺰﺑ؛ﺖﯾﺎﻨﺟ؛ﻡﺮﺟ: ﯽﯾﺎﻨﺟ, ﻩﺎﻨﮔ
ﻁﺎﺒﺗﺭﺍ: ﻁﺎﺒﺗﺭﺍ, ﺵﺭﺍﺰﮔ, ﻪﺟﻮﺗ
ﻥﺍﺮﮕﻧ: ﻥﺩﺍﺩﺖﻴﻤﻫﺍ, ﺲﭘﺍﻮﻟﺩ, ﻪﺟﻮﺗ
ﺎﻘﯿﻤﻋ: ﻖﯿﻤﻋ
ﻥﺪﻧﺍﻮﺧ: ﻥﺪﻧﺍﻮﺧ, ﯽﺴﮐﻪﭼ, ﻪﻧﺍﺮﺗ
ﺩﻭﺭﻭ: ﺏﺭﺩ, ﻝﻮﺻﻭﻡﻼﻋﺍ, ﻪﻧﺎﺘﺳﺁ
ﻥﺩﺮﮐﺭﺍﺮﻗﺍ: ﺮﮑﺸﺗ, ﻥﺩﺍﺩ
ﻦﯿﻣﺎﺗ: ﺽﺮﻋ, ﻩﺪﺷﻪﺋﺍﺭﺍ, ﻊﺑﺎﻨﻣ
ﺰﯿﻤﺗ: ﺕﻭﺍﺮﻃﺎﺑ, ﻪﺘﻓﺭﻭﻪﺘﺴﺷ, ﻩﺎﻨﮔﯽﺑ
ﺪﯿﻔﻣ: ﻡﺯﻻ, ﺭﺍﺬﮔﺮﻴﺛﺎﺗ, ﻪﺑﺭﺩﺎﻗ
ﻒﯾﺮﻇ: ﻒﯿﻄﻟ, ﺪﻨﺴﭘﻞﮑﺸﻣ, ﺎﺒﯾﺯ, ﻡﺮﻧ, ﻪﻧﺎﻧﺯ
ﻪﻣﺍﺩﺍ: ﻡﻭﺍﺪﻣ, ﻪﻣﺍﺩﺍ, ﻦﺘﺷﺍﺩﻪﮕﻧ
ﺏﺎﺨﺘﻧﺍ: ﻥﺩﺮﻛﺏﺎﺨﺘﻧﺍ, ﺏﺎﺨﺘﻧﺍ, ﯽﺳﺭﺮﺑ, ﻪﻨﯾﺰﮔ
ﮒﺭﺰﺑ: ﯽﻟﺎﻋ, ﻦﯿﮕﻨﺳ
ﻥﺍﻮﺗﺎﻧ: ﻪﻧ, ﺖﺴﮑﺷ
ﺶﺷﻮﭘ: ﮏﻫﻼﮐ, ﺖﮐ, ﻮﺘﭘ, ﻩﺪﺷﻩﺩﺍﺩﺶﺷﻮﭘ
ﺮﺑﺍﺮﺑﻭﺩ: ﻮﻠﻗﻭﺩ, ﺮﺑﺍﺮﺑﻭﺩ, ﻥﺩﺮﮐﺮﯿﺜﮑﺗ
ﯼﺯﻭﺮﯿﭘ: ﺖﯿﻘﻓﻮﻣ, ﺩﻮﺳ, ﻢﺘﺷﻭﺏﺮﺿ
ﻦﯿﺟﻭﺩ: ﻩﺩﺯﺍﻭﺩ
ﻡﻭﺍﺪﻣﺭﻮﻃﻪﺑ: ﻊﻗﺍﻮﻣﺮﺘﺸﯿﺑ, ﺭﺮﮑﻣ, ﻪﺸﯿﻤﻫ, ﺖﺑﺎﺛ, ﻡﻭﺍﺪﻣ
ﺢﻄﺳ: ﺖﯿﻌﺿﻭ, ﺢﻄﺳ, ﺱﺎﯿﻘﻣ
ﻥﺩﺮﮐﺩﺍﺯﺁ: ﻪﯿﻠﺨﺗ, ﺭﺎﺸﺘﻧﺍ, ﻥﺩﺮﮐﺩﺍﺯﺁ
ﻦﺸﺧ: ﻦﯾﺮﺗﺪﺑ, ﻕﻼﺧﺍﺪﺑ, ﺏﺩﺍﯽﺑ
ﺶﯿﭘﺭﺩ: ﺯﺍﻞﺒﻗ, ﺪﻌﺑ
ﻞﺼﺘﻣ: ﻥﺍﺮﮐ, ﻪﺘﺴﺑﺍﻭ, ﺝﻭﺩﺰﻣ
ﻥﺩﺮﮐﺐﺴﮐ: ﻥﺩﺭﻭﺁﺖﺳﺩﻪﺑ, ﺩﻮﺳ
ﻪﻓﺎﺿﺍ: ﯽﻓﺎﺿﺍ, ﻩﺪﻨﻨﮐﻞﯿﻤﮑﺗ
ﻕﺎﺗﺍ: ﻕﺎﺗﺍ, ﻦﻟﺎﺳ, ﻦﯿﺑﺭﻭﺩ, ﻦﯿﺑﺎﮐ
ﻪﺘﻓﺭﻪﺘﻓﺭ: ﯽﻣﺍﺭﺁﻪﺑ
ﯽﯾﺎﻨﺷﺁ: ﺎﻨﺷﺁ, ﺮﮔﺯﺎﻏﺁ, ﺖﯾﻮﻫ
ﻩﺎﺒﺘﺷﺍ: ﻩﺎﺒﺘﺷﺍ
ﺮﻘﺘﺴﻣ: ﻪﯾﺎﭘ, ﺕﺎﺣﻼﻄﺻﺍ
ﻭﺭﺩﻮﺧ: ﺭﺎﻄﻗ, ﻪﯿﻠﻘﻧﻪﻠﯿﺳﻭ, ﯼﺎﭼ
ﺲﻛﭻﻴﻫ: ﯽﺴﮐﺮﻫ, ﯽﭼﭻﯿﻫ
ﮏﯾﺩﺰﻧ: ﺖﻗﺩﺎﺑ
ﯼﮊﺮﻧﺍ: ﺕﺭﺪﻗ
ﺖﺨﻟ: ﻦﮐﺯﺎﺑ, ﻡﺮﺷ, ﯽﻟﺎﺧﻮﺗ, ﻮﻣﻥﻭﺪﺑ, ﯽﻟﺎﺧ, ﻂﻘﻓ
ﯼﺪﺣﺎﺗ: ﻩﺍﺭﻪﻤﯿﻧ, ﺶﺨﺑ
ﮓﻧﺭ: ﮓﻧﺭ
ﯽﻨﻤﯾﺍ: ﺮﻄﺧﯽﺑ, ﺕﺎﺠﻧ, ﻥﺩﺍﺩﺖﻴﻤﻫﺍ
ﺕﺎﺤﯿﺿﻮﺗ: ﺕﺎﻋﻼﻃﺍ, ﻒﯾﺮﻌﺗ, ﺕﺎﺼﺨﺸﻣ
ﻩﺪﯿﺑﺍﻮﺧ: ﺏﺍﻮﺧ
ﻖﯿﻗﺩ: ﺖﻗﺩﺎﺑ
ﺪﯾﺮﺒﺑﺕﺬﻟ: ﻝﺎﺤﺷﻮﺧ
ﻥﺩﺮﮐﺎﻫﺭ: ﺐﯿﺷ, ﻁﻮﻘﺳ, ﺖﺸﻧ
ﻥﺎﺸﺧﺭﺩ: ﻕﺍﺮﺑ, ﯽﻟﺎﻋ, ﺎﻧﺍﺩ
ﻥﺎﺘﺳﺍﺩ: ﻥﺎﺘﺳﺍﺩ
ﯼﺮﺘﺴﮐﺎﺧ: ﻱﺍﻩﻮﻬﻗ, ﺮﺘﺴﮐﺎﺧ
ﺭﺎﯿﺴﺑ: ﺭﺎﯿﺴﺑ
ﻪﺘﺨﯿﮕﻧﺍﺮﺑ: ﻥﺎﺠﯿﻫ, ﮏﯾﺮﺤﺗ
ﺱﺎﯾ: ﯼﺪﯿﻣﺍﺎﻧ, ﻦﺘﻓﺭﻝﺎﺣﺯﺍ
ﺖﻟﻮﻬﺳ: ﯽﺘﺣﺍﺭ, ﻥﺩﺮﮐﻞﯿﻬﺴﺗ, ﻢﮐ
ﻊﻤﺟ: ﺖﺷﺭﺩ, ﻪﻤﻫ, ﻊﻤﺟ, ﻩﺪﺷﺮﭘ
ﯽﻧﺎﺑﺮﻬﻣ: ﺍﻮﻘﺗ
ﻩﺮﯾﺍﺩ: ﺵﺩﺮﮔ, ﯽﻧﻮﮑﺴﻣﻥﺎﻤﺗﺭﺎﭘﺁ, ﺩﺮﮔ, ﺥﺮﭼ
ﺪﻨﮐ: ﻥﺩﺮﮐﺥﺍﺭﻮﺳﻪﺘﻣﺎﺑ, ﻢﮐ
ﻁﺮﻔﻣ: ﻦﯾﺮﺘﺸﯿﺑ, ﯽﺒﻄﻗ, ﺭﺎﯿﺴﺑ, ﻝﺎﮑﯾﺩﺍﺭ, ﻦﻣﺰﻣ
ﺪﺼﻗ: ﺪﺼﻗ, ﻑﺪﻫ
ﺕﺪﻣ: ﺕﺎﺣﻼﻄﺻﺍ, ﻞﺟﻻﺍﺏﺮﺿ, ﻩﮊﺍﻭ, ﻥﺎﯿﺑ
ﺖﺳﺍﻮﺧﺭﺩ: ﻥﺩﺮﮐﻩﺩﺎﻔﺘﺳﺍ, ﯼﺩﺮﺑﺭﺎﮐﯼﺎﻫﻪﻣﺎﻧﺮﺑ, ﻦﺘﻓﺮﮔ
ﺭﺎﮐ: ﺭﺎﮐ, ﺪﻨﻣﺭﺎﮐ
ﺵﻮﻫ: ﯼﺮﮑﻓ
ﺏﺎﺼﺘﻋﺍ: ﻪﻠﻤﺣ, ﻪﺟﻮﺗﻞﺑﺎﻗ, ﻢﺘﺷﻭﺏﺮﺿ
ﻪﻧﺎﻔﺼﻨﻣ: ﻞﻣﺎﮐﺭﻮﻄﺑ, ﯽﻓﺎﮐ, ﺭﺎﯿﺴﺑ
ﻪﻌﻗﺍﻭ: ﺖﺒﺳﺎﻨﻣ, ﺶﯾﺎﻤﻧ
ﯽﻣﺍﺭﺁﻪﺑ: ﻡﺮﻧ, ﯽﻣﺍﺭﺁﻪﺑ
ﻝﺎﺼﺗﺍ: ﯽﮕﺘﺳﻮﯿﭘ, ﯽﮕﺘﺴﺒﻟﺩ, ﻝﺎﺼﺗﺍ, ﻥﺩﺯﮓﻧﺯ
ﺖﻇﺎﻔﺣ: ﺖﻈﻓﺎﺤﻣ, ﻩﺎﻨﭘﻥﺎﺟ, ﻥﺩﺍﺩﺖﻴﻤﻫﺍ, ﯽﯾﻮﺟﻪﻓﺮﺻ
ﻪﻧﺎﻫﺎﮔﺁ: ﺭﺍﺪﯿﺑ, ﺍﺪﻤﻋ, ﺱﺎﺴﺣﺍ
ﭖﺎﭼ: ﻪﻨﯾﺰﻫ, ﭖﺎﭼ, ﻩﺯﺎﺟﺍ
ﺯﺍﻭﺮﭘ: ﻩﺪﻧﺮﭘ, ﺯﺍﻭﺮﭘ, ﻦﺘﻓﺮﮔﺝﻭﺍ, ﺍﻮﻫ, ﻢﯿﻈﻨﺗ, ﻝﺎﺑ
ﺩﻮﻬﺸﻣ: ﻑﺎﻔﺷ, ﮎﺭﺪﻣ, ﺍﺮﻫﺎﻇ
ﺮﻫﻮﺷﻭﻥﺯ: ﻮﻠﻗﻭﺩ, ﻭﺩ
ﻉﺍﻮﻧﺍ: ﯼﺯﺎﺳﺐﺗﺮﻣ, ﻒﻠﺘﺨﻣ
ﺍﺪﺟ: ﻢﻫﺯﺍﺍﺪﺟ, ﺭﻭﺩ, ﺰﺠﺑ, ﻞﻘﺘﺴﻣﺭﻮﻃﻪﺑ, ﻭﺩ
ﺡﺎﻀﺘﻓﺍ: ﮎﺎﻨﺘﺸﺣﻭ, ﺪﺑ
ﯽﺴﮐﺮﻫ: ﻪﻤﻫ, ﯽﺴﮐﺮﻫ, ﺝﺮﺨﻣ
ﺭﺎﮐ: ﺭﺎﮐ, ﺪﻨﻣﺭﺎﮐ
ﻖﺷﺎﻋ: ﺰﯾﺰﻋ
ﺖﺳﺍﻮﺧﺩﺍﺩ: ﻥﺪﺷﺎﺟ, ﯽﻧﻮﻧﺎﻗﺩﺮﮕﯿﭘ
ﯽﮔﺪﻨﻧﺍﻮﺧ: ﻪﻧﺍﺮﺗ
ﻕﺎﯿﺘﺷﺍﺎﺑ: ﻦﺘﺷﺍﺩﻞﻳﺎﻤﺗ, ﺲﭘﺍﻮﻟﺩ, ﻥﺩﺮﮐﻩﺩﺎﻣﺁ, ﺖﺷﺭﺩ
ﺯﺎﯿﻧ: ﻥﺩﺮﮐﺎﺿﺎﻘﺗ, ﻥﺩﺮﮐﺭﺍﺮﺻﺍ, ﻡﺯﻻ
ﻪﮐﻥﺎﻣﺯﺮﻫ: ﯽﻧﺎﻣﺯﻪﭼ
ﺮﯿﺷ: ﺕﺎﯿﻨﺒﻟ, ﻥﺎﺘﺴﭘ
ﻥﺪﺷﻖﻓﻮﻣ: ﺖﯿﻘﻓﻮﻣ
ﺯﺍﺪﻧﺍﻢﺸﭼ: ﺯﺍﺪﻧﺍﻢﺸﭼ, ﺰﮐﺮﻤﺗ
ﻥﺩﺮﺑﻻﺎﺑ: ﻥﺩﺮﮐﺮﺘﻬﺑ, ﻥﺩﺮﮐﻦﻬﭘ, ﻥﺩﺮﮐﺪﻨﻠﺑ, ﻥﺩﺍﺩﺶﯾﺍﺰﻓﺍ
ﻪﻌﺳﻮﺗ: ﻦﺘﻓﺭﺶﯿﭘ, ﯽﻠﻣﺎﮑﺗ
ﮏﻨﺧ: ﺩﺮﺳ, ﻞﮕﺷﻮﺧ
ﺶﯾﺎﻣﺯﺁ: ﻥﺩﺮﻛﺵﻼﺗ
ﺭﻮﺸﮐﺯﺍﺝﺭﺎﺧ: ﯽﺟﺭﺎﺧ, ﺪﯿﻌﺒﺗ
ﺭﺎﮐﺍﺪﻓ: ﯼﺭﺍﺩﺎﻓﻭ, ﻥﺎﻤﯾﺍﺎﺑ, ﻝﻮﻐﺸﻣ
ﯽﺑﺩﺍ: ﺕﺎﯿﺑﺩﺍ, ﯽﻈﻔﻠﻟﺍﺖﺤﺗ
ﻩﺪﻨﺴﯾﻮﻧ: ﻩﺪﻨﺴﯾﻮﻧ, ﺮﺗﮏﺒﺳ
ﺱﺭﻮﺑﻥﺎﻣﺯﺎﺳ: ﺏﻮﭼ, ﺶﻘﻧ, ﻞﻤﻋ
ﻉﻮﻧ: ﻦﺘﺷﻮﻧ, ﺕﺎﻋﻮﺒﻄﻣ
ﻥﺍﻭﺍﺮﻓ: ﺪﻨﻤﺗﻭﺮﺛ, ﯽﮕﻧﻭﺰﻓﺍ, ﯽﻓﺎﮐ, ﻞﯾﺎﻤﺗ
ﻥﺩﺮﮐﺏﺎﻨﺘﺟﺍ: ﻥﺩﺮﮐﯼﺮﯿﮔﻮﻠﺟ, ﺐﯿﺗﺮﺗ
ﻒﻄﻟ: ﺖﻤﺳ, ﺖﺒﺜﻣ, ﺭﻮﻈﻨﻣ
ﯽﻧﺍﻭﺭ: ﯼﺮﮑﻓ, ﯽﻨﻫﺫ, ﯽﻠﺧﺍﺩ
ﺵﺮﮕﻧ: ﻩﺎﮕﻧ, ﻥﺩﺎﺘﺴﯾﺍ, ﺖﺳﮊ, ﺪﻨﺑ
ﻦﯿﺴﺤﺗ: ﺶﯾﺎﺘﺳ
ﺏﺍﺮﻄﺿﺍ: ﺲﭘﺍﻮﻟﺩ, ﺱﺮﺗ, ﯽﮕﺘﻔﯿﺷ
ﺵﺯﻮﻣﺁ: ﻦﺘﺴﻧﺍﺩ, ﺮﯿﮕﺑﺩﺎﯾ, ﺕﻼﯿﺼﺤﺗ
ﻥﺩﺮﻤﺷ: ﻢﯿﺴﻘﺗ, ﻪﯿﮑﺗ, ﺏﺎﺴﺣ, ﺏﺎﺴﺘﺣﺍﺎﺑ
ﯼﻭﺎﮑﺠﻨﮐﺲﺣ: ﺲﭘﺍﻮﻟﺩ
ﺖﯾﻭﺭﻞﺑﺎﻗ: ﺪﺳﺭﯽﻣﺮﻈﻧﻪﺑ, ﻦﺘﺴﻧﺍﺩ
ﺎﻤﻨﻫﺍﺭ: ﯼﺎﻤﻨﻫﺍﺭﻪﭽﺑﺎﺘﮐ, ﮎﺭﺪﻣ, ﯽﮔﺪﻨﻧﺍﺭ, ﯼﺮﺒﻫﺭ
ﯽﻌﻗﺍﻭ: ﻦﯿﺑﻊﻗﺍﻭ, ﯽﻌﻗﺍﻭ, ﺖﯿﻌﻗﺍﻭ, ﯽﺘﻨﻄﻠﺳ
ﯽﺘﺨﺑﺪﺑ: ﻦﯿﮕﻤﻏ, ﻒﺳﺎﺗﻪﯾﺎﻣ, ﯽﺘﺨﺑﺪﺑ
ﻪﻣﺪﺻ: ﺪﺑ, ﯽﮔﺪﯾﺩﺐﯿﺳﺁ, ﺶﯿﻧ
ﻩﺎﮕﺷﻭﺮﻓ: ﯽﺷﻭﺮﻔﺑﺎﺘﮐ, ﺪﯾﺮﺧ, ﺵﻭﺮﻓﻩﺩﺮﺧ
ﺶﺸﺨﺑ: ﺶﺨﺒﺑ, ﻒﺳﺎﺘﻣ
ﻥﺩﺮﻛﺶﻫﺍﻮﺧ: ﻥﺩﺮﮐﺎﻋﺩ
ﺕﺭﺪﻨﺑ: ﺎﻬﺘﻗﻭﯽﻀﻌﺑ, ﺭﺩﺎﻧ
ﺩﺭﻮﮐﺭ: ﻂﺒﺿ, ﮏﺴﯾﺩ, ﯽﯾﻮﺟﻪﻓﺮﺻ
ﯽﺑﺮﭼ: ﺖﻔﻧ, ﻢﯿﺨﺿ, ﻥﺎﺘﺳﺍ
ﺖﺨﺗ: ﯽﻧﻮﮑﺴﻣﻥﺎﻤﺗﺭﺎﭘﺁ, ﻪﻧﺎﻓﺮﻃ, ﺡﺮﻃ
ﺖﻤﯾﺰﻋ: ﻦﺘﻓﺭ, ﺝﻭﺮﺧ
ﻪﯾﺪﻫ: ﻩﺰﯾﺎﺟ, ﺪﯾﺩﺯﺎﺑ
ﺕﺭﺎﻬﻣ: ﻪﺑﺭﺩﺎﻗ
ﺪﺒﻌﻣ: ﻪﻧﺎﺧ, ﺎﺴﯿﻠﮐ
ﺯﻮﺠﻣ: ﻩﺯﺎﺟﺍ, ﻉﺍﺮﺘﺧﺍﺖﺒﺛ
ﺖﯾﺎﺿﺭ: ﺪﯿﯾﺎﺗ, ﺖﯾﺎﺿﺭ, ﻩﺯﺎﺟﺍ
ﯽﻓﺎﮐﻩﺯﺍﺪﻧﺍﻪﺑ: ﻩﺪﺷﺮﭘ, ﯽﻓﺎﮐ, ﻩﻮﻬﻗ
ﻢﺧﺯ: ﯽﮔﺪﯾﺩﺐﯿﺳﺁ, ﺡﻭﺮﺠﻣ, ﻢﺧﺯ
ﻩﺪﻨﺧ: ﻩﺪﻨﺧ
ﺭﻮﺴﺟ: ﺖﻋﺎﺠﺷ
ﺪﻫﺎﺷ: ﮎﺭﺪﻣ
ﻖﻤﺣﺍ: ﻖﻤﺣﺍ
ﯽﺼﺨﺷﺮﻫ: ﯽﺴﮐﺮﻫ, ﯽﺴﮐﻪﭼ
ﺩﻮﺧ: ﯽﺻﻮﺼﺧ, ﻥﺎﺷﺩﻮﺧ, ﺩﻮﺧ
ﯽﻠﯿﺧ: ﺭﺎﯿﺴﺑ
ﻥﺎﻣﺭﺩ: ﻥﺎﻣﺭﺩ, ﻥﺩﺍﺩﺖﻴﻤﻫﺍ
ﻮﻠﮔ: ﻥﺩﺮﮔ, ﻦﺘﻓﺮﮔﺝﻭﺍ
ﺭﺎﻤﯿﺑ: ﺭﺎﻤﯿﺑ, ﺮﺒﺻ
ﺪﺷﺭ: ﻥﺩﺍﺩﺶﯾﺍﺰﻓﺍ, ﻦﺘﻓﺭﺶﯿﭘ, ﻥﺩﺮﮐﺪﺷﺭ
ﺭﺍﺪﻘﻣ: ﻊﻤﺟ, ﺖﯿﻌﻤﺟ, ﺭﺍﺪﻘﻣ, ﺩﺪﻋ
ﺪﯾﺪﺷ: ﺮﺒﻗ, ﻦﯿﮕﻨﺳ, ﺍﺪﮐﻮﻣ, ﺪﯾﺪﺷ, ﻦﻣﺰﻣ, ﺖﺷﺭﺩ
ﻪﻧﺎﻬﺑ: ﺶﺨﺒﺑ, ﯼﺪﻌﺘﻣ, ﻒﺳﺎﺘﻣ
ﺐﺴﻧﻭﻞﺻﺍ: ﺖﻌﯿﺒﻃ, ﺭﺪﺼﻣ, ﻪﺸﯾﺭ
ﺭﺎﻀﺣ: ﻝﺎﻌﻓﺮﯿﻏ, ﻡﺩﺮﻣﻡﻮﻤﻋ
ﺩﻭﺪﺤﻣ: ﮏﯾﺭﺎﺑ
ﻩﺪﻧﺎﻣﯽﻗﺎﺑ: ﯽﻗﺎﺑ, ﻩﺪﻧﺎﻣﯽﻗﺎﺑ
ﯼﺎﻨﺑﺮﯾﺯ: ﻪﯾﺎﭘ, ﻥﺎﺑﺯ
ﯼﺯﻭﺮﯿﭘ: ﺖﯿﻘﻓﻮﻣ, ﻢﺘﺷﻭﺏﺮﺿ
ﻥﺯﺖﻣﺪﺨﺸﯿﭘ: ﺮﺘﺧﺩ, ﺭﺍﺰﮕﺘﻣﺪﺧ, ﻩﺮﮐﺎﺑ
ﻢﯾﻼﻣ: ﻡﺮﻧ, ﯽﻣﺍﺭﺁﻪﺑ, ﻡﺍﺭﺁ
ﺖﯿﻌﻗﺍﻭ: ﺖﯿﻌﻗﺍﻭ
ﻩﻮﮑﺷﺎﺑ: ﺎﺒﯾﺯ, ﺱﺪﻘﻣ
ﺐﯿﺗﺮﺗﻦﯿﻤﻫﻪﺑ: ﯽﺘﺣ
ﻞﺤﻣ: ﻪﻨﺤﺻ, ﯽﺘﻧﺮﺘﻨﯾﺍﺖﯾﺎﺳ, ﻪﻄﻘﻧ
ﻥﺎﺑﺩﺎﺑ: ﯽﺘﺸﮐ, ﻪﻧﺎﻧﺯﺭﺩﺎﭼ
ﻩﺩﺯﺖﺸﺣﻭ: ﺱﺮﺗ
ﻡﺎﮐﺎﻧ: ﻒﺳﺎﺗﻪﯾﺎﻣ, ﻝﺎﺤﺷﻮﺧ, ﻦﯿﮕﻤﻏ
ﻩﺎﮕﺷﻭﺮﻓ: ﯼﺯﺎﺳﻩﺮﯿﺧﺫ, ﯽﯾﻮﺟﻪﻓﺮﺻ
ﺭﺎﻬﻇﺍ: ﺭﺎﻬﻇﺍ, ﻪﺟﻮﺗ, ﺕﺍﺮﻈﻧ, ﺐﺳﺍ
ﻒﻗﻮﺗ: ﺢﻳﺮﻔﺗﮓﻧﺯ
ﺪﻨﻤﺷﺯﺭﺍ: ﺵﺯﺭﺍ
ﻭﺭﻦﯾﺍﺯﺍ: ﺐﯿﺗﺮﺗﻦﯾﺪﺑ
ﻩﺎﯿﮔ: ﯼﺩﺭﻮﻧﮓﻨﺳ, ﺖﺧﺭﺩ, ﻪﻧﺎﺧﺭﺎﮐ, ﯽﻫﺎﯿﮔﯽﮔﺪﻧﺯ
ﻖﻠﻄﻣ: ﻩﺪﺷﺮﭘ, ﯽﻈﻔﻠﻟﺍﺖﺤﺗ, ﻼﻣﺎﮐ, ﻝﺎﮑﯾﺩﺍﺭ
ﯽﻧﺎﺳﺁﻪﺑ: ﯽﻧﺎﺳﺁﻪﺑ, ﯼﺩﻭﺯﻪﺑ
ﻩﺪﻧﺭﺩ: ﺰﯿﺗ, ﺪﯾﺪﺷ, ﺖﺨﺳ, ﻪﻧﺎﻤﻟﺎﻇ, ﯽﺸﺣﻭ
ﻢﺸﺧ: ﻢﺸﺧ
ﻒﺸﮐ: ﻩﺪﺷﺍﺪﯿﭘ, ﻥﺩﺮﮐﻮﺠﺘﺴﺟ, ﺡﺎﺘﺘﻓﺍ, ﯼﺭﻭﺁﻮﻧ
ﻁﻮﺑﺮﻣ: ﻪﺟﻮﺗ
ﺕﺍﺯﺎﺠﻣ: ﯽﯾﺎﻨﺟ, ﻪﻠﻤﺟ
ﯽﻤﮐ: ﯽﻤﮐﺭﺍﺪﻘﻣ, ﯽﻧﺎﺳﺁﻪﺑ
ﺰﯿﻣﺁﺭﺍﺮﺳﺍ: ﺯﺍﺭ, ﻢﻬﺒﻣ, ﯽﻔﺨﻣ, ﺐﻳﺮﻏﻭﺐﻴﺠﻋ
ﻪﯾﺎﺳ: ﻪﯾﺎﺳ, ﻦﺤﻟ, ﻒﯾﺮﻇﻭﻖﯿﻗﺩﺕﺎﮑﻧ
ﯽﺸﮐﻡﺩﺁ: ﻦﺘﺸﮐ
ﯽﻧﺎﺠﯿﻫ: ﺱﺎﺴﺣﺍ
ﺐﯾﺮﺨﺗ: ﯽﻫﺎﺒﺗ, ﻦﺘﻓﺭﻦﯿﺑﺯﺍ
ﺖﺸﺣﻭ: ﺱﺮﺗ
ﯽﻠﺤﻣ: ﯽﻠﺤﻣﺕﺭﻮﺻﻪﺑ, ﯽﻠﺧﺍﺩ, ﻪﻄﻘﻧ
ﻥﺍﺩﺎﻧ: ﻞﻬﺟ, ﻖﻤﺣﺍ
ﻩﺪﻨﺸﺨﺑ: ﻝﺍﺮﺒﯿﻟ, ﺪﻨﻤﺗﻭﺮﺛ
ﻩﺩﻭﺪﺤﻣ: ﻪﻠﺻﺎﻓ, ﻢﯿﻈﻨﺗ, ﻩﺩﻭﺪﺤﻣ
ﻥﺎﺑﺰﯿﻣ: ﺶﺗﺭﺍ, ﻥﺎﻤﻬﻣ, ﺖﯿﻌﻤﺟ
ﺏﻮﻃﺮﻣ: ﻥﺍﺭﺎﺑ, ﺖﺑﻮﻃﺭ
ﺯﺍﺭ: ﺯﺍﺭ
ﯼﺍﺭﺍﺩ: ﺩﻮﺧ, ﻞﻤﺤﺗ, ﺙﺭﺍﻭ, ﻦﺘﺷﺍﺩﻪﮕﻧ
ﯼﺭﺎﯿﺷﻮﻫ: ﺖﯿﻧﻼﻘﻋ, ﺱﺎﺴﺣﺍ, ﻥﺍﺪﺟﻭ, ﻢﺳﺍﺮﻣ
ﻖﺑﺎﺳ: ﺯﺍﻞﺒﻗ
ﻥﺩﺮﮐﺝﺮﺧ: ﻪﻨﯾﺰﻫ, ﻥﺩﺮﮐﺮﭘ
ﺪﯿﻟﻮﺗ: ﻥﺩﺮﮐﺪﯿﻟﻮﺗ
ﻊﺒﻨﻣ: ﺎﻤﻨﺑﺁ, ﻊﺑﺎﻨﻣ, ﺭﺪﺼﻣ
ﻪﺷﺮﻋ: ﻞﭘ, ﮏﻫﻼﮐ, ﺎﻫﻩﻭﺮﮔ
ﻪﻤﻋ: ﯽﯾﺍﺩ
ﺖﻨﻄﻠﺳ: ﻩﺎﺷﺩﺎﭘ, ﯽﺘﻨﻄﻠﺳﻩﺩﺍﻮﻧﺎﺧﯼﺎﻀﻋﺍ, ﻥﻮﻧﺎﻗ
ﻕﺎﺒﻄﻧﺍ: ﻥﺩﺮﮐﻝﺎﺒﻧﺩ, ﻕﺎﺒﻄﻧﺍ, ﮏﯿﻧﻮﻣﺭﺎﻫ, ﻖﺑﺎﻄﻣ
ﻭﺍ...: ﻥﺁ
ﻞﮔ: ﻪﻗﻼﻋ, ﻞﮔ, ﻥﺪﺷﺎﻓﻮﮑﺷ
ﻩﺪﺷﻡﺎﺠﻧﺍ: ﻩﺪﺷﺮﭘ
ﺮﮑﺸﺗﺎﺑ: ﺮﮑﺸﺗ
ﻪﻔﺴﻠﻓ: ﺪﯾﺩﺯﺎﺑ
ﻖﻠﻌﺗ: ﻪﻠﻤﺟﺯﺍ, ﻪﺟﻮﺗ
ﺖﺣﺍﺭ: ﻞﻣﺎﮐﺭﻮﻄﺑ, ﺮﯾﺬﭙﻟﺩ
ﺭﺍﺯﺎﺑ: ﺪﯾﺮﺧ, ﺭﺍﺩﺮﻬﺷ
ﺭﺍﺩﻪﺒﻟﻩﻼﮐ: ﻩﻼﮐ, ﮏﻫﻼﮐ
ﯽﯾﺎﺟﮏﯾ: ﺎﺟﺮﻫ, ﺎﺟﻪﻤﻫﺭﺩ
ﻝﺎﺤﺷﻮﺧ: ﻝﺎﺤﺷﻮﺧ
ﻝﺰﻨﻣﻡﺯﺍﻮﻟ: ﻩﺩﺍﻮﻧﺎﺧ, ﻪﻧﺎﺧ, ﺩﺎﺼﺘﻗﺍ, ﺪﯿﻨﮐﺽﺮﻓ
ﻥﺎﮔﻭﺎﻧ: ﯽﺘﺸﮐ, ﯽﯾﺎﯾﺭﺩﯼﻭﺮﯿﻧ, ﺭﻭﺎﻨﺷ
ﮎﺩﻮﮐ: ﺎﻫﻪﭽﺑ, ﮏﺳﻭﺮﻋ
ﻪﻘﻄﻨﻣ: ﻩﺯﻮﺣ
: 
ﻖﯿﻗﺩ: ﯽﻌﻗﺍﻭ, ﺭﺩﻮﭘ, ﻩﺪﺷﺮﭘ, ﻥﺪﺷﺎﺟ, ﯽﻈﻔﻠﻟﺍﺖﺤﺗ
ﺮﯾﻮﺼﺗ: ﺮﯾﻮﺼﺗ, ﺶﯾﺎﻤﻧ
ﻦﻇءﻮﺳ: ﻥﺩﺮﻛﻚﺷ, ﮎﻮﮑﺸﻣ
ﺩﺭ: ﻥﺩﺮﮐﺖﻣﻭﺎﻘﻣ, ﺩﺭ, ﯽﻨﺘﺨﯾﺭﺭﻭﺩ
ﻥﺎﻨﮐﺭﺎﮐ: ﻪﻣﺪﺧ, ﺏﻮﭼ, ﺪﻨﻣﺭﺎﮐ
ﯽﻫﺪﺑ: ﻪﻔﯿﻇﻭ, ﺶﻧﺯﺮﺳ
ﻥﺩﺮﮐﻩﺎﮕﻧﻝﺯﻝﺯ: ﻩﺎﮕﻧ, ﻥﺪﯾﺩ, ﻩﺮﯿﺧ
ﻩﺩﺯﺖﻟﺎﺠﺧ: ﻡﺮﺷ
ﯽﯾﺍﺬﻏﻩﺪﻋﻭ: ﺍﺬﻏ, ﻥﺩﺭﻮﺧ, ﺭﺩﻮﭘ, ﺭﺎﻫﺎﻧ
ﺖﯿﻌﺿﻭ: ﺖﯿﻌﻗﻮﻣ, ﺖﯿﻌﺿﻭ
ﻥﺩﺍﺩﻥﺎﺸﻧ: ﻥﺪﺷﻞﺧﺍﺩ, ﺶﯾﺎﻤﻧ, ﺮﮑﻓ, ﺪﻫﺩﯽﻣﺩﺎﻬﻨﺸﯿﭘ
ﺮﻌﺷ: ﺮﻌﺷ, ﻪﻧﺍﺮﺗ
ﺪﻨﯾﺁﯽﻣﺩﻮﺟﻮﺑ: ﺪﺳﺭﯽﻣﺮﻈﻧﻪﺑ, ﻦﺘﺳﻮﯿﭘﻉﻮﻗﻭﻪﺑ
ﺮﻔﺳ: ﺮﻔﺳ, ﺮﻓﺎﺴﻣ
ﻥﺩﺮﻛﻪﻌﺟﺍﺮﻣ: ﻥﺩﺮﮐﻞﺻﻭ
ﻦﺘﺷﺍﺩﺖﻋﺎﻄﺘﺳﺍ: ﻪﺑﺭﺩﺎﻗ, ﺪﯾﺮﺧ, ﻥﺩﺍﺩ, ﻞﻤﺤﺗ
ﻥﺩﺮﮐﺍﺪﻫﺍ: ﺖﮐﺭﺎﺸﻣ, ﻥﺩﺍﺩ
ﺭﺎﮐ: ﺭﺎﮐ, ﺯﻭﺭ
ﻪﻣﺍﺩﺍ: ﻥﺩﺍﺩﺶﯾﺍﺰﻓﺍ, ﻡﻭﺍﺪﻣ, ﻦﺘﻓﺭﺶﯿﭘ, ﯼﻭﺭﻩﺩﺎﯿﭘ, ﻪﻣﺍﺩﺍ, ﺪﻌﺑ
ﻥﺪﺷﻥﺎﻤﻴﺸﭘ: ﻒﺳﺎﺘﻣ, ﺮﺑﻥﺩﺮﮐﯼﺯﻮﺴﻟﺩ
ﺮﻄﺧ: ﺮﻄﺧ
ﻊﯾﺮﺳ: ﯼﺩﻭﺯﻪﺑ, ﻝﺎﺣﺭﺩﺖﻋﺮﺳﻪﺑ
ﺰﯾﺎﻤﺘﻣ: ﻒﻠﺘﺨﻣ, ﻢﻫﺯﺍﺍﺪﺟ, ﻪﻧﺎﮔﺍﺪﺟﺭﻮﻃﻪﺑ, ﺩﺎﻀﺘﻣ
ﯽﺘﺳﺭﺩﻪﺑ: ﻞﻣﺎﮐﺭﻮﻄﺑ, ﺎﭘ, ﺖﺳﺭﺩ
ﺩﺮﻔﻣ: ﺪﺤﺘﻣ, ﺪﺣﺍﻭ, ﯽﻌﯿﺒﻃﺮﯿﻏ
ﺎﻄﺧ: ﻩﺎﺒﺘﺷﺍ
ﺕﺮﻬﺷ: ﺶﯾﺎﺘﺳ, ﺕﺮﻬﺷ
ﺖﺳﺍﻮﺧﺭﺩ: ﺖﺴﻫﺐﻟﺎﺟ, ﻥﺩﺯﮓﻧﺯ
ﺕﺪﺷﻪﺑ: ﺭﺎﯿﺴﺑ
ﻡﺪﻋ: ﺵﺮﺑ, ﻡﺪﻋ, ﻪﻠﯿﺒﻗ
ﺖﻧﻮﺸﺧ: ﺪﯾﺪﺷ, ﻪﺠﻨﮑﺷ, ﺯﻭﺎﺠﺗ
ﻪﺋﺍﺭﺍ: ﻡﺎﺠﻧﺍ, ﻥﺩﺮﮐﯽﻓﺮﻌﻣ, ﻥﺩﺍﺩ
ﯼﺍﻪﻓﺮﺣ: ﻪﻓﺮﺣ, ﺭﺎﮐ, ﯽﮔﺪﻧﺯﮏﺒﺳ
ﻥﺩﺮﮐﯽﺣﺍﺮﻃ: ﺡﺮﻃ
ﯼﺭﺎﺠﺗ: ﺕﺭﺎﺠﺗ
ﺩﺎﻬﻨﺸﯿﭘ: ﺪﻫﺩﯽﻣﺩﺎﻬﻨﺸﯿﭘ, ﻪﻠﻤﺟ, ﺖﺤﯿﺼﻧ
ﻖﻠﻄﻣ: ﻞﻌﺟ, ﻩﺪﺷﺮﭘ
ﺡﻮﺿﻭ: ﻪﺠﯿﺘﻧ, ﻞﯿﻠﺤﺗ, ﯽﮔﺪﯿﺳﻮﭘ
ﯽﮐﺪﯾ: ﯽﻓﺎﺿﺍ, ﻥﺩﺮﮐﻦﯾﺰﮕﯾﺎﺟ
ﯽﮕﻧﺎﺧ: ﯽﻧﺪﻣ, ﯽﻠﺧﺍﺩ, ﻦﮐﺎﺳ, ﯽﻠﻣ, ﺭﺍﺰﮕﺘﻣﺪﺧ
ﻪﻋﺭﺰﻣ: ﯼﺯﺭﻭﺎﺸﮐ, ﻥﺪﺷﻞﻴﻜﺸﺗ, ﻩﺯﻮﺣ
ﻊﺟﺮﻣ: ﯽﻋﺎﺟﺭﺍ, ﻪﻈﻓﺎﺣ, ﻝﻮﻗﻞﻘﻧ
ﺩﻮﺟﻭ: ﺭﻮﻀﺣ, ﻥﺩﺎﺘﺴﯾﺍ, ﺎﺠﻧﺁ
: 
ﻪﻟﺎﺴﻣ: ﺕﺎﺣﻼﻄﺻﺍ, ﻞﮑﺸﻣ, ﻉﻮﺿﻮﻣ, ﻩﺩﺎﻣ
ﻥﺩﺭﻭﺁﻢﻫﺍﺮﻓ: ﻩﺪﺷﻪﺋﺍﺭﺍ, ﻥﺩﺍﺩ, ﻥﺩﺍﺩﺖﻴﻤﻫﺍ
ﻪﻠﻌﺷ: ﯼﺯﻮﺳﺶﺗﺁ, ﯼﺯﺎﺑﺶﺗﺁ
ﻩﺎﮕﯿﺑﻭﻩﺎﮔ: ﺎﻬﺘﻗﻭﯽﻀﻌﺑ, ﺭﺮﮑﻣ
ﺯﺍﻭﺮﭘ: ﺯﺍﻭﺮﭘ
ﻪﭼﺭﺎﭘ: ﻪﭼﺭﺎﭘ, ﺭﺍﺰﻫ
ﻡﺭﺎﻬﭼ: ﺭﺎﻬﭼ, ﻪﺒﻨﺷﺭﺎﻬﭼ, ﻕﺎﺗﺍ
ﻥﺩﺮﺑﻩﺮﻬﺑ: ﺩﻮﺳ, ﻑﺪﻫ
: 
ﻞﺼﻓ: ﺏﺭﺩ, ﺶﺨﺑ, ﺮﺳ, ﻞﺼﻓ, ﺖﺨﺘﯾﺎﭘ،ﻪﯾﺎﻣﺮﺳ, ﻩﺭﺎﺑﺭﺩ
ﺥﺍﺭﻮﺳ: ﻥﺩﺮﮐﺥﺍﺭﻮﺳﻪﺘﻣﺎﺑ, ﻝﺍﺩﻮﮔ, ﻦﻟﺎﺳ, ﯽﻟﺎﺧﻮﺗ
ﻝﻮﻘﻌﻣ: ﺎﻧﺍﺩ, ﯽﻘﻄﻨﻣ, ﯽﻓﺎﮐ
ﺪﻨﻗ: ﺮﯿﺴﻣ
ﯽﻨﯾﺰﮕﯾﺎﺟ: ﻥﺩﺮﮐﻦﯾﺰﮕﯾﺎﺟ, ﯼﺎﺠﺑ, ﯼﺮﻤﺘﺴﻣ, ﻝﺩﺎﺒﺗ
ﻩﺁ: ﺲﻔﻧ
ﺭﺎﺸﻓ: ﻥﺩﺮﮐﺭﺍﺮﺻﺍ, ﻩﺮﮔ, ﺖﺧﺍﺩﺮﭘ, ﺭﺎﺸﻓ
ﺏﺎﻗ: ﺱﺎﯿﻘﻣ, ﯽﻧﻮﻧﺎﻗ, ﺲﮑﻋ
ﺖﻔﻟﺎﺨﻣ: ﻥﺩﺮﮐﺖﻣﻭﺎﻘﻣ, ﺖﻣﻭﺎﻘﻣ, ﺩﺭ, ﻞﺑﺎﻘﻣ
ﻩﺩﺎﻣ: ﯽﯾﺎﻨﻌﻣ, ﻩﺩﺎﻣ, ﻪﺘﺴﻫ
ﮏﯿﻧﻭﺮﺘﮑﻟﺍﺖﺴﭘ: ﻝﺎﺳﺭﺍ, ﮏﯿﻧﻭﺮﺘﮑﻟﺍ
ﺶﺨﺑ: ﻢﯿﺴﻘﺗ, ﺶﺨﺑ, ﯽﻓﺎﮑﺷﺪﺒﻟﺎﮐ, ﺱﻼﮐ
ﺮﻌﺷ: ﺮﻌﺷ, ﺪﻨﺑ
ﻢﯿﻤﺼﺗ: ﺺﺨﺸﻣ
ﯽﻟﺎﻤﺘﺣﺍ: ﺪﯾﺎﺷ, ﻝﺎﻤﺘﺣﺍ
ﮎﺎﻧﺩﺭﺩ: ﺦﻠﺗ, ﺩﺭﺩ
ﻪﺸﯿﻤﻫﯼﺍﺮﺑ: ﻪﺸﯿﻤﻫ, ﯼﺪﺑﺍ
ﺱﻮﻧﺎﯿﻗﺍ: ﺎﯾﺭﺩ
ﺐﻘﻋ: ﺖﺸﮔﺯﺎﺑ
ﺮﺒﻫﺭ: ﺮﺳ, ﺮﯾﺪﻣ, ﺮﺘﺴﮐﺭﺍﺮﺒﻫﺭ, ﯼﺎﻤﻨﻫﺍﺭﻪﭽﺑﺎﺘﮐ
ﻕﺎﺘﺸﻣ: ﺪﺼﻗ, ﺲﭘﺍﻮﻟﺩ, ﺰﯿﺗ, ﻡﻭﺍﺪﻣ
ﻕﺎﯿﺘﺷﺍ: ﺖﯾﺎﺿﺭ, ﺪﺟﻭ, ﻥﺎﺠﯿﻫ
ﺮﻫﺎﻇ: ﯽﺸﯾﺎﻤﻧ, ﯽﻘﻄﻨﻣ, ﻥﺩﺮﮐﺵﺎﻓ
ﻪﻠﺠﻋ: ﯼﺩﻭﺯﻪﺑ, ﻪﻟﺎﺳﻮﮔ
ﺡﺮﻃ: ﺡﺮﻃ, ﻩﺍﺭﻩﺍﺭ, ﯽﻧﺎﻣﺯﺎﺳﺕﺭﺎﭼ
ﺭﻮﺨﻧﺩﺭﺪﺑ: ﯽﻨﺘﺨﯾﺭﺭﻭﺩ
ﻑﺎﺻﻭﺍﻦﯾﺍﺎﺑ: ﺎﻣﺍ, ﻪﮑﯿﻟﺎﺣﺭﺩ
ﻑﺎﺻ: ﻡﺮﻧ, ﻒﯿﻄﻟ
ﺪﻣﺎﺟ: ﯽﺸﯾﺎﻤﻧ, ﺩﺎﺠﯾﺍ, ﺖﺨﺳ, ﺐﻌﮑﻣ
ﺎﻣﻭﺰﻟ: ﺪﯾﺎﺑ, ﻡﺯﻻ
ﻦﺘﺧﺎﺳ: ﺎﻨﺑ, ﯼﺪﻨﺑﻝﻮﻣﺮﻓ, ﻥﺩﺍﺩﻢﯿﻤﻌﺗ, ﻥﺩﺮﮐﻩﺩﺎﻣﺁ
ﺵﻼﺗ: ﻥﺩﺮﻛﺵﻼﺗ, ﻥﺩﺯﻢﺧﺯ
ﻝﺩﺎﻌﻣ: ﺮﺑﺍﺮﺑ
ﺮﯿﺧﺍ: ﯽﮔﺯﺎﺗﻪﺑ, ﻥﺭﺪﻣ, ﻪﺘﺷﺬﮔ
ﻩﻭﺍ: 
ﻦﺘﻓﺭﺮﻔﺳ: ﺪﯾﺩﺯﺎﺑ, ﯼﺩﺮﮕﻧﺎﻬﺟ, ﺮﻓﺎﺴﻣ
ﺮﻬﻇ: ﺮﻬﻇﺯﺍﺪﻌﺑ, ﺏﻮﻨﺟ
ﻊﻗﺍﻭ: ﻁﻮﻘﺳ, ﺖﯿﻌﻗﻮﻣ
ﻥﻼﻋﺍ: ﺩﻼﯿﻣﺯﺍﺪﻌﺑ, ﻁﺎﺒﺗﺭﺍ
ﻒﻗﻮﺗ: ﻥﺩﺮﮐﯼﺮﯿﮔﻮﻠﺟ, ﻥﺪﺷﻪﺘﺴﺑ
ﯽﮕﻧﻮﮕﭼ: ﺖﯿﻌﺿﻭ, ﻪﻣﺎﻧﺖﻛﺎﭘ, ﺖﯿﻌﻗﻮﻣ
ﺭﺩﺎﭼ: ﻦﯿﺑﺎﮐ, ﻪﻨﺤﺻ
ﺭﺮﮑﻣ: ﺭﺮﮑﻣ, ﻊﻗﺍﻮﻣﺮﺘﺸﯿﺑ
ﺮﻄﺧﮓﻧﺯ: ﺱﻮﻗﺎﻧ, ﻥﺪﻧﺎﺳﺮﺗ
ﺪﻨﻠﺑﯼﺍﺪﺻﺎﺑ: ﺍﺪﺻ, ﺍﺪﺻﻭﺮﺳﺮﭘ
ﻞﻘﺘﺴﻣ: ﻝﻼﻘﺘﺳﺍ, ﻞﺷ, ﻞﻘﺘﺴﻣﺭﻮﻃﻪﺑ, ﻥﺁ
ﯼﺭﻭﺮﺿ: ﻡﺯﻻ, ﯽﻟﺍ
ﻩﺪﻫﺎﺸﻣ: ﻥﺩﺮﮐﻩﺪﻫﺎﺸﻣ
ﻲﻤﺋﺍﺩ: ﻡﻭﺍﺪﻣ, ﺖﺑﺎﺛ, ﯼﺪﺑﺍ, ﻆﻔﺣ
ﯽﺳﺎﻨﺷﻖﺣ: ﺮﮑﺸﺗ
ﻆﻔﺣ: ﻆﻔﺣ, ﯼﺯﺎﺳﻩﺮﯿﺧﺫ, ﻥﺩﺭﻭﺁﺖﺳﺩﻪﺑ, ﺖﻈﻓﺎﺤﻣ, ﯽﯾﻮﺟﻪﻓﺮﺻ
ﻪﺒﻨﺟ: ﺖﻤﺳ
ﻮﻗﺎﭼ: ﺮﯿﺸﻤﺷ
ﺖﺸﺣﻭ: ﺱﺮﺗ
ﺵﻮﻫﺎﺑ: ﺎﻧﺍﺩ, ﯼﺮﮔﻪﻠﯿﺣ
: 
ﻪﯿﺣﺎﻧ: ﻩﺪﻧﺯ, ﺱﻼﮐ, ﻥﺎﺘﺳﺍ
ﺖﺴﮑﺷ: ﺖﺴﮑﺷ, ﻩﺎﺒﺘﺷﺍ, ﯽﮕﺘﺴﮑﺷﺭﻭ
ﺪﺻﺭﺩ: ﯼﺪﺻﺭﺩ, ﺪﺻ, ﺪﺻﺭﺩ
ﺱﺎﺴﺣﺍ: ﺱﺎﺴﺣﺍ
ﻞﻣﺎﻋ: ﻦﺘﺷﺍﺩﺭﻮﻈﻨﻣ
ﻪﺘﺷﺬﮔﻥﺎﺟﺯﺍ: ﻦﺘﻓﺭﻝﺎﺣﺯﺍ
ﻪﯾﺩﺎﺤﺗﺍ: ﺩﺎﺤﺗﺍ, ﺪﺤﺘﻣ
ﻥﺩﺮﮐﺎﻄﻋﺍ: ﺪﯿﯾﺎﺗ, ﻥﺩﺍﺩ
ﯼﺪﺟﺭﻮﻃﻪﺑ: ﻪﻧﺎﺼﻟﺎﺧ, ﻦﯿﮕﻨﺳ, ﻦﯿﻣﺯﻪﺑﺫﺎﺟ, ﺖﯿﻌﻤﺟ
ﺖﺑﺎﺻﺍ: ﻥﺩﺮﮐﺮﯿﺜﮑﺗ, ﺖﯿﻘﻓﻮﻣ
ﻢﯿﻈﻋ: ﯽﻟﺎﻋ, ﻦﯿﮕﻨﺳ
: 
ﻩﺪﯿﻘﻋ: ﻪﻠﻤﺟ
ﯽﺑﻮﭼ: ﺖﺧﺭﺩ
ﻢﻫﺩﯽﻣﺢﯿﺟﺮﺗ: ﻪﻨﯾﺰﮔ, ﻝﺎﺤﺷﻮﺧ, ﺖﯾﻮﻟﻭﺍ
ﺐﺗ: ﯼﺯﻮﺳﺶﺗﺁ, ﺍﺰﻧﻻﻮﻔﻧﺁ
ﻪﺑﻥﺩﺍﺩﻩﺰﯿﮕﻧﺍ: ﻡﺎﻬﻟﺍ, ﺾﺒﻧ, ﺱﺎﺴﺣﺍ
ﺎﻣﻝﺎﻣ: ﺭﺎﻬﺑ, ﺎﻣ
ﻩﺎﺒﺘﺷﺍ: ﻩﺎﺒﺘﺷﺍ, ﻩﺩﺎﻔﺘﺳﺍﻮﺳ, ﺐﺳﺎﻨﻣﺎﻧ
ﻝﺁﻩﺪﯾﺍ: ﺮﺘﻬﺑ, ﯽﻌﯿﺒﻃﺮﯿﻏ
ﻥﺩﺮﺑﻡﻮﺠﻫ: ﺖﯿﻌﻤﺟ, ﻪﺑﺮﺿ
ﺭﺎﮑﻧﺍ: ﻥﺩﺮﮐﺵﻮﻣﺍﺮﻓ
ﺖﺳﺭﺩ: ﺖﺳﺭﺩ, ﻥﺎﻤﯾﺍﺎﺑ, ﻪﻨﯿﻬﺑ
ﻥﺩﺍﺩﻡﺎﺠﻧﺍ: ﺶﯾﺎﻤﻧ, ﻡﺎﺠﻧﺍ, ﺖﯾﺮﯾﺪﻣ, ﻪﻣﺍﺩﺍ
: 
ﺕﺭﻮﺸﻣ: ﺭﻭﺎﺸﻣ, ﺖﺤﯿﺼﻧ, ﻞﯿﮐﻭ
ﻡﻮﻬﻔﻣ: ﯽﮐﺍﺭﺩﺍ, ﻪﺸﯾﺪﻧﺍ, ﺱﺎﺴﺣﺍ
ﻪﺜﺣﺎﺒﻣ: ﻮﮕﺘﻔﮔﻭﺚﺤﺑ, ﻝﺪﺟﻭﺚﺤﺑ
ﻢﮑﺤﻣ: ﺩﺎﺠﯾﺍ
ﯽﯾﺍﻭﺮﻧﺎﻣﺮﻓ: ﯽﺘﻨﻄﻠﺳ
ﻡﻭﺍﺪﻣﻪﺒﻨﺟ: ﺏﻮﯿﻌﻣﻪﺒﻨﺟ
ﻢﻠﻗ: ﺩﺍﺪﻣ, ﺮﺳ
ﻩﺯﺎﺟﺍ: ﻩﺯﺎﺟﺍ
ﻦﺘﺷﺍﺩﻪﮕﻧ: ﻦﺘﺷﺍﺩﻪﮕﻧ, ﺖﻈﻓﺎﺤﻣ, ﻆﻔﺣ, ﺖﯾﺮﯾﺪﻣ
ﻍﻮﻠﺷ: ﺭﺎﺸﻓ, ﺖﯿﻌﻤﺟ
ﺖﯾﺩﻭﺪﺤﻣ: ﻥﺍﺮﮐ
ﺭﺎﺑﺖﺒﯿﺼﻣ: ﮎﺎﻨﺘﺸﺣﻭ
ﺭﺪﻨﺑ: ﺏﺭﺩ
ﻪﺑﺮﺠﺗﺎﺑ: ﻪﺑﺮﺠﺗ, ﺱﺎﻨﺷﺭﺎﮐ, ﺖﺤﺗ
ﻒﻟﺎﺨﻣ: ﻞﺑﺎﻘﻣ, ﺩﺭ, ﺩﺎﻀﺘﻣ, ﻥﺩﺮﮐﺖﻣﻭﺎﻘﻣ
ﻩﺪﻫﺎﻌﻣ: ﺖﺷﺍﺩﺩﺎﯾ, ﯼﺭﺎﮑﻤﻫﺩﺍﺩﺭﺍﺮﻗ, ﻩﺍﻮﺨﻟﺩ
ﺖﺳﺮﻬﻓ: ﻞﻣﺎﺷ, ﻥﺩﺮﮐﺮﭘ
ﺖﻟﺎﺣ: ﺮﯿﺴﻣ
ﻦﺘﺳﻮﯿﭘﻉﻮﻗﻭﻪﺑ: ﻦﺘﺳﻮﯿﭘﻉﻮﻗﻭﻪﺑ, ﺎﯿﺑ
ﻝﺎﺒﻧﺩﻪﺑ: ﻥﺩﺮﮐﻮﺠﺘﺴﺟ
ﻼﻤﻋ: ﯽﻠﻤﻋ, ﯽﺒﯾﺮﻘﺗ
ﺩﺭ: ﺖﻣﻼﻋ, ﺩﺭ, ﻪﻈﻓﺎﺣ
ﻪﺼﺨﺸﻣ: ﺺﺼﺨﺗ, ﺭﺎﺘﻓﺭ, ﺍﻮﻘﺗ, ﻪﻧﺎﺸﻧ
ﺵﻮﺧ: ﻝﺎﺤﺷﻮﺧ, ﺭﺍﺩﻩﺪﻨﺧ, ﺖﺷﺯ
ﺐﯿﺗﺮﺗ: ﺐﯿﺗﺮﺗ, ﻊﺿﻭ, ﯼﺭﺎﮑﻤﻫﺩﺍﺩﺭﺍﺮﻗ
ﯽﺑﺮﻏ: ﺏﺮﻏ
ﺭﺎﺸﻓ: ﭖﺎﭼ, ﺭﺎﺸﻓ, ﺱﺮﺘﺳﺍ
ﺖﺳﺎﯿﺳ: ﯽﺳﺎﯿﺳ
ﯽﻤﻠﻋ: ﯽﺑﺮﺠﺗﻡﻮﻠﻋ, ﺪﻨﻤﺸﻧﺍﺩ
ﺵﺯﺮﻟ: 
ﺖﻌﻨﺻ: ﯽﺘﻌﻨﺻ, ﻥﺩﺮﮐﯽﺘﻌﻨﺻ, 
ﯽﮕﺘﺴﯾﺎﺷ: ﺶﯾﺎﺘﺳ, ﻂﯾﺍﺮﺷﺪﺟﺍﻭ, ﺵﺯﺭﺍ, ﻥﺩﺮﮐﻪﺋﺮﺒﺗ, ﺖﯿﻔﯿﮐ
ﻪﺒﺣﺎﺼﻣ: ﺪﯾﺩﺯﺎﺑ
ﻭﺮﻤﻠﻗ: ﻩﺯﻮﺣ
ﯽﺴﻨﺟﻁﺎﺒﺗﺭﺍ: ﺩﺮﻣﯽﻠﺳﺎﻨﺗﺖﻟﺁ, ﯽﺴﻨﺟ, ﺶﺷ
ﺩﺎﺠﯾﺍ: ﯼﺪﻨﺑﻝﻮﻣﺮﻓ, ﺩﺎﺠﯾﺍ, ﻥﺩﺮﮐﺪﯿﻟﻮﺗ
ﻪﻟﺎﺒﻧﺩ: ﺖﻣﻼﻋ, ﺏﺎﺨﺘﻧﺍ, ﺮﯿﺴﻣ, ﻡﺩ
ﺯﺍﺪﻧﺍﻢﺸﭼ: ﺪﯿﻣﺍ, ﻝﺎﻤﺘﺣﺍ, ﺯﺍﺪﻧﺍﻢﺸﭼ, ﻪﻨﺤﺻ, ﻪﻧﺎﺘﺨﺒﺷﻮﺧ
ﻥﺩﺮﮐﺖﻋﺎﻃﺍ: ﻖﺑﺎﻄﻣ, ﻥﺩﺮﮐﻝﺎﺒﻧﺩ
ﺩﺮﮑﻠﻤﻋ: ﯽﮔﺪﻧﺍﺭ, ﻞﻤﻋ, ﺡﺍﺮﺟ, ﯼﺭﺎﮐﺖﺳﺩ, ﯼﺎﻤﻨﻫﺍﺭﻪﭽﺑﺎﺘﮐ
ﯽﻟﺎﻤﺷ: ﻩﺪﺑﺏﺍﻮﺟ
ﻖﯿﻤﻋ: ﻖﯿﻤﻋ
ﻦﺘﺷﺍﺩﯽﻧﺍﻮﺨﻤﻫ: ﺭﺎﻤﻗ, ﻪﻘﺑﺎﺴﻣ
ﻡﺮﻓﺱﺎﺒﻟ: ﺩﺎﺸﮔﻭﺪﻨﻠﺑﺱﺎﺒﻟ, ﻩﺪﯿﺷﻮﭘﺱﺎﺒﻟ
ﯽﻫﺪﺑ: ﺶﻧﺯﺮﺳ, ﻦﯾﺩ, ﻪﻔﯿﻇﻭ, ﺭﺎﺒﺘﻋﺍ
ﻢﯿﻠﻌﺗ: ﺕﻼﯿﺼﺤﺗ
ﯼﺭﺍﺬﮔﻪﯾﺎﻣﺮﺳ: ﺍﺮﺟﺎﻣ, ﯼﺭﺍﺬﮔﻪﯾﺎﻣﺮﺳ, ﺖﮐﺮﺷ
ﺍﺮﺟﺍ: ﻖﺑﺎﻄﻣ, ﻞﻤﻋ, ﯼﺯﺎﺳﻩﺩﺎﯿﭘ
ﺖﻟﺎﺣ: ﺱﺎﺴﺣﺍ, ﯽﻌﺒﻃﺥﻮﺷ, ﻊﺿﻭ
ﮎﺭﺩ: ﻥﺪﯾﺩ, ﻥﺪﯿﻤﻬﻓ, ﺭﺎﺑ, ﻥﺩﺮﻛﻙﺭﺩ, ﻥﺩﺮﮐﺐﺣﺎﺼﺗ, ﺱﻮﺳﺎﺟ, ﮎﺭﺩ
ﻦﺘﺷﺍﺩﺭﺎﻬﻇﺍ: ﺢﯿﺿﻮﺗ
ﻪﺨﺴﻧ: ﻪﺨﺴﻧ, ﻪﻤﺟﺮﺗ
ﺩﺮﻓ: ﺐﻳﺮﻏﻭﺐﻴﺠﻋ
ﺭﺍﺰﮕﺳﺎﭙﺳ: ﺮﮑﺸﺗ
ﺖﻳﺎﻬﻧﻲﺑ: ﯼﺪﺑﺍ, ﺭﺪﺼﻣ
ﺮﮕﯾﺩﯼﺎﺟﺭﺩ: ﺎﺟﺮﻫ
ﺖﯿﻨﻣﺍ: ﺮﻄﺧﯽﺑ, ﻥﺩﺍﺩﺖﻴﻤﻫﺍ
ﻝﻮﻘﻌﻣ: ﺎﻧﺍﺩ, ﯽﻘﻄﻨﻣ, ﺱﺎﺴﺣ, ﻪﻨﯿﻬﺑ
ﻪﺒﻠﮐ: ﻪﺒﻠﮐ, ﻦﯿﺑﺎﮐ
ﺖﯿﻓﺮﻇ: ﻪﺑﺭﺩﺎﻗ, ﺖﯿﻠﺑﺎﻗ
ﻞﺼﻓﻭﻞﺣ: ﻦﺘﺴﺸﻧ
ﺭﺎﮐﺭﺪﻧﺍﺖﺳﺩ: ﻝﻮﻐﺸﻣ, ﻥﺩﺮﮐﻞﺻﻭ, ﻞﻣﺎﺷ
ﺍﺭﻮﺷ: ﺖﺤﯿﺼﻧ
ﻪﻨﯾﺎﻌﻣ: ﯽﺳﺭﺮﺑ, ﻥﺩﺮﻛﺏﺎﺨﺘﻧﺍ, ﻥﺩﺮﻛﺵﻼﺗ
ﺩﻻﻮﻓ: ﻥﺪﯿﺸﮐﻮﺗﺍ
ﺖﺴﺗ: ﯽﺳﺭﺮﺑ, ﻥﺩﺮﻛﺵﻼﺗ
ﻪﻗﺪﺻ: ﻖﺸﻋ, ﺐﻠﻃﻭﺍﺩ
ﺮﺼﻨﻋ: ﺮﺻﺎﻨﻋ
ﻦﺘﺨﯾﺭ: ﻦﺘﺨﯾﺭ, ﺐﻟﺎﻗ, ﻪﺒﻠﮐ
ﯽﺴﮐ: ﯽﺴﮐﻪﭼ, ﺺﺨﺷ, ﯽﺴﮐﺮﻫ
ﻪﺛﺩﺎﺣ: ﻑﺩﺎﺼﺗ, ﻲﺳﺎﺳﺍﻥﻮﻧﺎﻗ
ﺭﺎﺑ: ﻢﯾﺭﺎﺑ
ﻒﯾﺩﺭ: ﻂﺧ, ﻢﯿﻈﻨﺗ, ﺖﻟﻭﺩ, ﺐﯿﺗﺮﺗ
ﯽﻟﻮﭘﯽﺑ: ﺮﯿﻘﻓ
ﯼﺮﻄﺑ: ﻪﺸﯿﺷ
ﺪﯾﺪﺷ: ﻪﺒﻟ, ﺪﯾﺪﺷ, ﺖﺷﺭﺩ
ﺱﺮﺘﺳﺩﺭﺩ: ﻩﺪﺷﻪﺋﺍﺭﺍ, ﯽﺳﺮﺘﺳﺩ, ﺭﺍﺬﮔﺮﻴﺛﺎﺗ
ﺖﺑﺎﺛ: ﻥﺩﺮﮐﺮﺘﻬﺑ, ﺖﺑﺎﺛ, ﻩﺮﯿﺧ
ﻝﻮﻤﻌﻣﺮﯿﻏ: ﯽﻌﯿﺒﻃﺮﯿﻏ, ﻝﻮﻤﻌﻣ, ﺐﻳﺮﻏﻭﺐﻴﺠﻋ
ﻖﺘﺸﻣ: ﻥﺩﺭﻭﺁﺖﺳﺩﻪﺑ, ﻖﺘﺸﻣ, ﻪﺘﻓﺮﮔﺕﺎﺸﻧ, ﻥﺩﺮﮐﺭﺍﺩﺍﻭ
ﻪﻨﮑﺳﺯﺍﯽﻟﺎﺧ: ﻪﮐﻭﺮﺘﻣ, ﺮﯾﻮﮐ, ﺎﻬﻨﺗ
ﺭﺍﺮﻘﺘﺳﺍ: ﯼﺪﻨﺑﻝﻮﻣﺮﻓ, ﺩﺎﺠﯾﺍ
ﯼﺍﺭ: ﻥﺩﺮﻛﺏﺎﺨﺘﻧﺍ, ﺍﺪﺻ
ﻞﻤﺤﺗ: ﻞﻤﺤﺗ, ﯽﻣﺎﺣ, ﻪﺘﺷﺬﮔ, ﻥﺩﺮﮐﺖﻣﻭﺎﻘﻣ
ﻥﺪﺷﻖﻓﻮﻣ: ﺖﯿﻘﻓﻮﻣ, ﺖﯿﻘﻓﻮﻣﺎﺑ
ﺎﭘ: ﺎﭘ, ﻥﺍﻮﺨﺘﺳﺍ, ﻞﭘ
ﺩﺎﻬﻨﺸﯿﭘ: ﻥﺩﺮﮐﺎﺿﺎﻘﺗ
ﯽﻠﺧﺍﺩ: ﯽﻠﺧﺍﺩ
ﮏﺒﺳ: ﯽﻧﺎﺳﺁﻪﺑ, ﮏﺒﺳ, ﯽﻤﮐﺭﺍﺪﻘﻣ
ﻥﺩﺍﺩﺶﯾﺎﻤﻧ: ﺶﯾﺎﻤﻧ, ﻪﻧﺎﺸﻧ, ﻪﻨﺤﺻ, ﮎﺭﺪﻣ, ﻩﺪﻨﻫﺩﻥﺎﺸﻧ
ﺩﺍﮋﻧ: ﺱﺮﺘﺳﺍ, ﺕﺪﺷ, ﻦﺘﻓﺮﯾﺬﭘ, ﻪﻠﯿﺒﻗ
ﺩﻭﺪﺤﻣ: ﻂﻘﻓ
ﻦﺘﻓﺮﮔﻪﻧﺎﺸﻧ: ﻑﺪﻫ, ﺰﮐﺮﻤﺗ
ﯽﻧﺍﺮﺤﺑ: ﻡﺯﻻ, ﻊﻃﺎﻗ, ﺮﺒﻗ
ﺩﺭﺍﺪﻧﺎﺘﺳﺍ: ﺖﺑﺎﺛ
ﻪﺴﯿﮐ: ﺐﯿﺟ, ﻪﺴﯿﮐ, ﺪﺒﺳ
ﻥﺩﺮﮐﺭﺍﺮﮑﺗ: ﺖﺸﮔﺯﺎﺑ, ﺭﺮﮑﻣ
ﺮﯿﺴﻣ: ﺭﻮﺘﯿﻧﺎﻣ, ﻪﻧﺍﺮﺗ, ﺮﯿﺴﻣ, ﻥﺩﺮﮐﻝﺎﺒﻧﺩ, ﻥﻮﯿﻣﺎﮐ
ﺮﺷﺯﺍﻥﺪﺷﺹﻼﺧ: ﻦﺘﺷﺍﺩﺮﺑ, ﻥﺩﺮﮐﻪﺋﺮﺒﺗ, ﯽﯾﻮﺟﻪﻓﺮﺻ
ﺖﻣﺎﻗﺍﻞﺤﻣ: ﻩﺎﻨﭘﻥﺎﺟ, ﻊﺿﻭ
: 
ﯽﻣﺮﮔﺮﺳ: ﺖﺴﻫﺐﻟﺎﺟ, ﻝﺎﺤﺷﻮﺧ, ﺭﺍﺩﻩﺪﻨﺧ, ﯽﻣﺮﮔﺮﺳﻭ​​ﺢﯾﺮﻔﺗ, ﺮﯾﺬﭙﻟﺩ
ﯼﺭﺍﺬﮔﻪﯾﺎﻣﺮﺳ: ﺖﮐﺮﺷ, ﻥﺎﻣﺯﺎﺳ
ﻉﺎﻓﺩ: ﺖﻈﻓﺎﺤﻣ, ﻞﯾﺎﻤﺗ, ﻥﺪﯾﻭﺩ
ﺕﺪﺷﻪﺑ: ﺮﺒﻗ, ﻦﯿﮕﻨﺳ
ﺰﯿﭼ: ﺕﻻﻮﺼﺤﻣ, ﻩﺩﺎﻣ
ﺶﺨﺑ: ﺶﺨﺑ, ﻢﯿﺴﻘﺗ, ﯽﻓﺎﮑﺷﺪﺒﻟﺎﮐ, ﻪﻟﺎﻘﻣ
ﻥﺎﮑﺳﺍ: ﯼﺭﺎﮑﻤﻫﺩﺍﺩﺭﺍﺮﻗ, ﻩﺎﻨﭘﻥﺎﺟ
ﻪﺤﻔﺻ: ﮏﺴﯾﺩ
ﺮﺑﻪﺒﻠﻏ: ﻪﻠﺑﺎﻘﻣ, ﻢﺘﺷﻭﺏﺮﺿ
ﻪﻨﯿﻣﺯ: ﻪﯾﺎﭘ, ﺕﺎﺣﻼﻄﺻﺍ
ﺮﻣﺮﻣﮓﻨﺳ: ﮓﻨﺳ
ﺮﯿﺧﺍﻪﺘﺷﺬﮔﺖﻔﺳ: 
ﯽﯾﺎﻧﺍﻮﺗ: ﻪﺑﺭﺩﺎﻗ, ﺩﺍﺪﻌﺘﺳﺍ, ﺖﯿﻠﺑﺎﻗ
ﻥﺩﺍﺩﻥﺎﮑﺗﺖﺳﺩ: ﺪﻣﻭﺭﺰﺟ, ﻢﻬﺒﻣ, ﺝﻮﻣﻝﻮﻃ
ﻡﺩﺮﻣ: ﺪﻨﺴﭘﻪﻣﺎﻋ, ﻝﺎﮕﻨﭼ, ﻪﻣﺎﻋﮓﻨﻫﺮﻓ
ﯼﺮﯾﺬﭘﻥﺎﮑﻣﺍ: ﻝﺎﻤﺘﺣﺍ, ﺖﺳﺍﻪﺘﺴﻧﺍﻮﺗ
ﻩﺮﮐ: ﺖﻔﻧ
ﺕﺮﻔﻧ: ﺮﯿﻘﺤﺗ, ﺕﺮﻔﻧ
ﺐﯿﻘﻌﺗ: ﯽﻧﻮﻧﺎﻗﺩﺮﮕﯿﭘ, ﻥﺩﺮﮐﻮﺠﺘﺴﺟ
ﻥﺪﯿﺸﮐ: ﯽﭽﯿﻗ, ﻦﺘﺷﺍﺩﺮﺑ
ﻝﺎﻨﮕﯿﺳ: ﺖﺳﮊ, ﺖﻣﻼﻋ, ﺭﻮﺒﻋﺰﻣﺭ
ﺮﻄﺧﻥﻭﺪﺑ: ﺮﻄﺧﯽﺑ
ﯽﮕﺘﺧﻮﺳ: ﻪﺘﺧﻮﺳ, ﺩﻭﺩ
ﻥﺩﺮﮐﻒﯿﺻﻮﺗ: ﺢﯿﺿﻮﺗ
ﺱﺭﺩ: ﺕﻼﯿﺼﺤﺗ, ﻩﺭﻭﺩ
ﻪﻧﺎﯿﻟﺎﺳ: ﻝﺎﺳ
ﺕﺭﺎﮐ: ﺍﻮﻘﻣ, ﻪﺸﻘﻧ, ﺮﺼﺘﺨﻣ, ﺬﻏﺎﮐ
ﺭﺍﺰﻓﺍﻡﺮﻧ: ﻥﺩﺮﮐﻩﺩﺎﻔﺘﺳﺍ, ﺭﺍﺰﻓﺍﻡﺮﻧ, ﻥﺩﺮﮐﺎﺿﺎﻘﺗ, ﯼﺩﺮﺑﺭﺎﮐﯼﺎﻫﻪﻣﺎﻧﺮﺑ
ﺪﻨﻤﺷﻮﻫ-ﺵﻮﻫﺎﺑ: ﯼﺮﮑﻓ, ﺎﻧﺍﺩ
ﻥﺎﺘﺳﺮﻬﺷ: ﻢﯾﺮﺤﺗ, ﯼﺍﻪﻘﻄﻨﻣ, ﻥﺎﺘﺳﺮﻬﺷ, ﻥﺎﺘﺳﺍ, ﯽﻣﺎﻈﻧ
ﺐﻟﺎﻗ: ﻥﺪﺷﻞﻴﻜﺸﺗ, ﺐﻟﺎﻗ, ﺖﺸﮕﯾﺎﺟ
ﻥﺎﯾﺮﺟ: ﻥﺎﯾﺮﺟ, ﯽﮔﺪﻧﺍﺭ
ﻥﺪﻧﺎﺳﺭﺐﯿﺳﺁ: ﯽﻫﺎﺒﺗ, ﯽﮔﺪﯾﺩﺐﯿﺳﺁ, ﯽﮔﺪﯿﺳﻮﭘ
ﻦﯾﺍﺮﺑﻩﻭﻼﻋ: ﯽﻓﺎﺿﺍ, ﯽﺘﺣ, ﺶﯿﺑ
ﺕﺭﺎﺠﺗ: ﺕﺭﺎﺠﺗ
ﯽﺑﻮﻨﺟ: ﺏﻮﻨﺟ
ﻂﺳﻮﺘﻣ: ﻦﺘﺷﺍﺩﺭﻮﻈﻨﻣ, ﮏﺗﮏﺗ
ﻪﻨﻫﺮﺑ: ﻡﺮﺷ
ﺢﺿﺍﻭ: ﻑﺎﻔﺷ, ﺍﺮﻫﺎﻇ, ﻦﮐﺯﺎﺑ
ﻪﻗﻼﻋ: ﻥﺩﺍﺩﺖﻴﻤﻫﺍ, ﺲﭘﺍﻮﻟﺩ, ﻪﻗﻼﻋ, ﯽﮕﺘﻔﯿﺷ
ﻭﺩﺎﺟ: ﻥﻮﺴﻓﺍ
ﯽﺗﺎﺑﺎﺨﺘﻧﺍﺕﺍﺯﺭﺎﺒﻣ: ﺮﻔﺳ, ﻦﯾﺮﻤﺗ
ﻥﺩﺮﮐﻪﻣﺰﻣﺯ: ﺮﻏﺮﻏ, ﺲﻔﻧ
ﺎﻣﻮﻤﻋ: ﻝﻮﻤﻌﻣ, ﻊﻗﺍﻮﻣﺮﺘﺸﯿﺑ, ﻡﺩﺮﻣﻡﻮﻤﻋ
ﺭﺎﮑﺷ: ﺪﯿﺻ, ﻥﺩﺮﮐﺮﯿﺳﺍ
ﻢﻠﻌﻣ: ﻩﺪﻨﺴﯾﻮﻧ
ﺕﺎﯿﻠﻤﻋ: ﺖﯿﻟﺎﻌﻓ, ﻥﺪﯾﻭﺩ
ﺕﺎﯿﺋﺰﺟ: ﻥﺩﺍﺩﺭﺎﺸﺘﻧﺍ, ﺕﺎﺼﺨﺸﻣ
ﯽﻫﺎﺗﻮﮐﺕﺪﻣ: ﯼﺩﻭﺯﻪﺑ, ﺮﺼﺘﺨﻣ
ﺖﮐﺮﺑ: ﺖﮐﺮﺑ
ﮏﭼﻮﮐ: ﯽﻤﮐﺭﺍﺪﻘﻣ, ﻒﯿﻄﻟ
ﺕﺪﺷﻪﺑ: ﺖﻋﺮﺳ, ﺰﯿﺗ, ﺭﺎﯿﺴﺑ
ﻪﻨﯿﺳﻪﺴﻔﻗ: ﻥﺎﺘﺴﭘ
ﻖﻤﻋ: ﻖﯿﻤﻋ, ﻕﺎﺗﺍ
ﺩﺮﮑﻠﻤﻋ: ﺶﯾﺎﻤﻧ, ﯼﺭﻭﻩﺮﻬﺑ, ﻩﺪﻨﻫﺩﻥﺎﺸﻧ
ﯽﺑﺎﯿﻣﺎﮐ: ﻥﺪﺷﺎﻓﻮﮑﺷ, ﺖﯿﻘﻓﻮﻣ, ﻩﺎﻓﺭ
ﺭﻮﺼﺗ: ﯼﺭﺍﺩﺭﺎﺑ, ﯽﮐﺍﺭﺩﺍ, ﺖﺷﺍﺩﺯﺎﺑ, ﺱﺎﺴﺣﺍ
ﯽﺸﻨﻣ: ﻩﺪﻨﺷﻭﺮﻓ, ﺪﻨﻣﺭﺎﮐ, ﯽﻤﺳﺭ
ﻦﺘﻓﺮﮔﻢﻴﻤﺼﺗ: ﺺﺨﺸﻣ, ﻊﻃﺎﻗ
ﯽﻧﺎﺑﺮﻗ: ﺪﯿﺻ, ﯽﻧﺎﺑﺮﻗ
ﻩﺰﯿﮕﻧﺍ: ﻡﺎﻬﻟﺍ, ﺪﺼﻗ, ﺭﻮﺗﻮﻣ, ﻑﺪﻫ, ﻉﻮﺿﻮﻣ, ﺭﻮﻈﻨﻣ
ﯽﻌﻄﻗ: ﺺﺨﺸﻣ
ﺶﯾﺍﺮﮔ: ﺭﺎﺘﻓﺭ, ﻞﯾﺎﻣ, ﻊﺿﻭ, ﯽﮔﺪﻧﺍﺭ
ﺭﻭﺩﻩﺍﺭﺯﺍ: ﺭﻭﺩ
ﻥﺎﯾﺎﭘ: ﭻﮔ, ﻦﯿﯾﺰﺗ, ﻪﺠﯿﺘﻧ
ﻢﭼﺮﭘ: ﻢﭼﺮﭘ, ﻦﺘﺴﻧﺍﺩ
ﺖﻣﻮﮑﺣ: ﻥﻮﻧﺎﻗ, ﺖﯾﺮﯾﺪﻣ
ﺕﺭﺪﻧﻪﺑ: ﺭﺩﺎﻧ
ﻼﺒﻗ: ﺯﺍﻞﺒﻗ
ﺭﺍﺯﺁﯽﺑ: ﺮﻄﺧﯽﺑ
ﺵﺯﻮﻣﺁ: ﺕﻼﯿﺼﺤﺗ
ﺪﺑ: ﻩﺎﺒﺘﺷﺍ, ﺭﺎﯿﺴﺑ, ﺪﺑ
ﻥﺩﺮﮐﻪﯾﺬﻐﺗ: ﻥﺩﺭﻮﺧ, ﺍﺬﻏ
ﯼﺰﮐﺮﻣ: ﺰﮐﺮﻣ, ﻪﺘﺴﻫ, ﻝﺍﺭﺪﻓ
ﺩﺎﻀﺗ: ﺩﺎﻀﺘﻣ, ﻥﺩﺮﮐﺖﻣﻭﺎﻘﻣ, ﮏﯿﮑﻔﺗ, ﻕﺮﻓ
ﺭﺎﺘﺧﺎﺳ: ﺎﻨﺑ, ﯼﺭﺎﺘﺧﺎﺳ, ﻥﺎﻣﺯﺎﺳ, ﯼﺪﻨﺑﺐﯿﮐﺮﺗ, ﯼﺭﺎﻤﻌﻣ, ﻪﭼﺭﺎﭘ
ﺖﺧﺍﺩﺮﭘ: ﺖﺧﺍﺩﺮﭘ
ﺖﻋﺮﺳ: ﺖﻋﺮﺳ
ﻮﺟﻭﺱﺮﭘ: ﻥﺩﺮﮐﺎﺿﺎﻘﺗ, ﻥﺩﺮﮐﻮﺠﺘﺴﺟ, ﯽﺑﺎﯾﺯﺭﺍ
ﻝﻭﺭ: ﯼﺯﺎﺑ
ﻪﮐﺎﺠﮐﺮﻫ: ﻪﮐﯽﯾﺎﺟ, ﺎﺟﺮﻫ
ﻥﺩﻮﺑﺭﺎﮑﻫﺪﺑ: ﺭﺎﮑﻫﺎﻨﮔ, ﻪﻔﯿﻇﻭ, ﻥﺩﺍﺩ
ﯽﮔﺪﯿﺳﺭ: ﺖﯾﺮﯾﺪﻣ, ﯼﺭﺎﮐﺖﺳﺩ, ﻡﺮﻫﺍ
ﺮﻔﺳ: ﺪﯾﺩﺯﺎﺑ, ﺮﻔﺳ
ﻦﺘﺨﯾﺭﻥﻭﺮﯿﺑ: ﺲﮑﻋ, ﺪﯿﻌﺒﺗ, ﻦﺘﻓﺮﮔ
ﺲﻧﺎﺷﺵﻮﺧ: ﺲﻧﺎﺷ
ﻪﻣﺎﻧﺯﻭﺭ: ﺕﺍﺮﻃﺎﺧﺮﺘﻓﺩ, ﺬﻏﺎﮐ, ﻥﺍﺮﻗ
ﻡﺍﺪﺨﺘﺳﺍ: ﺭﺎﮐﯽﺑ, ﯽﮕﺘﻔﯿﺷ, ﺭﺎﮐ
ﻥﺩﺍﺩﺵﺮﺑ: ﺵﺮﺑ
ﻥﺪﺷﻦﯿﯿﻌﺗ: ﺺﺨﺸﻣ, ﻊﻃﺎﻗ, ﻞﯿﻤﺤﺗ
ﻪﮑﯿﻟﺎﺣﺭﺩ: ﻪﮑﯿﻟﺎﺣﺭﺩ
ﺭﻮﺒﻋ: ﺐﯿﻠﺻ, ﻝﺎﺼﺗﺍ, ﺭﻮﺒﻋ
ﻩﺪﻧﺯ: ﻩﺪﻧﺯ
ﻢﯿﺴﻧ: ﺍﻮﻫ
ﯽﻠﯿﻣﺎﻓﺖﺒﺴﻧ: ﻩﺩﺍﺯﻪﻟﺎﺧ
ﻪﺠﯿﺘﻧﺭﺩ: ﺐﯿﺗﺮﺗﻦﯾﺪﺑ
ﮎﺭﺍﺪﺗ: ﻥﺩﺮﮐﯽﻓﺮﻌﻣ, ﻩﺪﺷﻪﺋﺍﺭﺍ, ﻩﺎﻓﺭ, ﻊﺿﻭ, ﯽﻨﯿﺑﺶﯿﭘ
ﺖﺑﺎﺑﺯﺍ: ﻩﺭﺎﺑﺭﺩ, ﻪﺟﻮﺗ
ﺪﯿﻨﮐﺏﺎﺨﺘﻧﺍ: ﻥﺩﺮﻛﺏﺎﺨﺘﻧﺍ, ﻦﺘﻓﺮﮔ
ﺏﺍﺮﺧ: ﻦﺘﻓﺭﻦﯿﺑﺯﺍ
ﻪﺋﺍﺭﺍ: ﻥﺩﺍﺩ, ﻥﺩﺮﮐﯽﻓﺮﻌﻣ, ﻝﺎﺳﺭﺍ
ﻪﺒﻗﺮﺘﻣﺮﯿﻏ: ﻥﺩﺮﮐﺮﯿﮕﻠﻓﺎﻏ, ﻩﺭﺎﺒﮑﯾﻪﺑ
ﻪﻌﻟﺎﻄﻣﺰﯿﻣ: ﺰﯿﻣ, ﯼﺭﺍﺩﺍﺮﺘﻓﺩ
ﻪﭼﻮﮐ: ﻂﺧ, ﺪﻧﺎﺑ
ﯽﮔﺪﻨﯾﺎﻤﻧ: ﻩﺪﻨﯾﺎﻤﻧ, ﻝﺎﺜﻣ, ﻦﺘﻔﮔ
ﻡﺍﺮﺘﺣﺍﻞﺑﺎﻗ: ﺭﺎﺨﺘﻓﺍ
ﺱﻭﺮﻋﻩﺯﺎﺗ: ﻢﻧﺎﺧﻩﺩﺍﺰﻫﺎﺷ
ﺖﯿﻟﻮﺌﺴﻣﺱﺎﺴﺣﺍ: ﻪﻔﯿﻇﻭ, ﺶﻧﺯﺮﺳ
ﺪﯿﻣﺍﺎﻧ: ﯽﺒﻠﻃﻩﺎﺟ, ﯼﺪﯿﻣﺍﺎﻧ
ﺐﺳﺎﻨﻣ: ﻥﺪﺷﺎﺟ, ﺖﺳﺭﺩ
ﺩﺭﺍﺩﯽﮕﺘﺴﺑ: ﻥﺍﺮﮐ, ﻪﯿﮑﺗ
ﻝﻮﻏ: ﯽﻟﺎﻋ, ﻻﻮﯿﻫ
ﻢﻬﻓ: ﻥﺩﺮﻛﻙﺭﺩ, ﺭﺎﺸﻓ, ﻥﺪﯿﻤﻬﻓ, ﻥﺩﺮﮐﺐﺣﺎﺼﺗ, ﻢﺸﯾﺮﺑﺍ
ﻥﺪﯿﺳﺭ: ﺎﯿﺑ, ﻦﺘﺳﻮﯿﭘﻉﻮﻗﻭﻪﺑ
ﺰﻴﻳﺎﭘﻞﺼﻓ: ﻁﻮﻘﺳ
ﺐﯾﺎﻏ: ﻡﺪﻋ
ﯽﮕﻨﺗﻝﺩ: ﮏﯾﺭﺎﺗ
ﻥﻮﻨﻈﻣ: ﻥﺰﺑﺱﺪﺣ, ﻥﺩﺮﻛﻚﺷ, ﮎﻮﮑﺸﻣ
ﻦﯿﯿﻌﺗ: ﺺﺨﺸﻣ, ﺵﺭﺍﺰﮔ, ﻒﯾﺮﻌﺗ, ﺪﺼﻗ
ﺱﺎﺳﺍ: ﻪﯾﺎﭘ, ﺕﺎﺣﻼﻄﺻﺍ, ﻥﺩﺮﮐﺖﯾﺎﻤﺣ
ﯽﺳﺭﺮﺑ: ﻥﺩﺮﮐﻩﺪﻫﺎﺸﻣ, ﯽﺳﺭﺮﺑ, ﻞﯿﻠﺤﺗ
ﻩﺰﯾﺎﺟ: ﻩﺰﯾﺎﺟ, ﻪﻤﯿﺑﻖﺣ
ﺪﯾﺮﺧ: ﺪﯾﺮﺧ
ﯽﺴﮐ: ﺺﺨﺷ, ﯽﺴﮐﺮﻫ
ﺖﺴﮑﺷ: ﻢﺘﺷﻭﺏﺮﺿ, ﺖﺴﮑﺷ, ﯼﺪﯿﻣﺍﺎﻧ, ﻦﺗﻭﺮﻓ
ﻪﻧﺎﻘﻤﺣﺍ: ﻖﻤﺣﺍ
ﻥﺍﻮﺧﺍﺮﻓ: ﻥﺩﺭﻭﺁﺩﺎﻳﻪﺑ
ﻝﺎﻐﺘﺷﺍ: ﻪﻓﺮﺣ, ﺰﯿﻣﺁﺖﻧﻮﺸﺧ
ﻦﺨﺳ: ﻥﺭﺪﻣ, ﯽﻧﺍﺮﻨﺨﺳ, ﻪﺒﻄﺧ
ﯼﺭﺎﮑﻤﻫ: ﮏﻤﮐ, ﻥﺩﺮﮐﺖﯾﺎﻤﺣ, ﯼﺭﺎﮑﻤﻫ
ﺵﻭﺮﻓ: ﺝﺍﺮﺣ, ﺵﻭﺮﻓ, ﻒﯿﻔﺨﺗ
ﻪﻣﺎﻧﺕﻮﻋﺩ: ﻥﺩﺯﮓﻧﺯ
ﺖﯾﺍﻭﺭ: ﻥﺎﺘﺳﺍﺩ
ﺖﺴﭘ: ﻦﯿﯾﺎﭘ
ﺺﯿﺨﺸﺗ: ﻥﺪﯿﻤﻬﻓ, ﺺﯿﺨﺸﺗ, ﺺﯿﺨﺸﺗ, ﮎﺭﺩ
ﺮﯾﻮﺼﺗ: ﺮﯾﻮﺼﺗ
ﻥﺩﺭﻭﺁﺩﻮﺟﻭﻪﺑ: ﻞﻌﺟ, ﻥﺩﺍﺩﻢﯿﻤﻌﺗ, ﻥﺩﺮﮐﻩﺩﺎﻣﺁ
ﺩﺎﻀﺗ: ﺎﻨﺜﺘﺳﺍ
ﯼﺪﯿﻣﺍﺎﻧ: ﯼﺪﯿﻣﺍﺎﻧ, ﯽﺒﻠﻃﻩﺎﺟ, ﺝﻭﺍﺩﺎﭘ
ﺖﺧﺎﺳ: ﺎﻨﺑ, ﯼﺭﺎﻤﻌﻣ, ﯼﺪﻨﺑﺐﯿﮐﺮﺗ
ﺐﺼﻌﺗ: ﺖﯾﺎﺿﺭ, ﻥﺎﺠﯿﻫ
ﻝﻮﺌﺴﻣ: ﻪﻔﯿﻇﻭ
ﺖﺒﺜﻣ: ﺖﺒﺜﻣ, ﺪﻨﻔﺳﻮﮔ
ﻥﺎﻣﺭﺩ: ﻥﺎﻣﺭﺩ, ﻥﺩﺍﺩﺖﻴﻤﻫﺍ, ﻥﺩﺮﮐﺮﺘﻬﺑ
ﻞﻣﺎﺷ: ﻪﻠﻤﺟﺯﺍ, ﻥﺪﺷﻞﺧﺍﺩ, ﻞﻣﺎﺷ
ﻥﺩﺮﮐﻊﻧﺎﻗ: ﯽﺿﺍﺭ, ﻖﺑﺎﻄﻣ, ﻦﺘﺧﺎﺳﺎﻫﺭ, ﻥﺩﺮﮐﻒﺸﮐ
ﺞﻧﺭ: ﺦﻠﺗ, ﺩﺭﺩ
ﻖﻤﺣﺍ: ﻞﻬﺟ, ﻖﻤﺣﺍ
ﺕﻼﻏ: ﺕﺭﺫ
ﺕﺬﻟ: ﻥﺎﻣﺭﺩ
ﺎﻘﯿﻗﺩ: ﻩﺪﺷﺮﭘ, ﻞﻣﺎﮐﺭﻮﻄﺑ, ﺍﺪﮐﻮﻣ
ﻢﯿﻨﮐﺽﺮﻓ: ﺪﯿﻨﮐﺽﺮﻓ, ﻪﺟﻮﺗ
ﻥﺩﺯﻦﯿﻤﺨﺗ: ﻥﺰﺑﺱﺪﺣ, ﻝﻮﻗﻞﻘﻧ
ﺮﯿﺴﻣ: ﺮﯿﺴﻣ, ﻪﺸﯾﺭ
ﻥﺎﻤﻬﻣ: ﺮﻓﺎﺴﻣ, ﻥﺎﻤﻬﻣ, ﻩﺪﻨﻨﮐﻩﺪﻫﺎﺸﻣ
ﺮﯿﻏ: ﻪﻧ, ﯽﻧﻮﻧﺎﻗﺮﯿﻏ, ﻥﺍﺭﺎﺑ
ﻢﯿﺳ: ﻂﺧ
ﺐﻠﻏﺍ: ﺹﻮﺼﺨﺑ, ﯼﺩﺎﯾﺯﺪﺣﺎﺗ
ﻩﺎﮔﺁﺩﻮﺧﺎﻧ: ﻦﺘﻓﺭﻝﺎﺣﺯﺍ
ﯽﺟﺭﺎﺧ: ﯽﻧﻭﺮﯿﺑ, ﯽﺟﺭﺎﺧ
ﻥﺎﻬﺟ: ﻥﺎﻬﯿﮐ, ﻥﺎﻬﺟ
ﺖﻋﺎﺳ: ﺱﻮﻗﺎﻧ
ﻞﻤﻌﻟﺍﺭﻮﺘﺳﺩ: ﻞﻤﻌﻟﺍﺭﻮﺘﺳﺩ, ﺖﻬﺟ, ﯼﺎﻤﻨﻫﺍﺭﻪﭽﺑﺎﺘﮐ, ﻥﺩﺮﮐﻪﺘﮑﯾﺩ, ﺕﻼﯿﺼﺤﺗ
ﻢﺧﺯ: ﻢﺧﺯ, ﺭﺎﻤﯿﺑ, ﺩﺭﺩ, ﺭﺎﯿﺴﺑ
ﻦﺘﺧﺎﺳﺭﺩﺎﻗ: ﻪﺑﺭﺩﺎﻗ
ﯽﻓﺮﻌﻣ: ﻥﺩﺮﮐﯽﻓﺮﻌﻣ, ﻩﺪﺷﻪﺋﺍﺭﺍ, ﺮﮔﺯﺎﻏﺁ, ﻥﺩﺮﻛﺩﺭﺍﻭ, ﺶﻘﻧ
ﯽﻣﻭﺭﻢﯾﺪﻗﻡﺍﺭﺩﺖﻤﺴﻗﻦﯿﺘﺴﺨﻧ: 
ﻥﺎﺑﺎﯿﺑ: ﺮﯾﻮﮐ
ﻢﮔﺭﺩﺮﺳ: ﯽﺒﺼﻋ, ﯼﺪﯿﻣﺍﺎﻧ, ﯽﺠﯿﮔ, ﯽﻫﺍﺭﻭﺩ
ﺝﺍﻭﺩﺯﺍﻦﺸﺟ: ﻩﺩﺮﮐﺝﺍﻭﺩﺯﺍ
: 
ﯽﮔﺪﻨﯾﺎﻤﻧ: ﻩﺪﻨﯾﺎﻤﻧ, ﺖﻤﺳ, ﺶﺨﺑ, ﯼﺎﺠﺑ
ﻥﺩﺮﮐﺏﺎﺴﺣﯼﺰﯿﭼﯼﻭﺭ: ﻦﺘﺷﺍﺩﺩﺎﻘﺘﻋﺍ, ﻪﯿﮑﺗ, ﺏﺎﺴﺣ, ﻥﺩﺮﮐﻪﺒﺳﺎﺤﻣ
ﯽﻌﻄﻗﺮﯿﻏ: ﺪﯾﺩﺮﺗ, ﻥﺍﺯﺮﻟ, ﻢﻬﺒﻣ
ﯼﺩﺰﻣﺎﻧ: ﻝﻮﻐﺸﻣ
ﻒﯿﺜﮐ: ﺖﺷﺭﺩ
ﻮﮑﺳ: ﻪﯾﺎﭘ
ﻝﻮﺳﺭ: ﺮﯿﻔﺳ, ﻪﺘﺷﺮﻓ
ﮏﺷﺰﭘ: ﺮﺘﮐﺩ
ﻪﺘﻓﺎﯾﻥﺎﻣﺯﺎﺳ: ﻥﺎﻣﺯﺎﺳ
ﺶﺷﻮﭘ: ﻩﺪﺷﻩﺩﺍﺩﺶﺷﻮﭘ, ﻒﻘﺳ, ﮏﻫﻼﮐ
: 
ﻕﺩﺎﺻ: ﻕﺩﺎﺻ, ﻦﯿﺑﻊﻗﺍﻭ, ﻪﻧﺎﺼﻟﺎﺧ, ﻪﻧﺎﺘﺳﻭﺩ, ﻩﺭﺁ, ﯽﻌﻗﺍﻭ
ﺱﺎﺴﺣﺍ: ﺱﺎﺴﺣﺍ, ﻥﺎﺠﯿﻫ
ﻝﺎﺳﺭﺍ: , ﻝﺎﺳﺭﺍ
ﺹﺎﺧ: ﺹﻮﺼﺨﺑ, ﯽﺻﻮﺼﺧ, ﺱﺎﻨﺷﺭﺎﮐ
ﺖﻔﺳ: ﺖﺨﺳ
ﻥﺩﺮﮐﯽﻫﺍﺮﻤﻫ: ﻖﺑﺎﻄﻣ, ﻥﺩﺮﮐﻝﺎﺒﻧﺩ
ﻩﺮﻤﻧ: ﺖﻣﻼﻋ
ﯽﮕﻨﺳﺮﮔ: ﻪﻨﺳﺮﮔ, ﺯﺁﻭﺹﺮﺣ
ﺏﻮﺒﺤﻣ: ﺏﻮﺒﺤﻣ
ﮎﺮﻤﮔ: ﺖﻨﺳ, ﭻﻨﯾﺍ, ﻪﻔﯿﻇﻭ
ﺭﺍﺮﻗﺮﯿﺛﺎﺗﺖﺤﺗ: ﺱﺎﺴﺣﺍ, ﻦﺘﺷﺍﺬﮔﺮﯿﺛﺎﺗ
ﺭﺎﮑﺷ: ﺪﯿﺻ, ﺕﺭﺎﻏ, ﯽﻧﺎﺑﺮﻗ
ﯽﻘﯿﺳﻮﻣ: ﯽﻘﯿﺳﻮﻣ, ﻥﺍﺩﯽﻘﯿﺳﻮﻣ, ﮏﯿﻧﻮﻣﺭﺎﻫ
ﺶﺨﺒﺘﯾﺎﺿﺭ: ﯼﺭﺎﻤﯿﺑ
ﮏﺤﻀﻣ: ﻞﻬﺟ, ﺭﺍﺩﻩﺪﻨﺧ
ﻕﺭﻭ: ﺬﻏﺎﮐ, ﮒﺮﺑ, ﻩﻭﺰﺟ
ﯽﯾﺍﻮﺳﺭ: ﻡﺮﺷ, ﻦﯿﻫﻮﺗ
ﻞﺻﺍﺭﺩ: ﯼﺩﺎﯾﺯﺪﺣﺎﺗ
ﺩﺰﻣ: ﺖﺧﺍﺩﺮﭘ
ﻊﯿﺳﻭ: ﻦﻬﭘ, ﻖﯿﻤﻋ
ﺖﻏﺍﺮﻓ: ﯽﻣﺮﮔﺮﺳﻭ​​ﺢﯾﺮﻔﺗ, ﯽﻟﺎﺧ, ﻪﺘﺴﺸﻧﺯﺎﺑ, ﺵﺎﺑﻡﻭﺭﺁ
ﻪﻧﺎﭼ: ﺶﯾﺭ, ﻥﺎﻣﺭﺩ
ﺶﺑﺎﺗ: ﮏﺒﺳ, ﺶﺑﺎﺗ, ﻥﺩﺯﻕﺮﺑ
ﺕﺩﺎﺴﺣ: ﺩﻮﺴﺣ
ﻢﺻﺎﺨﺘﻣ: ﻪﻧﺎﺘﺳﻭﺩﺮﯿﻏ, ﻦﻤﺷﺩ
ﻦﻫﺁﻩﺍﺭ: ﻦﻫﺁﻩﺍﺭ, ﺭﺎﻄﻗ
ﺪﻧﻮﭘ: ﺏﺎﺘﮐ
ﯽﻗﺮﺷ: ﻕﺮﺷ
ﺪﻧﻭﺮﻬﺷ: ﯽﻧﺪﻣ
ﺕﺎﯿﺻﻮﺼﺧ: ﺕﺎﻧﺎﮑﻣﺍ
ﺕﺎﺒﺗﺎﮑﻣ: ﻁﺎﺒﺗﺭﺍ
ﻩﺮﯿﺧﺫ: ﻆﻔﺣ, ﺏﺎﺘﮐ
ﺐﯿﺠﻋ: ﺐﻳﺮﻏﻭﺐﻴﺠﻋ
ﺩﺎﻬﻨﺸﯿﭘ: ﺪﻫﺩﯽﻣﺩﺎﻬﻨﺸﯿﭘ
ﮓﺳﺱﺭﺎﭘ: ﺮﺸﻗ, ﺖﺳﻮﭘ
ﺵﺮﯾﺬﭘ: ﯼﺪﻣﺁﺵﻮﺧ, ﻝﻮﺻﻭﻡﻼﻋﺍ, ﺫﺎﺨﺗﺍ, ﺪﯾﺮﺧ
ﺵﻮﺧ: ﺮﯾﺬﭙﻟﺩ, ﺪﻨﯾﺎﺷﻮﺧﺎﻧ, ﺭﺍﺩﻩﺪﻨﺧ
ﯼﺭﺍﺪﯿﺑ: ﺭﺍﺪﯿﺑ
ﻥﺩﺮﻛﻖﻴﻘﺤﺗ: ﻞﯿﻠﺤﺗ, ﻥﺩﺮﮐﻮﺠﺘﺴﺟ
ﻩﺎﺷﺩﺎﭘ: ﺭﻮﺗﺍﺮﭙﻣﺍ, ﻩﺎﺷﺩﺎﭘ
ﺵﻮﭘﻦﺗ: ﻪﭼﺭﺎﭘ, ﻩﺪﯿﺷﻮﭘﺱﺎﺒﻟ
ﯼﺭﺎﻤﯿﺑ: ﯼﺭﺎﻤﯿﺑ, ﺭﺎﻤﯿﺑ
ﻦﺷﻭﺭﺯﻭﺭ: ﮏﺒﺳ, ﺏﺎﺘﻓﺍﺭﻮﻧ
ﯽﺧﻮﺷ: ﻩﺪﻨﺧ
ﺢﯿﺿﻮﺗ: ﺢﯿﺿﻮﺗ, ﺕﺍﺮﻈﻧ
ﺰﻠﻓ: ﻥﺪﯿﺸﮐﻮﺗﺍ, ﯽﻧﺪﻌﻣ
ﻞﺣﻩﺍﺭ: ﻩﺪﺑﺏﺍﻮﺟ
ﻩﺩﺰﻧﺎﺷ: ﺖﺼﺷ
ﺩﻮﺟﻭ: ﺭﺍﺰﺑﺍ, ﺪﺣﺍﻭ, ﺭﻮﻀﺣ, ﻥﺎﻣﺯﺎﺳ, ﺖﮐﺮﺷ
ﮎﺮﺗ: ﻥﺪﺷﺕﺮﭘ, ﮎﺮﺗ, ﻦﺘﻓﺭ, ﻥﺩﻮﺑﻥﺍﺩﺮﮔﺮﺳ
ﯽﺨﻠﺗﻪﺑ: ﺦﻠﺗ
ﺰﯿﻣﺁﺢﻠﺻ: ﻡﺍﺭﺁ
ﺏﺮﻄﻀﻣ: ﺲﭘﺍﻮﻟﺩ, ﻥﺪﻧﺎﺳﺮﺗ
: 
ﮓﻨﻫﺮﻓ: ﯽﮕﻨﻫﺮﻓ, ﻥﺪﻤﺗ
ﻦﻓﻭﺕﻮﻓ: ﻒﯿﻄﻟ, ﻖﻤﺣﺍ, ﯼﺭﺎﮐﺖﺳﺩ, ﯼﺮﮔﻪﻠﯿﺣ, ﺶﯾﺍﺭﺁ
ﻥﻮﺘﺳ: ﯽﻌﻗﺍﻭ
ﯽﻟﺎﻣ: ﻝﻮﭘ
ﯼﺯﺎﺳﻩﺩﺎﻣﺁ: ﻥﺩﺮﮐﻩﺩﺎﻣﺁ, ﻩﺪﻧﺯﺎﺳ, ﯼﺪﻨﺑﻝﻮﻣﺮﻓ
ﯽﺧﻮﺷ: ﯽﻌﺒﻃﺥﻮﺷ
ﻪﺘﺳﻮﭘ: ﺮﺸﻗ, ﺖﺳﻮﭘ
: 
ﻪﻧﻻ: ﻩﺪﻧﺯ, ﺰﯾﺮﭘ
ﺭﻮﺼﺗ: ﯼﺭﺍﺩﺭﺎﺑ, ﺮﮑﻓ, ﻪﻠﻣﺎﺣ
ﺏﺎﺼﺘﻧﺍ: ﻩﺪﻋﻭ
ﯽﺸﮐﺍﻭ: ﻦﺘﻓﺮﮔ, ﻥﺩﺭﻭﺁﺖﺳﺩﻪﺑ, ﻪﺘﻓﺮﮔﺕﺎﺸﻧ, ﮏﯿﺘﮐﺎﺗ
ﻊﻤﺷ: ﮏﺒﺳ, ﭗﻣﻻ
ﻡﺮﺟ: ﻦﯿﻫﻮﺗ, ﻪﻠﻤﺣ
ﻁﻮﻠﺨﻣ: ﻁﻮﻠﺨﻣ
ﻝﺪﻣ: ﻝﺎﺜﻣ
ﺺﻘﻧ: ﺶﻧﺯﺮﺳ, ﮎﻭﺮﭼﻭﻦﯿﭼ, ﯽﻧﺍﻮﺗﺎﻧ
ﻩﺭﺎﺷﺍ: ﺖﺳﮊ
ﺽﺍﺮﺘﻋﺍ: ﺖﻣﻭﺎﻘﻣ
ﺕﺭﺎﻬﻣ: ﻒﯿﻄﻟ, ﻡﺎﻧ, ﯽﺘﺸﮐ
ﯽﻬﺟﻮﺗﯽﺑ: ﻪﮐﻭﺮﺘﻣ, ﻑﺬﺣ, ﻢﯾﺮﺤﺗ, ﯽﮕﻗﻼﻋﯽﺑ
ﺎﻫﻩﺩﺍﺩ: ﺕﺎﻋﻼﻃﺍ
ﺡﻼﺳ: ﻥﺩﺮﮐﺡﻼﺳﻊﻠﺧ, ﮓﻨﻔﺗ
ﯽﺗﺭﻮﺻﮓﻧﺭ: ﺥﺮﺳﻞﮔ
ﮒﺭﺰﺑﺎﺑﺎﺑ: ﺪﺟ, ﻩﺪﺟﺎﯾﺪﺟ
obviative: 
ﺪﻣﺁﺭﺩ: ﺪﻣﺍﺭﺩ, ﻥﺩﺮﻛﺩﺭﺍﻭ, ﻩﺩﺯﺎﺑ
ﺪﯾﺪﺷ: ﺪﯾﺪﺷ
ﻕﺮﺑ: ﮏﯿﻧﻭﺮﺘﮑﻟﺍ, ﭻﯿﭘ, ﻥﺩﺯﻕﺮﺑ
ﺵﺯﺭﻭ: ﻦﯾﺮﻤﺗ
ﺭﺩﻮﭘ: ﺭﺩﻮﭘ, ﮎﺎﺧﻭﺩﺮﮔ, ﮏﺸﺧ
ﯼﺰﯿﻣﺁﮓﻧﺭ: ﺮﯾﻮﺼﺗ
ﺩﺎﯾﺮﻓ: ﺍﺪﺻﻭﺮﺳﺮﭘ, ﺍﺪﺻﻭﺮﺳ, ﻥﺩﺮﮐﻪﯾﺮﮔ
ﻁﺎﯿﺘﺣﺍﯽﺑ: ﺍﻭﺮﭘﯽﺑ, ﯽﮕﻗﻼﻋﯽﺑ
ﻩﺎﮔﺭﺩ: ﺏﺭﺩ
ﺖﺣﺍﺭ: ﯽﻠﻤﻋ, ﯽﻧﺎﺳﺁﻪﺑ, ﻥﺪﺷﺎﺟ
ﻞﯿﻤﯾﺍ: ﺖﺴﭘﻩﺭﺍﺩﺍ, ﻪﻣﺎﻧ
ﮓﻧﺭ: ﮓﻧﺭ
ﻢﯿﻠﺴﺗ: ﺖﻨﺳ
ﺩﺎﺠﯾﺍ: ﻥﺩﺮﮐﯽﻓﺮﻌﻣ, ﺩﺎﺠﯾﺍ
ﻢﯾﻼﻣ: ﻡﺮﻧ, ﯽﺗﺎﺑﺎﺨﺘﻧﺍﻩﺯﻮﺣ, ﻥﺩﺮﮐﻖﯿﻗﺭ
ﮓﻧﺭﺩﯽﺑ: ﺭﺎﺑﮏﯾ
ﺶﺨﺑ: ﺶﺨﺑ, ﺱﻼﮐ
ﻦﺘﺷﺍﺩﻕﺎﻘﺤﺘﺳﺍ: ﺵﺯﺭﺍ, ﻂﯾﺍﺮﺷﺪﺟﺍﻭ
ﮎﺮﺗ: ﻪﮐﻭﺮﺘﻣ, ﮎﺮﺗ, ﺐﻟﺎﻗ, ﻥﺪﺷﻪﺘﺴﺑ, ﺝﻭﺮﺧ, ﺎﻔﻌﺘﺳﺍ
ﻦﯿﻤﻀﺗ: ﻥﺩﺍﺩﻥﺎﻨﯿﻤﻃﺍ, ﺖﻧﺎﻤﺿ, ﻪﯿﮑﺗ, ﻩﺪﻋﻭ
ﻪﻨﯿﯾﺁ: ﻪﺸﯿﺷ
ﺡﺮﻃ: ﺡﺮﻃ, ﻥﺎﺘﺳﺍﺩ
ﻻﺎﺑﻑﺮﻄﺑ: ﻻﺎﺑ, ﺶﯿﺑ
ﯽﺘﺣﺍﺭﺎﻧﺎﺑ: ﻦﯿﮕﻤﻏ, ﻩﺎﻨﮔ
ﻦﺗﻭﺮﻓ: ﻝﻮﻤﻌﻣ, ﻦﺗﻭﺮﻓ
ﺏﺎﻘﺸﺑ: ﻩﺎﮔﺩﺍﺩ, ﺍﺬﻏ, ﻥﺩﺭﻮﺧ, ﻪﺳﺎﮐ
ﯽﻧ: ﻦﻤﭼ
ﺺﻟﺎﺧ: ﺏﻭ
ﺮﺒﺻﯽﺑ: ﺮﺒﺻ
ﯽﻣﺮﮔ: ﻡﺮﮔ
ﺭﺍﺮﻗﻲﺑ: ﺲﭘﺍﻮﻟﺩ, ﻥﺍﺯﺮﻟ, ﺢﻳﺮﻔﺗﮓﻧﺯ
: 
ﻪﺑﺮﺠﺗ: ﻥﺎﺒﻠﺧ, ﻪﺑﺮﺠﺗ, ﻥﺩﺮﻛﺵﻼﺗ
ﻢﯿﻈﻋ: ﮎﺎﻨﺘﺸﺣﻭ, ﯽﻟﺎﻋ, ﺭﺎﯿﺴﺑ
ﺩﻮﺒﻬﺑ: ﺕﺎﺣﻼﺻﺍ, ﯼﺯﺎﺳﺯﺎﺑ, ﻦﺘﻓﺭﺶﯿﭘ, ﻥﺩﺮﮐﺮﺘﻬﺑ
ﻉﺍﺰﻧ: ﻉﺍﺰﻧ, ﻝﺪﺟﻭﺚﺤﺑ
ﻩﺭﺍﺰﮔ: ﻪﻠﻤﺟ, ﺡﺮﻃ, ﺪﻫﺩﯽﻣﺩﺎﻬﻨﺸﯿﭘ
ﺪﯾﺎﺷ: ﺪﯾﺎﺷ, ﺖﺳﺍﻪﺘﺴﻧﺍﻮﺗ
ﮓﻨﻔﺗ: ﮓﻨﻔﺗ
ﺮﭙﺳ: ﺖﻈﻓﺎﺤﻣ
ﻡﺍﺪﺨﺘﺳﺍ: ﺫﺎﺨﺗﺍ, ﻥﺩﺮﮐﻩﺭﺎﺟﺍ, ﻥﺩﺮﮐﻩﺩﺎﻔﺘﺳﺍ, ﻪﻔﯿﻇﻭ
ﻢﯿﻠﻗﺍ: ﻮﺟ
ﻑﻼﺧﺮﺑ: ﻒﻠﺘﺨﻣ, ﻞﺑﺎﻘﻣ
ﻦﺘﻓﺎﯾﺩﻮﺒﻬﺑ: ﯽﯾﻮﺟﻪﻓﺮﺻ, ﺏﻮﺧﺭﺎﻴﺴﺑ, ﺖﺸﮔﺯﺎﺑ
ﺮﺴﻤﻫ: ﻦﻫﺩﺏﺁ, ﮏﯾﺮﺷ, ﺖﺳﻭﺩ
ﻥﺩﺍﺩﺐﯿﺗﺮﺗ: ﺐﯿﺗﺮﺗ, ﻥﺩﺮﮐﯽﻧﻮﻧﺎﻗ, ﺖﯾﺮﯾﺪﻣ
ﻥﻮﯿﺴﯿﻤﮐ: ﻥﻮﯿﺴﯿﻤﮐ
ﻦﺴﻣ: ﯽﻤﯾﺪﻗ, ﻎﻟﺎﺑ
ﺡﻭﺭ: ﺡﻭﺭ
ﻥﺩﺍﺩﺰﯿﻤﺗ: ﮏﯿﮑﻔﺗ, ﻥﺩﺮﮐﺺﺨﺸﻣ, ﻕﺮﻓ, ﺩﺎﻀﺘﻣ, ﻢﻫﺯﺍﺍﺪﺟ, ﻥﺩﺮﮐﺵﺎﻓ
ﻦﺘﺧﺎﻨﺷﺖﯿﻤﺳﺭﻪﺑ: ﻥﺪﯿﻤﻬﻓ, ﺭﺍﺮﻗﺍ, ﺖﯾﻮﻫ, ﮎﺭﺩ
ﺱﺭﮎﺎﺧ: ﻞﮔ, ﻝﺎﺧ, ﯼﺮﮕﻟﺎﻔﺳ
ﻪﻨﺗ: ﻪﻠﯿﺒﻗ, ﻥﺍﺪﻤﭼ, ﻦﯿﺗﻮﭘ, ﯽﻟﺎﻋ
ﺖﯾﺮﯾﺪﻣ: ﺖﯾﺮﯾﺪﻣ, ﯽﮔﺪﻨﻧﺍﺭ
ﻥﺪﻧﺍﺩﺮﮔﺯﺎﺑ: ﻆﻔﺣ, ﺖﺸﮔﺯﺎﺑ
ﺽﺍﺮﺘﻋﺍ: ﻥﺩﺮﮐﺖﻣﻭﺎﻘﻣ, ﺱﺭﺎﻣ, ﺩﺭ, ﺖﻣﻭﺎﻘﻣ
ﻩﺩﻮﺗ: ﻪﻟﺎﺑﺯ, ﻁﺮﺷ, ﻩﺩﻮﺗ, ﺖﯿﻌﻤﺟ
ﻂﺳﻮﺘﻣﺪﺣﺭﺩ: ﻦﺘﺷﺍﺩﺭﻮﻈﻨﻣ, ﻝﻮﻤﻌﻣ
ﻥﺩﺮﮐﯽﺠﻫ: ﻥﻮﺴﻓﺍ, ﯽﺠﻫ, ﯽﮕﺘﺳﻮﯿﭘ, ﺐﯿﺗﺮﺗ
ﻪﻘﻄﻨﻣ: ﻩﺯﻮﺣ, ﯼﺍﻪﻘﻄﻨﻣ, ﺢﻄﺳ
ﯽﻤﺳﺭ: ﯽﻤﺳﺭ, ﯽﻤﺳﺭﺮﯿﻏ
ﺮﮕﺸﯾﺍﺮﯾﻭ: ﻩﺪﻨﺴﯾﻮﻧ, ﺮﺷﺎﻧ, ﺮﯿﺑﺩ
ﻥﺎﻋﺫﺍ: ﺭﺍﺮﻗﺍ, ﺮﮑﺸﺗ
ﻥﺎﻣﺭﺩ: ﻭﺭﺍﺩ, ﻥﺩﺮﮐﺮﺘﻬﺑ, ﻥﺎﻣﺭﺩ
ﻥﺩﺮﮐﻝﺎﺒﻧﺩ: ﻦﺘﺧﺎﺳﺎﻫﺭ, ﺭﻮﺘﯿﻧﺎﻣ, ﻥﺩﺮﮐﻝﺎﺒﻧﺩ
ﺐﻄﻗ: ﻒﺳﺎﺘﻣ, ﯽﺒﻄﻗ, ﻑﺎﻧ, ﺏﻮﭼ
ﯽﺗﺎﯿﺣ: ﻡﺯﻻ, ﻊﻃﺎﻗ, ﺪﯿﻠﮐ, ﺭﺎﺒﮔﺮﻣ
ﺭﻮﻬﻤﺟﺲﯿﺋﺭ: ﺮﺳ, ﺲﻴﺋﺭ
ﺶﺨﺑ: ﻝﺎﺑ, ﯼﺍﻪﻘﻄﻨﻣ, ﺶﺨﺑ
ﻢﻧﺎﺧ: 
ﻥﺩﺮﮐﻖﯾﻮﺸﺗ: ﺐﻠﻗ, ﻥﺩﺮﻛﻖﻳﻮﺸﺗ
ﻦﯿﻧﻮﺧ: ﻥﻮﺧ
ﻩﺪﺷﻞﯾﺪﻌﺗ: ﯽﻘﻄﻨﻣ, ﺖﺳﺭﺩ, ﻪﯿﺟﻮﺗ
ﻥﺩﺮﮐﻦﯿﺴﺤﺗ: ﺶﯾﺎﺘﺳ
ﻩﺩﺮﭘﯽﺑ: ﺍﺮﻫﺎﻇ, ﻦﮐﺯﺎﺑ, ﺡﺎﺘﺘﻓﺍ
: 
ﺡﻼﺻﺍ: ﻥﺩﺍﺩﺮﯿﯿﻐﺗ, ﻕﺎﺒﻄﻧﺍ
ﯽﺸﯾﺎﻤﻧ: ﺍﺪﺻﻭﺮﺳ, ﻡﺍﺭﺩ, ﯽﺸﯾﺎﻤﻧ, ﯼﺮﯿﮕﻤﺸﭼﺭﻮﻃﻪﺑ
ﺎﻫﻪﻠﭘﺯﺍ: ﻻﺎﺑ
ﻉﻮﻨﺘﻣ: ﻒﻠﺘﺨﻣ
ﻝﻭﺰﻧ: ﺖﻌﯿﺒﻃ
ﺕﺩﺎﺴﺣ: ﺩﻮﺴﺣ
ﺭﺎﺑ: ﯼﺭﺍﺩﺭﺎﺑ, ﻪﻠﯿﺒﻗ, ﺭﺎﺑ, ﻦﮐﺯﺎﺑ
ﺮﻫﺎﻈﺗ: ﻥﺩﺮﮐﻞﻌﺟ, ﻡﺍﺭﺩ
ﯽﻠﺧﺍﺩ: ﯽﻠﺧﺍﺩ
ﻩﺩﺮﭘ: ﻪﻧﺎﻧﺯﺭﺩﺎﭼ
ﻢﻟﺎﺳ: ﺖﻣﻼﺳ
ﻢﻬﺒﻣ: ﻢﻬﺒﻣ, ﻪﻧﺎﻓﺮﻃ
ﺰﮐﺮﻣ: ﺰﮐﺮﻣ
ﻥﺍﺯﺭﺍ: ﻢﮐ
ﻪﻘﺑﺎﺴﻣ: ﻪﻘﺑﺎﺴﻣ
ﻥﺩﺍﺩﺮﯿﯿﻐﺗ: ﻞﯾﺪﺒﺗ, ﻥﺩﺍﺩﺮﯿﯿﻐﺗ, ﻥﺩﺮﮐﻦﯾﺰﮕﯾﺎﺟ
ﯽﻟﺎﻤﺟﺍﺮﻈﻧ: ﻩﺎﮕﻧ
ﯼﺭﺎﮐﺩﺍﺩﺭﺍﺮﻗ: ﺖﺷﺍﺩﺩﺎﯾ, ﺐﯿﺗﺮﺗ, ﻦﺘﺷﺍﺩﻪﮕﻧ, ﯼﺭﺎﮑﻤﻫﺩﺍﺩﺭﺍﺮﻗ
ﻥﺩﺮﮐﯽﯾﻮﺟﻪﻓﺮﺻ: ﯽﯾﻮﺟﻪﻓﺮﺻ, ﯼﺯﺎﺳﻩﺮﯿﺧﺫ, ﺩﺎﺼﺘﻗﺍ
ﻪﺘﺷﺭ: ﺏﺎﻨﻃ, ﺮﯿﺠﻧﺯ, ﻢﯿﻈﻨﺗ
ﺐﯿﮐﺮﺗ: ﻁﻮﻠﺨﻣ, ﻢﯿﻈﻨﺗ, ﻥﺩﺯﮓﻧﺯ
ﺕﺭﺍﺮﺣﻪﺟﺭﺩ: ﻡﺮﮔ, ﻩﻮﯿﺟ
ﺖﺨﺳ: ﺍﺪﮐﻮﻣ, ﺰﯿﺗ, ﺖﺨﺳ
ﯽﺼﺼﺨﺗ: ﻪﻓﺮﺣ
ﺡﻭﺮﺠﻣ: ﺡﻭﺮﺠﻣ, ﯽﮔﺪﯾﺩﺐﯿﺳﺁ
ﯽﮕﯾﺎﺴﻤﻫ: ﻑﺍﺮﻃﺍ, ﻩﺪﻧﺯ
ﻥﺪﯿﺸﮐﺭﺎﮕﯿﺳ: ﺩﻭﺩ, ﺭﺎﮕﯿﺳ
ﯽﮑﺷﺰﭘ: ﺮﺘﮐﺩ
ﻥﺩﺮﮐﻩﺎﮔﺁ: ﺕﺎﻋﻼﻃﺍ
ﻪﺘﺴﺟﺮﺑ: ﺪﻨﺴﭘﻪﻣﺎﻋ, ﻲﻧﺪﻧﺎﻣﺩﺎﻳﻪﺑ, ﻢﻬﻣ, ﺪﯿﻠﮐ, ﻡﺎﻨﮑﯿﻧ
ﻪﺴﺳﻮﻣ: ﺖﮐﺮﺷ, ﻥﺎﻣﺯﺎﺳ
ﻩﻭﺪﻧﺍﻭﻢﻏ: ﺦﻠﺗ, ﯽﺘﺨﺑﺪﺑ, ﺩﺭﺩ, ﻪﺠﻨﮑﺷ, ﻒﺳﺎﺘﻣ
ﺺﺨﺸﻣﺭﻮﻃﻪﺑ: ﻦﮐﺯﺎﺑ, ﺍﺮﻫﺎﻇ, ﻑﺎﻔﺷ
ﻦﺘﻓﺮﮔ: ﻥﺩﺮﮐﺮﯿﺳﺍ, ﺖﺷﺍﺩﺯﺎﺑ, ﻦﺘﻓﺮﮔ, ﻥﺩﺮﮐﻊﻄﻗ
: 
ﻥﺍﻭﺍﺮﻓ: ﯽﻓﺎﮐ, ﻦﻬﭘ, ﺖﯿﻌﻤﺟ
ﺏﺍﻮﺧﻕﺎﺗﺍ: ﻕﺎﺗﺍ
ﺎﻓﺮﺻ: ﻂﻘﻓ, ﻞﻣﺎﮐﺭﻮﻄﺑ
ﮎﺮﺘﺸﻣ: ﯽﻌﻤﺟ, ﮏﯾﺮﺷ, ﻁﻮﻠﺨﻣ, ﻥﺩﺯﮓﻧﺯ, ﻞﺑﺎﻘﺘﻣ, ﺪﺤﺘﻣ
ﺪﯿﻨﮐﻪﻌﺟﺍﺮﻣ: ﯽﻋﺎﺟﺭﺍ, ﻥﺪﯾﺩ
ﯽﯾﺎﺳﺎﻨﺷ: ﺖﯾﻮﻫ, ﻥﺪﯿﻤﻬﻓ, ﺺﯿﺨﺸﺗ
ﺖﮑﻤﯿﻧ: ﮏﻧﺎﺑ
ﺕﺎﺠﻧﻭﺩﺍﺪﻣﺍ: ﯽﯾﻮﺟﻪﻓﺮﺻ, ﺕﺎﺠﻧ
ﺪﺣ: ﻥﺍﺮﮐ, ﻥﺩﺮﮐﻩﺎﺗﻮﮐ
ﺭﺎﻈﺘﻧﺍ: ﯽﻨﯿﺑﺶﯿﭘ, ﻪﻧﺎﺘﺨﺒﺷﻮﺧ, ﺪﯿﻣﺍ
: 
ﻪﻣﺎﻧﺮﺑ: ﺡﺮﻃ, ﻪﺴﻠﺟﺭﻮﺘﺳﺩ
ﻉﺍﺮﺘﺧﺍ: ﻥﺩﺮﮐﻉﺍﺮﺘﺧﺍ, ﯼﺭﻭﺁﻮﻧ, ﻥﺩﺮﮐﻮﺠﺘﺴﺟ
ﻮﻧﺎﯿﭘ: 
ﻝﻮﭘﻒﯿﮐ: ﻝﻮﭘﻒﯿﮐ, 
ﯽﻗﺮﺑ: ﮏﯿﻧﻭﺮﺘﮑﻟﺍ
ﻩﺯﺎﺑ: ﺖﻗﻮﻣ, ﺢﻳﺮﻔﺗﮓﻧﺯ
ﺐﯿﻘﻌﺗ: ﺪﯿﺻ
ﻝﺎﻐﺷﺍ: ﻦﺘﻓﺮﮔ, ﻥﺩﺮﮐﺐﺣﺎﺼﺗ
ﺐﺷﺱﺎﺒﻟ: ﺖﮐ, ﻩﺪﯿﺷﻮﭘﺱﺎﺒﻟ, ﺩﺎﺸﮔﻭﺪﻨﻠﺑﺱﺎﺒﻟ
ﻞﻔﻗ: ﻪﻌﻠﻗ
ﻦﯾﺮﺗﻦﯿﯾﺎﭘ: ﻦﯾﺮﺗﺪﺑ, ﻦﯾﺮﺘﻤﮐ
ﮓﻧﺭﺩ: ﻎﯾﺭﺩ, ﯽﻠﯿﻣﯽﺑ, ﻥﺩﺮﻛﻚﺷ, 
ﯼﺩﺎﻬﻨﺸﯿﭘﺡﺮﻃ: ﺪﻫﺩﯽﻣﺩﺎﻬﻨﺸﯿﭘ, ﻪﻠﻤﺟ, ﺡﺮﻃ, ﻪﺠﯿﺘﻧ
ﯽﻟﺎﺤﺷﻮﺧﺎﺑ: ﻝﺎﺤﺷﻮﺧ
ﺐﻗﺎﻌﺘﻣ: ﺪﻌﺑ, ﻊﻗﻮﻣﻥﻭﺍ, ﻥﺩﺮﮐﻝﺎﺒﻧﺩ
ﺏﺮﻄﻀﻣ: ﻥﺍﺯﺮﻟ, ﺪﻨﯾﺎﺷﻮﺧﺎﻧ, ﺲﭘﺍﻮﻟﺩ
ﺶﺸﺧﺭﺩ: ﻥﺩﺯﻕﺮﺑ, ﺏﺎﺘﻓﺍﺭﻮﻧ, ﯽﻧﺎﺘﺴﻬﻟ
ﻩﺎﮕﺘﺳﺩ: ﯽﮑﯿﻧﺎﮑﻣ, ﻦﯿﺷﺎﻣ, ﻡﺰﯿﻧﺎﮑﻣ
ﺏﺍﺬﺟ: ﺖﺴﻫﺐﻟﺎﺟ, ﯽﺴﯿﻃﺎﻨﻐﻣ, ﺏﻮﻠﻄﻣ
ﻝﻮﺼﺤﻣ: ﺕﻻﻮﺼﺤﻣ, ﻥﺩﺮﮐﺪﯿﻟﻮﺗ
ﯼﺩﺎﺼﺘﻗﺍ: ﺩﺎﺼﺘﻗﺍ, ﺮﺼﺘﺨﻣ
ﯼﺭﺎﻤﯿﺑ: ﯼﺭﺎﻤﯿﺑ, ﺭﺎﻤﯿﺑ
ﺭﻮﺗﻮﻣ: ﺭﻮﺗﻮﻣ, ﻦﯿﺷﺎﻣ
ﯽﻧﺎﻣﺩﻮﺧ: ﺎﻬﻧﺁ
ﻡﺮﭼ: ﺖﺳﻮﭘ
ﺐﯿﺷ: ﻞﯾﺎﻣ, ﺐﯿﺷ, ﻩﺪﺷﻢﺧ
ﻥﺩﻮﺑﻥﺍﺮﮕﻧ: ﺲﭘﺍﻮﻟﺩ, ﯽﮕﺘﻔﯿﺷ, ﻥﺩﺍﺩﺖﻴﻤﻫﺍ
ﺖﻧﻮﺸﺧ: ﺖﺨﺳ
: 
ﻩﺪﺷﻦﯿﯿﻌﺗ: ﺺﺨﺸﻣ, ﯽﻤﺳﺍ
ﺏﻮﭼ: ﺏﻮﭼ, ﺖﺧﺭﺩ
ﻥﺩﺮﻛﺏﺎﺴﺣ: ﺏﺎﺴﺣ
ﻞﺘﻗ: ﻦﺘﺸﮐ
ﺭﺍﺩﻩﺪﻨﺧ: ﺐﻳﺮﻏﻭﺐﻴﺠﻋ, ﺭﺍﺩﻩﺪﻨﺧ
ﻥﺩﺮﻛﻦﻴﻫﻮﺗ: ﻦﯿﻫﻮﺗ, ﺮﯿﻘﺤﺗ, ﻡﺮﺷ
ﯽﮔﺪﻨﯾﺎﻤﻧ: ﻥﺎﯿﺑ, ﺖﺷﺍﺩﺩﺎﯾ
ﻥﺍﻮﺗﺎﻧ: ﻪﺑﺭﺩﺎﻗ
ﻥﺩﺭﻮﺧﺭﺎﻫﺎﻧ: ﻥﺩﺭﻮﺧ, ﺍﺬﻏ, ﺭﺎﻫﺎﻧ
ﺱﺎﺴﺣ: ﺱﺎﺴﺣ, ﺪﯿﻠﮐ
ﺎﻬﺘﺷﺍ: ﻦﺘﺷﺍﺩﻞﻳﺎﻤﺗ, ﺯﺁﻭﺹﺮﺣ
ﻊﺿﺍﻮﺗ: ﺏﺩﺍﺎﺑ, ﺭﺎﺨﺘﻓﺍ
ﻩﺮﮐ: ﻩﺯﻮﺣ, ﭖﻮﺗ, ﯼﺍﻪﻘﻄﻨﻣ, ﺩﺮﮔ
ﯽﻠﯿﻠﺠﺗ: ﺭﺎﺨﺘﻓﺍ
ﻩﺎﻨﮔ: ﺭﺎﮑﻫﺎﻨﮔ, ﺶﻧﺯﺮﺳ, ﻩﺎﻨﮔ
ﺬﯾﺬﻟ-ﻩﺰﻤﺷﻮﺧ: ﻢﻌﻃﺵﻮﺧ, ﻢﻌﻃ
ﮎﺩﻮﮐ: ﭖﻮﺗ
ﻡﺪﻨﮔﻪﺷﻮﺧ: ﻪﻣﺎﻋﮓﻨﻫﺮﻓ, ﺕﺭﺫ, ﻱﺍﻩﻮﻬﻗ, ﻪﻧﺎﺧﺭﺎﮐ
ﯽﻌﺒﻃﺥﻮﺷ: ﯽﻌﺒﻃﺥﻮﺷ
ﺩﺭﻮﺧﺮﺑ: ﻪﻠﺑﺎﻘﻣ, ﺦﯾﺭﺎﺗ
ﺶﯿﻣﻭﮒﺮﮔ: ﻡﺩﻩﺪﯿﭙﺳ
ﮎﺭﺎﭘ: ﻍﺎﺑ
ﻥﺩﺮﮐﺖﻣﻮﮑﺣ: ﺖﯾﺮﯾﺪﻣ, ﻥﻮﻧﺎﻗ, ﺩﺎﺘﺳﺍ, ﻩﺪﺷﻩﺩﺍﺩﺶﺷﻮﭘ
ﻞﯿﮑﺸﺗ: ﺕﻼﯿﺼﺤﺗ, ﻞﻌﺟ, ﯼﺪﻨﺑﻝﻮﻣﺮﻓ, ﯼﺪﻨﺑﺐﯿﮐﺮﺗ, ﺩﺎﺠﯾﺍ, ﻥﺩﺮﮐﺪﯿﻟﻮﺗ
ﺮﻏﻻ: ﻞﯾﺎﻣ, ﯼﺮﺒﻫﺭ
ﻩﺭﺎﻗ: ﯼﺎﻫﺭﺎﻗ, ﻢﺠﺣ
ﻥﺩﺯﺭﺩ: ﻎﯾﺭﺩ, ﻢﺘﺷﻭﺏﺮﺿ, ﮏﯿﻠﮐ
ﺕﺪﺣﻭ: ﺪﺤﺘﻣ, ﺪﺣﺍﻭ, ﯽﮕﺘﺴﺒﻤﻫ
ﮒﺭﺰﺑ: ﻡﺎﮕﺸﯿﭘ, ﺪﯿﻠﮐ, ﻦﯾﺪﻟﺍﻭ, ﯽﻟﺎﻋ, ﯽﻠﺻﺍ, ﯽﻠﺧﺍﺩ
ﯽﺗﺎﻣﺪﻘﻣ: ﺡﺎﺘﺘﻓﺍ
ﻝﻮﻠﺳ: ﻪﺘﺴﻫ, ﻩﺍﺮﻤﻫﻦﻔﻠﺗ, ﻞﺒﻬﻣ, ﻦﯿﺑﺎﮐ
ﺯﺮﻣ: ﻥﺍﺮﮐ, ﻪﺒﻟ
ﻥﺪﯿﺸﮐﺲﻔﻧ: ﺲﻔﻧ
ﻑﺎﻌﻣ: ﻥﺩﺮﮐﺩﺍﺯﺁ, ﻥﺩﺮﮐﻪﺋﺮﺒﺗ, ﺶﺨﺒﺑ, ﺎﻨﺜﺘﺳﺍ
ﺪﻨﻤﺗﻭﺮﺛ: ﺪﻨﻤﺗﻭﺮﺛ
ﺲﮐﺮﻫ: ﻪﻤﻫ, ﯽﺴﮐﺮﻫ
ﻥﺍﻭﺍﺮﻓ: ﺪﻨﻤﺗﻭﺮﺛ, ﺭﺎﯿﺴﺑ
ﺵﺎﻘﻧ: ﺪﻨﻣﺮﻨﻫ
ﮏﻨﯿﻋ: ﻪﺸﯿﺷ
ﯼﺯﺍﺪﻧﺍﺮﯿﺗ: ﺲﮑﻋ, ﺪﯿﺻ
ﻦﮔﺍﻭ: ﺭﺎﻄﻗ, ﯽﻗﺮﺑﻦﮔﺍﻭ, ﯽﻧﻮﮑﺴﻣﻥﺎﻤﺗﺭﺎﭘﺁ
ﻥﺩﺍﺩﺽﺮﻗ: ﻥﺩﺍﺩ, ﺭﺎﺒﺘﻋﺍ, ﻝﻮﻗﻞﻘﻧ
ﻦﺘﻓﺮﮔﻩﺪﻬﻌﺑ: ﻉﻭﺮﺷ, ﻡﺎﺠﻧﺍ
ﻥﻮﯿﻧﺎﺣﻭﺭ: ﺶﯿﺸﮐ
ﻩﻮﮐ: ﻥﺩﺮﮐﺐﺼﻧ, ﻥﺩﺍﺩﺶﯾﺍﺰﻓﺍ, ﻪﭙﺗ, ﺪﯿﺳﺍ
ﻪﯾﺍﺭﺁ: ﻢﯿﻈﻨﺗ, ﺐﯿﺗﺮﺗ, ﺖﺸﮕﯾﺎﺟ, ﻦﯿﭼ
ﻪﻠﺠﻣ: ﺕﺎﻋﻮﺒﻄﻣ, ﻪﻧﺎﯿﻫﺎﻣ
: 
ﻦﺸﺧ: ﺖﺨﺳ, ﺍﺪﮐﻮﻣ, ﺏﺩﺍﯽﺑ
ﺭﺎﺸﻓ: ﺭﺎﺸﻓ, ﻥﺩﺮﻛﻖﻳﻮﺸﺗ, ﺕﺎﻋﻮﺒﻄﻣ
ﮓﻨﺗ: ﮏﯾﺭﺎﺑ, ﺍﺪﮐﻮﻣ, ﺖﺨﺳ
: 
ﻥﺩﺮﮐﮎﺮﺗ: ﻪﮐﻭﺮﺘﻣ
ﻩﺪﻤﻋﺭﻮﻃﻪﺑ: ﺹﻮﺼﺨﺑ, ﯼﺩﺎﯾﺯﺪﺣﺎﺗ
ﺭﺍﺩﺎﻓﻭ: ﯼﺭﺍﺩﺎﻓﻭ, ﻕﺩﺎﺻ, ﻥﺎﻤﯾﺍﺎﺑ, ﯽﻟﻮﺘﻣ
ﺐﺳﺎﻨﻣ: ﻪﻧﺎﺘﺳﻭﺩ, ﻥﺪﺷﺎﺟ, ﻪﻨﯿﻬﺑ
ﻪﯿﺻﻮﺗ: ﺖﺤﯿﺼﻧ
ﺮﻤﮐﺭﻭﺩ: ﮏﯿﺘﻧﺎﻣﻭﺭ
ﺕﺎﺒﺛﺎﺑ: ﺖﺑﺎﺛ, ﺩﺎﺠﯾﺍ, ﺺﺨﺸﻣ
ﺐﮑﺗﺮﻣ: ﻩﺪﻋﻭ, ﻡﺎﺠﻧﺍ, ﮎﻭﺮﭼﻭﻦﯿﭼ, ﻩﺎﻨﮔ
ﺩﺭﺍﺬﮔﯽﻣﺮﯿﺛﺎﺗ: ﺮﺛﺍ, ﻦﺘﺷﺍﺬﮔﺮﯿﺛﺎﺗ
ﺖﯿﻤﻫﺍ: ﺖﯿﻤﻫﺍ
ﯽﻧﺎﻘﻫﺩ: ﺭﺍﺩﻪﻋﺭﺰﻣ
ﯽﻬﺟﻮﺗﻞﺑﺎﻗﺭﻮﻄﺑ: ﺭﺎﯿﺴﺑ, ﻢﻬﻣ, ﯽﻓﺎﮐ
ﻥﺩﺮﻛﺪﻳﺪﻤﺗ: ﻥﺩﺍﺩﺭﺎﺸﺘﻧﺍ, ﻥﺩﺮﮐﻦﻬﭘ, ﻂﺴﺑ
ﺎﺼﺨﺷ: ﻪﻧﺎﮔﺍﺪﺟﺭﻮﻃﻪﺑ, ﯽﺻﻮﺼﺧ, ﺩﻮﺧ, ﺺﺨﺷ
ﻕﻼﺧﺍ: ﯽﻗﻼﺧﺍ
ﺵﺭﻮﺷ: ﯽﺷﺭﻮﺷ, ﺏﻼﻘﻧﺍ
ﺦﻧ: ﻂﺧ
ﻥﺍﻮﻠﻣ: ﮏﻤﻧ
ﺦﺳﺎﭘ: ﻞﻤﻌﻟﺍﺲﻜﻋ, ﻩﺪﺑﺏﺍﻮﺟ
ﯼﺭﻮﺗﺍﺮﭙﻣﺍ: ﯽﺘﻨﻄﻠﺳ
ﯽﻟﺎﺧﯼﺎﺟ: ﯽﻟﺎﺧ, ﯽﻟﺎﺧﻮﺗ, ﺪﯿﻔﺳ
ﯽﺋﺰﺟ: ﻡﻭﺩ, ﯽﻤﮐﺭﺍﺪﻘﻣ, ﺶﯿﺧ, ﯽﺷﻭﺮﻓﻩﺩﺮﺧ
: 
ﻪﻠﻣﺎﻌﻣ: ﺕﺭﺎﺠﺗ, ﺖﺒﺳﺎﻨﻣ, ﯼﺭﺎﮑﻤﻫﺩﺍﺩﺭﺍﺮﻗ
ﯽﮕﺘﺴﺧ: ﻪﺘﺴﺧ
ﻦﺘﺷﺍﺪﻧﺖﺳﻭﺩ: ﺮﯿﻘﺤﺗ, ﺕﺮﻔﻧ, ﯽﻠﯿﻣﯽﺑ
ﯽﻌﯿﺒﻃ: ﻝﻮﻤﻌﻣ
ﺡﺮﻃ: ﯽﻠﮐﺡﺮﻃ, ﺡﺮﻃ, ﺶﯾﺎﻤﻧ
ﻝﺎﺣﺮﻫﻪﺑ: ﻼﺒﻗ
ﻩﺪﻨﻧﺍﺭ: ﻥﺎﮔﺪﻨﻧﺍﺭ, ﯽﮔﺪﻨﻧﺍﺭ, ﺮﺘﺴﮐﺭﺍﺮﺒﻫﺭ, ﻥﺎﺒﻠﺧ
ﻡﻼﻋﺍ: ﺩﻼﯿﻣﺯﺍﺪﻌﺑ
ﺖﯿﺼﺨﺷ: ﺺﺨﺷ
ﺩﺍﺯﺎﻣ: ﯽﻓﺎﺿﺍ, ﯽﮕﻧﻭﺰﻓﺍ
ﯽﯾﺍﺪﺟ: ﺱﻼﮐ, ﻪﻠﺻﺎﻓ, ﻢﻫﺯﺍﺍﺪﺟ
ﺭﺎﺟﺰﻧﺍ: ﺮﯿﻘﺤﺗ
ﻥﺩﺍﺩﻡﺎﺠﻧﺍ: ﻥﺪﯿﻤﻬﻓ, ﻥﺩﺭﻭﺁﺖﺳﺩﻪﺑ, ﻪﻠﺑﺎﻘﻣ, ﻩﺪﺷﺮﭘ
ﯽﺘﺳﺭﺩ: ﺮﺑﺍﺮﺑ
ﺖﯿﻌﻤﺟ: ﺖﯿﻌﻤﺟ
ﯼﺭﻭﺮﺿﺮﯿﻏ: ﯽﻨﺘﺨﯾﺭﺭﻭﺩ, ﺪﯾﺎﺑ
ﺰﺧ: ﺖﺳﻮﭘ, ﺖﮐ
ﻡﺍﺮﺘﺣﺍ: ﻥﺩﺮﮐﻩﺭﺎﺟﺍ
ﻥﺩﺮﺑﻦﯿﺑﺯﺍ: ﻥﺩﺮﮐﻪﺋﺮﺒﺗ, ﺶﺨﺒﺑ, ﻥﺩﺮﮐﻞﯿﻬﺴﺗ, ﻥﺩﺮﮐﻦﯾﺰﮕﯾﺎﺟ, ﺵﺎﺑﻡﻭﺭﺁ
ﻥﻮﻧﺎﻗ: ﻥﺩﺮﮐﯽﻧﻮﻧﺎﻗ, ﻥﻮﻧﺎﻗ, ﻪﻨﻨﻘﻣﻩﻮﻗ
ﻩﮊﻭﺮﭘ: ﺡﺮﻃ
ﺮﻇﺎﻨﺘﻣ: ﻪﯿﺒﺷ, ﻪﺟﻮﺗ, ﻥﺪﺷﺎﺟ
ﯼﺮﭘﻭﻦﺟ: ﻪﺘﺷﺮﻓ
ﻦﺘﻓﺮﮔﻪﺠﯿﺘﻧ: ﻦﺘﺷﺍﺩﻪﮕﻧ, ﻪﺠﯿﺘﻧ
ﺲﻧﺎﺷﺵﻮﺧ: ﺲﻧﺎﺷ, ﻝﺎﺤﺷﻮﺧ
ﻥﺩﺮﮐﭗﻠﺷﭗﻠﺷ: ﻮﻧﺍﺯ, ﺩﺮﮔ, ﺫﺎﺨﺗﺍ
ﺱﺍﺮﻟﺍﻂﺧ: ﻪﻠﻗ, ﺕﺍﺮﻘﻓﻥﻮﺘﺳ
ﻥﺩﺮﺑﻦﯿﺑﺯﺍ: ﺕﺭﺎﻏ, ﯽﻫﺎﺒﺗ, ﻥﺩﺮﮐﻪﻄﺴﻔﺳ
ﻝﻮﺌﺴﻣ: ﯽﻧﺎﺳﺁﻪﺑ, ﻞﯾﺎﻤﺗ, ﺱﺎﺴﺣ
ﺮﮑﻔﺘﻣ: ﺲﭘﺍﻮﻟﺩ, ﺎﻧﺍﺩ
ﺏﻮﻠﻄﻣ: ﻪﻧﺎﺘﺳﻭﺩ, ﺮﯾﺬﭙﻟﺩ, ﻥﺩﺮﮐﻢﺧ, ﺏﻮﻠﻄﻣ, ﻪﻨﯿﻬﺑ, ﺪﯿﯾﺎﺗ
ﻊﻠﻗ: ﮏﻧﺎﺑ
ﻪﺘﺴﺑﺍﻭ: ﺩﺎﺘﻌﻣ, ﻪﺘﺴﺑﺍﻭ, ﺪﻨﻣﺭﺎﮐ, ﻪﯿﮑﺗ
ﻢﮑﺣ: ﻥﺩﺍﺩﻥﺎﻨﯿﻤﻃﺍ, ﻪﯿﺟﻮﺗ, ﺖﺷﺍﺩﺩﺎﯾ
ﺖﯾﺎﮑﺷ: ﻥﺩﺮﻛﺖﻳﺎﻜﺷ, ﺪﯿﻔﺳ
ﺩﺍﺩﺭﺍﺮﻗ: ﺖﺷﺍﺩﺩﺎﯾ, ﯼﺭﺎﮑﻤﻫﺩﺍﺩﺭﺍﺮﻗ, ﻪﻠﻗ
ﻪﯾﻭﺍﺯ: ﻪﺷﻮﮔ, ﯽﻌﻠﺿﺪﻨﭼ, ﻪﯾﻭﺍﺯ, ﻦﻬﭘ
ﻩﺩﺮﺘﺴﮔﺭﻮﻃﻪﺑ: ﺭﺎﯿﺴﺑ, ﯼﺩﺎﯾﺯﺪﺣﺎﺗ, ﻦﻬﭘ
ﻭﺎﮔ: ﻭﺎﮔ
ﺐﺼﻌﺗ: ﺕﺮﻔﻧ, ﺐﺼﻌﺗ, ﺮﺒﯿﻓ
ﻩﺪﻨﻨﮐﺮﯿﮕﻠﻓﺎﻏ: ﺐﻳﺮﻏﻭﺐﻴﺠﻋ, ﻥﺩﺮﮐﺕﺎﻣ, ﻥﺩﺮﮐﺮﯿﮕﻠﻓﺎﻏ, ﻪﺟﻮﺗﻞﺑﺎﻗ
ﺐﺳﺎﻨﻣ: ﻥﺪﺷﺎﺟ, ﺖﺳﺭﺩ
ﻦﺌﻤﻄﻣ: ﺖﻋﺎﺠﺷ, ﺮﻄﺧﯽﺑ, ﻦﺘﺷﺍﺩﺩﺎﻘﺘﻋﺍ, ﯽﻌﻗﺍﻭ, ﻩﺭﻭﺩ
ﻮﻀﻋ: ﺭﺍﺰﺑﺍ, ﻮﻀﻋ, ﻥﺪﺑ
ﺏﺎﺨﺘﻧﺍ: ﻥﺩﺮﻛﺏﺎﺨﺘﻧﺍ, ﻪﻨﯾﺰﮔ, ﺏﺎﺨﺘﻧﺍ, ﺢﺷﺮﺗ
ﺖﺒﯿﻫ: ﺱﺮﺗ
: 
ﻥﺩﺮﻛﻪﺴﻳﺎﻘﻣ: ﻪﺴﯾﺎﻘﻣ
ﻁﺎﺒﺗﺭﺍ: ﺏﻼﻗ, ﻁﺎﺒﺗﺭﺍ, ﻪﺟﻮﺗ, ﻦﺘﻔﮔ
ﺽﺮﻓ: ﻦﺘﺷﺍﺩﺩﺎﻘﺘﻋﺍ, ﻥﺰﺑﺱﺪﺣ, ﺪﯿﻨﮐﺽﺮﻓ, ﻪﺟﻮﺗ
ﻢﮔ: ﻩﺪﺷﺽﺮﻘﻨﻣ, ﻩﺪﺷﻢﮐ
ﺯﻭﺭﺪﻣ: ﺵﻭﺭ, ﻥﺭﺪﻣ, ﺎﺒﯾﺯ
ﻥﺪﺷﻢﺣﺍﺰﻣ: ﯽﺒﺼﻋ, ﺰﯿﻣﺁﺖﻧﻮﺸﺧ, ﻥﺩﺮﮐﻪﻠﺧﺍﺪﻣ, ﻊﻧﺎﻣ, ﯽﺠﯿﮔ
ﻦﻤﺠﻧﺍ: ﯽﮕﺘﺳﻮﯿﭘ, ﻪﺟﻮﺗ, ﻥﺎﻣﺯﺎﺳ
ﻩﺩﺍﺯﺮﻫﺍﻮﺧ: ﺭﺩﺍﺮﺑﺎﯾﺮﻫﺍﻮﺧﺮﺴﭘ, ﻩﻮﻧ
ﯽﻧﺪﺑ: ﻥﺪﺑ
ﻩﺪﮑﺸﻧﺍﺩ: ﺞﻟﺎﮐ, ﻞﯾﺭﻮﺘﮐﺎﻓ
ﻩﺩﺰﯿﺳ: ﯽﺳ
ﯽﻧﺍﺮﯿﺘﺸﮐ: ﯽﺘﺸﮐ, ﻪﻧﺎﻧﺯﺭﺩﺎﭼ
ﺪﻨﻤﺷﻮﻫ: ﺎﻧﺍﺩ
ﺩﺮﺧ: ﻪﻘﻠﺣ, ﯽﻬﯾﺪﺑ, ﯽﻤﮐﺭﺍﺪﻘﻣ
ﻁﺎﯿﺘﺣﺍ: ﺭﺍﺪﺸﻫ, ﻥﺩﺍﺩﺖﻴﻤﻫﺍ
ﻮﺠﮕﻨﺟ: ﻥﺎﻣﺮﻬﻗ
ﻊﯾﺎﻣ: ﺏﺍ
ﻡﻮﻬﻔﻣ: ﯽﮐﺍﺭﺩﺍ, ﺱﺎﺴﺣﺍ
ﻩﮋﻳﻭﻪﺑ: ﺹﻮﺼﺨﺑ
ﺵﺮﭘ: ﺯﺍﻭﺮﭘ, ﺺﻗﺭ, ﯽﯾﻮﮔﻑﺍﺰﮔ
ﻞﯿﻣﯽﺑ: ﺪﺼﻗ, ﻥﺩﺮﮐﻩﺩﺎﻣﺁ
ﯽﻓﺎﺿﺍ: ﯽﻓﺎﺿﺍ
ﺮﯿﻗ: ﻭﺭﻩﺩﺎﻴﭘ, ﻦﺤﻟ, ﻪﻧ
ﺎﭘﻭﺖﺳﺩﯽﺑ: ﺐﻳﺮﻏﻭﺐﻴﺠﻋ
ﯽﻧﺍﺩﺭﺪﻗ: ﺮﮑﺸﺗ
ﻥﺍﺭﻭﺍﺩﺖﺌﯿﻫ: ﯽﺿﺎﻗ
ﻥﺪﻧﺎﻣﻩﺪﻧﺯ: ﻩﺪﻧﺯ
ﺎﻨﯿﻋ: ﯽﻈﻔﻠﻟﺍﺖﺤﺗ
ﻪﺻﻼﺧﺕﺭﻮﺻﻪﺑ: ﺮﺼﺘﺨﻣ, ﯽﻧﺎﺳﺁﻪﺑ
ﺩﺮﻣ: ﺺﺨﺷ
ﯽﻨﭘ: ﻪﮑﺳ
ﺫﺎﺨﺗﺍ: ﺫﺎﺨﺗﺍ, ﺪﯿﯾﺎﺗ, ﺪﯿﻨﮐﺽﺮﻓ, ﻦﺘﻓﺮﮔ
ﺐﺗﺮﻣﺭﻮﻃﻪﺑ: ﻊﻗﺍﻮﻣﺮﺘﺸﯿﺑ, ﺖﺑﺎﺛ, ﺭﺮﮑﻣ
ﯽﺳﺭﺮﺑﻭﻖﯿﻘﺤﺗ: ﻥﺩﺮﮐﻮﺠﺘﺴﺟ
ﻪﻃﻭﺮﺸﻣ: ﻲﺳﺎﺳﺍﻥﻮﻧﺎﻗ
ﻦﯾﺮﺧﺁ: ﻪﺘﺷﺬﮔ, ﺕﻭﺍﺮﻃﺎﺑ
ﺩﺮﮔﺎﺷ: ﻮﺠﺸﻧﺍﺩ
ﻼﻣﺎﮐ: ﻼﻣﺎﮐ, ﻞﻣﺎﮐﺭﻮﻄﺑ, ﻩﺪﺷﺮﭘ, ﺖﺒﺜﻣ
ﻩﺩﺭﻮﺧﭻﯿﭘ: ﻩﺪﺷﻢﺧ
: 
ﻦﺘﺷﺍﺩﺕﻭﺎﻔﺗ: ﻒﻠﺘﺨﻣ, ﻢﻫﺯﺍﺍﺪﺟ, ﻕﺮﻓ, ﻪﻧﺎﮔﺍﺪﺟﺭﻮﻃﻪﺑ
ﻪﻌﺟﺎﻓ: ﯽﻫﺎﺒﺗ, ﯽﮕﻧﻭﺭﺍﻭ
ﻁﺮﺷ: ﻁﺮﺷ, ﺖﯿﻌﺿﻭ, ﯼﺯﺎﺑﺶﺗﺁ
ﯼﺎﻫﺭﻭﺩ: ﻥﺩﺍﺩ
ﻡﺎﺧ: ﻩﺪﻧﺯ, ﺖﺷﺭﺩ, ﺰﺒﺳ, ﻮﻣﻥﻭﺪﺑ
ﻢﺘﺴﯿﺳﻪﺑﺩﻭﺭﻭ: ﻥﺪﺷﻞﺧﺍﺩ, ﻂﺒﺿ, ﺩﻭﺭﻭ
ﻱﺯﺍﻮﻧﻥﺎﻤﻬﻣ: ﯽﻣﺮﮔﺮﺳﻭ​​ﺢﯾﺮﻔﺗ
ﯼﺭﺎﮔ: ﺭﺎﻄﻗ, ﻪﯿﻠﻘﻧﻪﻠﯿﺳﻭ, ﯽﻗﺮﺑﻦﮔﺍﻭ
: 
ﻥﺩﺮﮐﻝﻮﻐﺸﻣ: ﻪﺘﺴﺑﺍﻭ, ﻥﺩﺮﮐﻩﺩﺎﻔﺘﺳﺍ, ﻥﺩﺮﮐﻩﺭﺎﺟﺍ, ﻆﻔﺣ, ﻞﻣﺎﺷ, ﻝﻮﻐﺸﻣ
ﻪﻠﮔ: ﻪﻠﮔ, ﻪﻣﺪﺧ, ﺖﯿﻌﻤﺟ
: 
ﯼﺭﻭﺁﻊﻤﺟ: ﻥﺩﺮﮐﻊﻤﺟ, ﯼﺭﻭﺁﺩﺮﮔ
ﻪﺑﺎﺗﯽﻫﺎﻣ: ﻥﺍﺪﻠﮔ, ﻥﺎﻧ
ﺍﺮﭘﺍ: 
ﻪﻠﻤﺣ: ﻪﻠﻤﺣ
ﻥﺩﺍﺩﺐﯾﺮﻓ: ﻖﻤﺣﺍ, ﻍﻭﺭﺩ
ﯼﺭﺍﺩﺍﺰﻋ: ﻒﺳﺎﺘﻣ
: 
ﺐﯾﻮﺼﺗ: ﺪﯿﯾﺎﺗ, ﺫﺎﺨﺗﺍ, ﺪﯿﺠﻤﺗﻭﻖﯾﻮﺸﺗ, ﻩﺯﺎﺟﺍ
ﻥﺪﯿﺸﮐﺭﺎﻨﮐ: ﻦﺘﺷﺍﺩﺮﺑ, ﺖﺴﻫﺐﻟﺎﺟ, ﻪﺘﺴﺸﻧﺯﺎﺑ, ﺖﺸﮔﺯﺎﺑ
ﮓﻨﻫﺍ: ﻪﻧﺍﺮﺗ, ﯽﻧﻮﻣﺭﺎﻫ
ﺖﻘﻔﺷ: ﯼﺩﺭﺪﻤﻫﺯﺍﺮﺑﺍ
ﻥﺩﺮﮐﺖﻧﺎﯿﺧ: ﺵﻭﺮﻓ
ﻥﺩﺮﮐﻥﺎﻬﻨﭘ: ﻥﺩﺮﮐﯽﻔﺨﻣ
ﯽﺴﯾﻮﻧﻭﺭ: ﻪﺨﺴﻧ, ﻖﺘﺸﻣ
ﺪﻨﺳ: ﻞﯾﺎﻓ, ﯼﺎﻤﻨﻫﺍﺭﻪﭽﺑﺎﺘﮐ
ﻪﯾﺎﺴﻤﻫ: ﻑﺍﺮﻃﺍ, ﮏﯾﺩﺰﻧ
ﻥﺩﺮﮐﻪﯿﺒﻨﺗ: ﻪﻠﻤﺟ
ﻥﺩﺮﮐﺩﻭﺪﺴﻣ: ﻩﺩﻮﺗ, ﻥﺩﺮﮐﯼﺮﯿﮔﻮﻠﺟ, ﻢﺠﺣ, ﻊﻧﺎﻣ, ﻩﺎﯿﺳ
ﺪﻬﻌﺗ: ﻪﻔﯿﻇﻭ
ﺶﻫﺎﮐ: ﻁﻮﻘﺳ, ﺐﯿﺷ, ﯽﮔﺪﯿﺳﻮﭘ
ﺐﻠﻃﻩﺎﺟ: ﯽﺒﻠﻃﻩﺎﺟ
ﻞﯿﻄﻌﺗﺯﻭﺭ: ﺕﻼﯿﻄﻌﺗ, ﻦﺸﺟ
ﺏﺎﻘﻋ: ﻦﯿﻫﺎﺷ, ﺕﺍﻭﺍﺮﮐ
ﺰﯿﻣﺁﺭﺎﺨﺘﻓﺍ: ﺭﺎﺨﺘﻓﺍ
ﻪﺟﻮﺗﻞﺑﺎﻗ: ﻡﺯﻻ, ﻢﻬﻣ, ﻪﺟﻮﺗﻞﺑﺎﻗ
ﻊﺑﺍﻮﺗ: ﺕﺎﻧﺎﮑﻣﺍ
ﻢﮐﺍﺮﺘﻣ: ﻢﯿﺨﺿ
ﻥﺎﺘﺳﺍﺩ: ﻥﺎﻣﺭ, ﯽﻟﺎﯿﺧ, ﻥﺎﺘﺳﺍﺩ
ﻪﯿﺻﻮﺗ: ﺪﻫﺩﯽﻣﺩﺎﻬﻨﺸﯿﭘ, ﻥﺩﺮﮐﯽﻓﺮﻌﻣ, ﺖﺤﯿﺼﻧ
ﯽﺷﺯﻮﻣﺁ: ﺕﻼﯿﺼﺤﺗ
ﻻﺎﺑﻑﺮﻄﺑ: ﻻﺎﺑ, ﺶﯿﺑ
ﺥﺎﺷ: ﺕﺭﺫ
ﻕﻭﺪﻨﺻ: ﻪﺒﻌﺟ, ﺖﺨﺘﯾﺎﭘ،ﻪﯾﺎﻣﺮﺳ, ﻪﻌﺷﺍ, ﯽﮕﺘﺷﺎﺒﻧﺍ
ﻝﺰﻨﻣ: ﻪﺒﻠﮐ, ﻞﯾﺎﻓ, ﻦﯿﺑﺎﮐ
ﺱﺎﺒﻟ: ﯽﺷﺭﺎﻔﺳ
ﻪﯾﺍﺮﮐ: ﻥﺩﺮﮐﻩﺭﺎﺟﺍ, ﻦﺘﻓﺭ, ﻪﺸﻘﻧ
ﯼﺭﻭﺁﺩﺎﯾ: ﻥﺩﺭﻭﺁﺩﺎﻳﻪﺑ, ﻪﯿﺒﺷ
ﺶﻟﺎﺑ: ﻪﻧﺎﺧﺩﻭﺭ
ﯽﯾﺎﺟﭻﯿﻫ: ﻪﻄﻘﻧ, ﺎﺟﺮﻫ
: 
ﺪﺴﺟ: ﻥﺪﺑ
ﺖﯿﻫﺎﻣ: ﻪﺘﺴﻫ, ﺮﺻﺎﻨﻋ, ﯽﮕﻧﺎﺧﻥﺍﻮﯿﺣ
ﯼﺪﻨﻠﺑ: ﺪﻨﺗﺐﯿﺷ
ﻩﺯﻮﺣ: ﻩﺯﻮﺣ, ﻥﺎﻬﺟ, ﻩﺩﻭﺪﺤﻣ
ﻪﻠﭘﻩﺍﺭ: ﺎﻫﻪﻠﭘ, ﺱﺎﯿﻘﻣ
ﻖﻓﺍﻮﺗ: ﺖﺷﺍﺩﺩﺎﯾ, ﯼﺭﺎﮑﻤﻫﺩﺍﺩﺭﺍﺮﻗ, ﻥﺪﺷﺎﺟ, ﻩﺍﻮﺨﻟﺩ
ﯼﺭﻮﺗ: ﻪﻘﺑﺎﺴﻣ, ﺾﺒﻧ
ﻩﻭﮋﭘﺶﻧﺍﺩ: ﻮﺠﺸﻧﺍﺩ, ﺪﻨﻤﺸﻧﺍﺩ
ﺶﻛﻂﺧ: ﮎﻭﺩ, ﺭﺍﺪﻧﺎﻣﺮﻓ
ﻪﻧﺍﻮﯾﺩ: ﻖﻤﺣﺍ
ﻥﺩﺮﮐﻡﺮﮔﺮﺳ: ﯼﺪﻣﺁﺵﻮﺧ, ﯽﻣﺮﮔﺮﺳﻭ​​ﺢﯾﺮﻔﺗ
ﯽﺳﺮﭘﻝﺍﻮﺣﺍﻭﻡﻼﺳ: ﯼﺪﻣﺁﺵﻮﺧ
ﻻﻮﯿﻫ: ﻻﻮﯿﻫ, ﮎﺎﻨﺘﺸﺣﻭ
ﯽﺘﺨﺳﻪﺑ: ﻂﻘﻓ
ﻥﺎﮑﻣﺍ: ﺕﺍﺰﯿﻬﺠﺗ, ﻥﺩﺮﮐﻞﯿﻬﺴﺗ, ﯽﺘﺣﺍﺭ
ﺕﺭﺎﻏ: ﺖﻗﺮﺳ, ﺕﺭﺎﻏ, ﻥﺩﺮﮐﻡﻭﺮﺤﻣ
ﻥﺎﺑﺩﺮﻧ: ﺎﻫﻪﻠﭘ, ﺮﺘﺴﮐﺭﺍﺮﺒﻫﺭ, ﺱﺎﯿﻘﻣ, ﻪﺳﺭﺪﻣ
ﻥﺎﯾﺎﭘ: ﻪﺘﺷﺬﮔ
: 
ﻥﺩﺮﮐﻢﯿﺴﻘﺗ: ﻢﯿﺴﻘﺗ, ﻊﯾﺯﻮﺗ, ﯽﻓﺎﮑﺷﺪﺒﻟﺎﮐ
ﺝﺁ: ﯼﻭﺭﻩﺩﺎﯿﭘ, ﻪﻠﭘ
ﻉﺎﻓﺩ: ﻥﺩﺍﺩﺖﻴﻤﻫﺍ, ﺖﻈﻓﺎﺤﻣ
ﯽﻧﺩﺮﮑﻧﺭﻭﺎﺑ: ﺐﻳﺮﻏﻭﺐﻴﺠﻋ, ﺎﺒﯾﺯ
ﺱﻮﻗ: ﻢﯿﻈﻌﺗ
ﺐﺨﺘﻨﻣ: ﺏﺎﺨﺘﻧﺍ, ﻥﺩﺮﻛﺏﺎﺨﺘﻧﺍ
ﯽﺘﻟﺎﺠﺧ: ﯽﯾﻭﺮﻤﮐ, ﻡﺮﺷ
ﺖﺴﺨﻧ: ﯽﻠﺻﺍ, ﻝﻭﺍ
ﻪﻧﺎﻔﺳﺎﺘﻣ: ﻒﺳﺎﺗﻪﯾﺎﻣ
ﻪﻣ: ﺭﺎﺒﻏ
ﯽﮕﻧﺭ: ﮓﻧﺭ
ﺕﺭﻮﺸﻣ: ﻪﺘﺳﺍﻮﺧ, ﺖﺤﯿﺼﻧ
ﻥﺩﺍﺩﺭﺍﺪﺸﻫ: ﺭﺍﺪﺸﻫ, ﻥﺩﺮﮐﺭﺍﺩﺍﻭ
ﻖﻤﻋﻢﮐ: ﻖﯿﻤﻋ, ﻪﯾﺎﭘ, ﻢﮐ
ﻖﯾﻮﺸﺗ: ﻥﺩﺮﻛﻖﻳﻮﺸﺗ, ﯽﺘﺣﺍﺭ, ﻡﺎﻬﻟﺍ
ﻪﯾﻭﺭﯽﺑ: ﻝﻮﻤﻌﻣ
ﻊﯿﻓﺮﺗ: ﻦﺘﻓﺭﺶﯿﭘ, ﺩﻼﯿﻣﺯﺍﺪﻌﺑ
ﻪﻧﺎﻗﺩﺎﺻ: ﯼﺭﺍﺩﺎﻓﻭ, ﻥﺎﻤﯾﺍﺎﺑ, ﻪﻧﺎﺼﻟﺎﺧ
: 
ﻝﺎﻘﺘﻧﺍ: ﻪﻤﺟﺮﺗ, ﻞﻘﻧﻭﻞﻤﺣ
ﯽﺳﺎﺳﺍ: ﻪﯾﺎﭘ, ﺖﺧﺎﺳﺮﯾﺯ
ﻪﺘﺴﺑ: ﻪﺘﺴﺑ, ﺮﺒﯿﻓ
ﺰﯿﮕﻧﺍﻢﻏ: ﮎﺎﻨﺘﺸﺣﻭ
ﯽﻨﯿﺑﺯﺎﺑ: ﺩﺎﻘﺘﻧﺍ
ﯽﮐﺎﻨﺘﺸﺣﻭ: ﮎﺎﻨﺘﺸﺣﻭ, ﺭﺎﯿﺴﺑ
ﺰﭘﻭﺖﺨﭘ: ﻦﺘﺨﭘ, ﻪﻧﺎﺧﺰﭙﺷﺁ
ﺵﺭﻮﺷ: ﯽﺷﺭﻮﺷ, ﺏﻼﻘﻧﺍ
ﻥﺩﺮﮐﺏﺍﺮﺧ: ﻦﺘﻓﺭﻦﯿﺑﺯﺍ, ﻑﺩﺎﺼﺗ, ﯽﻫﺎﺒﺗ
ﻥﺩﺮﻛﻊﻧﺎﻗ: ﻥﺩﺮﮐﺪﻋﺎﻘﺘﻣ, ﻥﺩﺍﺩﻥﺎﻨﯿﻤﻃﺍ
ﺮﯾﻮﺼﺗ: ﻝﺎﺜﻣ, ﺮﯾﻮﺼﺗ
ﺐﺼﻋ: ﺪﯾﺭﻭ, ﺖﻋﺎﺠﺷ, ﯽﺒﺼﻋ
ﻡﻮﻠﻌﻣ: ﻦﺘﺴﻧﺍﺩ, ﻥﺩﺍﺩﻥﺎﻨﯿﻤﻃﺍ, ﺺﺨﺸﻣ, ﯽﺳﺭﺮﺑ
ﻭﺮﮔ: ﻥﺩﺍﺩﻥﺎﻨﯿﻤﻃﺍ, ﻩﺪﻋﻭ, ﻥﺎﮔﻭﺮﮔ, ﺖﻧﺎﻤﺿ, ﻭﺮﮔ, ﺪﻨﮔﻮﺳ
ﻥﺩﺭﻭﺁﺖﺳﺪﺑ: ﺖﻣﺪﺧ
ﺎﺒﻗﺎﻌﺘﻣ: ﻊﻗﻮﻣﻥﻭﺍ, ﺪﻌﺑ
ﺪﯿﻨﮐﺏﺎﺨﺘﻧﺍ: ﻥﺩﺮﻛﺏﺎﺨﺘﻧﺍ
ﺮﯿﺴﻔﺗ: ﻪﻤﺟﺮﺗ, ﺢﯿﺿﻮﺗ
ﺶﻟﺎﭼ: ﻥﺩﺯﮓﻧﺯ
ﻉﻮﻨﻤﻣ: ﻥﺩﺮﮐﯼﺮﯿﮔﻮﻠﺟ, ﯼﺭﺍﺩﺯﺎﺑ
ﺵﺮﯾﺬﭘ: ﻝﻮﺻﻭﻡﻼﻋﺍ, ﺫﺎﺨﺗﺍ, ﺭﺍﺮﻗﺍ, ﻪﻧﺎﺘﺳﺁ
ﺮﺨﺘﺳﺍ: ﺮﺨﺘﺳﺍ, ﻝﺍﺩﻮﮔ, ﻞﭘ
ﺲﻧﺍﺮﻔﻨﮐ: ﻪﺴﻠﺟ, ﮊﺎﺘﻧﻮﻣ
ﯼﺮﺑﺍﺮﺑ: ﺱﺎﯿﻗ, ﻝﺩﺎﻌﺗ, ﯼﺯﺭﺍﻢﻫ
ﺍﺮﯿﺧﺍ: ﯽﮔﺯﺎﺗﻪﺑ, ﻥﺎﻣﺭ
ﻑﺍﺮﻃﺍﻂﯿﺤﻣ: ﺯﺍﺪﻧﺍﻢﺸﭼ, ﻑﺍﺮﻃﺍ, ﻮﺟ
ﻢﺟﺎﻬﺗ: ﻪﻠﻤﺣ, ﺩﻭﺭﻭ
ﻮﮕﻟﺍ: ﻝﺎﺜﻣ, ﺭﺎﺑﮏﯾ, ﻥﺪﺷﻞﻴﻜﺸﺗ, ﻪﮑﺒﺷ
ﻦﺘﺧﺎﺳﺭﺎﮑﺷﺁ: ﻥﺩﺮﮐﺵﺎﻓ, ﻥﺩﺮﮐﺲﮑﻌﻨﻣ, ﻦﮐﺯﺎﺑ
ﻥﺩﺮﮐﻑﺮﻃﺮﺑ: ﻞﺷ
ﻥﺩﺮﮐﺖﺤﯿﺼﻧ: ﻪﺒﻄﺧ
ﮒﺭﺰﺑﺭﺩﺎﻣ: ﻩﺪﺟﺎﯾﺪﺟ
ﻢﺸﭘ: ﻪﺒﻨﭘ
ﻥﺩﺮﻛﺭﺍﺮﻗﺮﺑﻁﺎﺒﺗﺭﺍ: ﻁﺎﺒﺗﺭﺍ, ﻥﺩﺮﮐﯽﻋﺎﻤﺘﺟﺍ, ﻩﺮﮐﺍﺬﻣ
: 
ﺎﺳﺎﺳﺍ: ﺕﺎﺣﻼﻄﺻﺍ, ﯼﺩﺎﯾﺯﺪﺣﺎﺗ, ﻦﺘﺷﺍﺩﺭﻮﻈﻨﻣ
ﺖﻔﻟﺎﺨﻣ: ﻥﺩﺮﮐﺖﻣﻭﺎﻘﻣ
ﻪﻧﻮﻤﻧ: ﻝﺎﺜﻣ
ﻥﺪﯿﺸﮐ: ﯽﭽﯿﻗ, ﺖﻣﻭﺎﻘﻣ
ﻝﻮﺼﺤﻣ: ﻥﺩﺮﮐﻭﺭﺩ, ﺵﺮﺑ, ﻥﺩﺮﮐﺪﯿﻟﻮﺗ
ﻖﯿﻗﺩ: ﺭﺩﻮﭘ, ﯽﻈﻔﻠﻟﺍﺖﺤﺗ
ﺭﺮﮑﻣﺪﻣﺁﻭﺖﻓﺭ: ﻦﺘﻓﺮﮔ, ﻩﺎﻨﭘﻥﺎﺟ, ﺢﻳﺮﻔﺗﮓﻧﺯ
ﻉﺎﻨﺘﻣﺍ: ﯽﻨﺘﺨﯾﺭﺭﻭﺩ
ﻪﺿﺮﻗﻕﺍﺭﻭﺍ: ﺪﯿﻠﮐ, ﺖﻧﺎﻤﺿ, ﯽﮔﺩﺮﺑ
ﺯﻮﺴﻟﺩ: ﯼﺩﺭﺪﻤﻫﺯﺍﺮﺑﺍ
ﻕﻮﻘﺣ: ﺖﺧﺍﺩﺮﭘ
ﻡﻭﺍﺪﻣ: ﻡﻭﺍﺪﻣ, ﺖﺑﺎﺛ
ﻥﺩﺮﮐﮏﯾﺮﺤﺗ: ﻥﺩﺮﮐﺭﺍﺩﺍﻭ, ﻥﺩﺮﮐﮏﯾﺮﺤﺗ, ﻥﺩﺯﻢﻬﺑ, ﺭﺍﺪﯿﺑ
ﺪﯾﺪﺷ: ﯽﺸﺣﻭ, ﺪﯾﺪﺷ
ﻪﺼﻏﻭﻢﻏ: ﯼﺩﮊﺍﺮﺗ, ﻒﺳﺎﺘﻣ
ﺪﺤﺘﻣ: ﺪﺤﺘﻣ
ﻒﻘﺳ: ﻮﺘﭘ, ﻒﻘﺳ
ﻪﯾﺪﯿﺋﺎﺗ: ﻪﻣﺎﻧﯽﻫﺍﻮﮔ, 
ﻑﺪﻫ: ﺰﮐﺮﻤﺗ, ﻑﺪﻫ
ﺪﻘﻧ: ﻝﻮﭘ
ﯽﻟﺎﺧ: ﻦﮐﺯﺎﺑ, ﻥﺩﺮﮐﺩﺍﺯﺁ, ﯽﻟﺎﺧ, ﻞﺷ, ﻢﻬﺒﻣ, ﺮﻔﺻ
ﻥﺩﺮﻤﺷﺭﺍﻮﺧ: ﺮﯿﻘﺤﺗ
ﻦﻤﭼ: ﻦﻤﭼ, ﺭﺍﺰﻔﻠﻋ
ﻥﻮﻤﻠﻗﻮﺑ: 
ﻪﯾﺎﺴﻤﻫ: ﻑﺍﺮﻃﺍ, ﮏﯾﺩﺰﻧ
ﯽﯾﺎﻬﻧ: ﻪﺘﺷﺬﮔ, ﻦﯾﺮﺘﺸﯿﺑ, ﺖﯾﺎﻬﻧﺭﺩ
ﻝﺎﺳﺭﺍ: ﻝﺎﺳﺭﺍ
ﺩﻭﺭﻭ: ﻥﺪﺷﻞﺧﺍﺩ, ﻂﺒﺿ
: 
ﻞﻣﺎﮐ: ﻖﯿﻤﻋ, ﻞﻣﺎﮐﺭﻮﻄﺑ, ﻩﺪﺷﺮﭘ
ﺞﯿﻬﻣ: ﺖﺴﻫﺐﻟﺎﺟ
ﻩﺪﻧﺮﺑ: ﺖﯿﻘﻓﻮﻣ, ﻢﺘﺷﻭﺏﺮﺿ
ﺭﺎﮐﻪﻈﻓﺎﺤﻣ: ﺲﮐﻭﺪﺗﺭﺍ, ﺭﺍﺪﻧﺎﻣﺮﻓ
ﻕﺎﺘﺸﻣ: ﺲﭘﺍﻮﻟﺩ, ﻥﺎﺠﯿﻫ
ﻦﯿﯾﺎﭘﻪﻘﺒﻃ: ﻦﯿﯾﺎﭘ
ﻥﺩﺮﻛﺕﻮﻋﺩ: ﺐﯿﺗﺮﺗ
ﺵﻮﺟ: ﻦﺘﺨﭘ, ﻢﺧﺯ, ﻥﺩﺮﮐﺥﺮﺳ
ﯽﯾﺎﺒﯾﺯ: ﯽﯾﺎﺒﯾﺯ, ﻞﮕﺷﻮﺧ, ﺮﯾﺬﭙﻟﺩ, ﻪﺘﻓﺭﻭﻪﺘﺴﺷ
ﺍﺩﺮﻓ: ﺯﻭﺮﯾﺩ
: 
ﺖﺣﺍﺭﺎﻧ: ﺲﭘﺍﻮﻟﺩ, ﺪﻨﯾﺎﺷﻮﺧﺎﻧ
ﻩﺎﮔﺭﺪﻨﺑ: ﻩﺎﻨﭘﻥﺎﺟ
ﻩﺎﮕﺘﺳﺩ: ﺕﺍﺰﯿﻬﺠﺗ, ﻡﺰﯿﻧﺎﮑﻣ
ﺎﻋﺩﺍ: ﻥﺩﺮﮐﺭﺍﺮﺻﺍ, ﻥﺩﺮﮐﺐﺣﺎﺼﺗ
ﻦﺨﺳ: ﻥﺎﯿﺑ, ﺐﺳﺍ
ﻞﯾﺭ: ﻦﻫﺁﻩﺍﺭ, ﺭﺎﻄﻗ
ﯽﻋﺍﺭﺯﺕﻻﻮﺼﺤﻣ: ﻥﺩﺮﮐﻭﺭﺩ, ﻥﺩﺮﮐﺪﯿﻟﻮﺗ
ﺺﻗﺎﻧ: ﻩﺪﺷﺮﭘ, ﯽﻧﺍﻮﺗﺎﻧ, ﺖﯿﻣﺎﻤﺗﺎﻧ
: 
ﻥﺩﺭﻭﺁﺖﺳﺩ: ﻥﺩﺭﻭﺁﺖﺳﺩﻪﺑ, ﺪﯾﺮﺧ
ﻪﻠﻤﺣ: ﻪﻠﻤﺣ, ﻦﯿﻫﻮﺗ, ﺰﯿﻣﺁﺖﻧﻮﺸﺧ
ﺩﺮﺳﺭﻮﻄﺑ: ﺩﺮﺳ
ﯽﻧﺍﺮﻨﺨﺳ: ﯽﻧﺍﺮﻨﺨﺳ, ﻩﺭﻭﺩ, ﻪﺒﻄﺧ, ﺶﯾﺎﻤﻧ
ﻥﺁﺐﺟﻮﻣﻪﺑ: ﻪﮐﯽﯾﺎﺟ
ﮎﺍﺭﺩﺍ: ﺱﺎﺴﺣﺍ, ﻩﺎﮕﻧ, ﻩﺪﺷﻢﺧ, ﮎﺭﺩ, ﻥﺩﺮﻛﻙﺭﺩ
ﻪﻌﺳﻮﺗ: ﻩﺪﺷﺖﺳﺭﺩﻪﻧﺍﺩﺎﺘﺳﺍ
ﺩﺮﮑﻠﻤﻋ: ﻢﺳﺍﺮﻣ, ﺭﺎﮐ, ﺖﯿﻟﺎﻌﻓ
ﻪﻟﻮﻠﮔ: ﺹﺮﻗ, ﺲﮑﻋ, ﯼﺮﺒﻫﺭ, ﭖﻮﺗ
: 
ﻥﺩﺮﮐﺮﯿﺳﺍﻭﺭﺎﺘﻓﺮﮔ: ﻥﺍﺮﮐ, ﺏﺎﻨﻃ
ﻥﺎﺴﮑﯾ: ﺮﺑﺍﺮﺑ
ﻪﺟﻮﺗﻞﺑﺎﻗ: ﯽﺸﯾﺎﻤﻧ, ﯽﻟﺎﻋ, ﻢﻬﻣ, ﻪﺟﻮﺗﻞﺑﺎﻗ, ﯽﻓﺎﮐ
ﻢﺠﺣ: ﻩﺩﻮﺗ, ﻊﻤﺟ, ﻢﺠﺣ, ﺭﻮﻣﻮﺗ, ﺖﯿﻌﻤﺟ
ﺕﺪﻣﯽﻧﻻﻮﻃ: ﯽﻧﻻﻮﻃ, ﻥﺪﻧﺎﻣﺮﻈﺘﻨﻣ, ﯽﻟﻮﻃ
ﺖﯾﺫﺍ: ﮏﯾﺮﺤﺗ, ﺪﻨﯾﺎﺷﻮﺧﺎﻧ, ﻢﺸﺧ
ﻦﯿﮕﻤﻏ: ﯽﺒﺼﻋ, ﻦﯿﮕﻤﻏ
ﯽﺴﮐﺎﺗ: ﯽﺴﮐﺎﺗ, 
ﻪﺘﺳﺩ: ﻪﻣﺪﺧ, ﺪﻧﺎﺑ
ﻩﺎﮕﺸﯾﺎﻤﻧ: ﻪﻧﺎﺸﻧ, ﺶﯾﺎﻤﻧ
ﮏﺸﺧﻒﻠﻋ: ﻦﻤﭼ
ﻩﺮﻇﺎﻨﻣ: ﻝﺪﺟﻭﺚﺤﺑ
ﻥﻮﮑﺳ: ﺕﻮﮑﺳ, ﻡﺍﺭﺁ
ﻲﺋﺰﺟ: ﺎﻨﺜﺘﺳﺍ, ﺶﺨﺑ
ﻭﺎﮔﺖﺷﻮﮔ: ﺖﺷﻮﮔ
ﻩﺪﻧﻮﺷﺭﺍﺮﮑﺗ: ﻥﺎﻣﺯ, ﺭﺮﮑﻣ
: 
ﻥﺩﺮﮐﺪﺤﺘﻣ: ﯽﮕﺘﺴﺒﻤﻫ, ﻡﺎﻏﺩﺍ, ﻥﺩﺍﺩﯽﺘﺷﺁ, ﻥﺩﺮﮐﻞﺻﻭ, ﻥﺪﺷﺏﻭﺫ
ﻪﻐﯿﺗ: ﮒﺮﺑ, ﺮﯿﺸﻤﺷ
ﻪﻧﺎﺧﺭﺎﮐ: ﻪﻧﺎﺧﺭﺎﮐ, ﻩﺎﮔﺭﺎﮐ
logophoric: 
ﺭﻮﻀﺣ: ﺖﮐﺭﺎﺸﻣ, ﯽﺳﺮﺘﺳﺩ, ﺭﻮﻀﺣ
ﻪﻠﺠﻣ: ﺕﺎﻋﻮﺒﻄﻣ, ﺕﺍﺮﻃﺎﺧﺮﺘﻓﺩ
ﻪﻧﺎﻗﺩﺎﺻ: ﻪﻧﺎﺼﻟﺎﺧ, ﯼﺭﺍﺩﺎﻓﻭ, ﻕﺩﺎﺻ
ﻉﻭﺮﺸﻣ: ﯽﻧﻮﻧﺎﻗ, ﻪﯿﺟﻮﺗ
ﻪﺒﻨﺷﺞﻨﭘ: ﺎﺠﻧﺁ
ﻪﯾﺩﺎﺤﺗﺍ: ﺩﺎﺤﺗﺍ
: 
ﮏﯿﻓﺍﺮﺗ: ﺵﺩﺮﮔ, ﻞﻘﻧﻭﻞﻤﺣ, ﺭﺍﺩﺍﺪﺻﻑﺮﺣ
ﻡﺍﺪﻧﺍ: ﻮﻀﻋ, ﻝﺎﺑ
: 
ﺮﺷﺎﺒﻣ: ﺮﯾﺪﻣ, ﺭﺍﺰﮕﺘﻣﺪﺧ
ﻩﺩﺎﻌﻟﺍﻕﺭﺎﺧ: ﺎﺒﯾﺯ
ﯽﻠﻣﺎﮑﺗﺮﯿﺳ: ﺕﺎﺣﻼﺻﺍ, ﯽﻠﻣﺎﮑﺗ
ﺱﻮﮑﻌﻣ: ﺲﮑﻋﺮﺑ, ﻞﺑﺎﻘﻣ
ﯽﺳﺭﺮﺑ: ﯽﺳﺭﺮﺑ, ﻥﺩﺮﮐﻮﺠﺘﺴﺟ
ﻥﺩﺮﮐﺮﯿﺤﺘﻣﻭﺕﺎﻣ: ﯽﻣﺮﮔﺮﺳﻭ​​ﺢﯾﺮﻔﺗ
ﺮﺻﺎﻌﻣ: ﻥﺭﺪﻣ, ﯼﺯﺎﺳﻡﺎﮕﻤﻫ, ﺖﻗﻮﻣ
ﯽﯾﺍﻮﺳﺭ: ﺩﺎﺴﻓ
ﻪﻧﺎﻫﺎﮔﺁ: ﺍﺪﻤﻋ
ﻞﺒﻤﺳ: ﺖﺳﮊ, ﻪﺸﻘﻧ, ﺖﻣﻼﻋ
ﺩﻮﺒﻬﺑ: ﺕﺎﺠﻧ
ﯽﯾﻮﺸﺳﺎﺒﻟ: ﻮﺸﺘﺴﺷ, ﯽﯾﻮﺸﮑﺸﺧ
: 
ﻖﯿﻗﺩ: ﺭﺩﻮﭘ, ﻥﺪﺷﺎﺟ, ﯽﻈﻔﻠﻟﺍﺖﺤﺗ
ﻉﻮﻗﻭ: ﻦﺘﺳﻮﯿﭘﻉﻮﻗﻭﻪﺑ, ﺖﺒﺳﺎﻨﻣ, ﺭﻮﻀﺣ, ﻲﺳﺎﺳﺍﻥﻮﻧﺎﻗ
ﺭﻮﺤﻣ: ﻪﻧﺎﺷ, ﺖﺧﺭﺩ
ﻩﺭﺍﻮﻨﺸﺟ: ﯽﺴﯿﻋﯽﻠﺠﺗﻭﺭﻮﻬﻇ
: 
ﻪﻗﺎﺳ: ﮏﺸﺧ, ﻪﻠﯿﺒﻗ, ﻪﺸﯾﺭ
ﺖﮐﺮﺷ: ﺖﮐﺮﺷ, ﻥﺎﻣﺯﺎﺳ
ﺢﯿﺟﺮﺗ: ﺯﺎﯿﺘﻣﺍ, ﻥﺩﺮﻛﺏﺎﺨﺘﻧﺍ, ﺐﺼﻌﺗ, ﻪﻨﯾﺰﮔ, ﺖﯾﻮﻟﻭﺍ
ﻢﯿﻫﺍﻮﺧﯽﻣ: ﻥﺩﺮﮐﺭﺍﺩﺍﻭ, ﻦﺘﺷﺍﺩﻞﻳﺎﻤﺗ, ﻥﺩﺮﻛﻖﻳﻮﺸﺗ, ﻪﺘﺳﺍﻮﺧ
ﻥﺩﺍﺩﺶﻫﺎﻛ: ﻢﮐ
ﺖﺷﺍﺩﺮﺑ: ﻪﻠﺻﺎﻓ, ﺮﻄﺧﯽﺑ
ﺎﻋﺩﺍ: ﻝﺪﺟﻭﺚﺤﺑ, ﺩﻼﯿﻣﺯﺍﺪﻌﺑ
ﺱﺮﺘﺳﺩﺭﺩ: ﺪﯾﺩﺯﺎﺑ, ﻩﺪﺷﺍﺪﯿﭘ
ﯼﺪﻤﮐ: ﯽﻌﺒﻃﺥﻮﺷ
ﻥﺩﺮﮐﺖﯿﭘﻭﻂﯿﺧ: ﮓﻧﺭ, ﻥﺎﺠﯿﻫ
ﺪﮐ: ﻁﺎﯿﺣ, ﻥﺩﺭﻭﺍﺭﺩﺰﻣﺭﺕﺭﻮﺼﺑ, ﺭﻮﺒﻋﺰﻣﺭ
ﯽﻓﺎﮐ: ﯽﻓﺎﮐ, ﻩﻮﻬﻗ, ﻥﺪﺷﺎﺟ
ﻑﺎﮑﺷ: ﻊﯾﺯﻮﺗ
: 
ﺱﺎﻨﺷﺦﯾﺭﺎﺗ: ﯽﺨﯾﺭﺎﺗ
ﯽﺳﺍﺮﮐﻮﻣﺩ: ﯼﺭﻮﻬﻤﺟ, ﮏﯿﺗﺍﺮﮐﻮﻣﺩ
ﻩﺪﯿﻘﻋ: ﺭﺍﺮﻗﺍ, ﻦﯾﺩ, ﺮﯿﺴﻣ
ﻪﺑﺫﺎﺟ: ﻥﻮﺴﻓﺍ, ﻦﯿﻣﺯﻪﺑﺫﺎﺟ
ﺕﺮﺴﻨﮐ: ﻢﺳﺍﺮﻣ
ﻦﯿﯾﺎﭘﻪﺑﻭﺭ: ﻦﯿﯾﺎﭘ
ﮓﻧﺭﺩﯽﺑ: ﯼﺩﻭﺯﻪﺑ, ﻥﺩﺮﮐﺎﺿﺎﻘﺗ
: 
ﺪﯿﮐﺎﺗ: ﻪﺠﻬﻟ, ﺱﺮﺘﺳﺍ, ﻥﺩﺮﮐﺭﺍﺮﺻﺍ, ﺖﯿﻤﻫﺍ
ﯼﺰﻧﺮﺑ: ﺲﻣﺰﻠﻓ, ﻱﺍﻩﻮﻬﻗ
ﮎﺎﺷﻮﭘ: ﺩﺎﺸﮔﻭﺪﻨﻠﺑﺱﺎﺒﻟ
ﺖﻣﺍﺪﻧ: ﻦﯿﮕﻤﻏ
: 
ﯼﺭﺎﺼﺤﻧﺍ: ﺭﺎﺼﺤﻧﺍ, ﯽﺻﻮﺼﺧ, ﻩﺩﺭﺎﻬﭼ, ﺺﺼﺨﺗ
ﺮﺑﺭﺎﺑ: ﻥﺪﯿﺷﻮﭘ
ﻩﺮﯿﺗﻂﺧ: ﻂﺧ, ﺩﺭﻮﺒﺷﺍﺩ
ﺭﺍﻮﻧ: ﺪﻧﺎﺑ, ﻥﺩﺮﮐﻥﺎﯾﺮﻋ
ﺖﯾﺎﻬﻧﺭﺩ: ﺖﯾﺎﻬﻧﺭﺩ
ﻢﯿﺗ: ﻪﻣﺪﺧ
ﻪﮐﯽﺴﮐﺮﻫ: ﯽﺴﮐﻪﭼ, ﻪﮐﻡﺍﺪﮐﺮﻫ, ﯽﺴﮐﺮﻫ
ﻥﺍﺮﮔ: ﺰﯾﺰﻋ
ﯽﻫﺪﻧﺎﻣﺮﻓﺰﮐﺮﻣ: ﺩﺎﺘﺳ, ﺰﮐﺮﻣ
ﺩﺎﺣ: ﺰﯿﺗ, ﻦﻣﺰﻣ
ﻞﺠﺧ: ﯽﺒﺼﻋ, ﻡﺮﺷ, ﻦﺘﺷﺍﺬﮔﺎﺟ
ﺪﻧﺯﺮﻓ: ﺎﻫﻪﭽﺑ
ﻪﮑﺒﺷ: ﺏﻭ
ﺢﻄﺳ: ﻩﺪﻧﺮﭘ, ﺢﻄﺳ, ﻦﯿﺷﺎﻣ, ﻦﺘﻓﺮﮔﺝﻭﺍ
ﯼﺍﻩﺯﺍﺪﻧﺍﺎﺗ: ﺶﺨﺑ
ﺭﺎﺨﺘﻓﺍﺎﺑ: ﺭﻭﺮﻏ
ﺱﺍﺮﺗ: ﻦﮑﻟﺎﺑ, ﻒﻘﺳ
ﮓﻨﭼ: ﻦﺘﺷﺍﺩﻪﮕﻧ, ﻡﺍﺩ, ﺖﺸﻣ, ﺭﺎﺸﻓ, ﻢﺸﯾﺮﺑﺍ
ﯽﻨﺗﻭﺮﻓ: ﯽﮔﺩﺎﺳ
ﺭﺎﺠﻔﻧﺍ: ﺭﺎﺠﻔﻧﺍ
ﺕﺭﺍﺯﻭ: ﯼﺭﺍﺩﺍﺮﺘﻓﺩ
ﺮﻄﻗ: ﻪﻟﺎﻘﻣ
ﯽﻣﺎﻈﻧﯼﺎﻫﻭﺮﯿﻧ: ﺶﺗﺭﺍ
ﻢﮑﺤﻣ: ﺍﺪﮐﻮﻣ
ﺕﺍﺯﺎﺠﻣ: ﻪﻠﻤﺟ
ﺏﻭﺎﻨﺘﻣ: ﻪﻨﯾﺰﮔ, ﻝﺩﺎﺒﺗ
ﯼﺭﺍﺩﻦﺘﺸﯾﻮﺧ: ﺮﺒﺻ
ﺶﯾﺎﻤﻧﻪﺤﻔﺻ: ﻪﻧﺎﻧﺯﺭﺩﺎﭼ
ﮎﺎﺧ: ﺖﺑﻮﻃﺭ, ﻞﮔ, ﮎﺎﺧﻭﺩﺮﮔ
ﺮﺼﻋ: ﻞﺼﻓ, ﺖﻣﺪﻗ, ﯽﻧﻻﻮﻃ, ﯽﮕﺘﺴﺒﻤﻫ
ﺩﺍﮋﻧﺡﻼﺻﺍﻭﺵﺭﻭﺮﭘ: ﻥﺩﺮﮐﺮﯿﺜﮑﺗ, ﻪﻘﺑﺎﺴﻣ, ﯼﺭﻭﺭﺎﺑ, ﯼﺯﺎﺳﺐﺗﺮﻣ
ﻞﺧﺍﺪﺗ: ﻥﺩﺮﮐﻪﻠﺧﺍﺪﻣ, ﯼﺭﻮﺨﻟﺩ, ﻝﻼﺘﺧﺍ
ﻞﻣﺎﺷ: ﻞﻣﺎﺷ, ﻪﻠﻤﺟﺯﺍ, ﻞﯾﺎﻤﺗ
ﺵﺮﯾﺬﭘ: ﻝﻮﺒﻗﻞﺑﺎﻗ, ﺫﺎﺨﺗﺍ, ﻝﻮﺻﻭﻡﻼﻋﺍ
ﺱﺪﻨﻬﻣ: ﯽﮑﯿﻧﺎﮑﻣ, ﻪﻟﺎﻘﻣ
ﻒﻗﻮﺗ: ﺎﭘ, ﺖﺷﺍﺩﺯﺎﺑ, ﻥﺪﺷﻪﺘﺴﺑ, ﻥﺩﺮﮐﯼﺮﯿﮔﻮﻠﺟ
ﻦﯾﺰﮕﯾﺎﺟ: ﻪﻨﯾﺰﮔ, ﻥﺩﺮﮐﻦﯾﺰﮕﯾﺎﺟ
ﺮﻬﻣ: ﯽﺑﺍﮎﻮﺧ
ﺭﻮﺟﻭﻊﻤﺟ: ﺮﺼﺘﺨﻣ, ﻥﺩﺮﮐﻩﺎﺗﻮﮐ
ﻥﺪﺷﺪﯾﺪﭘﺎﻧ: ﻩﺪﺷﺽﺮﻘﻨﻣ, ﯽﻔﺨﻣ, ﻩﺪﺷﻢﮐ
ﻩﺪﻧﺭﺎﻤﺷ: ﮏﺴﯾﺩ, ﺩﺭ, ﻞﺑﺎﻘﻣ, ﺐﯿﻗﺭ
ﻩﺮﻫﺯﻩﺭﺎﯿﺳ: ﻪﻌﻤﺟ
ﻥﺩﺮﻛﺏﺬﺟ: ﺖﺴﻫﺐﻟﺎﺟ, ﻦﺘﺷﺍﺬﮔﺮﯿﺛﺎﺗ, ﻥﺩﺮﮐﺮﯿﺳﺍ
ﺐﯿﺠﻋ: ﻥﺩﺮﮐﺮﯿﮕﻠﻓﺎﻏ, ﻪﺟﻮﺗﻞﺑﺎﻗ
ﺖﺑﺎﻗﺭ: ﺐﯿﻗﺭ, ﻪﻘﺑﺎﺴﻣ
ﻝﺎﺘﺴﯾﺮﮐ: ﻪﺸﯿﺷ
ﺵﻭﺩ: ﻥﺍﻭ, ﻥﺍﺭﺎﺑ
: 
ﻢﯿﻈﻋ: ﻦﯿﮕﻨﺳ
ﺭﺎﺒﻧﺍ: ﻕﺎﺗﺍ
ﯽﻔﺴﻠﻓ: ﻑﻮﺴﻠﯿﻓ
ﻩﺎﮕﺘﺳﺩ: ﺕﺍﺰﯿﻬﺠﺗ, ﮏﯿﺘﮐﺎﺗ, ﺭﺍﺰﺑﺍ
ﻩﺪﻨﻨﮐﻩﺮﯿﺧﺶﺑﺎﺗ: ﻩﺎﮕﻧ, ﺰﯿﺗ
ﺖﯾﺎﻬﻧﺭﺩ: ﺖﯾﺎﻬﻧﺭﺩ
ﺶﺸﺨﺑ: ﺶﺨﺒﺑ
ﺭﻮﺟﺪﺑ: ﺭﺎﯿﺴﺑ, ﮎﺎﻨﺘﺸﺣﻭ
ﺮﮑﻔﺗ: ﻥﺩﺮﮐﺲﮑﻌﻨﻣ, ﺱﺎﮑﻌﻧﺍ, ﺡﺮﻃ
ﺪﯿﻟﻮﺗ: ﻥﺩﺮﮐﺪﯿﻟﻮﺗ, ﻩﺪﻧﺯﺎﺳ
ﯽﺘﺣﺍﺭﻪﺑ: ﺮﯾﺬﭙﻟﺩ
ﻩﺎﮕﺸﯾﺎﻤﻧ: ﺵﺭﺍﺰﮔ
ﻮﺠﺘﺴﺟ: ﻥﺩﺮﮐﻮﺠﺘﺴﺟ
ﺵﺮﺘﺴﮔ: ﻥﺩﺍﺩﺭﺎﺸﺘﻧﺍ, ﻪﯿﻠﮐ
ﺪﻨﻫﺩﯽﻣﻞﯿﮑﺸﺗﺍﺭ: ﻞﻣﺎﺷ, ﯼﺪﻨﺑﺐﯿﮐﺮﺗ
ﻝﺍﺪﺟ: ﺰﯿﮕﻧﺍﺮﺑﺚﺤﺑ, ﻝﺪﺟﻭﺚﺤﺑ
: 
ﺎﺒﯾﺮﻘﺗ: ﻝﻮﻤﻌﻣ, ﯽﺒﯾﺮﻘﺗ
ﺮﺳﯼﻻﺎﺑﺭﺩ: ﻻﺎﺑ
: 
ﻪﺌﻃﻮﺗ: ﺵﺮﺑ
ﻥﺩﺮﮐﺭﺎﻬﻣ: ﯼﺭﺍﺩﺯﺎﺑ, ﻥﺩﺮﮐﯼﺮﯿﮔﻮﻠﺟ, ﻆﻔﺣ
ﻆﻔﺣ: ﯽﯾﻮﺟﻪﻓﺮﺻ, ﻥﺩﺍﺩﺖﻴﻤﻫﺍ, ﻆﻔﺣ
ﻪﻧﺎﺨﯿﻣ: ﻪﻧﺎﺧﺮﻓﺎﺴﻣ
ﻪﻧﺎﺧﺩﻭﺭﻩﺯﻮﺣ: ﻩﺭﺩ, ﺮﺨﺘﺳﺍ, ﯽﯾﻮﺸﻓﺮﻇﮏﻨﯿﺳ
ﯼﺩﻮﻠﻣ: ﻦﺤﻟ
: 
ﻡﺍﺪﺨﺘﺳﺍ: ﻥﺩﺮﮐﻩﺭﺎﺟﺍ
ﻥﺍﺮﮕﻧ: ﺲﭘﺍﻮﻟﺩ, ﯽﺒﺼﻋ, ﻥﺩﺍﺩﺖﻴﻤﻫﺍ
ﻦﺴﻣﺩﺍﺮﻓﺍ: ﻝﺎﺴﻨﻬﮐ, ﯽﻤﯾﺪﻗ
ﻩﺎﮕﺸﻧﺍﺩ: ﺞﻟﺎﮐ
: 
ﺮﯿﯿﻐﺗ: ﻥﺩﺮﮐﻦﯾﺰﮕﯾﺎﺟ
: 
ﻁﺎﺘﺤﻣ: ﺖﻗﺩﺎﺑ
ﻪﯾﺎﭘ: ﻪﯾﺎﭘ
ﯽﻠﺒﻗ: ﻕﺮﺷ, ﺯﺍﻞﺒﻗ, ﯽﻤﯾﺪﻗ
ﺞﻧﺮﻐﺑ: ﻩﺪﯿﭽﯿﭘ, ﺖﺨﺳ, ﻩﺪﺷﺖﺳﺭﺩﻪﻧﺍﺩﺎﺘﺳﺍ
ﯽﻫﺍﻮﺧﺭﺬﻋ: ﻒﺳﺎﺘﻣ, ﺐﯿﺳ
ﻩﺪﯿﺳﺮﺗ: ﺱﺮﺗ
ﻦﯿﺸﻧﺎﺟ: ﻪﻨﯾﺰﮔ, ﯼﺮﻤﺘﺴﻣ, ﻥﺩﺮﮐﻦﯾﺰﮕﯾﺎﺟ, ﻥﻭﺎﻌﻣ
ﻩﺩﺎﻔﺘﺳﺍ: ﻥﺩﺮﮐﻩﺩﺎﻔﺘﺳﺍ
ﻢﯿﻣﺮﺗ: ﯼﺯﺎﺳﺯﺎﺑ
ﻦﯿﭼﺮﭘ: ﺭﺎﺼﺣ
ﯽﻠﺻﺍ: ﺩﺎﺘﺳﺍ, ﻪﯾﺎﭘ, ﻩﺭﺎﯿﺳ
ﻮﺗﺮﭘ: ﻪﻌﺷﺍ
ﺮﻔﺳ: ﺪﯾﺩﺯﺎﺑ, ﺮﻔﺳ
ﺰﯿﻣﺁﻕﺍﺮﻏﺍ: ﮏﻤﻧ, ﯽﻌﯿﺒﻃﺮﯿﻏ
ﻪﺘﺴﯾﺎﺷ: ﻪﺑﺭﺩﺎﻗ, ﻂﯾﺍﺮﺷﺪﺟﺍﻭ
ﯼﺯﺭﻭﺎﺸﮐ: ﯼﺯﺭﻭﺎﺸﮐ
ﯼﺭﻮﻓ: ﯼﺩﻭﺯﻪﺑ, ﻥﺩﺮﮐﻊﯾﺮﺴﺗ, ﻡﺯﻻ
ﺖﻗﺩ: ﺹﻮﻠﺧ
ﺭﺎﯿﺷﻮﻫ: ﺭﺍﺪﺸﻫ, ﺭﺍﺪﯿﺑ, ﺖﻣﻼﻋ
ﻞﮑﺷ: ﻥﺪﺷﻞﻴﻜﺸﺗ
ﺮﻓ: ﻕﺎﺟﺍ
ﻩﺪﺷﺩﺮﮔ: ﺩﺮﮔ, ﻥﺩﺮﮐﺩﺮﮔ
ﯽﻟﻮﻤﻌﻣ: ﻝﻮﻤﻌﻣ, ﺲﮐﻭﺪﺗﺭﺍ
ﻥﺩﺮﮐﻪﺑﻻ: ﻪﯿﺟﻮﺗ
ﺏﺎﻨﻃ: ﺏﺎﻨﻃ
ﮏﯿﺳﻼﮐ: ﮏﯿﺳﻼﮐ, ﯽﻘﯿﺳﻮﻣ
ﺭﺎﻨﮐﺭﺩ: ﺕﺍﺯﺍﻮﻣﻪﺑ, ﺪﻌﺑ, ﯽﮕﺘﺳﻮﯿﭘ
ﻥﺩﺮﮐﺝﺍﺮﺨﺘﺳﺍ: ﻝﻮﻗﻞﻘﻧ, ﻩﻮﯿﻤﺑﺁ
ﺖﻨﯾﺎﭘ: ﻮﺠﺑﺁ
ﻪﻟﻮﻟ: ﻪﻟﻮﻟ
ﻥﺎﺑﺎﯿﺧ: ﺖﺒﺳﺎﻨﻣ
ﻞﯿﻓ: ﺝﺎﻋ
ﻦﻓﺩ: ﯼﺭﺎﭙﺴﮐﺎﺧ
ﺪﻣﺁﺭﺎﮐ: ﺭﺍﺬﮔﺮﻴﺛﺎﺗ, ﺮﺛﺍ
ﻁﻮﻠﺨﻣ: ﻁﻮﻠﺨﻣ, ﻥﺩﺯﻢﻬﺑ
ﻝﻼﺘﺧﺍ: ﻝﻼﺘﺧﺍ, ﯼﺭﻮﺨﻟﺩ, ﻥﺩﺮﮐﻪﻠﺧﺍﺪﻣ
ﯽﯾﺍﺮﺟﺍ: ﺮﯾﺪﻣ
ﻢﻫﺩ: ﻩﺩ
ﯼﺍﻪﺴﯾﺎﻘﻣ: ﻪﺴﯾﺎﻘﻣ
.ﺢﺒﺻ: ﺢﺒﺻ, ﻕﺍﺮﺑ
ﺲﻔﻗ: ﻪﻌﻠﻗ
ﺭﺎﺑ: ﺕﻻﻮﺼﺤﻣ, 
ﻥﺍﺪﻧﺯ: ﻥﺍﺪﻧﺯ, ﺮﯿﺠﻧﺯ
ﺮﻫﺎﻣ: ﯼﺮﮔﻪﻠﯿﺣ, ﻪﺑﺭﺩﺎﻗ
ﺩﺎﯾﺮﻓ: ﻥﺩﺮﮐﻪﯾﺮﮔ
ﺵﺯﺎﺳ: ﯼﺭﺎﮑﻤﻫﺩﺍﺩﺭﺍﺮﻗ, ﯽﻧﻮﻣﺭﺎﻫ
ﺕﺎﻤﻬﻣ: ﺲﮑﻋ
ﺭﺎﯿﺘﺳﺩ: ﯽﻣﺎﺣ, ﮏﻤﮐ, ﻥﻭﺎﻌﻣ
ﺮﮑﺸﯿﻧ: ﺏﻮﭼ
ﻥﺩﺮﮐﺎﺗ: ﻝﻮﻐﺸﻣ
ﺯﺮﻣ: ﻥﺍﺮﮐ
ﯼﺎﻫﺪﻨﯾﺁﺮﻓ: ﯼﺩﺮﺑﺭﺎﮐﯼﺎﻫﻪﻣﺎﻧﺮﺑ, ﺵﺯﺍﺩﺮﭘﻝﺎﺣﺭﺩ
ﺚﺤﺑﻭﺮﺟ: ﻮﮕﺘﻔﮔﻭﺚﺤﺑ, ﻉﺍﺰﻧ, ﻥﺩﺮﮐﺭﺍﺮﺻﺍ
ﻖﻄﻨﻣ: ﻝﺪﺟﻭﺚﺤﺑ, ﯽﻘﻄﻨﻣ, ﺖﯿﻧﻼﻘﻋ
ﺖﺸﺣﻭ: ﺱﺮﺗ
ﻑﺮﺼﻣ: ﻥﺩﺮﮐﻩﺩﺎﻔﺘﺳﺍ, ﻥﺩﺭﻮﺧ
ﻆﻔﺣ: ﻥﺩﺮﮐﺖﯾﺎﻤﺣ, ﻥﺩﺭﻭﺁﺖﺳﺩﻪﺑ, ﻆﻔﺣ, ﻦﺘﺷﺍﺩﻪﮕﻧ
ﻁﻮﻘﺳ: ﻑﺩﺎﺼﺗ, ﻁﻮﻘﺳ
ﺪﻗﺎﻓ: ﺵﺮﺑ, ﻪﻠﯿﺒﻗ
ﯽﺠﯾﺭﺪﺗ: ﯽﻣﺍﺭﺁﻪﺑ
ﻥﺪﺷﻪﻟ: ﻦﺘﻓﺭﻦﯿﺑﺯﺍ, ﻦﯿﻣﺯﻪﺑﺫﺎﺟ, ﺭﺎﺸﻓ, ﻖﺸﻋ
ﻩﺪﯾﺪﭘ: ﻩﺩﺎﻣ, ﻪﻧﺎﺸﻧ
ﻥﺩﺮﮐﺍﺮﺟﺍ: ﻖﺑﺎﻄﻣ, ﻥﺪﯾﻭﺩ, ﻥﺪﯿﻤﻬﻓ, ﻞﻤﻋ, ﯼﺯﺎﺳﻩﺩﺎﯿﭘ
ﻦﺘﻔﮔﮏﯾﺮﺒﺗ: ﺖﻣﻼﺳ, ﯼﺪﻣﺁﺵﻮﺧ, ﺖﮐﺮﺑ
ﺖﻨﻄﻠﺳ: ﯽﺘﻨﻄﻠﺳ
ﻥﺩﺮﻛﺭﺎﺘﻓﺭ: ﻩﺪﻧﺯ, ﻥﺎﻣﺭﺩ
ﯽﻨﺤﻨﻣ: ﻢﯿﻈﻌﺗ
ﯽﺘﺣﺍﺭ: ﯽﻧﺎﺳﺁﻪﺑ, ﯽﺘﺣﺍﺭ
ﻩﺮﺑ: ﺪﻨﻔﺳﻮﮔ
ﯽﻘﻄﻨﻣ: ﯽﻘﻄﻨﻣ
ﯽﯾﺍﺬﻏﻢﯾﮊﺭ: ﺍﺬﻏ, ﺭﺍﺪﻘﻣ
ﯽﯾﺎﻀﻗ: ﻩﺎﮔﺩﺍﺩ, ﯽﻧﻮﻧﺎﻗ
ﺭﺍﻮﺘﺳﺍ: ﻡﻭﺍﺪﻣ, ﻝﺩﺎﻌﺘﻣ, ﺖﺑﺎﺛ, ﻦﯿﭼ
ﯼﺩﺎﻤﺘﻋﺍﯽﺑ: ﻥﺩﺮﻛﻚﺷ, ﯼﺭﺍﺩﺎﻓﻭ
ﺮﭘ: ﺭﺎﻬﺑ
ﯽﮕﺸﯿﻤﻫ: ﻝﻮﻤﻌﻣ, 
ﻪﻧﺎﺒﻠﻃﻭﺍﺩ: ﺐﻠﻃﻭﺍﺩ
: 
ﺖﮐﺍﮊ: ﺖﮐ, ﺖﮐﺍﮊ
ﺎﻨﺷ: ﺎﻨﺷ
ﺮﯿﮕﻤﺸﭼ: ﺖﺴﻫﺐﻟﺎﺟ, ﻪﺟﻮﺗﻞﺑﺎﻗ, ﺭﺍﺬﮔﺮﻴﺛﺎﺗ
ﺮﯾﺯﺭﺩ: ﻦﯿﯾﺎﭘ
ﯽﻧﺎﺘﺳﺍ: ﯽﯾﺎﺘﺳﻭﺭ, ﻥﺎﺘﺳﺍ, ﯼﺍﻪﻘﻄﻨﻣ
: 
: 
ﻥﺍﺮﺒﺟ: ﯼﺮﻤﺘﺴﻣ, ﻩﺰﯾﺎﺟ
ﺱﺪﺣ: ﻥﺰﺑﺱﺪﺣ
ﺖﻣﺪﺨﺸﯿﭘ: ﺭﺍﺰﮕﺘﻣﺪﺧ
ﺞﯾﻭﺮﺗ: ﻥﺩﺮﮐﻞﯿﻬﺴﺗ, ﻥﺩﺮﻛﻖﻳﻮﺸﺗ, ﺩﻼﯿﻣﺯﺍﺪﻌﺑ
ﻥﺩﺍﺩﺹﺎﺼﺘﺧﺍ: ﺪﺼﻗ, ﺮﺑﻥﺩﺮﮐﯼﺯﻮﺴﻟﺩ
ﺖﻣﻮﺼﺧ: ﻥﺩﺮﮐﺖﻣﻭﺎﻘﻣ
ﻊﻧﺎﻣ: ﻊﻧﺎﻣ, ﻝﻼﺘﺧﺍ, ﻞﮑﺸﻣ
: 
ﻉﺭﺯﻭﺖﺸﮐ: ﮎﻼﻣﺍ, ﻪﻧﺎﺨﻠﮔ
ﺮﺘﺳﺎﻓ: ﻥﺩﺮﮐﻞﯿﻬﺴﺗ, ﻦﯾﺩ, ﯽﮕﻧﺎﺧﻥﺍﻮﯿﺣ
ﻦﺘﺷﺍﺬﮔﺽﺮﻌﻣﺭﺩ: ﯽﻠﮐﺡﺮﻃ, ﻥﺩﺮﮐﺵﺎﻓ, ﻦﮐﺯﺎﺑ
ﻪﻠﺻﻭ: ﻪﻄﻘﻧ, ﯽﮕﺘﺴﺒﻟﺩ
ﻪﻔﻗﻭ: ﺢﻳﺮﻔﺗﮓﻧﺯ, ﯼﺭﻮﺨﻟﺩ, ﻊﻧﺎﻣ
: 
ﺖﺴﺷ: ﭻﻨﯾﺍ, ﻞﻬﺟ
ﯽﺑﻼﻘﻧﺍ: ﺏﻼﻘﻧﺍ, ﻝﺎﮑﯾﺩﺍﺭ
: 
: 
ﺭﺍﺮﮑﺗ: ﻦﯿﮕﻨﺳ, ﺭﺮﮑﻣ
ﺭﻭﺁﺖﻔﮕﺷ: ﺐﻳﺮﻏﻭﺐﻴﺠﻋ, ﻥﺩﺮﮐﺕﺎﻣ
ﻡﺎﻌﻧﺍ: ﻩﺮﮑﻤﯿﻧ, ﻪﻠﻗ, ﺖﺤﯿﺼﻧ
ﻥﺩﺯﺪﮕﻟ: ﻝﺎﺒﺗﻮﻓ, ﺲﮑﻋ
ﺪﯾﺪﻬﺗ: ﺰﯿﻣﺁﺪﯾﺪﻬﺗ
ﻞﮕﻨﺟ: ﻞﮕﻨﺟ, ﯽﺸﺣﻭ
ﻪﻨﺷﺎﭘ: ﺎﭘﭻﻣ, ﻪﺷﻮﮔ
ﯽﻟﻮﻤﻌﻣ: ﻝﻮﻤﻌﻣ
: 
ﺖﺧﻮﺳ: ﺖﻔﻧ
ﻡﺍﺭﺁ: ﻡﺍﺭﺁ
ﺪﺼﻘﻣ: ﻑﺪﻫ, ﻪﻘﺒﻃ, ﻊﺿﻭ
ﻕﺎﺠﻨﺳ: ﺯﺍﺭ, ﻥﺯﻮﺳ, ﺩﺮﻣﯽﻠﺳﺎﻨﺗﺖﻟﺁ
ﻡﺍﺮﻬﺑ: ﺱﺭﺎﻣ
ﻪﺘﺴﺑﺍﻭ: ﮏﯾﺮﺷ, ﯽﮕﺘﺳﻮﯿﭘ, ﺕﺍﺯﺍﻮﻣﻪﺑ, ﻪﺘﺴﺑﺍﻭ, ﺖﺳﻭﺩ, ﯽﻧﻭﺎﻌﺗ
ﺮﯾﺮﺷ: ﺪﺳﺎﻓ, ﺪﺑ
ﺖﻓﺎﯿﺿ: ﻦﺸﺟ
ﻖﯿﻗﺩ: ﻩﺪﺷﺖﺳﺭﺩﻪﻧﺍﺩﺎﺘﺳﺍ, ﻖﯿﻤﻋ, ﻻﻮﻟ
ﺱﺎﺒﻟﺪﻤﮐ: ﻪﻨﯿﺑﺎﮐ
ﻪﻨﻨﻘﻣ: ﻥﺩﺮﮐﯽﻧﻮﻧﺎﻗ, ﻪﻨﻨﻘﻣﻩﻮﻗ
ﻪﯿﺷﺎﺣ: ﻪﺒﻟ, ﻩﺯﻮﺣ
ﻥﺎﻣﺮﻬﻗ: ﻥﺎﻣﺮﻬﻗ, ﯽﻧﺎﻣﺮﻬﻗ
ﯼﺭﺍﺪﻬﮕﻧ: ﻆﻔﺣ
: 
ﺕﻭﺎﻔﺘﻣﺭﻮﻄﺑ: ﻕﺮﻓ, ﻪﻧﺎﮔﺍﺪﺟﺭﻮﻃﻪﺑ, ﻒﻠﺘﺨﻣ
ﻦﺘﺨﯾﺮﮔ: ﻥﺪﯾﻭﺩ, ﻦﺘﻓﺭﺭﺩ
ﺪﻨﺑ: ﻥﺎﯾﺮﺟ, ﺪﻨﺑ, ﻪﻟﺎﻘﻣ, ﻢﺠﺣ
: 
ﺐﯿﮐﺮﺗ: ﻖﺘﺸﻣ, ﯽﮕﺘﺳﻮﯿﭘ, ﻩﺪﯿﭽﯿﭘ
ﻩﺮﮔ: ﻩﺩﻮﺗ, ﻦﺘﺷﺍﺩﻪﮕﻧ, ﻩﺮﮔ, ﻝﺎﺼﺗﺍ
ﻁﺎﺒﺗﺭﺍ: ﻁﺎﺒﺗﺭﺍ, ﺵﺭﺍﺰﮔ, ﻪﺟﻮﺗ
ﯽﮔﺪﻨﯾﺎﻤﻧ: ﻥﺎﻣﺯﺎﺳ, ﺖﮐﺮﺷ, ﯼﺭﺍﺩﺍﺮﺘﻓﺩ
ﺪﻨﺧﺯﻮﭘ: ﺪﻨﺨﺒﻟ, ﻝﻮﺻﺍﻭﺍﺩﺍ
ﻩﺮﻈﺘﻨﻣﺮﯿﻏ: ﯽﻌﯿﺒﻃﺮﯿﻏ, ﺭﺎﯿﺴﺑ
: 
ﺕﺍﺮﻫﺎﻈﺗ: ﺶﯾﺎﻤﻧ, ﺱﺭﺎﻣ, ﻩﺪﻨﻫﺩﻥﺎﺸﻧ
ﯽﮔﺩﺮﺴﻓﺍ: ﺱﺮﺘﺳﺍ
ﯽﮕﺘﻔﻫ: ﻪﺘﻔﻫ
ﻦﺘﻓﺮﮔﺖﻧﺎﻣﺍ: ﺭﺎﺒﺘﻋﺍ, ﻝﻮﻗﻞﻘﻧ, ﻥﺩﺮﮐﺎﻋﺩ
ﻡﺭﻭ: ﻡﺭﻮﺗ
ﻉﻮﺿﻮﻣ: ﻉﻮﺿﻮﻣ, ﻩﺩﺎﻣ, ﻥﺎﺘﺳﺍﺩ
: 
ﺖﯾﻮﻘﺗ: , ﺖﯾﻮﻘﺗ
: 
ﺮﻤﻋﻝﻮﻃ: ﯽﮔﺪﻧﺯﮏﺒﺳ, ﻥﺩﺯﮓﻧﺯ
ﻢﮑﺣ: ﻥﻮﻧﺎﻗ
ﺖﻔﺻ: ﺍﻮﻘﺗ
ﺫﻮﻔﻧ: ﺐﯿﻠﺻ, ﻥﺩﺍﺩﺭﺎﺸﺘﻧﺍ
ﺖﯾﻮﻫﺺﯿﺨﺸﺗ: ﺖﯾﻮﻫ, ﻒﯾﺮﻌﺗ, ﺺﯿﺨﺸﺗ
: 
ﻦﯿﺘﺳﺍ: ﯽﺷﻭﺮﻓﻩﺩﺮﺧ, ﺖﺸﮕﻧﺍ
: 
ﺲﮑﻋ: ﺮﯾﻮﺼﺗ, ﺲﮑﻋ
ﺪﺤﺘﻣ: ﺖﺳﻭﺩ, ﻪﻧﺎﺘﺳﻭﺩ, ﺪﺤﺘﻣ, ﺮﺻﺎﻨﻋ
ﻕﺪﻨﺧ: ﺮﮕﻨﺳ, ﻝﺍﺩﻮﮔ
ﻪﻟﺎﺳﺭ: ﺮﯿﺴﻣ, ﻂﺴﺑ, ﻝﺪﺟﻭﺚﺤﺑ, ﺕﻮﺑﺎﺗ
ﻥﺎﺑﻭﺭ: ﺪﻧﺎﺑ, ﺎﻤﻨﯿﺳﻢﻠﯿﻓ
ﻩﻭﻼﻌﺑ: ﺶﯿﺑ
ﺮﻄﻋ: ﻮﺑ, ﺮﻄﻌﻣ
ﺖﻤﺣﺯ: ﻞﮑﺸﻣ, ﻥﺩﺮﮐﻪﻠﺧﺍﺪﻣ, ﯼﺭﻮﺨﻟﺩ, ﯽﺠﯿﮔ
ﻪﻟﺎﻘﻣ: ﻪﻟﺎﻘﻣ, ﺵﺭﺍﺰﮔ
: 
ﺭﺍﻮﺳ: ﯼﺭﺍﻮﺳ
ﯽﯾﺎﻬﻨﺗ: ﺎﻬﻨﺗ, ﺕﻮﮑﺳ
ﺖﺳﺩﭻﻣ: ﺖﺳﺩ, ﺾﺒﻧ
ﺰﯾﺭ: ﻡﺮﻧ, ﻒﯿﻄﻟ, ﺖﯾﺎﻬﻧﺭﺩ
ﯽﻟ: 
ﯼﺭﻭﻩﺮﻬﺑ: ﺖﯿﻠﺑﺎﻗ, ﻩﺩﺯﺎﺑ, ﻪﺑﺭﺩﺎﻗ
ﻥﺩﺮﮐﻡﻮﮑﺤﻣ: ﻪﻠﻤﺟ, ﺮﺑﻥﺩﺮﮐﯼﺯﻮﺴﻟﺩ, ﺭﺎﮑﻫﺎﻨﮔ, ﺶﻧﺯﺮﺳ
ﮏﻓ: ﻥﺎﻣﺭﺩ
ﺩﺮﻔﺑﺮﺼﺤﻨﻣ: ﺪﺤﺘﻣ
ﺭﺎﭼﺎﻧﻪﺑ: ﺮﯾﺬﭘﺎﻧﺏﺎﻨﺘﺟﺍ
ﻞﺒﻃ: ﺺﻗﺭ, ﯽﻟﺎﺧ
ﺐﯾﻮﺼﺗ: ﺪﯿﯾﺎﺗ
ﻦﺑ: ﻪﺒﻌﺟ, ﺪﺒﺳ
: 
ﻥﺎﻣﺯﺕﺪﻣ: ﺖﻗﻮﻣ, ﻥﺎﻣﺯ, ﻝﻮﻃ
ﻥﺯﻭ: ﻦﺘﻓﺮﮔﻩﺯﺍﺪﻧﺍ
ﻪﻌﻣﻮﺻ: ﻪﻌﻣﻮﺻ
ﺭﺎﺸﺘﻧﺍ: ﺭﺎﺸﺘﻧﺍ, ﻊﯾﺯﻮﺗ, ﻥﺩﺮﮐﺵﺎﻓ
ﺶﻨﯿﺑ: ﻥﺩﺮﻛﻙﺭﺩ
ﺎﻌﻄﻗ: ﺍﺪﮐﻮﻣ, ﻩﺭﻭﺩ
: 
ﺮﯿﯿﻐﺗ: ﻥﺩﺍﺩﺮﯿﯿﻐﺗ, ﺭﻮﺒﻋ
ﺐﺸﻣﺍ: ﺐﺷ
ﻞﻣﺎﻋ: ﺪﻨﻣﺭﺎﮐ, ﺐﯾﺮﺿ, ﺮﺻﺎﻨﻋ
ﯽﮕﺘﺨﯾﺭﻢﻬﺑ: ﺰﯿﻣﺁﺖﻧﻮﺸﺧ, ﻝﻼﺘﺧﺍ, ﯽﺠﯿﮔ
ﻞﻤﻋ: ﻦﯾﺮﻤﺗ, ﻞﻤﻋ
ﺏﺍﺮﺤﻣ: ﺏﺍﺮﺤﻣ
ﯽﻗﺎﻔﺗﺍ: ﻝﻮﻤﻌﻣ, ﺖﻗﻮﻣ, ﯽﻓﺩﺎﺼﺗ, 
ﯽﺨﯾﺭﺎﺗ: ﯽﺨﯾﺭﺎﺗ
ﻪﻠﺻﻮﺣﯽﺑ: ﻥﺩﺮﮐﺥﺍﺭﻮﺳﻪﺘﻣﺎﺑ, ﮏﯾﺮﺤﺗ
ﻥﺪﺷﮏﭼﻮﮐ: ﻥﺩﺮﮐﻊﻤﺟ
ﻪﻨﯾﺰﻫ: ﻪﻨﯾﺰﻫ, ﻥﺩﺮﮐﻩﺩﺎﻔﺘﺳﺍ
ﻩﺪﻨﻨﮐﻡﺮﮕﻟﺩ: ﺐﻠﻗ
ﮏﯿﺗﺎﻤﻠﭙﯾﺩ: ﯼﺮﮔﻪﻠﯿﺣ
ﻩﺎﮔﺭﺎﮐ: ﻩﺎﮔﺭﺎﮐ
ﻪﺋﺍﺭﺍ: ﻥﺎﯿﺑ, ﺵﺭﺍﺰﮔ, ﺮﺛﺍ, ﮏﺒﺳ, ﻞﻤﻌﻟﺍﺲﻜﻋ
ﻡﺎﺧ: ﺖﺷﺭﺩ, ﺰﺒﺳ
ﺯﻭﺎﺠﺗ: ﺯﻭﺎﺠﺗ, ﺐﯿﻠﺻ, ﻦﯾﺮﺘﺸﯿﺑ
ﻥﺪﯿﺸﺨﺑﻡﺎﻬﻟﺍ: ﻥﺩﺮﻛﻖﻳﻮﺸﺗ, ﻡﺎﻬﻟﺍ
ﻂﯿﻠﺑ: ﻢﭼﺮﭘ, ﻪﺸﻘﻧ
ﺐﻘﻋﻪﺑ: ﺖﺸﮔﺯﺎﺑ, ﺎﻔﻌﺘﺳﺍ
ﺶﻔﮐ: ﺶﻔﮐ, ﻦﯿﺗﻮﭘ
ﺐﻠﻘﺗ: ﻝﺎﯿﺧ, ﯼﺭﺎﮐﺖﺳﺩ
ﺭﺎﺠﻔﻧﺍ: ﺭﺎﺠﻔﻧﺍ
ﯼﺭﺎﺨﺑ: ﺶﮐﺩﻭﺩ, ﺭﺩﺍﺮﺑ, ﯼﺯﻮﺳﺶﺗﺁ, ﻕﺎﺟﺍ
ﻪﺸﯿﺷ: ﻪﺸﯿﺷ, ﻥﺍﺪﻠﮔ
ﺏﺭ: ﺲﺳ
ﺪﺳﺎﻓ: ﻞﺒﻨﺗ, ﺪﺳﺎﻓ
ﺭﺎﺘﻓﺭ: ﺭﺎﺘﻓﺭ
ﻩﺯﻭﺮﻣﺍ: ﺯﻭﺮﯾﺩ, ﺮﺿﺎﺣﻝﺎﺣﺭﺩ, ﯽﮔﺯﺎﺗﻪﺑ, ﻥﺭﺪﻣ
: 
ﻡﺍﻭ: ﺭﺎﺒﺘﻋﺍ, ﻝﻮﻗﻞﻘﻧ
ﻞﯿﻟﺩﯽﺑ: ﯽﻘﻄﻨﻣ, ﻑﺮﺧﺰﻣ, ﯽﻘﻄﻨﻣﺮﯿﻏ, ﺍﻭﺮﭘﯽﺑ
ﺕﻮﻬﺷ: ﯽﺒﻠﻃﻩﺎﺟ, ﻦﺘﺷﺍﺩﻞﻳﺎﻤﺗ
ﻪﻧﻻﺎﺳ: ﻝﺎﺳ
: 
ﻊﯾﺎﻣ: ﺏﺍ
ﻪﭽﺑ: ﺎﻫﻪﭽﺑ
ﻪﻧﺍﻮﯾﺩ: ﻖﻤﺣﺍ
ﯽﻧﻮﮕﻧﺮﺳ: ﻦﺘﺨﯾﺭ, ﺖﯾﺎﻬﻧﺭﺩ
ﺖﯿﻘﻓﻮﻣ: ﺖﯿﻘﻓﻮﻣ, ﯼﺭﺍﺩﺮﺑﻩﺮﻬﺑ
ﺽﺮﻓ: ﺪﯿﻨﮐﺽﺮﻓ, ﯽﮐﺍﺭﺩﺍ, ﺫﺎﺨﺗﺍ, ﻩﺪﺷﻢﺧ, ﻒﯿﻔﺨﺗ
ﯽﻫﺎﮑﻓ: ﯽﻌﺒﻃﺥﻮﺷ, ﺭﺍﺩﻩﺪﻨﺧ
ﯽﮕﺘﺴﺸﻧﺯﺎﺑ: ﻪﺘﺴﺸﻧﺯﺎﺑ, ﺎﻔﻌﺘﺳﺍ
ﻆﻔﻠﺗ: ﻪﺠﻬﻟ
: 
: 
ﺲﻠﺠﻣ: ﻪﻨﻨﻘﻣﻩﻮﻗ, ﺎﻨﺳﺲﻠﺠﻣ
ﻥﺪﯾﺰﺧ: ﯼﺩﺭﻮﻧﮓﻨﺳ
ﯼﺭﺍﺮﻄﺿﺍ: ﺲﭘﺍﻮﻟﺩ, ﻥﺍﺮﺤﺑ
ﻪﺘﺴﺑ: ﻪﺘﺴﺑ, ﺶﺨﺑ
ﻮﺸﮐ: ﻪﺒﻌﺟ, ﺎﻫﻪﻠﭘ
ﻢﻬﺳ: ﺖﮐﺭﺎﺸﻣ, ﻁﺮﺷ, ﯼﺭﺎﮑﻤﻫ
ﻥﺩﺍﺩﻁﺎﺒﺗﺭﺍ: ﯽﮕﺘﺴﺒﻟﺩ
ﺕﺍﺮﺟﻭﻝﺩ: ﺖﻋﺎﺠﺷ, ﺕﻮﺗ, ﻥﺩﺮﮐﯼﺫﺎﺧﺍ
ﭖﺎﭼ: ﺭﺎﺸﺘﻧﺍ, ﭖﺎﭼ, ﯽﺑﺍﮎﻮﺧ, ﺕﺎﻋﻮﺒﻄﻣ
ﻊﻓﺍﺪﻣ: ﻞﯿﮐﻭ, ﻪﯿﺟﻮﺗ, ﻊﻓﺍﺪﻣ
ﻂﯿﺤﻣ: ﻮﺟ, ﺯﺍﺪﻧﺍﻢﺸﭼ, ﻑﺍﺮﻃﺍ
ﻥﺩﺮﻛﺪﻴﻳﺎﺗ: ﻥﺩﺮﻛﺖﺑﺎﺛ, ﻥﺩﺍﺩﻥﺎﻨﯿﻤﻃﺍ, ﺪﯿﯾﺎﺗ, ﺖﯾﻮﻘﺗ
ﺮﻫﺎﻣ: ﻪﺑﺭﺩﺎﻗ, ﻂﯾﺍﺮﺷﺪﺟﺍﻭ
ﻡﻼﻋﺍ: ﻥﺩﺮﮐﺵﺎﻓ, ﺭﺎﺸﺘﻧﺍ
ﺎﻔﻌﺘﺳﺍ: ﺎﻔﻌﺘﺳﺍ
ﺩﺭ: ﻥﺩﺮﮐﺖﻣﻭﺎﻘﻣ, ﺩﺭ
ﺖﺨﺳ: ﺖﺨﺳ, ﻪﻧﺎﻤﻟﺎﻇ, ﻪﺘﺷﺮﻓ
ﻪﻌﻄﻗ: ﻪﺷﺍﺮﺗ, ﻪﺿﺍﺮﻗ, ﻂﺴﺑ, ﻢﯿﺴﻘﺗ, ﻥﺍﻮﺗ
ﻪﺒﻗﺍﺮﻣ: ﻥﺩﺍﺩﺖﻴﻤﻫﺍ, ﻥﺩﺮﮐﺲﮑﻌﻨﻣ
ﻪﮑﻟ: ﻪﻄﻘﻧ
ﯼﺭﺎﭙﺴﮐﺎﺧ: ﯼﺭﺎﭙﺴﮐﺎﺧ
ﻪﯿﺿﺮﻓ: ﺪﯿﻨﮐﺽﺮﻓ
ﯽﺿﺮﻓﺖﻟﺎﺣ: ﯼﺮﮑﻔﺗﺖﻟﺎﺣ, ﯽﺿﺮﻓﺖﻟﺎﺣ, ﻁﻭﺮﺸﻣﺖﻟﺎﺣ
ﺶﻨﮐﺍﺮﺗ: ﺖﯿﻟﺎﻌﻓ, ﺕﺭﺎﺠﺗ, ﻁﺎﺒﺗﺭﺍ
ﺖﻣﺮﺣﮏﺘﻫ: ﺯﻭﺎﺠﺗ, ﻢﺸﺧ, ﺮﯿﻘﺤﺗ, ﻡﺮﺷ
ﺕﻭﺎﻔﺘﻣ: ﺮﯿﻐﺘﻣ, ﻒﻠﺘﺨﻣ, ﻥﺩﺮﮐﻦﯾﺰﮕﯾﺎﺟ
ﻞﯿﮐﻭ: ﻞﯿﮐﻭ, ﻩﺪﻨﯾﺎﻤﻧ
ﻥﺩﺮﮐﺖﯾﺫﺍ: ﻦﯿﻫﻮﺗ, ﺭﺎﮑﻫﺎﻨﮔ, ﺩﺭ, ﺵﺍﺮﺧ
ﻪﺘﺴﺑ: ﻪﺘﺴﺑ, ﺐﯿﺟ
ﻪﻋﺭﺰﻣ: ﺭﺎﻫﺎﻧ
ﻥﺩﺮﮐﻢﻬﺘﻣ: ﺶﻧﺯﺮﺳ
ﺲﻧﺎﺷ: ﻝﺎﻤﺘﺣﺍ
ﯼﺎﭘ: ﮏﯿﮐ
ﯽﮕﺘﺴﺸﻧﺯﺎﺑﻕﻮﻘﺣ: ﻮﺤﻧ, ﻪﺘﺴﺸﻧﺯﺎﺑ
ﻞﻌﻓ: ﻩﮊﺍﻭ
ﺖﻗﺩ: ﺖﺳﺭﺩ, ﺍﺪﮐﻮﻣ, ﻞﻣﺎﮐﺭﻮﻄﺑ
ﺮﻄﺧ: ﺍﺮﺟﺎﻣ, ﻥﺍﺮﺤﺑ, ﺮﻄﺧ, 
: 
ﻥﺩﺮﮐﺕﺮﭘ: ﺐﻟﺎﻗ, ﻪﺿﺍﺮﻗ
ﯽﯾﺎﯾﺭﺩ: ﯽﯾﺎﯾﺭﺩﯼﻭﺮﯿﻧ, ﺎﯾﺭﺩ
: 
ﻕﺮﺑ: ﮏﯿﻧﻭﺮﺘﮑﻟﺍ, ﻥﺎﯾﺮﺟ, ﻪﻣﺎﻨﯿﮔﺪﻧﺯ
ﻪﻧﺎﮕﯿﺑ: ﯽﺟﺭﺎﺧ, ﻥﺎﻤﻬﻣ, ﻦﯿﻣﺯﻂﯿﺤﻣﺯﺍﻥﻭﺮﯿﺑ
ﻩﺩﺭﻮﺧﮎﺮﺗ: ﺭﺎﺠﻔﻧﺍ, ﮎﺮﺗ
ﻩﺩﺮﺴﻓﺍ: ﻦﯿﮕﻤﻏ, ﻩﺩﺮﺴﻓﺍ
ﺰﻨﻃ: ﯽﺘﺨﺑﺪﺑ
ﻢﯿﺨﺿﺎﺘﺒﺴﻧ: ﻢﯿﺨﺿ
ﯽﻘﻄﻨﻣ: ﯽﻘﻄﻨﻣ
ﻞﺑﺎﮐ: ﯽﻟﺎﺧﻮﺗ, ﻥﺩﺮﮐﻢﺧ
ﻥﺩﺍﺩﻥﺎﺸﻧ: ﺢﯿﺿﻮﺗ, ﻝﺎﺜﻣ
ﻡﺎﻧﺪﺑ: ﻡﺎﻨﮑﯿﻧ
ﻥﺩﺯﺐﯿﺳﺍ: ﯽﮔﺪﯾﺩﺐﯿﺳﺁ
ﺖﺳﺭﺩ: ﺖﺳﺭﺩ, ﺏﻮﺧﺭﺎﻴﺴﺑ
ﻥﺪﯾﺮﭼ: ﺭﺍﺰﻔﻠﻋ
: 
ﻡﺮﮐ: ﮏﺳﺎﻣ, ﻖﯿﻤﻋ, ﻩﺮﺸﺣ
ﻥﺩﺮﮐﺩﺭﻭﺁﺮﺑ: ﻥﺰﺑﺱﺪﺣ
ﺶﯾﺍﺮﯾﻭ: ﺵﺯﺍﺩﺮﭘﻝﺎﺣﺭﺩ
ﮒﺮﺑﻭﺯﺎﺳ: ﻥﺎﻣﺯﺎﺳ, ﺕﺍﺰﯿﻬﺠﺗ, ﺩﺎﺸﮔﻭﺪﻨﻠﺑﺱﺎﺒﻟ, ﺕﺎﯿﺑﺩﺍ
ﺲﻧﺎﺷﺪﺑ: ﻒﺳﺎﺗﻪﯾﺎﻣ
ﻢﺘﺸﻫ: ﺖﺸﻫ
ﻡﺍﺭﺁ: ﯽﺘﺣﺍﺭ, ﺵﺎﺑﻡﻭﺭﺁ, ﻡﺍﺭﺁ, ﺖﺑﺎﺛ
ﺭﻭﺎﺠﻣ: ﮏﯾﺩﺰﻧ, ﻑﺍﺮﻃﺍ
: 
ﯼﺎﻫﻪﺒﻨﺟ: ﺕﺎﻧﺎﮑﻣﺍ
ﺪﺷﺭﺍ: ﻦﯾﺪﻟﺍﻭ
ﯽﺑﺮﻣ: ﯽﺑﺮﻣ, ﺩﺭ
ﺖﻗﺮﺳ: ﺕﺭﺎﻏ, ﺖﻗﺮﺳ, ﯼﺭﺍﺩﺮﺑﻩﺮﻬﺑ
ﺕﺭﺎﺠﺗ: ﺕﺭﺎﺠﺗ
: 
ﯽﻓﺩﺎﺼﺗ: ﻑﺩﺎﺼﺗ, ﯽﻓﺩﺎﺼﺗ, ﺖﻗﻮﻣ, ﻥﺩﺮﮐﺮﯿﮕﻠﻓﺎﻏ, ﺍﺪﻤﻋ
ﻞﺤﻣ: ﻪﻧﺎﺧ, ﻪﻄﻘﻧ, ﺎﻨﺑ
ﻞﯾﻮﺤﺗ: ﻥﺩﺮﮐﯽﻓﺮﻌﻣ, ﭖﻮﺗ
: 
ﯽﻨﺤﻨﻣ: ﻩﺪﺷﻢﺧ, ﻥﺩﺮﮐﻢﺧ
ﻩﺪﻨﻨﮐﺪﯿﻟﻮﺗ: ﻥﺩﺮﮐﺪﯿﻟﻮﺗ
ﺕﺍﺮﯿﯿﻐﺗ: ﻕﺮﻓ, ﮏﯿﮑﻔﺗ, ﻥﺩﺍﺩﺮﯿﯿﻐﺗ
ﻡﺭﻮﺘﻣ: ﻡﺭﻮﺗ
ﺖﺸﮐ: ﻥﺩﺮﮐﺪﺷﺭ
ﺮﯿﯿﻐﺗ: ﻥﺩﺍﺩﺮﯿﯿﻐﺗ, ﻒﻠﺘﺨﻣ, ﻕﺮﻓ
ﻩﺯﺍﺪﻧﺍ: ﺕﺪﺷ
ﻒﯾﺮﺣ: ﺐﯿﻗﺭ, ﺩﺭ, ﻦﻤﺷﺩ
ﻩﻮﻧ: ﻩﻮﻧ, ﺭﺩﺍﺮﺑﺎﯾﺮﻫﺍﻮﺧﺮﺴﭘ
ﻦﺧﺎﻧ: ﻦﺧﺎﻧ, ﭻﯿﭘ
ﯽﻫﺍﻮﺧﺮﯿﺧ: ﻩﺎﻓﺭ, ﺍﻮﻘﺗ
ﺖﻗﺩ: ﺹﻮﻠﺧ
ﻪﻧﺎﺸﻧ: ﻪﻧﺎﺸﻧ, ﺖﻣﻼﻋ, ﺖﺳﮊ
: 
ﺶﻫﺎﮐ: ﺵﺮﺑ, ﺭﺎﺸﻓ, ﺰﻣﺮﻗ
ﻪﺑﻥﺩﺯﺖﺳﺩﻪﺘﺴﻫﺍ: ﻥﺍﺪﻠﮔ
ﺩﻮﻨﺷﻭﺖﻔﮔ: ﻩﺮﮐﺍﺬﻣ, ﻁﺎﺒﺗﺭﺍ
ﻢﮑﺷ: ﻩﺪﻌﻣ, ﻑﺎﻧ, ﯽﺘﺸﮐ
ﯽﺷﻮﮐﺖﺨﺳ: ﻥﺩﺮﻛﺵﻼﺗ
ﺮﺟﺰﻨﻣ: ﺕﺮﻔﻧ
ﻥﺩﻭﺮﺳ: ﻦﺘﺷﻮﻧ, ﻞﻌﺟ, ﻥﺩﺍﺩﻢﯿﻤﻌﺗ, ﯼﺭﻭﺁﺩﺮﮔ
: 
: 
ﺾﻗﺎﻨﺗ: ﺰﯿﮕﻧﺍﺮﺑﺚﺤﺑ, ﻥﺩﺮﮐﺖﻣﻭﺎﻘﻣ
: 
ﺮﻓﺎﺴﻣ: ﺮﻓﺎﺴﻣ
ﺶﯿﻧ: ﻥﺩﺯﻢﺧﺯ, ﺦﻠﺗ, ﺶﯿﻧ
ﻥﺎﻣﺰﻤﻫﺭﻮﻄﺑ: ﻦﻤﺿﺭﺩ, ﯽﻌﻤﺟ
ﺖﻤﺴﻗ: ﻢﻬﻣ, ﺶﺨﺑ
ﻥﺪﯿﺳﺭ: ﻥﺪﯿﻤﻬﻓ, ﻪﺘﻓﺮﮔﺕﺎﺸﻧ, ﻥﺩﺭﻭﺁﺖﺳﺩﻪﺑ, ﻞﻣﺎﺷ
ﻥﺩﺮﻣﯽﮕﻨﺳﺮﮔﺯﺍ: ﻪﻨﺳﺮﮔ
ﻩﺭﻭﺎﺸﻣ: ﺖﺤﯿﺼﻧ, ﻩﺮﮐﺍﺬﻣ
ﺰﺑ: ﺪﻨﻔﺳﻮﮔ, ﻦﯾﺮﻠﮐ
ﻁﺎﯿﺧ: 
ﺵﺮﺗ: ﺪﯿﺳﺍ
ﻂﺧﺭﺍﺩﻂﺧﺮﯾﺯ: ﺱﺮﺘﺳﺍ, ﻥﺩﺮﮐﺭﺍﺮﺻﺍ
ﻩﮊﺭ: ﺱﺭﺎﻣ
ﯽﻨﻤﯾﺍﻩﻼﮐ: ﻩﻼﮐ
ﻡﻼﻋﺍ: ﺭﺎﺸﺘﻧﺍ
ﺖﻣﺎﻗﺍﻞﺤﻣ: ﻞﺘﻫ, ﻕﺎﺒﻄﻧﺍ
ﻥﺪﯿﺷﺎﭘ: ﻭﺭﺍﺩ, ﻁﺎﺒﺗﺭﺍ, ﻞﺳﻭﺮﺋﺁ
ﯽﻤﺳﺭﺭﻮﻃﻪﺑ: ﯽﻤﺳﺭ, ﯽﻤﺳﺭﺮﯿﻏ
: 
ﻥﺍﺮﮕﻧ: ﯽﺒﺼﻋ, ﻥﺩﺮﮐﻪﻠﺧﺍﺪﻣ, ﺲﭘﺍﻮﻟﺩ, ﯼﺭﻮﺨﻟﺩ
ﻪﺟﺭﺩ: ﻞﭘ, ﺱﻼﮐ, ﺖﯿﻔﯿﮐ, ﺐﯾﺮﺿ
ﻉﻮﻓﺪﻣ: ﯽﻟﺪﻨﺻ
ﻪﯿﺟﻮﺗ: ﻪﯿﺟﻮﺗ
ﯽﺟﺭﺎﺧ: ﯽﺟﺭﺎﺧ, ﻥﺎﻤﻬﻣ
ﻥﺩﺮﮐﻑﺬﺣ: ﻦﺘﺷﺍﺩﺮﺑ
ﻞﻘﻧﻭﻞﻤﺣ: ﻞﻘﻧﻭﻞﻤﺣ
ﺐﻠﻄﻣﮎﺭﺩ: ﻥﺩﺮﻛﻙﺭﺩ
ﻱﺰﻳﺭﻪﻣﺎﻧﺮﺑ: ﺡﺮﻃ
ﺐﯾﺮﻏﻭﺐﯿﺠﻋ: ﺐﻳﺮﻏﻭﺐﻴﺠﻋ
ﺮﯾﺪﻣ: ﺮﯾﺪﻣ, ﺮﺳ
ﯽﻧﺎﻣﺯ: ﺖﻗﻮﻣ, ﻥﺎﻣﺯ
ﻪﻧﺎﻔﯾﺮﻇ: ﻞﮕﺷﻮﺧ, ﺮﯾﺬﭙﻟﺩ, ﺖﯿﻘﻓﻮﻣﺎﺑ, ﻪﺘﻓﺭﻭﻪﺘﺴﺷ
ﯼﺍﺮﺟﺍ: ﻖﺑﺎﻄﻣ, ﻞﯿﻤﺤﺗ, ﺲﯿﻠﭘ, ﯼﺯﺎﺳﻩﺩﺎﯿﭘ
ﯼﺪﻨﺑﻥﺍﻮﺨﺘﺳﺍ: ﻥﺍﻮﺨﺘﺳﺍ, ﺎﻨﺑ
ﻊﻣﺎﺟ: ﻦﻬﭘ, ﻖﯿﻤﻋ, ﻩﺪﺷﺮﭘ, ﻑﺍﺮﻃﺍ, ﺮﺗﻭ
ﻥﺩﺮﮐﺪﯾﺪﻬﺗ: ﺰﯿﻣﺁﺪﯾﺪﻬﺗ
ﯽﻗﺮﺘﻣ: ﻦﺘﻓﺭﺶﯿﭘ, ﻝﺎﮑﯾﺩﺍﺭ
ﻼﯾﻭ: 
ﻊﺑﺎﻨﻣ: ﻊﺑﺎﻨﻣ
ﻥﺩﺮﮐﺩﻭﺪﺤﻣ: ﻥﺩﺮﮐﺐﺣﺎﺼﺗ, ﻥﺩﺮﮐﻩﺎﺗﻮﮐ, ﮏﯾﺭﺎﺑ, ﻥﺍﺮﮐ
ﻦﺘﻔﮔﮏﯾﺮﺒﺗ: ﺶﯾﺎﺘﺳ
ﻪﻤﯿﺑ: ﺮﻄﺧﯽﺑ
ﻦﯿﯿﻌﺗ: ﻢﺸﭼ, ﻥﺩﺮﻛﺏﺎﺨﺘﻧﺍ
ﻥﺩﺮﮐﻊﻄﻗ: ﻥﺩﺮﮐﺖﻣﻭﺎﻘﻣ, ﺵﺮﺑ, ﻥﺩﺮﮐﻪﻠﺧﺍﺪﻣ, ﻥﺩﺮﮐﺍﺪﺟ, ﺢﻳﺮﻔﺗﮓﻧﺯ
ﻥﺩﺮﮐﺏﻮﮐﺮﺳ: ﻥﺩﺮﮐﻢﺘﺳ, ﻥﺩﺮﮐﯼﺮﯿﮔﻮﻠﺟ
: 
ﻪﯾﻻ: ﺱﻼﮐ
ﺪﯿﻠﮐ: ﮎﺭﺪﻣ, ﺪﯿﻠﮐ
ﻥﺍﺪﻧﺩ: ﺎﻬﻧﺍﺪﻧﺩ
ﻎﻟﺎﺑ: ﻎﻟﺎﺑ, ﺎﻧﺍﺩ
ﯽﮕﺘﺴﺑﺍﻭ: ﺩﺎﺘﻌﻣ, ﻪﯿﮑﺗ, ﻦﺘﺷﺍﺩﺩﺎﻘﺘﻋﺍ
ﺖﻧﺎﻤﺿ: ﻥﺩﺍﺩﻥﺎﻨﯿﻤﻃﺍ, ﺖﻧﺎﻤﺿ
ﺵﻭﺭ: ﻡﺰﯿﻧﺎﮑﻣ, ﻞﻤﻋ, ﺵﻭﺭ, ﺵﺯﺍﺩﺮﭘﻝﺎﺣﺭﺩ
ﻪﯿﺻﻮﺗ: ﺪﻫﺩﯽﻣﺩﺎﻬﻨﺸﯿﭘ, ﺖﺤﯿﺼﻧ
ﻑﺎﮑﺷ: ﺢﻳﺮﻔﺗﮓﻧﺯ, ﺡﺎﺘﺘﻓﺍ, ﻕﺮﻓ, ﻪﻠﺻﺎﻓ
: 
ﺪﻨﻧﺎﺳﺮﯿﻣﺍﺭﻡﻮﻬﻔﻣﻦﯾﺍ: ﻦﺘﺷﺍﺩﺭﻮﻈﻨﻣ, ﺪﻫﺩﯽﻣﺩﺎﻬﻨﺸﯿﭘ
ﻪﻤﯿﻤﺿ: ﻪﺘﺴﺑﺍﻭ, ﻥﺩﺮﮐﻞﺼﺘﻣﻢﻫﺎﺑ
ﺖﻟﺎﺣ: ﺖﺳﮊ, ﺺﺧﺎﺷ, ﺖﯿﻌﻗﻮﻣ, ﻥﺩﺎﺘﺴﯾﺍ
ﺪﻐﺟ: ﻩﺪﻧﺮﭘ
ﻪﻋﻮﻤﺠﻣ: ﻝﺎﺑ, ﻢﯿﻈﻨﺗ, ﯽﻧﻮﮑﺴﻣﻥﺎﻤﺗﺭﺎﭘﺁ
ﺮﻫﺍﻮﺟ: ﺞﻨﮔ, ﻥﺪﺷﺎﻓﻮﮑﺷ, ﺖﻧﺎﻤﺿ
: 
ﻡﻭﺩﻪﻠﺣﺮﻣﺭﺩ: ﻦﯿﻣﻭﺩ
ﻦﻟﻮﯾﻭ: 
: 
ﯽﻔﻃﺎﻋ: ﺱﺎﺴﺣﺍ, ﺱﺎﺴﺣ
ﻦﺘﺑ: ﯽﺸﯾﺎﻤﻧ
ﻦﺘﺨﯿﻣﺁ: ﺩﺎﺤﺗﺍ, ﻡﺎﻏﺩﺍ, ﯽﮕﺘﺳﻮﯿﭘ
ﺐﯿﺗﺮﺗﻪﺑ: ﻕﺮﻓ
ﺝﻭﺍ: ﻪﻠﻗ, ﺱﺍﺭ
ﻝﻮﭘﺪﺣﺍﻭ: ﻝﻮﭘ, ﻪﮑﺳ, ﻝﺩﺎﺒﺗ
ﻑﺪﻫ: ﻑﺪﻫ, ﺰﮐﺮﻤﺗ
ﺩﻮﺑﺩﺎﯾ: ﻪﻈﻓﺎﺣ, ﺭﺍﺪﺸﻫ
: 
: 
ﻪﻧﺎﮔﺍﺪﺟﺕﺭﻮﺼﺑ: ﻢﻫﺯﺍﺍﺪﺟ, ﻒﻠﺘﺨﻣ, ﻪﻧﺎﮔﺍﺪﺟﺭﻮﻃﻪﺑ, ﺎﻬﻨﺗ, ﻞﻘﺘﺴﻣﺭﻮﻃﻪﺑ
ﯽﻨﯿﺳ: ﮏﺴﯾﺩ
ﯽﻘﻓﺍ: ﻝﺩﺎﻌﺗ, ﺕﺍﺯﺍﻮﻣﻪﺑ
ﻪﻨﺸﺗ: ﯽﮕﻨﺸﺗ
ﺭﻮﺸﻨﻣ: ﻲﺳﺎﺳﺍﻥﻮﻧﺎﻗ, ﺬﻏﺎﮐ, ﻥﺩﺮﮐﻩﺭﺎﺟﺍ
ﺩﺭﻮﻣ: ﺕﻻﻮﺼﺤﻣ, ﻪﻟﺎﻘﻣ, ﺍﺪﺻ, ﯼﺯﺎﺳﺐﺗﺮﻣ, ﺖﯿﻌﻗﻮﻣ, ﻥﺩﺮﮔ
: 
ﻪﺒﺳﺎﺤﻣ: ﺏﺎﺴﺣ, ﯼﺭﺎﻤﺷﺮﺳ, ﺱﻮﻨﯿﺴﮐ, ﻥﺩﺮﮐﻪﺒﺳﺎﺤﻣ, ﺏﺎﺴﺘﺣﺍﺎﺑ
ﻪﻌﺳﻮﺗ: ﻥﺩﺍﺩﺭﺎﺸﺘﻧﺍ, ﻥﺩﺮﮐﻦﻬﭘ
ﭻﯿﭘ: ﭻﯿﭘ
ﯽﺘﻨﺳ: ﺖﻨﺳ, ﺲﮐﻭﺪﺗﺭﺍ
ﻞﻣﺎﺷ: ﻪﻠﻤﺟﺯﺍ, ﻞﻣﺎﺷ
ﻝﺍﻭﺭ: ﻝﻮﻤﻌﻣ, ﻡﺰﯿﻧﺎﮑﻣ
ﻥﺩﺮﻛﻞﺣ: ﻥﺩﺯﻢﺨﺷ, ﻞﺷ, ﻥﺩﺮﮐﻒﺸﮐ
ﻥﺩﺮﮐﺍﻮﻏﺍ: ﻦﺘﺧﺍﺪﻧﺍﺖﺳﺩﺍﺭﯽﺴﮐ, ﻥﺩﺮﮐﺭﺍﺩﺍﻭ, ﻪﺳﻮﺳﻭ
ﻖﻓﻮﻣﺎﻧ: ﺖﺴﮑﺷ, ﺖﯿﻘﻓﻮﻣﺎﺑ
ﺭﺍﺪﻤﺘﺳﺎﯿﺳ: ﯽﺳﺎﯿﺳ
: 
ﺕﺍﺭﺮﻘﻣ: ﻥﻮﻧﺎﻗ
ﺾﻘﻧ: ﯽﮔﺪﯾﺩﺐﯿﺳﺁ
ﺲﻴﺋﺭ: ﺮﯾﺪﻣ, ﺎﻣﺮﻓﺭﺎﮐ, ﺮﺳ
ﺎﺘﻤﻫ: ﻒﯿﻠﮑﺗ, ﮎﻭﺩ
ﻪﺠﯿﺘﻧ: ﺖﯿﻘﻓﻮﻣﺎﺑ, ﺮﺛﺍ
ﻪﺘﺷﺭ: ﺎﯾﺭﺩﻞﺣﺎﺳ, ﺪﻧﺎﺑ, ﻞﺣﺎﺳ
: 
ﺯﺮﻣ: ﻪﺒﻟ, ﺐﻟ, ﻞﺣﺎﺳ
ﻻﺎﮐ: ﺕﺭﺎﺠﺗ, ﺕﻻﻮﺼﺤﻣ, ﺮﺟﺎﺗ
ﺭﻭﺩ: ﻢﻫﺯﺍﺍﺪﺟ, ﺭﻭﺩ
ﺏﺎﺴﺘﮐﺍ: ﻥﺩﺭﻭﺁﺖﺳﺩﻪﺑ, ﯽﺳﺮﺘﺳﺩ
ﻩﺎﻨﭘ: ﻥﺎﺘﺳﺭﺎﻤﯿﺑ, ﻩﺎﻨﭘﻥﺎﺟ, ﺪﯿﻌﺒﺗ
ﺪﯿﯾﺄﺗ: ﻥﺩﺮﻛﺖﺑﺎﺛ, ﺪﯿﯾﺎﺗ, ﻥﺩﺍﺩﻥﺎﻨﯿﻤﻃﺍ
ﻥﺎﺒﻏﺎﺑ: ﻍﺎﺑ, 
ﻪﻣﺎﻧﺮﺑ: ﺰﯿﻣ, ﻊﺿﻭ
ﯼﺭﺍﺩﺮﻬﺷ: ﻥﺎﺘﺳﺮﻬﺷ, ﺮﻌﺷ
ﺵﺭﻮﺷ: ﻥﺩﺯﻢﻬﺑ
ﺯﺎﺑﺮﺳﻪﻨﻬﮐ: ﺪﻨﺴﭘﻪﻣﺎﻋ
: 
ﻥﺩﺍﺩﺕﺩﺎﻬﺷ: ﻥﺩﺮﻛﺖﺑﺎﺛ, ﮎﺭﺪﻣ
ﺮﺘﺴﮐﺭﺍ: ﺪﻧﺎﺑ
ﯼﺭﺩﺎﻣ: ﻪﻠﻣﺎﺣ, ﺭﺩﺎﻣ
ﯼﺯﺎﺳﻪﻤﺴﺠﻣ: ﻪﻤﺴﺠﻣ
: 
ﻢﻌﻃ: ﻢﻌﻃ, ﻮﺑ
ﮎﺭﺎﻣ: ﯼﺎﻤﻨﻫﺍﺭﻪﭽﺑﺎﺘﮐ, ﺖﻣﻼﻋ
: 
ﻪﺷﻮﺗ: ﻥﺍﺪﻤﭼ
ﻪﻟﺎﺑﺯ: ﻑﺮﺧﺰﻣ, ﻪﺿﺍﺮﻗ, ﻪﻟﺎﺑﺯ, ﯽﻨﺘﺨﯾﺭﺭﻭﺩ, ﻦﯾﺮﺗﺪﺑ
ﺭﺍﺰﺑﺍ: ﺭﺍﺰﺑﺍ
ﺝﺮﻣﻭﺝﺮﻫ: ﻝﻼﺘﺧﺍ, ﯽﺠﯿﮔ
ﻥﺎﻣﺯ: ﯽﺒﺼﻋ, ﻥﺎﻣﺯ, ﯽﻧﻻﻮﻃ, ﺱﺮﺘﺳﺍ
: 
ﻍﺮﻣ: ﻪﺟﻮﺟ
ﻁﺎﯿﺘﺣﺍﺎﺑ: ﺎﻧﺍﺩ, ﻒﯿﻄﻟ
ﻥﺩﺮﮐﻪﯾﺮﮔ: ﻥﺩﺮﮐﻪﯾﺮﮔ, ﺮﺑﻥﺩﺮﮐﯼﺯﻮﺴﻟﺩ, ﻒﺳﺎﺘﻣ
ﺶﯾﻮﮔ: ﻪﺠﻬﻟ, ﯽﻧﺎﺘﺴﻬﻟ
ﯽﯾﺍﺪﺘﺑﺍ: ﻪﯾﺎﭘ
ﺭﺎﺑ: ﻥﺍﺪﻤﭼ, ﺕﻻﻮﺼﺤﻣ
ﻥﺩﺮﮐﮎﺎﭘ: ﺖﺸﮔﺮﺑﻭﺖﻓﺭ, ﻦﺘﺷﺍﺩﺮﺑ
ﺭﺎﮑﻧﺍ: ﯽﻔﻨﻣ
ﻦﯿﻣﺯﺮﯾﺯ: ﺯﺍﺭ, ﯽﺳﺎﻨﺷﻦﯿﻣﺯ
: 
ﻂﺳﺍﻭﺪﺣ: ﯽﺳﺭﺮﺑ
ﻝﻮﻣﺮﻓ: ﻞﻤﻌﻟﺍﺭﻮﺘﺳﺩ, ﺕﺎﻋﻮﺒﻄﻣ, ﻢﺳﺍﺮﻣ
ﻥﺩﺍﺩﺐﯾﺮﻓ: ﻖﻤﺣﺍ, ﯼﺭﺎﮐﺖﺳﺩ, ﻍﻭﺭﺩ
ﻩﺪﻨﺴﺑﺎﻧ: ﻒﺳﺎﺗﻪﯾﺎﻣ, ﺐﺳﺎﻨﻣﺎﻧ
ﺩﺎﯾﺯﺪﺷﻭﺪﻣﺍ: ﻎﯾﺭﺩ, ﻥﺪﻧﺎﺳﺮﺗ, ﺪﺳﺭﯽﻣﺮﻈﻧﻪﺑ
ﻡﺎﻧﺖﺒﺛ: ﺖﺳﺮﻬﻓ, ﻂﺒﺿ, ﻥﺪﺷﻞﺧﺍﺩ
ﻦﯿﻌﻣﺎﻧ: ﻢﻬﺒﻣ
ﺩﺍﺯﺎﻣ: ﯽﻓﺎﺿﺍ, ﯽﮕﻧﻭﺰﻓﺍ
ﺯﺮﻟ: ﻩﺯﺮﻟ
ﺖﻓﺎﺑ: ﻥﺎﻣﺯﺎﺳ, ﺏﻭ, ﻪﭼﺭﺎﭘ, ﺯﻮﻣ
ﺲﯾﻮﻧﺶﯿﭘ: ﯽﻠﮐﺡﺮﻃ, ﯽﮐﺍﺭﺩﺍ
ﯼﺯﺎﺑﺏﺎﺒﺳﺍ: ﮏﺳﻭﺮﻋ, ﯼﺯﺎﺑ
ﻪﻠﭘ: ﺎﻫﻪﻠﭘ, ﻪﻠﭘ, ﺱﺎﯿﻘﻣ
ﻝﺎﻘﺘﻧﺍ: ﺖﻧﻮﻔﻋ, ﻥﺩﺍﺩﺮﯿﯿﻐﺗ, ﺭﻮﺒﻋ, ﻞﯾﺪﺒﺗ
ﻪﻤﮐﺩ: ﺪﯿﻠﮐ
ﺩﺭﺩﺮﺳ: ﺮﺳ
ﺮﺟﺎﺘﺴﻣ: ﻦﮐﺎﺳ
ﻥﺎﺑﺮﻬﻣﺎﻧ: ﻪﻧﺎﺘﺳﻭﺩﺮﯿﻏ, ﺏﺩﺍﯽﺑ, ﻪﻧﺎﻤﻟﺎﻇ
ﻪﻣﺎﻧﺮﺑ: ﺡﺮﻃ, ﻪﺴﻠﺟﺭﻮﺘﺳﺩ
ﺪﯿﻟﻮﺗ: ﯽﺘﻌﻨﺻ, ﻪﻧﺎﺧﺭﺎﮐ, ﻥﺩﺮﮐﺪﯿﻟﻮﺗ, ﻩﺪﻧﺯﺎﺳ, ﯼﺎﻤﻨﻫﺍﺭﻪﭽﺑﺎﺘﮐ
ﻪﻘﻄﻨﻣ: ﻩﺯﻮﺣ, ﯼﺍﻪﻘﻄﻨﻣ, ﺪﻧﺎﺑ, ﻪﻘﯾ
ﻦﯿﻤﻬﻧ: ﺮﻔﻧﻪﻧ, ﻪﺳ
ﻞﮑﻟﺍ: ﺏﺍﺮﺷ
ﺎﻔﺷ: ﻥﺩﺮﮐﺮﺘﻬﺑ, ﻥﺎﻣﺭﺩ
: 
: 
ﺭﺎﺠﻧ: 
ﻥﺩﺮﮐﺖﯾﺍﺪﻫ: ﯼﺮﺒﻫﺭ, ﺖﯾﺮﯾﺪﻣ, ﻥﺎﻓﻮﻃ, ﺝﻭﺩﺰﻣ, ﯽﺘﺸﮐ
ﺫﻮﻔﻧ: ﺭﺍﺬﮔﺮﻴﺛﺎﺗ
ﻪﻃﺎﺣﺍ: ﻪﻘﯾ, ﻩﺮﺻﺎﺤﻣ
ﻥﺪﺷﻕﺮﻏ: ﯽﯾﻮﺸﻓﺮﻇﮏﻨﯿﺳ
ﺵﺰﻐﻟ: ﺵﺰﻐﻟ
ﻕﺎﭼﻭﻪﺘﺨﻠﺷ: ﯼﺩﺭﻮﻧﮓﻨﺳ, ﻥﺎﻧ, ﮎﻮﺧ
ﺐﻟﺎﻏ: ﯽﻟﺎﻋ
ﯼﺮﺒﻫﺭ: ﯼﺮﺒﻫﺭ, ﺐﺗﺍﺮﻣﻪﻠﺴﻠﺳ, ﯼﺎﻤﻨﻫﺍﺭﻪﭽﺑﺎﺘﮐ, ﻪﺸﻘﻧ, ﯽﮔﺪﻨﻧﺍﺭ
ﻦﺘﻓﺮﮔﻦﺸﺟ: ﻥﺩﺮﮐﺪﻋﺎﻘﺘﻣ
ﭻﮔ: ﭻﮔ, ﻥﺩﺮﮐﻩﺩﺎﻣﺁ, ﻥﺩﺮﮐﻪﻔﺧ
ﻦﺘﻓﺮﮔﺩﺍﺮﯾﺍ: ﻥﺎﺠﯿﻫ, ﯽﺠﯿﮔ
ﻡﺎﻘﻣﻢﺋﺎﻗ: ﻩﺪﻨﯾﺎﻤﻧ, ﻥﻭﺎﻌﻣ
ﻞﯿﺒﻣﻮﺗﺍ: ﺭﻮﺗﻮﻣ, ﻪﯿﻠﻘﻧﻪﻠﯿﺳﻭ
: 
ﺡﻼﺻﺍ: ﺕﺎﺣﻼﺻﺍ, ﯼﺯﺎﺳﺯﺎﺑ
ﯼﺩﻮﻤﻋ: ﻥﺩﺎﺘﺴﯾﺍ, ﯽﻟﻮﻃ
ﯽﻓﺎﮐ: ﯽﻓﺎﮐ
ﯽﺘﻨﻌﻟ: ﻩﺩﺎﻔﺘﺳﺍﻮﺳ
ﺝﺎﺘﻨﺘﺳﺍ: ﻥﺰﺑﺱﺪﺣ, ﻪﺠﯿﺘﻧ
ﯽﻃﺎﺒﻨﺘﺳﺍﺖﻟﺎﺣ: ﯽﺋﺎﻘﻟﺍﺖﻟﺎﺣ
ﺕﺎﻐﯿﻠﺒﺗ: ﺩﻼﯿﻣﺯﺍﺪﻌﺑ
ﯼﺩﺯﺩ: ﺖﻗﺮﺳ
ﺩﻮﺨﺑﺩﻮﺧ: ﻩﺰﯾﺮﻏ, ﻩﺍﻮﺨﻟﺩ, ﯽﻓﺩﺎﺼﺗ
ﺭﺍﺰﺑﺍ: ﻥﺎﻣﺯﺎﺳ, ﻥﺩﺮﮐﻩﺩﺎﻔﺘﺳﺍ, ﺭﺍﺰﺑﺍ, ﻥﺩﺮﮐﻞﯿﻬﺴﺗ
ﻝﺎﺼﺗﺍ: ﺏﻼﻗ, ﻝﺎﺼﺗﺍ, ﻥﺩﺮﮐﻞﺼﺘﻣﻢﻫﺎﺑ, ﻡﺎﻏﺩﺍ, ﻥﺩﺮﮐﻞﺻﻭ
ﻦﯿﯾﺎﭘﻪﺑﻭﺭ: ﻦﯿﯾﺎﭘ
ﻪﻠﺧﺍﺪﻣ: ﻥﺩﺮﮐﻪﻠﺧﺍﺪﻣ
ﺎﯿﺣﺍ: ﯼﺎﯿﺣﺍ
: 
ﺖﻧﺮﺘﻨﯾﺍ: ﺕﺭﺎﺠﺗ
ﯽﻤﺴﺟﻅﺎﺤﻟﺯﺍ: ﮏﯾﺰﯿﻓ, ﻥﺪﺑ
ﻪﻄﻘﻧ: ﻪﻄﻘﻧ, ﺖﺷﺭﺩ
ﻩﺪﻨﻫﺩﻥﺎﮑﺗ: ﻥﺪﺷﻪﮐﻮﺷ
ﻪﻧﺎﺧﺎﺘﺴﮔ: ﺏﺩﺍﯽﺑ
ﺺﺧﺎﺷ: ﻥﺍﻮﺗ, ﺖﺳﺮﻬﻓ, ﺺﺧﺎﺷ
ﺪﺒﮐ: ﻦﯿﮕﻨﺳ
ﻝﺎﻘﺘﻧﺍ: ﻝﺎﺳﺭﺍ, ﻊﯾﺯﻮﺗ
: 
ﯼﻭﺭﺮﺑ: ﻻﺎﺑ
ﻥﺩﺯﭗﮔ: ﻩﺮﮐﺍﺬﻣ, ﺱﺎﺳﺍﯽﺑﺕﺎﻌﯾﺎﺷ
ﺎﺑﺮﻬﮐ: ﺩﺭﺯﮓﻧﺭ
ﻦﺗ: ﻦﺤﻟ
ﺩﻮﻤﻋ: ﺪﻨﺗﺐﯿﺷ
ﺭﺍﻮﻤﻫ: ﻞﻣﺎﮐﺭﻮﻄﺑ
ﺶﻨﺗ: ﺱﺮﺘﺳﺍ, ﻥﺎﺠﯿﻫ, ﺕﺪﺷ
ﮓﻨﻬﻧ: ﺏﺎﺨﺘﻧﺍ
ﯽﻤﺳ: ﻢﺳ
: 
ﺯﺎﯿﺘﻣﺍ: ﺯﺎﯿﺘﻣﺍ, ﻒﯿﻔﺨﺗ
ﺮﮔﺭﺎﮐ: ﺪﻨﻣﺭﺎﮐ
ﺐﯿﺷ: ﺐﯿﺷ, ﺝﻭﺩﺰﻣ
ﺖﻟﺍﻮﺗ: ﻪﻨﯿﺑﺎﮐ
ﺍﺩﻮﺑ: ﯼﺯﻮﺳﺶﺗﺁ
ﻦﯿﻫﻮﺗ: ﻦﯿﻫﻮﺗ, ﻪﻠﻤﺣ
ﻪﻨﯿﮐ: ﺕﺮﻔﻧ, ﻡﺎﻘﺘﻧﺍ
ﯽﯾﺎﺒﯿﮑﺷ: ﺮﺒﺻ, ﺖﻋﺎﺠﺷ
ﯽﻨﯿﺑﺶﯿﭘ: ﺪﯿﻣﺍ, ﯽﻨﯿﺑﺶﯿﭘ
ﻢﺘﯾﺭ: ﻢﺘﺷﻭﺏﺮﺿ
ﺵﻮﻣ: ﺱﻭﺎﻣ
ﻥﺩﻮﺑﻖﺑﺎﻄﻣ: ﻖﺑﺎﻄﻣ, ﻥﺪﺷﺎﺟ, ﻩﺪﺑﺏﺍﻮﺟ, ﻪﺟﻮﺗ
ﺖﺷﺍﺩﺯﺎﺑ: ﻥﺩﺮﮐﯼﺮﯿﮔﻮﻠﺟ, ﻥﺩﺮﮐﺐﺣﺎﺼﺗ, ﻆﻔﺣ, ﺖﺷﺍﺩﺯﺎﺑ
ﺮﯿﺴﻔﺗ: ﺢﯿﺿﻮﺗ
ﻦﻟﺎﺳ: ﻦﻟﺎﺳ
ﻞﻤﻋ: ﯼﺭﺎﮐﺖﺳﺩ, ﺭﺎﮐ, ﻥﺪﯾﻭﺩ, ﻞﻤﻋ, ﺖﯾﺮﯾﺪﻣ
ﯽﺸﮐﻩﺯ: ﻥﺪﺷﻩﺮﻄﻗﻩﺮﻄﻗ, ﻥﺪﯾﻭﺩ, ﺝﻭﺮﺧ, ﻝﺎﻧﺎﮐ
ﻪﻤﺣﺰﻟﺍﻖﺣ: ﺖﺧﺍﺩﺮﭘ
ﻩﺪﻨﻧﺯﻭﺪﻨﺗ: ﺕﺮﻔﻧ, ﺪﺑ, ﺪﻨﯾﺎﺷﻮﺧﺎﻧ, ﻦﯾﺮﺗﺪﺑ, ﺖﺷﺯ
ﻥﺎﺘﺳﺮﺒﻗ: ﯼﺭﺎﭙﺴﮐﺎﺧ, ﺮﺒﻗ
ﺮﯿﺷ: ﻪﻟﻮﻟ, ﻪﺑﻥﺩﺯﺖﺳﺩ
ﺩﺭ: ﻪﺴﯿﮐ, ﺩﺭ, ﯽﮕﻧﻭﺰﻓﺍ, ﺶﺨﺒﺑ
ﮏﯾﺮﺤﺗ: ﻥﺎﺠﯿﻫ, ﮏﯾﺮﺤﺗ, ﻩﺩﺮﺴﻓﺍ
ﻪﺠﻨﭘ: ﻪﺠﻨﭘﮎﻮﻧ, ﺎﭘ, ﺖﺸﮕﻧﺍ
ﺰﺠﻋ: ﯽﻧﺍﻮﺗﺎﻧ, ﻒﻌﺿ
ﻦﯾﺮﺗﺭﻭﺩ: ﺭﻭﺩ
ﻥﺩﺮﻛﻒﻳﺮﻌﺗ: ﻩﺪﺷﺖﺳﺭﺩﻪﻧﺍﺩﺎﺘﺳﺍ
ﺮﺼﺤﻨﻣ: ﻥﺍﺮﮐ, ﻊﻧﺎﻣ
ﻪﺠﻨﮔ: ﻪﻨﯿﺑﺎﮐ, ﻪﭽﻗﺎﺗ
ﮎﺮﺤﻣ: ﻞﻤﻌﻟﺍﺭﻮﺘﺳﺩ, ﮏﯾﺮﺤﺗ, ﻡﺎﻬﻟﺍ
ﻥﺩﺮﮐﺭﺍﺩﻪﻧﺍﺪﻧﺩ: ﻪﭽﻗﺎﺗ, ﻪﺠﻨﮑﺷ, ﻥﺩﺎﺘﺴﯾﺍ
ﺖﺳﺮﭘﺮﺳ: ﺮﺘﺴﮐﺭﺍﺮﺒﻫﺭ
ﻪﺋﺍﺭﺍ: ﻥﺩﺮﮐﯽﻓﺮﻌﻣ, ﺶﯾﺎﻤﻧ, ﻪﻧﺎﺸﻧ, ﻩﺪﻨﻫﺩﻥﺎﺸﻧ
ﮏﯿﺘﺳﻻ: ﭖﻮﺗ, ﻥﺎﺴﺸﮐ
ﻥﺩﺮﮐﻡﻭﺮﺤﻣ: ﻥﺩﺮﮐﻡﻭﺮﺤﻣ, ﻦﺘﺴﺑ
ﺕﻼﮑﺷ: ﻱﺍﻩﻮﻬﻗ
ﺯﺎﺘﻤﻣ: ﺯﺎﯿﺘﻣﺍ
ﯽﻗﺎﻔﺗﺍ: ﻒﺳﺎﺗﻪﯾﺎﻣ
ﺵﺍﺮﺧ: ﺵﺍﺮﺧ, ﻉﻭﺮﺷ
ﭻﯿﭘ: ﭻﯿﭘ
ﻒﺸﮐ: ﻥﺩﺮﮐﻩﺪﻫﺎﺸﻣ, ﯼﺭﺍﺩﺮﺑﻩﺮﻬﺑ
ﻥﺩﺮﮐﻪﻤﯿﺑ: ﻥﺩﺍﺩﻥﺎﻨﯿﻤﻃﺍ
ﺭﺪﻨﻠﯿﺳ: ﮏﺴﯾﺩ
ﻪﺻﻼﺧ: ﯽﻠﮐﺡﺮﻃ, ﻩﺪﯿﮑﭼ, ﻪﺠﯿﺘﻧ
ﺪﯿﻌﺑ: ﻝﺎﻤﺘﺣﺍ
ﻡﺎﺣﺩﺯﺍ: ﻪﻠﮔ, ﺮﺴﭘﺪﻧﺯﺮﻓ
ﯽﻟﻮﺻﺍ: ﻡﺰﯿﻧﺎﮑﻣ
ﺎﺒﯾﺮﻘﺗ: ﮏﯾﺩﺰﻧ, ﯽﻠﻤﻋ
ﻩﺪﻨﻫﺩﺵﺭﺎﻔﺳ: ﯽﺷﺭﺎﻔﺳ, ﻥﺎﻤﻬﻣ
ﺖﺳﺮﻬﻓ: ﺖﺳﺮﻬﻓ, ﺰﯿﻣ, ﯽﻧﺎﻣﺯﺎﺳﺕﺭﺎﭼ
: 
ﯽﻫﺎﻔﺷ: ﻦﯿﻫﻮﺗ, ﯽﻈﻔﻠﻟﺍﺖﺤﺗ, ﻢﯿﻘﺘﺴﻣﺭﻮﻃﻪﺑ
ﯽﻤﯿﺷﻢﻠﻋ: ﯽﯾﺎﯿﻤﯿﺷ
: 
ﺭﻻﻮﮑﺳ: ﯽﺜﻨﺧ
ﻦﺘﺨﭘ: ﻥﺎﻧ, ﻦﺘﺨﭘ, ﻥﺩﺮﮐﺥﺮﺳ
ﻥﺩﺮﮐﺥﺍﺭﻮﺳ: ﻥﺩﺯﻢﺧﺯ, ﻥﺩﺮﮐﺥﺍﺭﻮﺳﻪﺘﻣﺎﺑ, ﻥﺩﺮﮐﺥﺍﺭﻮﺳ
ﻥﺩﻮﺑﺭ: ﻥﺩﺍﺩﺮﺟ, ﻥﺩﺮﮐﺐﺣﺎﺼﺗ, ﯽﯾﺎﺑﺭﻡﺩﺁ
ﯼﺯﺍﺪﻧﺍﻩﺍﺭ: ﺐﻟﺎﻗ
ﻢﯿﻈﻨﺗ: ﻥﻮﻧﺎﻗ
ﯼﺯﺭﻭﺎﺸﮐ: ﯼﺯﺭﻭﺎﺸﮐ
ﻥﺩﺮﮐﺖﻔﺳ: ﺖﺷﺍﺩﺯﺎﺑ, ﺏﻮﺧﺭﺎﻴﺴﺑ
ﺮﮕﯾﺯﺎﺑ: ﺮﮕﯾﺯﺎﺑ
ﺮﺗﺎﺌﺗ: ﺮﺗﺎﺌﺗ, ﻦﻟﺎﺳ
ﻭﺭﺍﺩ: ﻭﺭﺍﺩ, ﻩﺭﺎﺑﺭﺩ
ﺮﻀﻣ: ﻦﯾﺮﺗﺪﺑ, ﺭﺮﺿ, ﯽﻔﻨﻣ, ﻪﻧﺎﺘﺳﻭﺩﺮﯿﻏ
ﺕﺎﺒﻧ: ﻦﯾﺮﯿﺷ
ﺮﯿﻤﺧ: ﻢﯿﻈﻨﺗ
ﻡﻮﮑﺤﻣ: ﻡﺍﺩ, ﺭﺎﮑﻫﺎﻨﮔ, ﯽﻧﺍﺪﻧﺯ
ﯽﺳﺭﺮﺑ: ﻥﺩﺮﮐﻩﺪﻫﺎﺸﻣ, ﯽﺳﺭﺮﺑ, ﯽﺑﺎﯾﺯﺭﺍ
ﻪﺘﺴﺑ: ﻪﺘﺴﺑ, ﻢﯿﻈﻨﺗ
ﯽﻧﺎﻬﮔﺎﻧﻭﻢﮑﺤﻣﻪﺑﺮﺿ: ﮏﯿﻠﮐ, ﺮﯾﻮﺼﺗ, ﺪﻣﻭﺭﺰﺟ, ﯼﺩﻭﺯﻪﺑ
ﮏﯿﺘﺳﻻ: ﻪﻘﻠﺣ
ﻪﺟﻮﺗﻞﺑﺎﻗ: ﻪﺟﻮﺗﻞﺑﺎﻗ, ﻩﺎﮕﻧ
ﻪﺘﺴﻫ: ﻪﯾﺎﭘ, ﻪﺘﺴﻫ, ﻪﻧﺍﺩ
ﻒﻠﺳ: ﺪﺟ, ﯽﻤﯾﺪﻗ
ﻪﺑﺎﺸﻣﺭﻮﻃﻪﺑ: ﯽﭼﻪﺳﺍﻭ
ﺪﺳ: ﮎﺎﺧﻭﺩﺮﮔ
ﻩﺪﻧﺰﻐﻟ: ﺵﺰﻐﻟ
ﯽﻧﻮﮔﺮﮔﺩ: ﻥﺩﺍﺩﺮﯿﯿﻐﺗ, ﻞﯾﺪﺒﺗ
ﻪﯿﺷﺎﺣ: ﻪﺒﻟ
: 
ﻞﺤﻣ: ﺖﯿﻌﻗﻮﻣ, ﻪﻄﻘﻧ
ﻪﺷﻮﺧ: ﻁﻼﺘﺧﺍ, ﻩﺩﻮﺗ, ﺪﻧﺎﺑ
ﻝﻮﻗﻞﻘﻧ: ﻝﻮﻗﻞﻘﻧ
ﻒﯿﻗﻮﺗ: ﻥﺩﺍﺩﺖﻴﻤﻫﺍ
ﻞﻤﺘﺤﻣ: ﻝﻮﺒﻗﻞﺑﺎﻗ
ﺏﺎﺗﺮﭘ: ﺐﻟﺎﻗ
ﺰﮐﺮﻤﺗ: ﯽﮕﺘﺷﺎﺒﻧﺍ, ﺰﮐﺮﻤﺗ, ﺖﯿﻣﺎﻤﺗ
ﯽﺘﺳﺩ: ﯽﻠﻤﻋ
ﻪﻤﻌﻃ: ﻢﻌﻃ, ﺮﮔﺯﺎﻏﺁ
ﻉﻮﻨﺘﻣ: ﻒﻠﺘﺨﻣ, ﮏﯿﯾﺍﺯﻮﻣ, ﺩﺎﻀﺘﻣ
ﻪﮑﺗ: ﻪﺷﺍﺮﺗ, ﮏﺴﯾﺩ
ﺪﻨﺑﻥﺩﺮﮔ: ﺮﯿﺠﻧﺯ
: 
ﻪﺘﻣ: ﻥﺩﺮﮐﺥﺍﺭﻮﺳﻪﺘﻣﺎﺑ, ﯼﺭﺎﻔﺣ, ﻦﯾﺮﻤﺗ
ﺦﺳﺎﭘ: ﻞﻤﻌﻟﺍﺲﻜﻋ, ﺩﺍﺩﺮﺘﺳﺍ, ﻩﺪﺑﺏﺍﻮﺟ
: 
ﺮﯿﻣﻭﮒﺮﻣ: ﮒﺮﻣ
ﺯﺮﻫﻒﻠﻋ: ﻦﻤﭼ, ﺭﺎﮕﯿﺳ
ﯽﺒﺴﻧﺭﻮﻃﻪﺑ: ﻢﺠﺣ
ﯽﺿﺎﯾﺭ: ﺕﺎﯿﺿﺎﯾﺭ, ﺭﺎﮑﺷﺯﺭﻭ
ﯽﻗﻼﺧﺍﺮﻈﻧﺯﺍ: ﯽﻗﻼﺧﺍ
ﻥﺩﺯﺲﻔﻧﺲﻔﻧ: ﺲﻔﻧ
ﻪﻘﺑﺎﺴﻣ: ﻪﻘﺑﺎﺴﻣ
ﺍﻭﺰﻧﺍ: ﻢﻫﺯﺍﺍﺪﺟ
ﺖﻗﻭﺪﻨﭼ: ﺎﻬﺘﻗﻭﯽﻀﻌﺑ
ﯽﺘﺨﺳ: ﺦﻠﺗ, ﯽﺘﺨﺑﺪﺑ, ﻞﮑﺸﻣ, ﯼﺭﻮﺨﻟﺩ, ﻒﺳﺎﺘﻣ
ﻪﻌﯾﺎﺷ: ﺱﺎﺳﺍﯽﺑﺕﺎﻌﯾﺎﺷ, ﺍﺪﺻ, ﺕﺮﻬﺷ
ﺭﺍﺰﻓﺍﻡﺮﻧ: 
ﯽﺷﻮﭘﻢﺸﭼ: ﯽﮕﻗﻼﻋﯽﺑ
ﺮﺘﻫﺯﺎﺗ: ﻥﺍﻮﺟ
ﯽﺳﺎﻨﺸﻧﺍﻭﺭ: ﯽﺳﺎﻨﺷﻥﺍﻭﺭ, ﯽﻨﻫﺫ
ﯽﮔﺪﻨﻓﺎﺑ: ﻩﺮﮔ, ﻝﺎﺼﺗﺍ, ﺏﻭ
ﻢﯿﻘﺘﺴﻣﺮﯿﻏ: ﻢﯿﻘﺘﺴﻣﺭﻮﻃﻪﺑ, ﻢﻬﻣ
ﻪﻘﺑﺎﺳ: ﻝﺎﺜﻣ
ﻭﺮﻫﺍﺭ: ﻪﻌﺷﺍ, ﻦﻟﺎﺳ, ﺭﻮﺒﻋ
ﺾﻗﺎﻨﺗ: ﻞﺑﺎﻘﻣ
ﻥﺩﺭﻭﺍﺭﺩﻭﺮﮔﺯﺍ: ﯽﯾﻮﺟﻪﻓﺮﺻ
ﻩﺎﮔﺭﺬﮔ: ﺮﯿﺴﻣ, ﻩﺩﺎﯿﭘﺮﺑﺎﻋﻂﺧ, ﻪﻠﮑﺳﺍ
ﻩﺪﻧﺩ: ﺕﺍﺰﯿﻬﺠﺗ, ﺎﻬﻧﺍﺪﻧﺩ, ﻩﺪﻧﺩ, ﻥﺪﯾﻭﺩ
ﻦﺸﺟ: ﻦﺸﺟ, ﻢﺳﺍﺮﻣ
ﺮﺸﻧﻭﭖﺎﭼ: ﺭﺎﺸﺘﻧﺍ, ﻊﯾﺯﻮﺗ, ﺮﺷﺎﻧ
ﯼﺮﺘﺸﻣ: ﻥﺎﻤﻬﻣ, ﺭﺍﺪﯾﺮﺧ
ﻪﭽﯿﻟﺎﻗ: ﺵﺮﻓ, ﻪﻘﺒﻃ, ﻮﺘﭘ
: 
ﺯﺍﺪﻧﺍﻢﺸﭼ: ﻩﺎﮕﻧ, ﺯﺍﺪﻧﺍﻢﺸﭼ, ﺯﺍﺪﻧﺍﻢﺸﭼ
ﯽﯾﺎﺒﯾﺯ: ﯽﯾﺎﺒﯾﺯ, ﻥﻮﺴﻓﺍ
ﻥﺩﺮﮐﻑﺮﺼﻣ: ﻥﺩﺮﮐﻩﺩﺎﻔﺘﺳﺍ
ﺯﺍﻥﺪﺷﻦﯿﮕﻤﺸﺧ: ﺕﺮﻔﻧ, ﺖﻣﻭﺎﻘﻣ, ﻢﺸﺧ
ﺖﻟﺎﺣ: ﻥﺩﺮﮐﺭﺍﺩﺍﻭ, ﻥﺩﺎﺘﺴﯾﺍ
ﺖﻋﺎﻨﻗ: ﯽﺿﺍﺭ
ﻢﺴﯿﻧﺎﮔﺭﺍ: ﻥﺎﻣﺯﺎﺳ
ﻡﻮﻬﻔﻣﺎﻧ: ﻢﻬﺒﻣ
ﺪﮐﻮﻣ: ﺎﺒﯾﺯ
ﻞﻣﺍﻮﻋ: ﺮﺻﺎﻨﻋ
: 
ﺮﻬﻇ: ﺮﻬﻇﺯﺍﺪﻌﺑ, ﺏﻮﻨﺟ
ﻖﺒﻧﺯ: ﻥﺪﻧﺍﻮﺧ, ﺭﺪﺳﺖﺧﺭﺩ
ﻢﺳﺍ: ﻡﺎﻧ, ﻩﮊﺍﻭ
ﻮﺷﺎﺗ: ﻩﺪﺷﻢﺧ
ﺪﯿﻔﻣ: ﮏﻤﮐ
ﻪﻣﺍﺩﺍ: ﻥﺩﺮﮐﺭﺍﺮﺻﺍ, ﻪﻣﺍﺩﺍ, ﻪﺘﺷﺬﮔ, ﻥﺩﺮﮐﻝﺎﺒﻧﺩ
ﺰﯾﺮﭘ: ﺝﻭﺮﺧ, ﺰﯾﺮﭘ
ﻥﺩﺮﺑﺙﺭﺍ: ﺙﺭﺍﻭ
ﺖﻋﺮﺳ: ﺖﻋﺮﺳ, ﻥﺩﺮﮐﻊﯾﺮﺴﺗ
ﺭﺎﮑﻤﻫ: ﯽﻧﻭﺎﻌﺗ, ﮏﯾﺮﺷ, ﺭﺩﺍﺮﺑ
ﺩﻮﺒﻤﮐ: ﺵﺮﺑ, ﻑﺬﺣ, ﻢﮐ, ﻪﻠﯿﺒﻗ
ﻥﺎﻨﯿﻤﻃﺍ: ﻥﺩﺍﺩﻥﺎﻨﯿﻤﻃﺍ
ﻪﻧﺎﻔﺼﻨﻣﺮﯿﻏ: ﺖﺳﺭﺩ, ﺐﺳﺎﻨﻣﺎﻧ
ﺮﯾﺯ: ﻥﺩﺮﮐﻦﯾﺰﮕﯾﺎﺟ
ﻞﻄﺳ: ﻪﮑﺸﺑ, ﻖﺷﺎﻗ
ﻥﺎﻣﺯﺎﺳ: ﻥﺎﻣﺯﺎﺳ
ﻝﻻﺩ: ﺵﻭﺮﻓﻩﺩﺮﺧ, ﻩﺪﻨﺷﻭﺮﻓ, ﺮﺟﺎﺗ
ﻝﻭﺍﻪﺟﺭﺩﺭﺩ: ﺹﻮﺼﺨﺑ
ﺕﺎﻔﯾﺮﺸﺗ: ﻢﺳﺍﺮﻣ, ﺕﺩﺎﺒﻋ
ﻥﺍﺭ: ﻥﻮﺒﻣﺍﮊ, ﺎﭘ
: 
ﺱﺭﺯﺎﺑ: ﻩﺪﻨﻨﮐﻩﺪﻫﺎﺸﻣ
ﯽﺘﺧﺭﺎﺟ: ﻪﻨﯿﺑﺎﮐ, ﺩﺎﺸﮔﻭﺪﻨﻠﺑﺱﺎﺒﻟ
ﺖﻓﺎﺑ: ﻥﺎﻣﺯﺎﺳ, ﯼﺭﺎﻤﻌﻣ
ﻢﯿﻈﻨﺗ: ﻥﺩﺍﺩﯽﺘﺷﺁ
ﺶﮐﺮﺳ: ﺪﯾﺪﺷ
ﺮﺒﺧﯽﺑ: ﻥﺪﯿﻤﻬﻓ
ﻥﺍﺪﻠﮔ: ﻥﺍﺪﻠﮔ, 
ﻪﯿﻟﻭﺍ: ﺡﺎﺘﺘﻓﺍ, ﻉﻭﺮﺷ, ﻝﻭﺍ, ﻪﯿﻟﻭﺍ
ﻞﻗﺍﺪﺣ: ﻦﯾﺮﺘﻤﮐ
ﺡﻼﺻﺍ: ﺕﺎﺣﻼﺻﺍ, ﯼﺯﺎﺳﺯﺎﺑ
ﻪﻤﻘﻟ: ﻥﺎﻧ, ﺶﯿﻧ
ﻥﺩﺮﮐﯽﺷﻮﭘﻢﺸﭼ: ﻥﺩﺮﮐﺵﻮﻣﺍﺮﻓ, ﯽﮕﻗﻼﻋﯽﺑ
ﻝﻮﻘﻟﺍﻖﻔﺘﻣ: ﺪﺤﺘﻣ
ﻦﺑﺮﮐ: ﮓﻨﺳﻝﺎﻏﺯ
: 
ﺩﺮﺗ: ﺰﯿﺗ
ﻥﺎﮔﮊﺍﻭ: ﺖﻐﻟﮓﻨﻫﺮﻓ, ﻩﮊﺍﻭ
ﻥﺩﺯﻡﺪﻗ: ﻥﺩﻮﺑﻥﺍﺩﺮﮔﺮﺳ, ﯼﻭﺭﻩﺩﺎﯿﭘ
: 
ﻡﺍﺪﻧﺍﺐﺳﺎﻨﺗ: ﻦﯾﺮﻤﺗ, ﺖﯿﻌﺿﻭ
ﺖﯿﻠﻣ: ﻡﺰﯿﻟﺎﻧﻮﯿﺳﺎﻧ, ﯽﻠﻣ
ﻢﻌﻃ: ﻢﻌﻃ, ﻮﺑ
: 
ﺖﯿﻤﻫﺍﯽﺑ: ﻡﺯﻻ, ﯽﻬﯾﺪﺑ, ﻂﺒﺗﺮﻣﺮﯿﻏ
ﺎﺒﻔﻟﺍ: ﯽﯾﺎﺒﻔﻟﺍ, ﺭﺍﺩﺍﺪﺻﻑﺮﺣ, ﺎﺠﻫ
ﻥﺩﺮﮐﺶﺨﭘ: ﻥﺩﺍﺩﺭﺎﺸﺘﻧﺍ
ﺖﺸﻣ: ﺖﺸﻣ, ﻢﺘﺷﻭﺏﺮﺿ
: 
ﻦﺘﺷﺍﺩﺮﺑﺪﻨﻠﺑﯼﺎﻫﻡﺎﮔ: ﻦﺘﻓﺭﺶﯿﭘ
ﻂﯿﺤﻣ: ﻢﺠﺣ
ﺭﻮﺤﻣ: ﻪﻧﺎﺷ, ﭖﺎﭼ, ﻻﻮﻟ
ﺲﻣﺍﺩﺁ: ﺐﺴﭼ, 
ﺶﺨﺑﺖﯾﺎﺿﺭ: ﯼﺭﺎﻤﯿﺑ, ﯽﺿﺍﺭ
ﺩﺎﻤﺘﻋﺍﻞﺑﺎﻗ: ﻥﺎﻤﯾﺍﺎﺑ
ﺭﻭﺁﺵﺪﻨﭼ: ﺕﺮﻔﻧ, ﺖﺷﺯ
ﯽﻗﻼﺧﺍ: ﯽﻗﻼﺧﺍ, ﺏﺩﺍﺎﺑ
ﻁﻮﻘﺳ: ﻁﻮﻘﺳ
ﻦﺳﻮﮐ: ﻪﻧﺎﺧﺩﻭﺭ
ﻥﺩﺮﮐﺕﺎﻣ: ﻦﺘﻓﺭﻦﯿﺑﺯﺍ, ﻥﺩﺮﮐﺕﺎﻣ, ﺖﺴﮑﺷ
ﻩﺭﻮﻄﺳﺍ: ﻥﺎﺘﺳﺍﺩ, ﻪﻧﺎﺴﻓﺍ
ﺖﯿﮑﻟﺎﻣ: ﮎﻼﻣﺍ
ﻥﺪﻧﺎﺳﺮﺗ: ﻥﺪﻧﺎﺳﺮﺗ, ﮎﺎﻨﺘﺸﺣﻭ, ﺱﺮﺗ
ﺰﻣﺮﺗ: ﺢﻳﺮﻔﺗﮓﻧﺯ
ﻩﺮﻬﻣ: ﺕﺎﺑﻮﺒﺣ, ﻪﻧﺍﺩ
ﻥﺩﺮﮐﮒﺭﺰﺑ: ﻡﺭﻮﺗ, ﻥﺩﺍﺩﺶﯾﺍﺰﻓﺍ
ﯼﺪﯿﺷﺭﻮﺧ: ﺏﺎﺘﻓﺍﺭﻮﻧ
ﺵﺭﻮﯾ: ﻪﻠﻤﺣ
ﺭﺎﻘﻨﻣ: ﺐﻟ, ﺪﺣﺍﻭ, ﯽﻨﯿﺑ
ﻩﺭﺎﺟﺍ: ﯽﯾﺎﺗﻪﺳﻪﺘﺳﺩ, ﻥﺩﺮﮐﻩﺭﺎﺟﺍ
: 
ﺖﺒﺴﻧ: ﻝﺩﺎﻌﺘﻣ, ﻪﺴﯾﺎﻘﻣ, ﺱﺎﯿﻘﻣ, ﺵﺭﺍﺰﮔ, ﺱﺎﯿﻗ
ﻪﻧﺎﺷ: ﻮﻣﻢﻠﻗ, ﻪﻧﺎﺷ
ﻥﺩﺮﮐﻪﻤﺟﺮﺗ: ﻪﻤﺟﺮﺗ
ﺢﯾﺮﻔﺗ: ﯽﻣﺮﮔﺮﺳﻭ​​ﺢﯾﺮﻔﺗ
ﻪﻧﻮﻤﻧ: ﻝﺎﺜﻣ, ﻥﺩﺮﻛﺵﻼﺗ
ﻞﻤﻋﺭﺎﮑﺘﺑﺍ: ﺡﺮﻃ, ﻥﺩﺮﻛﺵﻼﺗ
ﻪﻟﮊ: ﺎﺑﺮﻣ
: 
ﺝﺮﻣﻭﺝﺮﻫ: ﻝﻼﺘﺧﺍ, ﯽﺠﯿﮔ
ﺮﻈﻧﺪﯾﺪﺠﺗ: ﺕﺎﺣﻼﺻﺍ, ﺭﺮﮑﻣ
ﻞﯾﺎﻓﻭﺮﭘ: ﯽﻠﮐﺡﺮﻃ, ﻞﯾﺎﻓ
ﯽﯾﺍﺭﺍﺩ: ﻝﻮﭘ
ﻪﻣﺎﻨﻫﺎﮔ: ﺭﺮﮑﻣ, ﺖﺸﮔ, 
ﯽﺳﺎﺳﺍ: ﻪﯾﺎﭘ, ﺖﺧﺎﺳﺮﯾﺯ
ﻥﺩﺮﮐﺩﺮﻃ: ﻪﻟﺎﺑﺯ, ﺭﻭﺩ, ﻥﺩﺮﮐﺭﺎﻨﮐﺮﺑ
ﯽﮑﯾﺮﺘﮑﻟﺍ: ﮏﯿﻧﻭﺮﺘﮑﻟﺍ
ﻥﺎﻫﺎﯿﮔﮒﺮﺑﻭﺥﺎﺷ: ﻦﻤﭼ
ﻖﻧﻭﺭ: ﻥﺪﺷﺎﻓﻮﮑﺷ, ﺖﯿﻘﻓﻮﻣ
ﻪﺑﺎﺸﺗ: ﺱﺎﯿﻗ, ﻪﯿﺒﺷ, ﯽﮕﺘﺴﺒﻤﻫ
: 
ﯽﺻﻮﺼﺧﻢﯾﺮﺣ: ﯽﺻﻮﺼﺧ
ﻪﺻﺮﻋ: ﻩﺯﻮﺣ
ﺶﺧﺮﭼ: ﭻﯿﭘﺭﺎﻣ, ﯼﺯﺎﺑ
ﺮﻓﺎﺴﻣ: ﺮﻓﺎﺴﻣ
: 
: 
ﻩﺭﺫ: ﻪﻧﺍﺩ
ﯽﺗﺍﺫ: ﯽﻌﻗﺍﻭ, ﻡﺮﻧ, ﻥﺪﻣﺁﺎﯿﻧﺪﺑ
ﻦﮐﺎﺳ: ﻦﮐﺎﺳ, ﻩﺪﻧﺯ
ﻢﯾﻮﻘﺗ: ﺕﺍﺮﻃﺎﺧﺮﺘﻓﺩ
ﺕﻮﻠﻓ: ﺕﻮﺳ
ﯼﺩﺰﻣﺎﻧ: ﺖﻣﻼﻋ
ﻞﺜﻣﺪﯿﻟﻮﺗ: ﯼﺭﻭﺭﺎﺑ
ﻝﻮﻃ: ﻝﻮﻃ
ﺩﻻﺎﺳ: ﺕﺭﺪﻗ
ﯽﻧﺍﻭﺮﯿﺷﺮﯾﺯﻕﺎﺗﺍ: ﻦﮑﻟﺎﺑ
: 
ﮓﻧﺭ: ﮓﻧﺭ
ﻥﺩﺍﺩﻥﺎﺸﻧ: ﻥﺩﺮﻛﺖﺑﺎﺛ
ﺏﺎﺴﺣ: ﺏﺎﺴﺣ
: 
ﻕﻼﺧﺍﻝﻮﺻﺍ: ﯽﻗﻼﺧﺍ
ﺎﻤﺳﺭ: ﯽﻤﺳﺭ
ﻥﺩﺮﮐﮏﯾﺮﺤﺗ: ﻥﺩﺮﮐﻪﻠﺧﺍﺪﻣ, ﻦﺘﺧﺍﺪﻧﺍﺖﺳﺩﺍﺭﯽﺴﮐ, ﻥﺩﺮﮐﮏﯾﺮﺤﺗ, ﻥﺩﺮﮐﺥﺍﺭﻮﺳﻪﺘﻣﺎﺑ
ﻥﺩﺭﻮﺧﺮﺳ: ﺵﺰﻐﻟ
ﯽﮔﮋﯾﻭ: ﺺﺼﺨﺗ, ﻂﺴﺑ, ﺍﻮﻘﺗ
ﺯﺎﺴﮕﻨﻫﺁ: ﻥﺍﺩﯽﻘﯿﺳﻮﻣ
ﺖﮐﺭﺎﺸﻣ: ﯼﺭﺎﮑﻤﻫ, ﺩﺎﺤﺗﺍ, ﯽﻌﻤﺟ, ﺖﮐﺭﺎﺸﻣ
ﻪﻟﺎﺒﻧﺩ: ﺮﯿﺠﻧﺯ, ﺐﯿﺗﺮﺗ
ﯽﺷﺯﺭﻭ: ﺭﺎﮑﺷﺯﺭﻭ, ﻦﯾﺮﻤﺗ
ﯽﺘﺴﻣ: ﺖﺴﻣ, ﻥﺪﯿﺷﻮﻧ
ﻥﺩﺍﺩﺹﺎﺼﺘﺧﺍ: ﻊﻃﺎﻗ, ﻦﺘﻓﺮﮔ
ﺎﺑﺩﺭﻮﺧﺮﺑ: ﻥﺩﺮﮐﺐﺣﺎﺼﺗ, ﻪﻠﺑﺎﻘﻣ, ﺕﺍﺰﯿﻬﺠﺗ, ﻥﺩﺮﮐﻊﻄﻗ
ﻥﺩﺮﮐﺩﻭﺪﺤﻣ: ﯼﺭﺍﺩﺯﺎﺑ, ﻭﺭﻩﺩﺎﻴﭘ
: 
ﺕﺎﻐﯿﻠﺒﺗ: ﺩﻼﯿﻣﺯﺍﺪﻌﺑ, ﺕﺮﻬﺷ
ﺏﺎﺴﺣﺯﺍﺖﺷﺍﺩﺮﺑ: ﺖﻓﺮﺴﭘ, ﺰﯾﺮﭘ, ﻪﺠﯿﺘﻧ
ﻦﻫﺭ: ﻥﺎﮔﻭﺮﮔ, ﺭﺎﺒﺘﻋﺍ, ﻭﺮﮔ
ﻞﻤﺤﺗ: ﺮﺒﺻ, ﻞﻤﺤﺗ
ﻥﺩﺮﮐﺏﻮﮐﺮﺳ: ﻥﺩﺮﮐﯼﺮﯿﮔﻮﻠﺟ, ﻥﺩﺮﮐﻢﺘﺳ
ﺮﺴﻤﻫ: ﻥﺯ, ﺮﻫﻮﺷ, ﮏﯾﺮﺷ
ﺮﺒﺘﻌﻣ: ﺭﺍﺬﮔﺮﻴﺛﺎﺗ, ﻂﯾﺍﺮﺷﺪﺟﺍﻭ, ﺏﻮﺧﺭﺎﻴﺴﺑ
ﻪﮑﻠﻓﺮﯿﺷ: ﻥﻭ, ﺯﺎﯿﭘ, ﮏﻫﻼﮐ
: 
ﻩﺮﺸﺣ: ﻩﺮﺸﺣ, ﯽﺴﯿﻋﯽﻠﺠﺗﻭﺭﻮﻬﻇ
ﺭﺎﺘﺧﺎﺳ: ﺎﻨﺑ, ﯼﺪﻨﺑﻝﻮﻣﺮﻓ, ﺯﺎﻓ, ﻞﻣﺎﺷ, ﯼﺪﻨﺑﺐﯿﮐﺮﺗ
ﺵﺎﻔﺧ: ﺏﻮﭼ, ﻩﺎﮕﺷﺎﺑ
ﺾﻗﺎﻨﺘﻣ: ﻂﺒﺗﺮﻣﺮﯿﻏ, ﺩﺎﻀﺘﻣ, ﺰﯿﮕﻧﺍﺮﺑﺚﺤﺑ, ﺐﯿﻗﺭ
ﮏﯿﺗﺎﻣﻮﺗﺍ: ﻢﯿﻘﺘﺴﻣﺭﻮﻃﻪﺑ, ﺭﺎﮐﺩﻮﺧﺭﻮﻄﺑ
ﺢﯾﺮﺻ: ﻦﮐﺯﺎﺑ, ﻑﺎﻔﺷ, ﻦﯿﺑﻊﻗﺍﻭ
ﺮﺛﻮﻣﺭﻮﻃﻪﺑ: ﺭﺍﺬﮔﺮﻴﺛﺎﺗ, ﺮﺛﺍ
ﺩﺎﻤﺘﻋﺍ: ﺩﺎﺘﻌﻣ, ﻪﯿﮑﺗ
ﯽﺳﺭﺯﺎﺑ: ﻥﺩﺮﮐﻩﺪﻫﺎﺸﻣ, ﯽﺳﺭﺮﺑ, ﻞﯿﻠﺤﺗ
ﯼﺪﻨﺑﻢﯿﺴﻘﺗ: ﯼﺯﺎﺳﺐﺗﺮﻣ
ﺐﯿﺠﻋ: ﺐﻳﺮﻏﻭﺐﻴﺠﻋ
ﻞﻘﻧﻭﻞﻤﺣ: ﻞﻘﻧﻭﻞﻤﺣ, ﺕﺭﺎﻏ, ﻦﻟﺎﺳ
ﺭﻭﺁﻡﺮﺷ: ﻡﺮﺷ
ﻝﺎﻌﻓﺮﯿﻏ: ﯽﻧﺍﻮﺗﺎﻧ, ﻝﺎﻌﻓﺮﯿﻏ
ﺮﺒﮑﺘﻣ: ﺭﻭﺮﻏ
ﻪﻘﻠﺣ: ﺪﻌﺠﻣ, ﻪﻘﻠﺣ
ﺮﻫﻮﮔ: ﮓﻨﺳ, ﻥﺪﺷﺎﻓﻮﮑﺷ, ﺱﺎﻤﻟﺍ, ﺖﻧﺎﻤﺿ
ﺩﺮﮕﻟﺎﺳ: ﺪﻟﻮﺗﺯﻭﺭ
ﻥﺩﺮﮐﯼﺪﻨﺑﻪﺘﺴﺑ: ﻪﺘﺴﺑ
ﻉﻮﻨﺗ: ﻕﺮﻓ
ﺭﺎﺒﺘﻋﺍ: ﺭﺎﺒﺘﻋﺍ, ﺕﺮﻬﺷ
ﯼﺭﺎﮕﻧﺍﻞﻬﺳ: ﻑﺬﺣ, ﺮﯿﻘﺤﺗ, ﺍﻭﺮﭘﯽﺑ
ﺾﯿﻌﺒﺗ: ﮏﯿﮑﻔﺗ, ﺎﻨﺜﺘﺳﺍ, ﻕﺮﻓ
ﻑﺪﻫ: ﻑﺪﻫ
ﻪﻓﺮﻏ: ﻥﺩﺎﺘﺴﯾﺍ
ﻭﺭﻩﺩﺎﯿﭘ: ﻭﺭﻩﺩﺎﻴﭘ, 
ﯼﺭﺍﺬﮔﻪﯾﺎﻣﺮﺳ: ﯼﺭﺍﺬﮔﻪﯾﺎﻣﺮﺳ, ﺪﯾﺮﺧ
ﯽﯾﺎﯾﺭﺩﺮﻔﺳ: ﯽﺘﺸﮐ
ﻊﻤﺠﺗ: ﯽﮕﺘﺴﺒﻤﻫ, ﯽﻌﻤﺟ, ﮊﺎﺘﻧﻮﻣ
ﻪﻌﯾﺎﺷ: ﺱﺎﺳﺍﯽﺑﺕﺎﻌﯾﺎﺷ, ﺍﺪﺻ, ﺕﺮﻬﺷ
ﻪﻧﻻﺎﻌﻓ: ﻼﻣﺎﮐ, ﺖﺒﺜﻣ
ﯽﺳﺭﺮﺑ: ﯽﺳﺭﺮﺑ
ﻥﺪﺷﺭﺍﺪﯾﺪﭘ: ﺪﺳﺭﯽﻣﺮﻈﻧﻪﺑ
ﻥﺎﻓﻮﻃ: ﻥﺎﻓﻮﻃ, 
: 
ﻪﭘﻮﮐ: ﻢﯿﺴﻘﺗ, ﯽﻧﻮﮑﺴﻣﻥﺎﻤﺗﺭﺎﭘﺁ, ﻦﯿﺑﺎﮐ, ﻕﺎﺗﺍ
ﺹﺎﺧﺭﻮﻃﻪﺑ: ﺹﻮﺼﺨﺑ
ﺏﻮﭼﺭﺎﭼ: ﺱﺎﯿﻘﻣ
ﻩﺪﻨﻫﺩﺭﺍﺯﺁ: ﺪﻨﺴﭘﻞﮑﺸﻣ, ﮏﯾﺭﺎﺑ, ﻥﺩﺮﮐﻪﻠﺧﺍﺪﻣ
ﺭﺎﺠﻔﻧﺍ: ﺭﺎﺠﻔﻧﺍ, ﺲﮑﻋ
: 
ﻉﻮﻤﺠﻣ: ﺖﺷﺭﺩ, ﯽﻌﻤﺟ, ﺏﺎﺴﺘﺣﺍﺎﺑ, ﻩﺰﯾﺭﮓﻨﺳ
ﺮﺴﮐ: ﺶﺨﺑ, ﻁﺮﺷ, ﺎﻤﻨﺑﺁ
ﯽﻧﻮﻧﺎﻗﺮﯿﻏ: ﯽﻧﻮﻧﺎﻗﺮﯿﻏ, ﯽﺸﺣﻭ, ﺐﺳﺎﻨﻣﺎﻧ
ﻥﺩﺮﮐﻞﺣ: ﻝﻼﺣ, ﻪﮐﻭﺮﺘﻣ
ﻥﺎﺸﻔﺸﺗﺍ: ﻪﭙﺗ
ﻝﺩﺎﻌﺗ: ﻝﺩﺎﻌﺗ
ﻪﻧﺎﺧﻞﺧﺍﺩﺭﺩ: ﻩﺪﺷﻩﺩﺍﺩﺶﺷﻮﭘ
ﯼﺮﺳﻭﺭ: 
ﮏﯿﻧﮏﯿﭘ: ﯼﺩﺮﮕﻧﺎﻬﺟ, 
: 
ﻑﺎﺸﺘﮐﺍ: ﻞﯿﻠﺤﺗ, ﻥﺩﺮﮐﻮﺠﺘﺴﺟ
: 
ﺎﺘﺴﯾﺍ: ﺖﺑﺎﺛ, ﻦﺘﺷﻮﻧ
ﺯﺎﯿﭘ: ﻢﯿﻈﻌﺗ, ﺯﺎﯿﭘ
ﯽﮕﺘﺴﺑﺍﻭ: ﺱﺎﯿﻗ, ﯽﮕﺘﺴﺒﻤﻫ
ﺐﻠﻘﺘﻣ: ﻥﺎﻤﯾﺍﺎﺑ, ﻕﺩﺎﺻ
ﻞﻤﮑﻣ: ﯽﻓﺎﺿﺍ, ﻩﺪﻨﻨﮐﻞﯿﻤﮑﺗ
ﺩﺭﻮﺧﺮﺑ: ﻥﺪﺷﻪﮐﻮﺷ, ﻥﺩﺮﮐﻪﻠﺧﺍﺪﻣ
ﯽﺘﺣﺍﺭﯽﻟﺪﻨﺻ: ﯽﻟﺪﻨﺻ, ﻪﭘﺎﻧﺎﮐ
ﺮﯿﻤﺧ: ﺭﺩﻮﭘ, ﺮﻤﺨﻣ, ﮏﯿﮐ
ﻮﺷﺭﺍﻮﺳ: ﻥﺩﺮﮐﻞﺻﻭ, ﻉﻭﺮﺷ
ﯽﺷﻮﻬﯿﺑ: ﺪﺟﻭ
ﻥﺪﺷﺩﺮﻃ: ﯽﻨﺘﺨﯾﺭﺭﻭﺩ
ﺲﻧﺎﯾﺭﺍﻭ: ﻉﺍﺰﻧ, ﮏﯿﮑﻔﺗ, ﻥﺩﺍﺩﺮﯿﯿﻐﺗ, ﻕﺮﻓ
ﺏﺬﺟ: ﺖﺳﻮﭘ, ﯼﺭﺍﺩﺮﺑﻩﺮﻬﺑ
: 
: 
: 
: 
ﻊﻗﻮﻤﺑ: ﻥﺎﻣﺯ, ﻥﺪﯾﺮﺑﺮﺳ
ﻪﻠﻤﺣ: ﻪﻠﻤﺣ
ﺝﺍﺮﺧﺍ: ﻪﺴﯿﮐ, ﯽﮕﻧﻭﺰﻓﺍ
ﻪﻈﺣﻼﻣﻞﺑﺎﻗﺭﻮﻃﻪﺑ: ﯼﺩﺎﯾﺯﺪﺣﺎﺗ, ﯽﻓﺎﮐ
ﯽﺑﺮﺠﺗ: ﻥﺎﺒﻠﺧ
ﻢﻠﯿﻓ: ﺎﻤﻨﯿﺳﻢﻠﯿﻓ, ﺮﯾﻮﺼﺗ
: 
ﺕﺎﻐﯿﻠﺒﺗ: ﺩﻼﯿﻣﺯﺍﺪﻌﺑ, ﺕﺮﻬﺷ
ﺏﺎﺼﻋﺍﺩﺪﻤﺗ: ﺵﺎﺑﻡﻭﺭﺁ, ﯽﻣﺮﮔﺮﺳﻭ​​ﺢﯾﺮﻔﺗ
ﻥﺩﺍﺩﻪﻌﺳﻮﺗ: ﻥﺩﺮﮐﻦﻬﭘ, ﻥﺩﺍﺩﺭﺎﺸﺘﻧﺍ, ﺝﺭﺎﺧﻩﺩﺮﺸﻓﺖﻟﺎﺣﺯﺍ
ﻥﺩﺮﮐﺰﯿﺧﻭﺖﺴﺟ: ﻥﺩﺭﻮﺧﻮﻠﺗﻮﻠﺗ, ﻁﻮﻘﺳ, ﺐﯿﺷ
ﻞﯿﺴﻓ: ﺖﻔﻧ, ﯽﺳﺎﻨﺷﻥﺎﺘﺳﺎﺑ, ﯽﻟﺍ
ﻢﺗﺍ: ﯽﻤﺗﺍ
ﺖﯾﺩﻭﺪﺤﻣ: ﻊﻧﺎﻣ
ﮏﯿﻧﺎﮑﻣ: ﯽﮑﯿﻧﺎﮑﻣ, ﯽﺳﺪﻨﻬﻣ, ﯽﮑﯿﻣﺎﻨﯾﺩ, ﯽﺳﺎﻨﺷﺮﯿﮕﻬﻤﻫ
ﻞﯿﻧﺍﻭ: 
ﺯﺪﯾﺍ: 
ﻩﺰﻣ: ﻪﯾﻭﺩﺍ, ﻪﺑﺮﺠﺗ, ﻢﻌﻃ, ﺖﺳﻮﭘ
ﻪﺧﺮﭼ: ﺵﺩﺮﮔ, ﻪﺧﺮﭼﻭﺩ, ﺥﺮﭼ, ﻥﺩﺍﺩ
ﻥﺩﺯﺕﺮﭼ: ﺏﺍﻮﺧ, ﻥﺩﺮﮐﻩﺭﺎﺷﺍﺮﺳﺎﺑ
ﻩﺪﮑﻫﺩ: ﺮﻬﺷﻪﻣﻮﺣ, ﻩﺪﮑﻫﺩ
ﻪﺠﻨﭘ: ﺎﭘ
ﺵﺮﻏ: ﻥﺪﺷﺎﻓﻮﮑﺷ, ﯽﯾﻮﮔﻑﺍﺰﮔ, ﺭﺎﺠﻔﻧﺍ
ﺮﯿﺜﮑﺗ: ﻪﺨﺴﻧ, ﻩﺩﺯﺎﺑ
ﻩﺮﮕﻨﮐ: ﮊﺎﺘﻧﻮﻣ
ﻥﺩﺮﮐﻝﻭﺰﻧ: ﺵﺮﺑ, ﻁﻮﻘﺳ, ﻢﮐ
ﺏﻭﺭﺎﺟ: ﻥﺍﺭﺎﺑ
: 
ﻆﻔﻠﺗ: ﻪﺠﻬﻟ
ﯼﺭﻭﺍﺩ: ﻪﻠﻤﺟ, ﻥﻮﻧﺎﻗ, ﯽﺿﺎﻗ, ﻩﺎﮔﺩﺍﺩﻦﯾﺍﺖﯿﺣﻼﺻ, ﻥﺍﺮﺤﺑ
ﻦﺘﺷﺍﺩﺰﮐﺮﻤﺗ: ﺰﮐﺮﻤﺗ
ﻥﺩﺮﮐﻞﻃﺎﺑ: ﻥﺩﺮﮐﺵﺎﻓ, ﺖﺸﮔﺯﺎﺑ
ﯽﺘﺸﮐ: ﯽﻧﺎﺑﺩﺎﺑﻖﯾﺎﻗ, ﯽﺘﺸﮐ
ﻮﻠﺑﺎﺗ: ﺩﺭﻮﺒﺷﺍﺩ, ﺹﺮﻗ
ﺖﺳﺍﺭﺮﺳ: ﻢﯿﻘﺘﺴﻣﺭﻮﻃﻪﺑ, ﯽﻧﺎﺳﺁﻪﺑ, ﻑﺎﻔﺷ, ﻩﺪﻧﺯ
: 
: 
ﻉﺎﻔﺗﺭﺍ: ﻝﻮﻃ
ﺭﻭﺎﺸﻣ: ﺭﻭﺎﺸﻣ, ﻪﺠﻨﮑﺷ
: 
ﻥﺩﺮﮐﯽﻨﻌﻣ: ﺶﯾﺎﻤﻧ, ﻦﺘﺷﺍﺩﺭﻮﻈﻨﻣ
ﺕﺍﺭﺩﺎﺻ: ﺝﻭﺮﺧ, ﻪﺸﯿﺷ
ﻒﻠﺨﺘﻣ: ﺭﺍﺩﻪﻟﺎﺒﻧﺩﻩﺭﺎﺘﺳ, ﺭﺎﮑﻫﺎﻨﮔ, ﯽﯾﺎﻨﺟ
ﻝﺩﺎﻌﺗ: ﺮﺑﺍﺮﺑ, ﻝﺩﺎﻌﺗ, ﺪﻨﺑ, ﯽﻤﺳﺍ, ﯽﺑﺎﯾﺯﺭﺍ
ﻥﺩﺮﺑﻥﺎﯿﻣﺯﺍ: ﻦﺘﺷﺍﺩﺮﺑ
ﻥﺩﺮﮐﻢﯿﻈﻨﺗ: ﻕﺎﺒﻄﻧﺍ, ﻪﻨﯿﻬﺑ, ﻥﺪﺷﺎﺟ, ﻥﺩﺍﺩﯽﺘﺷﺁ, ﻪﯿﺟﻮﺗ
ﺖﯾﻮﻀﻋ: ﻮﻀﻋ
ﻩﺯﺍﺪﻧﺍ: ﻦﺘﻓﺮﮔﻩﺯﺍﺪﻧﺍ, ﺱﺎﯿﻘﻣ, ﺺﺧﺎﺷ
ﻥﺩﺮﻛﻞﻤﺤﺗ: ﺶﺨﺒﺑ, ﻞﻤﺤﺗ
ﻥﺎﺸﻧ: ﯼﺯﺎﺳﻪﯿﺒﺷ, 
ﻥﺍﺭﻞﺼﻔﻣ: ﻦﯾﺮﺳ, ﮏﯿﺘﻧﺎﻣﻭﺭ
ﻥﺪﯿﺒﺴﭼ: ﻥﺩﺮﮐﻝﺎﺒﻧﺩ, ﻥﺩﺮﮐﻞﺻﻭ, ﺏﻮﭼ, ﻆﻔﺣ, ﻖﺑﺎﻄﻣ
ﮏﯾﺮﺤﺗ: ﮏﯾﺮﺤﺗ, ﻥﺩﺮﮐﮏﯾﺮﺤﺗ
ﻡﺍﺭﺁﺎﻧ: ﻝﻼﺘﺧﺍ, ﺲﭘﺍﻮﻟﺩ
ﺖﻔﻋ: ﺹﻮﻠﺧ
ﺽﺎﺒﻘﻧﺍ: ﯽﯾﻭﺮﻤﮐ
ﺭﺎﮕﻧﻪﻣﺎﻧﺯﻭﺭ: ﺭﺎﮕﻧﺮﺒﺧ
ﺮﯿﺴﻔﺗ: ﻦﺴﮐﺍﻭ, ﻒﯾﺮﻌﺗ, ﺕﺍﺮﻈﻧ
ﻝﺎﻘﺘﻧﺍ: ﺖﻧﻮﻔﻋ, ﻝﺎﺳﺭﺍ
: 
ﻥﺩﺮﮐﯽﻫﺍﻮﺧﺭﺬﻋ: ﺐﯿﺳ
: 
: 
ﯼﺍﺭﻪﻗﺭﻭ: ﺍﺪﺻ, ﻪﻟﺎﺑ
ﻥﺪﯿﺴﯿﻟ: ﻦﻣﻪﺑ
ﻩﻮﻘﻟﺎﺑ: ﻪﺑﺭﺩﺎﻗ
ﻂﯾﺍﺮﺷﺪﺟﺍﻭ: ﻂﯾﺍﺮﺷﺪﺟﺍﻭ, ﺖﺳﺭﺩ, ﻥﺪﺷﺎﺟ
ﻪﻘﻠﺣ: ﺵﺩﺮﮔ, ﻻﻮﻟ, ﻪﻘﻠﺣ
ﺮﮔﺭﺎﮐ: ﺪﻨﻣﺭﺎﮐ
ﺭﺍﺮﻗﯽﻧﻮﻧﺎﻗﺩﺮﮕﯿﭘﺖﺤﺗ: ﯽﻧﻮﻧﺎﻗﺩﺮﮕﯿﭘ, ﺶﻧﺯﺮﺳ
ﺯﻮﺠﻣ: ﻩﺯﺎﺟﺍ, ﻉﺍﺮﺘﺧﺍﺖﺒﺛ
ﻥﺩﺮﮐﮎﺮﺗ: ﻪﯿﻠﺨﺗ
ﺲﻔﻧ: ﻥﺎﺷﺩﻮﺧ, ﺲﻔﻧ
ﺖﺟ: ﻩﺪﻧﺮﭘ, ﻥﺎﯾﺮﺟ
ﺾﻘﻧ: ﺵﺮﺑ
ﺲﯿﻨﺗ: 
: 
ءﺎﻘﺑ: ﯽﮔﺪﻧﺯﮏﺒﺳ, ﺭﺍﺩﺍﺪﺻﻑﺮﺣ
ﯽﮔﺩﺯﺦﯾ: ﻩﺩﺯﺦﯾ
ﺖﻓﺎﺑ: ﻩﺮﮔ
ﺖﻗﻭ: ﺩﺎﺠﯾﺍ
ﯽﮕﻗﻼﻋﯽﺑ: ﯽﮕﻗﻼﻋﯽﺑ
: 
ﻥﺩﺍﺩﻥﺎﻣﺯﺎﺳ: ﻥﺎﻣﺯﺎﺳ, ﻥﺩﺮﮐﻩﺩﺎﻣﺁ, ﻥﺩﺮﮐﯽﻧﻮﻧﺎﻗ, ﺖﯾﺮﯾﺪﻣ, ﯼﺪﻨﺑﺐﯿﮐﺮﺗ
ﻻﺎﻤﺘﺣﺍ: ﺪﯾﺎﺷ
: 
: 
ﺮﺗﻭ: ﺮﺗﻭ, ﯼﺭﺎﮑﻤﻫﺩﺍﺩﺭﺍﺮﻗ
ﻦﺘﻓﺮﮔﻥﻮﺧ: ﻥﻮﺧ
ﺮﺳﺩ: ﻦﯾﺮﯿﺷ, ﮓﻨﯾﺩﻮﭘ, 
ﺱﻮﻗ: ﻢﯿﻈﻌﺗ, 
ﻒﺸﮐ: ﻩﺪﺷﺍﺪﯿﭘ, ﻥﺩﺮﮐﻮﺠﺘﺴﺟ, ﻥﺩﺮﮐﺵﺎﻓ, ﺺﯿﺨﺸﺗ
ﻥﺪﯿﺑﻮﮐﻢﻫﺭﺩ: ﻦﺘﻓﺭﻦﯿﺑﺯﺍ, ﺢﻳﺮﻔﺗﮓﻧﺯ
ﺲﻧﺎﮐﺮﻓ: ﺵﺩﺮﮔ, ﻎﯾﺭﺩ
ﻥﺩﺯﻪﯿﺨﺑ: ﯽﮔﺪﻧﺯﻭﺩ, ﻕﺮﻋ
ﺎﻤﻨﻫﺍﺭﺖﺳﺮﻬﻓ: ﮎﺭﺪﻣ
ﻥﺩﺮﮐﻪﮑﺗ: ﺶﯿﻧ, ﺵﺮﺑ, ﮏﯿﺘﺳﺍ
ﺶﯾﺎﻣﺮﮔ: ﻡﺮﮔ, ﻥﺎﺘﺴﺑﺎﺗ
ﺎﺗﺩﻮﮐ: ﺏﻼﻘﻧﺍ, ﺲﮑﻋ, ﻪﺑﺮﺿ, ﯽﺷﺭﻮﺷ, ﻊﻃﺎﻗ
: 
ﻥﺎﺑﺮﻬﻣ: ﯼﺩﺭﺪﻤﻫﺯﺍﺮﺑﺍ
ﺯﺍﺩﺮﭘﻩﺪﯾﺍ: ﯼﺮﮑﻓ
ﻪﺟﺩﻮﺑ: ﻝﺩﺎﻌﺗ
ﯽﻧﺪﻣ: ﯽﻧﺪﻣ
ﻝﺎﺗﺭﻮﭘ: ﺏﺭﺩ
: 
ﻥﺩﺍﺩﺭﺍﺮﻗ: ﻥﺪﺷﻞﺧﺍﺩ, ﻥﺩﺍﺩﺶﯾﺍﺰﻓﺍ, ﻥﺩﺮﮐﯽﻓﺮﻌﻣ
ﻥﺩﺮﮐﺮﮑﻔﺗ: ﻥﺩﺮﮐﺲﮑﻌﻨﻣ, ﺮﮑﻓ
ﺮﯾﺬﭘﻑﺎﻄﻌﻧﺍ: ﻥﺩﺮﮐﻢﺧ, ﻥﺎﺴﺸﮐ
ﮓﻨﺳﻪﺘﺨﺗ: ﺹﺮﻗ, ﻕﺎﺟﺍ
ﺖﯿﺣﻼﺻ: ﻂﯾﺍﺮﺷﺪﺟﺍﻭ, ﺩﺍﺪﻌﺘﺳﺍ
ﭻﯿﺋﻮﺳ: ﻞﯾﺪﺒﺗ, ﺪﯿﻠﮐ, ﻥﺩﺮﮐﻦﯾﺰﮕﯾﺎﺟ
ﯼﺮﻈﻧ: ﻪﯾﺮﻈﻧ
ﻪﻟﻮﺣ: ﻪﭼﺭﺎﭘ
ﻪﻫﺩ: ﻩﺩ, ﻦﺘﺷﺍﺩﻪﮕﻧ
ﻦﯾﺪﻨﭼ: ﻒﻠﺘﺨﻣ, ﻊﻤﺟ, ﺶﯿﺑ
: 
ﯼﺪﻨﺑﻢﺧﺯﺭﺍﻮﻧ: ﺲﺳ
ﺐﺗﺮﻣ: ﻪﺘﻓﺭﻭﻪﺘﺴﺷ
ﺭﻭﺩﺰﻣ: ﻦﯿﻫﺎﺷ
ﻥﺩﺯﻒﮐ: ﺪﯿﺠﻤﺗﻭﻖﯾﻮﺸﺗ
ﯽﭼﻮﭘ: ﯽﻟﺎﺧ, ﭖﻮﺗ
ﺰﻐﻣ: ﺖﻔﻧ, ﺰﻐﻣ, ﻲﻳﺍﻮﻠﺣﻭﺪﻛ
ﻥﺪﺷﺏﺬﺟ: ﯼﺭﺍﺩﺮﺑﻩﺮﻬﺑ, ﻦﺘﻓﺮﯾﺬﭘ, ﻦﺘﺷﺍﺩﺮﺑ
ﯽﻨﯿﺑﺶﯿﭘ: ﯽﻨﯿﺑﺶﯿﭘ, ﻥﺰﺑﺱﺪﺣ
ﺵﺯﻮﻣﺁ: ﺕﻼﯿﺼﺤﺗ, ﺭﺎﻄﻗ
ﻮﺟﻭﺱﺮﭘ: ﻥﺩﺮﮐﺎﺿﺎﻘﺗ, ﻥﺩﺮﮐﻮﺠﺘﺴﺟ, ﯽﺑﺎﯾﺯﺭﺍ
ﻪﻄﻠﺳ: ﻥﻮﻧﺎﻗ
ﯽﻨﯾﺪﻟﺍﻭ: ﻦﯾﺪﻟﺍﻭ
ﻥﺩﺮﮐﺖﮐﺮﺷ: ﻥﺩﺮﮐﻞﺻﻭ, ﻝﻮﻐﺸﻣ, ﺖﮐﺭﺎﺸﻣ, ﺶﺨﺑ
: 
ﺭﻮﺴﻧﺎﺳﺁ: ﻥﺩﺮﮐﺪﻨﻠﺑ
ﻩﺪﻧﺯﺎﺳ: ﻩﺪﻧﺯﺎﺳ
ﯽﺒﻧﺎﺟ: ﺖﻤﺳ, ﯽﻓﺎﺿﺍ
ﻥﺩﺎﺘﻓﺍﻖﯾﻮﻌﺗﻪﺑ: ﻦﺘﺧﺍﺪﻧﺍﺮﯿﺧﺎﺗ, ﺩﻭﺩ
ﺕﺮﻔﻧ: ﺮﯿﻘﺤﺗ, ﺕﺮﻔﻧ
ﺽﺭﺍﻮﻋ: ﯽﻧﺎﺑﺮﻗ
ﻩﺭﺎﻌﺘﺳﺍ: ﻝﺎﺜﻣ, ﻞﻘﻧﻭﻞﻤﺣ
ﻩﺩﺮﺘﺴﮔ: ﻥﺩﺍﺩﺭﺎﺸﺘﻧﺍ, ﻦﻬﭘ
: 
ﮏﭼﻮﮐ: ﯽﻤﮐﺭﺍﺪﻘﻣ
: 
ﺪﺻﺭﺩ: ﯼﺪﺻﺭﺩ, ﺪﺻﺭﺩ
ﺐﻤﺑ: ﻪﺒﻤﻠﺗ
ﻪﻧﺍﺪﻘﺘﻨﻣ: ﻖﯿﻤﻋ
ﻭﺭﺯﺭ: ﻆﻔﺣ, ﻥﺩﺮﮐﺐﺣﺎﺼﺗ
ﻦﺘﺧﻭﺩ: ﯽﮔﺪﻧﺯﻭﺩ
ﻥﺍﺩﯽﻤﯿﺷ: ﯽﯾﺎﯿﻤﯿﺷ
ﻦﻟﺎﺳ: ﺢﻳﺮﻔﺗﮓﻧﺯ, ﻦﻟﺎﺳ, ﯽﻟﺪﻨﺻ
: 
ﻉﻭﺮﺷ: ﻉﻭﺮﺷ, ﻪﻠﻤﺣ
ﻥﺩﺯﮏﻣ: ﺐﻠﻗ
: 
ﻪﺟﺮﯿﺷ: ﺐﯿﺷ
: 
ﻡﻮﮑﺤﻣ: ﻪﻠﻤﺟ, ﺶﻧﺯﺮﺳ
ءﺎﺸﻏ: ﻪﻧﺎﻧﺯﺭﺩﺎﭼ
ﻥﺩﺮﮐﻖﻠﻌﻣ: ﻥﺩﺮﮐﯼﺮﯿﮔﻮﻠﺟ
ﻥﺩﺯﯽﻠﯿﺳ: ﻢﺘﺷﻭﺏﺮﺿ
ﻪﻘﺷﺎﻌﻣ: ﻁﺎﯿﺣ
ﻻﺎﮐ: ﺕﻻﻮﺼﺤﻣ
: 
ﯽﮕﺘﺳﻮﯿﭘ: ﻪﻣﺍﺩﺍ, ﯽﮕﺘﺳﻮﯿﭘ
ﻞﺑﺎﻘﺘﻣ: ﻝﺩﺎﺒﺗ, ﻞﺑﺎﻘﺘﻣ, ﯽﮕﻧﻭﺭﺍﻭ
ﻥﺪﯿﺷﺍﺮﺗ: ﻪﻧﺎﺨﭘﻮﺗ
ﻪﺨﺴﻧ: ﻭﺭﺍﺩ, ﻞﻤﻌﻟﺍﺭﻮﺘﺳﺩ, ﻪﺨﺴﻧ, ﻥﻮﻧﺎﻗ
ﻩﺩﺎﻔﺘﺳﺍ: ﯼﺭﺍﺩﺮﺑﻩﺮﻬﺑ, ﻥﺩﺮﮐﻩﺩﺎﻔﺘﺳﺍ
ﻡﺍﻭﺩﺎﺑ: ﯽﻧﻻﻮﻃ, ﻡﻭﺍﺪﻣ
ﺐﺴﻧﻭﻞﺻﺍ: ﺎﻨﺷﺁ
: 
ﯼﻭﺭﺰﻠﻓ: ﯽﯾﻮﺸﻓﺮﻇﮏﻨﯿﺳ
ﺩﻭﺪﺤﻣ: ﺖﯾﺎﻬﻧﺭﺩ
ﺮﮕﻧﻩﺪﻨﯾﺁ: ﯽﻨﯿﺑﺶﯿﭘ, ﺩﺰﻣﺎﻧ, 
ﺵﻼﺗ: ﻒﯾﺮﺤﺗ, ﻪﺑﺮﺿ, ﻪﻘﺑﺎﺴﻣ
ﯽﻫﺎﮕﺸﻧﺍﺩ: ﺕﻼﯿﺼﺤﺗ, ﻮﺠﺸﻧﺍﺩ
ﮏﯿﺘﺳﻻ: ﻪﻘﻠﺣ
ﻩﺪﻨﻨﻛﻑﺮﺼﻣ: ﻥﺩﺮﮐﻩﺩﺎﻔﺘﺳﺍ, ﻩﺪﻨﻨﮐﻩﺩﺎﻔﺘﺳﺍ
ﺭﺎﺒﺘﻋﺍ: ﺵﺯﺭﺍ, ﺭﺎﺒﺘﻋﺍ
ﺎﺒﯾﺮﻘﺗ: ﯽﺒﯾﺮﻘﺗ, ﻩﺭﺎﺑﺭﺩ
ﯽﻨﺘﻓﺎﺑ: ﻩﺮﮔ
ﭗﮑﺳﻭﺮﮑﯿﻣ: ﭖﻮﮑﺴﻠﺗ
ﯽﻣﺎﻈﻧﺮﯿﻏ: ﯽﻧﺪﻣ
ﻪﻤﺴﺗ: ﯽﯾﺎﺗﻪﺳﻪﺘﺳﺩ, ﺏﺎﻨﻃ, ﻕﻼﺷ
ﻦﯾﺩﺎﻤﻧ: ﺖﺳﮊ, ﺖﯾﻮﻫ, ﺖﻣﻼﻋ
ﻕﺎﺒﻄﻧﺍ: ﻕﺎﺒﻄﻧﺍ, ﻪﻠﺑﺎﻘﻣ, ﻥﺩﺮﮐﯽﺴﯾﻮﻧﻭﺭ, ﻪﻨﯿﻬﺑ, ﻥﺩﺮﮐﻦﯾﺰﮕﯾﺎﺟ
ﻝﺎﻤﺘﺣﺍ: ﻝﺎﻤﺘﺣﺍ, ﺖﺳﺍﻪﺘﺴﻧﺍﻮﺗ
ﯽﻨﻫﺫ: ﯽﻨﻫﺫ, ﯽﻟﺎﯿﺧ
ﺮﯿﻤﺿ: ﻥﺍﺪﺟﻭ
ﻩﺎﺒﺘﺷﺍ: ﻩﺎﺒﺘﺷﺍ, ﻩﺩﺎﻔﺘﺳﺍﻮﺳ
: 
ﻥﺩﺮﮐﺩﺮﺴﻟﺩ: ﯽﺒﻠﻃﻩﺎﺟ, ﻩﺩﺮﺴﻓﺍ
ﯼﺰﯿﭼﺮﻫﯽﻠﺻﺍءﺰﺟ: ﭗﯿﻠﮐ, ﯽﻠﺻﺍ
ﺩﺭﺍﻭﻩﺯﺎﺗ: ﻥﺎﻤﻬﻣ, ﻥﺩﺮﮐﻞﺻﻭ, ﻩﺪﮑﺸﻧﺍﺩﻝﻭﺍﻝﺎﺳﯼﻮﺠﺸﻧﺍﺩ
ﺖﯾﺎﻬﻧﯽﺑ: ﺭﺪﺼﻣ, ﺕﺎﯿﺿﺎﯾﺭ
ﮏﯿﻓﺍﺮﮔ: ﯽﻧﺎﻣﺯﺎﺳﺕﺭﺎﭼ, ﯽﮑﯿﻓﺍﺮﮔ
ﻞﮑﺷ: ﺮﯾﻮﺼﺗ
ﺭﺍﻮﯾﺩﺭﺩﯽﮕﺘﻓﺭﻮﺗ: ﺪﯿﻠﮐ
ﺪﯿﻣﺍﺎﻧ: ﺖﺴﮑﺷ, ﯼﺪﯿﻣﺍﺎﻧ
ﻞﻣﺎﺣ: ﺭﺍﺩﺮﺑ, ﺭﻮﺗﺍﺮﭘﺍ
: 
ﺡﺮﻃ: ﺡﺮﻃ, ﺶﯾﺎﻤﻧ, ﻥﺩﺮﮐﺲﮑﻌﻨﻣ
ﯽﯾﺎﻫﺭ: ﻪﯿﻠﺨﺗ, ﺕﺎﺠﻧ, ﻥﺩﺮﮐﻪﺋﺮﺒﺗ, ﻝﻼﻘﺘﺳﺍ
ﺵﺎﻌﺗﺭﺍ: ﺪﯾﺪﺸﺗ, ﻩﺯﺮﻟ, ﻥﺎﺳﻮﻧ
ﻩﻭﺎﺟ: 
: 
ﻥﺩﺍﺩﯼﺍﺭﻖﺣ: ﺯﺎﯿﺘﻣﺍ
ﺲﻧﺎﺠﺘﻣﺎﻧ: ﻑﺮﺧﺰﻣ, ﻂﺒﺗﺮﻣﺮﯿﻏ, ﻒﺳﺎﺗﻪﯾﺎﻣ, ﺐﺳﺎﻨﻣﺎﻧ
ﺶﺧﺮﭼ: ﺵﺩﺮﮔ, ﺏﻼﻘﻧﺍ
ﯽﮑﯾﮊﻮﻟﻮﯾﺰﯿﻓ: ﯽﺳﺎﻨﺷﻥﺍﻭﺭ
ﺮﺘﻣ: ﻦﺘﻓﺮﮔﻩﺯﺍﺪﻧﺍ
ﺖﯾﺩﻭﺪﺤﻣ: ﻥﺍﺮﮐ, ﻊﻧﺎﻣ
ﯼﺪﻨﺑﻪﺘﺳﺩ: ﻉﺎﻤﺘﺟﺍ, ﺱﻼﮐ
ﯼﺩﺍﮋﻧ: ﻪﻘﺑﺎﺴﻣ, ﯽﺘﺳﺮﭘﺩﺍﮋﻧ
ﯽﻨﯾﺰﮕﯾﺎﺟ: ﯼﺎﺠﺑ, ﻥﺩﺮﮐﻦﯾﺰﮕﯾﺎﺟ, ﻪﻨﯾﺰﮔ
ﺎﺑﻥﺪﺷﻭﺮﺑﻭﺭ: ﻪﻠﺑﺎﻘﻣ
ﻥﺩﺮﮐﻊﻨﻣ: ﻊﻧﺎﻣ
ﯽﺘﻨﯾﺯ: ﻦﯿﯾﺰﺗ
ﻭﺮﻫﺍﺭ: ﻥﺩﺮﮐﺭﺍﺩﺍﻭ, ﻦﻟﺎﺳ
ﺏﺎﺗﺮﭘ: ﺐﻟﺎﻗ, ﺪﻌﺠﻣ, ﻪﺿﺍﺮﻗ, ﻪﻟﺎﺑﺯ
ﻥﺩﺮﮐﻥﺍﺮﺒﺟ: ﺶﯾﺍﺭﺁ, ﻥﺩﺮﮐﻦﯾﺰﮕﯾﺎﺟ, ﻩﺰﯾﺎﺟ
ﺭﺎﻣﻮﻃ: ﺏﺎﺘﮐ, ﺪﻌﺠﻣ
ﮏﯿﻧﺎﮑﻣ: ﯽﮑﯿﻧﺎﮑﻣ, ﺮﮔﺖﻌﻨﺻ
ﺯﻭﺎﺠﺗ: ﻪﻠﻤﺣ, ﺰﯿﻣﺁﺖﻧﻮﺸﺧ, ﺯﻭﺎﺠﺗ
ﯽﻫ: ﺩﻭﺭﺩ, ﯼﺪﻣﺁﺵﻮﺧ
ﯼﺮﯿﮔﻩﺯﺍﺪﻧﺍ: ﻦﺘﻓﺮﮔﻩﺯﺍﺪﻧﺍ
ﺖﺑﺎﻗﺭ: ﺐﯿﻗﺭ
ﺭﺍﺪﻣ: ﺱﻼﮐ
ﺭﺎﺒﻧﺍ: 
: 
ﻩﺎﮕﺸﻧﺍﺩ: ﺞﻟﺎﮐ
: 
ﺭﺎﮐﻩﺯﺎﺗ: ﺕﻭﺍﺮﻃﺎﺑ
ﻩﺪﺷﺍﺪﺟ: ﻕﻼﻃ
ﻒﻠﮔ: 
ﻥﺰﺨﻣ: ﻥﺰﺨﻣ
ﻥﺩﺮﻛﺪﻳﺮﺧ: ﺪﯾﺮﺧ
: 
ﯽﻨﻤﺿ: ﻩﺪﺷﺮﭘ
ﮏﯾﮋﺗﺍﺮﺘﺳﺍ: ﯼﮋﺗﺍﺮﺘﺳﺍ
ﻪﺷﺎﻣ: ﯼﺮﮔﻪﻠﯿﺣ
ﺐﻟﺎﻗ: ﻥﺪﺷﻞﻴﻜﺸﺗ, ﭖﺎﭼ, ﺐﻟﺎﻗ, ﯽﮐﺍﺭﻮﺧﭺﺭﺎﻗ, ﺭﺍﺩﺍﺪﺻﻑﺮﺣ, ﺐﻟﺎﻗ
ﻦﯾﺮﻤﺗ: ﻦﯾﺮﻤﺗ
ﻡﺎﺠﻧﺍ: ﻩﺪﺷﺮﭘ
ﺭﺍﺮﺻﺍ: ﻥﺩﺮﮐﺭﺍﺮﺻﺍ
: 
ﻞﺒﻗ: ﺯﺍﻞﺒﻗ
ﻪﻤﯿﻧ: ﯽﻄﺳﻭﻥﻭﺮﻗ, ﻦﯿﺑ
: 
: 
ﺖﺴﯾﺭﻮﺗ: ﺮﻓﺎﺴﻣ, ﯼﺩﺮﮕﻧﺎﻬﺟ
ﻪﺑﺎﺷﻮﻧ: ﻥﺪﯿﺷﻮﻧ
ﻪﺟﻮﺘﻣ: ﻥﺩﺮﮐﺵﻮﻣﺍﺮﻓ
ﻥﺎﯿﺑ: ﺢﯿﺿﻮﺗ, ﻥﺎﯿﺑ, ﯽﺸﯾﺎﻤﻧ
ﺭﺎﺑﺩﺮﺑ: ﺮﺒﺻ
ﺡﻼﺻﺍ: ﻥﺩﺍﺩﺮﯿﯿﻐﺗ, ﻥﺩﺮﮐﻦﯾﺰﮕﯾﺎﺟ, ﻥﺩﺮﮐﻞﺼﺘﻣﻢﻫﺎﺑ, ﺕﺎﺣﻼﺻﺍ, ﯼﺯﺎﺳﺯﺎﺑ
ﻦﯿﻨﺟ: ﻪﺘﺴﻫ
ﺭﺍﺩﻮﻤﻧ: ﯽﻧﺎﻣﺯﺎﺳﺕﺭﺎﭼ, ﻪﺸﻘﻧ
ﺮﺴﮐ: ﻩﺎﮔﺍﺭﺎﮐ, ﺎﻨﺜﺘﺳﺍ
ﯽﺳﺎﯿﻗﺎﯾﯽﯾﺍﺮﻘﺘﺳﺍﺖﻟﺎﺣ: ﯽﺋﺎﻘﻟﺍﺖﻟﺎﺣ
ﻥﺩﺮﮐﻝﺎﻤﯾﺎﭘ: ﻥﺩﺮﮐﻢﺘﺳ, ﻞﯿﺳ
ﺭﺎﯿﺳ: ﯽﺸﮐﺙﺎﺛﺍ, ﻦﻔﻠﺗ, ﮎﺮﺤﺗ, ﺮﯿﻐﺘﻣ
ﻥﺩﺮﺑﻻﺎﺑ: ﻥﺩﺮﮐﺪﻨﻠﺑ
ﻦﯾﺍﺮﺑﻩﻭﻼﻋ: ﯽﺘﺣ
ﺩﺍﺪﺿﺍ: ﯼﺩﮊﺍﺮﺗ
ﻥﺩﺯﻒﮐ: ﺪﯿﺠﻤﺗﻭﻖﯾﻮﺸﺗ
ﻪﻐﻟﺎﺒﻣ: ﮏﻤﻧ
ﺎﻫﺵﺯﺭﻭ: ﺩﺭﺯﮓﻧﺭ, ﯽﯾﻼﻃ
ﻒﺻ: ﺖﻣﻼﻋ, ﺭﻮﺒﻋﺰﻣﺭ, ﺏﻮﭼ
ﻩﺪﻧﻭﺩ: ﻦﻟﺎﺳ
ﻩﺮﮐﺍﺬﻣ: ﻩﺮﮐﺍﺬﻣ, ﻮﮕﺘﻔﮔﻭﺚﺤﺑ
ﻢﯾﮊﺭ: ﻥﻮﻧﺎﻗ
ﻞﻤﺤﺗ: ﻞﻤﺤﺗ, ﺮﺒﺻ
ﯽﺒﯿﻠﺻﮓﻨﺟ: ﺮﻔﺳ
ﻥﺪﺷﺮﯿﮔﺍﺮﻓ: ﯼﺩﮊﺍﺮﺗ, ﻪﻤﺟﺮﺗ
ﮏﯿﻨﮑﺗ: ﯽﻨﻓ, ﮏﯿﺘﮐﺎﺗ, ﯽﺳﺪﻨﻬﻣ
ﻪﻧﺎﯾﺎﭘ: ﺖﯾﺎﻬﻧﺭﺩ, ﻪﻧﺎﯾﺎﭘ
ﺪﯿﻟﻮﺗ: ﻪﻨﯾﺰﻫ, ﻪﺠﯿﺘﻧ, ﺭﺎﺸﺘﻧﺍ, ﯼﺭﻭﻩﺮﻬﺑ, ﺝﻭﺮﺧ
ﻝﺍﻡﺍﯽﺗﭺﺍ: 
ﻥﺩﺍﺩﺭﺍﺮﻗ: ﻪﻄﻘﻧ, ﺺﯿﺨﺸﺗ, ﻦﺘﻓﺮﮔﺎﺟ
ﺽﺮﻓﺶﯿﭘﺭﻮﻃﻪﺑ: ﻑﺬﺣ
ﻪﻨﯿﻣﺯ: ﺯﺍﺪﻧﺍﻢﺸﭼ, ﻪﻨﺤﺻ
ﻥﺩﺮﮐﻡﺍﺪﺨﺘﺳﺍﺯﻮﻣﺍﻮﻧ: ﺩﺰﻣﺎﻧ, ﻩﺪﮑﺸﻧﺍﺩﻝﻭﺍﻝﺎﺳﯼﻮﺠﺸﻧﺍﺩ
ﺎﻫﻪﻟﺎﺑﺯ: ﻦﯾﺮﺗﺪﺑ, ﯽﻨﺘﺨﯾﺭﺭﻭﺩ
ﺭﺍﺪﻗﻭﺪﻨﺻ: ﺭﺍﺩﻪﻧﺍﺰﺧ, ﻪﺒﻌﺟ, 
: 
ﻑﻼﺘﺋﺍ: ﺩﺎﺤﺗﺍ, ﺪﺤﺘﻣ
: 
ﺐﯿﻋ: ﺶﻧﺯﺮﺳ, ﻩﺎﺒﺘﺷﺍ, ﯽﻧﺍﻮﺗﺎﻧ, ﺭﺮﺿ
: 
ﻥﺩﺮﮐﺭﺍﺬﮔﺍﻭ: ﺮﮑﺸﺗ
ﺶﺨﭘ: ﺭﺎﺸﺘﻧﺍ, ﻝﺎﺳﺭﺍ
ﯼﺮﯿﮔﻩﺭﺎﻤﺷ: ﻥﺩﺮﻛﺏﺎﺨﺘﻧﺍ, ﻪﻘﻠﺣ, ﻥﺩﺮﮐﻊﻤﺟ
ﻉﻮﯿﺷ: ﺪﻨﺴﭘﻪﻣﺎﻋ, ﺵﺩﺮﮔ, ﻥﺩﺍﺩﺭﺎﺸﺘﻧﺍ
ﻩﺪﻨﯾﺍﺰﻓﺭﻮﻃﻪﺑ: ﻻﺎﺑ, ﻪﻤﻫ, ﯼﺩﺎﯾﺯﺪﺣﺎﺗ
ﻞﯾﺪﺒﺗ: ﻥﺩﺍﺩﺮﯿﯿﻐﺗ, ﻞﯾﺪﺒﺗ
ﮎﺩﺎﺑﺩﺎﺑ: ﺎﻫﺩﮊﺍ
ﻢﻬﺒﻣ: ﻢﻬﺒﻣ, ﺰﯿﮕﻧﺍﺮﺑﺚﺤﺑ, ﻪﻧﺎﻓﺮﻃ
ﻪﻓﺎﮐ: ﻩﻮﻬﻗ
ﻩﺰﯾﺎﺟ: ﻩﺰﯾﺎﺟ, ﻪﻤﯿﺑﻖﺣ, ﻥﺩﺍﺩ, ﯽﻠﯿﺼﺤﺗﺱﺭﻮﺑ
ﻪﺴﯾﺎﻘﻣﻞﺑﺎﻗ: ﻪﺴﯾﺎﻘﻣ
ﺐﺴﭼﺮﺑ: ﺖﻣﻼﻋ
ﺐﯾﻮﺼﺗ: ﺪﯿﯾﺎﺗ
ﯼﺪﻧﻭﺎﺸﯾﻮﺧ: ﺱﺎﯿﻗ, ﺖﺴﯿﻟﺎﯿﺳﻮﺳ
ﻩﺪﻧﺰﺧ: ﺭﺎﻣ
ﻝﺰﻨﻣﺯﺍﺝﺭﺎﺧ: ﯽﻧﻭﺮﯿﺑ, ﻦﮐﺯﺎﺑ
ﻮﯾﺩﺍﺭ: ﻢﻴﺳﻲﺑ
ﯽﺳﺎﯿﺳ: ﯽﺳﺎﯿﺳ
ﺩﺎﻨﺘﺳﺍ: ﻝﻮﻗﻞﻘﻧ
ﻩﺪﻧﺎﻣﯽﻗﺎﺑ: ﯽﻗﺎﺑ
: 
ﺭﺍﻮﻧ: ﺖﺳﺎﮐ, ﺪﻧﺎﺑ, ﺦﯾ, ﺎﻤﻨﯿﺳﻢﻠﯿﻓ
ﺏﻮﻠﻄﻣﻭﻦﯾﺮﯿﺷ: ﻡﺮﻧ, ﻦﯾﺮﯿﺷ
: 
ﯽﻫﺎﻔﺷ: ﺐﻟ, ﻥﺎﻫﺩ
ﺮﻈﻧﻑﻼﺘﺧﺍ: ﻉﺍﺰﻧ
ﻥﺪﯿﺸﯾﺪﻧﺍ: ﻥﺰﺑﺱﺪﺣ
: 
ﻦﺘﺧﺍﺪﻧﺍﻥﻭﺮﯿﺑ: ﻥﺩﺮﮐﺭﺎﻨﮐﺮﺑ, ﻪﯿﻠﺨﺗ, ﻦﺘﺷﺍﺩﺮﺑ
: 
ﺰﯿﺧﻭﺖﺴﺟ: ﺺﻗﺭ, ﺩﺮﮐﮎﺮﺗ
ﻥﺍﻮﯿﻟ: ﻥﺎﺠﻨﻓ, ﻝﻮﺻﺍﻭﺍﺩﺍ, ﻥﺎﻫﺩ
ﺖﯿﻓﺎﻌﻣ: ﻒﯿﻔﺨﺗ, ﺎﻨﺜﺘﺳﺍ, ﯽﮕﻧﻭﺰﻓﺍ
ﻞﻤﺣﻞﺑﺎﻗ: ﮎﺮﺤﺗ, ﯽﻤﮐﺭﺍﺪﻘﻣ, ﻩﺍﺮﻤﻫﻦﻔﻠﺗ
ﯼﺪﻨﺑﻪﺘﺴﺑﺬﻏﺎﮐ: ﻪﺘﺴﺑ
ﯽﮔﺪﻨﺸﺧﺭﺩ: ﺩﺍﺪﻌﺘﺳﺍ, ﯽﯾﺎﺒﯾﺯ
ﻪﻟﺎﺑ: ﻪﻟﺎﺑ, ﻝﺎﺑ
ﺕﺮﺟﺎﻬﻣ: ﭺﻮﮐ
: 
: 
: 
ﻞﯿﻠﺤﺗﻭﻪﯾﺰﺠﺗ: ﯽﻠﯿﻠﺤﺗ, ﻞﯿﻠﺤﺗ
ﻲﺣﺍﺮﺟﻞﻤﻋ: ﺡﺍﺮﺟ
ﺕﺎﻐﯿﻠﺒﺗ: 
ﯽﺳﻮﻨﯿﺳ: ﻩﺩﺭﺎﻬﭼ
ﻦﺘﺷﺎﺒﻧﺍ: ﯽﮕﺘﺷﺎﺒﻧﺍ, ﯽﮑﻧﺎﺑﻩﺩﺮﭙﺳ, ﻥﺩﺮﮐﻊﻤﺟ
ﻥﺩﺍﺩﺕﺭﻮﻗ: ﻪﻟﻮﻟ
ﻡﻮﻬﻔﻣ: ﻪﺠﯿﺘﻧ, ﺮﺛﺍ
ﭖﺎﭘ: 
ﻩﺰﯿﮕﻧﺍ: ﻥﺩﺮﻛﻖﻳﻮﺸﺗ, ﮏﯾﺮﺤﺗ
: 
ﺭﻭﺁﻥﺎﯾﺯ: ﯽﺘﻧﺮﺘﻨﯾﺍﻢﯾﺍﺮﺟ, ﻪﻧﺎﺘﺳﻭﺩﺮﯿﻏ
ﺮﻬﺷﻪﻣﻮﺣ: ﺯﺍﺪﻧﺍﻢﺸﭼ, ﯽﯾﺎﺘﺳﻭﺭ, ﺮﻬﺷﻪﻣﻮﺣ, ﻩﺯﻮﺣ, ﻩﺪﮑﻫﺩ, ﺭﻮﺸﮐ
ﺶﻫﺎﮐ: ﻦﺘﻓﺭﻦﯿﺑﺯﺍ
: 
ﯽﻣﻮﺑ: ﺖﻌﯿﺒﻃ, ﯽﻌﻗﺍﻭ, ﻦﮐﺎﺳ
ﻪﺘﺸﭘ: ﻪﻟﺎﺑﺯ, ﺶﮐﺩﻭﺩ
ﺱﺭﺪﻣ: ﻮﮔﺪﻨﻠﺑ
: 
ﮏﺴﯾﺩ: ﮏﺴﯾﺩ, ﮏﭼﻮﮐﻩﺩﺮﮔ
ﻥﺪﺷﻂﯾﺍﺮﺷﺪﺟﺍﻭ: ﻂﯾﺍﺮﺷﺪﺟﺍﻭ
ﺪﻧﻭﺭ: ﺖﻬﺟ, ﻩﺪﺷﻢﺧ, ﻊﺿﻭ, ﯽﮔﺪﻧﺍﺭ, ﻞﯾﺎﻤﺗ
ﻢﮐﺍﺮﺗ: ﺕﺪﺷ
ءﺎﻘﻟﺍ: ﻡﺎﻬﻟﺍ, ﻥﺩﺮﮐﺭﺍﺩﺍﻭ
ﮒﺭﺰﺑﯼﺎﻫﺖﮐﺮﺷ: ﺖﮐﺮﺷ
ﺕﺎﺒﺛﯽﺑ: ﻥﺍﺯﺮﻟ, ﯼﺭﺍﺪﯾﺎﭘﺎﻧ
ﺭﺎﮔﺯﺎﺳ: ﺕﺍﺯﺍﻮﻣﻪﺑ, ﻥﺪﺷﺎﺟ, ﻪﻨﯿﻬﺑ
ﻦﻔﻠﺗ: ﻦﻔﻠﺗ, ﻥﺩﺯﮓﻧﺯ
: 
ءﻼﺧ: ﯽﻟﺎﺧ, ﻪﺒﻤﻠﺗ
: 
ﻦﺘﻓﺮﮔ: ﻥﺩﺯﻢﺧﺯ, ﻦﺘﻓﺮﮔ, ﻥﺩﺮﮐﺐﺣﺎﺼﺗ
ﺞﻨﺸﺗ: ﻪﻟﺰﻟﺯ, ﺭﺎﺠﻔﻧﺍ, ﯼﺮﺘﺴﯿﻫ
: 
ﺮﺑﺮﺳﻪﻠﺻﻮﺣ: ﻥﺩﺮﮐﺥﺍﺭﻮﺳﻪﺘﻣﺎﺑ
ﻡﺎﻘﻣ: ﻢﯿﻈﻨﺗ, ﻝﻮﭘﻒﯿﮐ
ﻑﺎﮑﺷ: ﮎﺮﺗ
ﺽﺭﺍﻮﻋ: ﯽﮔﺪﯿﭽﯿﭘ
ﻪﻠﺧﺍﺪﻣ: ﻥﺩﺮﮐﻪﻠﺧﺍﺪﻣ
: 
ﻩﺪﻨﯾﺎﻤﻧ: ﻩﺪﻨﯾﺎﻤﻧ
: 
ﻩﺩﺍﺭﺍ: ﻩﺩﺍﺭﺍﯼﻭﺮﯿﻧ, ﻦﺘﺷﺍﺩﻞﻳﺎﻤﺗ
ﯽﻨﯿﺑﺶﯿﭘ: ﯽﻨﯿﺑﺶﯿﭘ, ﻥﺰﺑﺱﺪﺣ
ﯽﻨﯿﺑﺵﻮﺧ: ﺪﯿﻣﺍ, ﻦﺘﺷﺍﺩﺩﺎﻘﺘﻋﺍ, ﻪﻧﺎﺘﺨﺒﺷﻮﺧ
ﻥﺪﻨﮐﺖﺳﻮﭘ: ﺖﺳﻮﭘ, ﺮﺸﻗ
ﻥﺩﺮﻛﻚﺣ: ﺶﯿﻧ
: 
ﺭﻭﺎﻨﺷ: ﺭﻭﺎﻨﺷ, ﻦﺘﻓﺮﮔﺝﻭﺍ, ﻎﯾﺭﺩ
ﺶﺨﺑ: ﻩﺯﻮﺣ, ﯼﺍﻪﻘﻄﻨﻣ, ﺶﺨﺑ
ﯽﮔﺩﺍﻮﻧﺎﺧﻡﺎﻧ: ﻡﺎﻧ, ﺎﻬﻧﺁ, ﻪﻌﻠﻗ
ﻪﺴﺳﻮﻣ: ﺖﮐﺮﺷ, ﻥﺎﻣﺯﺎﺳ
ﺕﺭﻭﺮﺿ: ﺲﭘﺍﻮﻟﺩ, ﻥﺎﺠﯿﻫ
ﺏﺮﺿ: ﻥﺩﺮﮐﺮﯿﺜﮑﺗ
ﺶﺨﺑﺕﺬﻟ: ﺮﯾﺬﭙﻟﺩ, ﺖﺷﺯ
ﯽﯾﻻ: 
ﺭﺎﺸﺑﺍ: ﺎﻤﻨﺑﺁ
ﻩﺪﻨﻨﮐﺪﯿﻣﺍﺎﻧ: ﻩﺩﺮﺴﻓﺍ, ﯼﺪﯿﻣﺍﺎﻧ
ﻥﺪﻧﺎﺳﺮﺗ: ﻥﺩﺮﮐﯼﺮﯿﮔﻮﻠﺟ, ﻥﺪﻧﺎﺳﺮﺗ, ﯼﺭﺍﺩﺯﺎﺑ
ﯽﻔﻧ: ﯽﻔﻨﻣ
ﻩﺪﻧﺮﺑ: ﺖﯿﻘﻓﻮﻣ, ﯽﻧﺎﻣﺮﻬﻗ
ﺐﮐﺮﻣ: ﻁﻮﻠﺨﻣ, ﺪﺤﺘﻣ, ﻩﺪﯿﭽﯿﭘ
ﺩﺭ: ﺩﺭ, ﯼﺭﺍﺩﺯﺎﺑ
ﺮﯿﺛﺄﺗ: ﺮﺛﺍ, ﻥﺪﺷﻪﮐﻮﺷ
ﺮﺒﯿﻓ: ﺮﺒﯿﻓ
ﻪﻋﺮﺟ: ﻥﺎﻫﺩ, ﻊﻠﺑ, ﺶﯿﻧ
ﯼﺮﺼﺑ: ﯼﺮﺼﺑ, ﻪﻨﺤﺻ
ﻪﺠﻨﭘ: ﻦﺧﺎﻧ
ﯽﻨﯾﺮﯿﺷ: ﮏﯿﮐ, ﺮﻤﺨﻣ, 
: 
ﯽﮐﺎﺷ: ﺮﮕﯾﺯﺎﺑ, ﯽﻄﺧﻪﺨﺴﻧ, ﯽﻧﻮﻧﺎﻗﺩﺮﮕﯿﭘ
ﻥﺩﺮﮐﻩﺍﺮﻤﮔ: ﻒﯾﺮﺤﺗ, ﻥﺩﺮﮐﺕﺎﻣ, ﻖﻤﺣﺍ
ﺖﺳﺍﻩﺩﺮﮐﻉﻮﻨﻤﻣ: ﯼﺭﺍﺩﺯﺎﺑ, ﻥﺩﺮﮐﯼﺮﯿﮔﻮﻠﺟ, ﻊﻧﺎﻣ
ﺮﮕﯾﺯﺎﺑ: ﺮﮕﯾﺯﺎﺑ, ﺪﻨﻣﺮﻨﻫ, ﻦﮑﯾﺯﺎﺑ
: 
ﻪﻘﺑﺎﺴﻣ: ﻪﻘﺑﺎﺴﻣ, ﯽﻧﺎﻣﺮﻬﻗ
ﻦﺘﻓﺮﮔﯽﺘﺸﮐ: ﮓﻨﺟ
ﺯﺎﯿﻧ: ﻥﺩﺮﮐﺎﺿﺎﻘﺗ, ﺖﯿﻌﺿﻭ
ﯼﺎﻬﻨﻣ: ﻦﯾﺮﺘﻤﮐ
: 
ﻢﻫﺮﺑﻭﻢﻫﺭﺩ: ﺍﻭﺮﭘﯽﺑ
ﯽﻧﻮﻔﻋ: ﺖﻧﻮﻔﻋ
: 
ﺪﯿﮐﺎﺗ: ﺱﺮﺘﺳﺍ, ﻥﺩﺮﮐﺭﺍﺮﺻﺍ
ﺭﺍﻮﻠﺷ: ﺭﺍﻮﻠﺷ
ﻥﺩﺮﮐﺞﯿﮔ: ﻝﺯﺎﭘ, ﻥﺩﺮﮐﺕﺎﻣ
ﻥﺩﺍﺩﺹﺎﺼﺘﺧﺍ: ﺐﻠﻃﻭﺍﺩ, ﺪﺼﻗ, ﺮﺑﻥﺩﺮﮐﯼﺯﻮﺴﻟﺩ
ﯽﺣﺍﺮﺟ: ﺡﺍﺮﺟ
ﯽﯾﻮﮕﻘﺣ: ﺖﯿﻌﻗﺍﻭ
: 
ﻢﻗﺭ: ﺢﯿﺤﺻﺩﺪﻋ, ﺖﺸﮕﻧﺍ
: 
ﻡﺪﺻﮏﯾ: ﺪﺻ
ﮏﯾﺩﺰﻧ: ﮏﯾﺩﺰﻧ, ﯼﺩﻭﺯﻪﺑ, ﺵﻭﺮﻓﻩﺩﺮﺧ
ﯽﮑﻠﻓﺕﺭﻮﺻ: ﻥﺎﺸﮑﻬﮐ, ﺩﺎﺤﺗﺍ, ﻩﺭﺎﯿﺳ
ﻝﻮﻤﻌﻣﺭﻮﻃﻪﺑ: ﻝﻮﻤﻌﻣ, ﻊﻗﺍﻮﻣﺮﺘﺸﯿﺑ, ﻞﯾﺎﻤﺗ
ﻩﺪﻨﻨﮐﺞﯿﮔ: ﺰﯿﮕﻧﺍﺮﺑﺚﺤﺑ, ﻝﺯﺎﭘ, ﯽﺠﯿﮔ, ﯽﻫﺍﺭﻭﺩ
ﺖﺒﺴﻧﻪﺑ: ﻝﺩﺎﻌﺗ, ﺱﺎﯿﻘﻣ
ﻥﺍﻮﺨﻤﻫ: ﻞﻤﻌﻟﺍﺭﻮﺘﺳﺩ
ﻥﺩﻮﺑﻒﻟﺎﺨﻣ: ﺩﺭ
ﺖﻧﻮﻓ: ﻞﻌﺟ
: 
ﮏﯾﺮﺤﺗ: ﻢﺸﺧ, ﻥﺩﺮﮐﻪﻠﺧﺍﺪﻣ, ﻦﺘﺧﺍﺪﻧﺍﺖﺳﺩﺍﺭﯽﺴﮐ, ﮏﯾﺮﺤﺗ
ﻪﺘﺴﺟﺮﺑ: ﺮﺘﻬﺑ, ﻪﺟﻮﺗﻞﺑﺎﻗ, ﺎﻨﺜﺘﺳﺍ
ﻉﻭﺮﺷ: ﻉﻭﺮﺷ
ﺵﺭﺎﺑ: ﻥﺩﺮﮐﻊﯾﺮﺴﺗ, ﻥﺍﺭﺎﺑ
ﻥﺩﺮﮐﻩﺩﺯﺖﺸﺣﻭ: ﻥﺪﻧﺎﺳﺮﺗ
ﯽﻣﺮﮔﺮﺳ: ﯽﻣﺮﮔﺮﺳﻭ​​ﺢﯾﺮﻔﺗ
ﯼﺭﻮﺘﺳﺩ: ﻥﺎﺑﺯﺭﻮﺘﺳﺩ
ﯼﺩﺪﻋ: ﺩﺪﻋ, ﻝﺎﺘﯿﺠﯾﺩ, ﯼﺭﺎﻣﺁ
ﺭﺎﯿﻌﻣ: ﺱﺎﯿﻘﻣ
ﯽﻨﯿﺑﺶﯿﭘ: ﻥﺰﺑﺱﺪﺣ, ﯽﻨﯿﺑﺶﯿﭘ
ﻥﺩﺮﮐﺩﺭ: ﺩﺭ
ﺐﯾﺮﻏﻭﺐﯿﺠﻋ: ﯽﺟﺭﺎﺧ, ﺐﻳﺮﻏﻭﺐﻴﺠﻋ
ﻥﺩﺮﺑﻻﺎﺑ: ﻥﺩﺮﮐﺮﺘﻬﺑ, ﻥﺩﺮﮐﻦﻬﭘ, ﻥﺩﺍﺩﺶﯾﺍﺰﻓﺍ, ﺝﺭﺎﺧﻩﺩﺮﺸﻓﺖﻟﺎﺣﺯﺍ
ﻡﺎﻏﺩﺍ: ﻡﺎﻏﺩﺍ, ﻥﺪﺷﺏﻭﺫ, ﻥﺩﺯﮓﻧﺯ, ﻁﻮﻠﺨﻣ
ﯼﺍﺭ: ﺏﺎﺨﺘﻧﺍ
ﺪﻌﺘﺴﻣ: ﺩﺍﺪﻌﺘﺳﺍ, ﻪﺑﺭﺩﺎﻗ
ﻥﺪﺷﻡﺮﮔ: ﻥﺪﺷﺏﻭﺫ
ﻩﺪﻨﺒﺴﭼ: ﻡﺯﻻ
ءﺰﺟ: ﯼﺪﻨﺑﺐﯿﮐﺮﺗ, ﺮﺻﺎﻨﻋ, ﻢﯿﺴﻘﺗ
ﻪﺘﺴﻫ: ﻪﺘﺴﻫ, ﻪﻧﺍﺩ
ﺖﺳﺍﺭ: ﻂﺴﺑ, ﻢﯿﻘﺘﺴﻣﺭﻮﻃﻪﺑ
ﻥﺩﺮﮐﻦﯿﺋﺰﺗ: ﻦﯿﯾﺰﺗ
ﺎﺤﯾﺮﺻ: ﺍﺮﻫﺎﻇ
ﯼﺭﻮﻬﻤﺟﺖﺳﺎﯾﺭ: ﺖﺳﺎﯾﺭ
ﻥﺪﺷﻑﺩﺎﺼﻣ: ﻥﺪﺷﺎﺟ
ﻢﻳﻮﮔﻲﻣﻚﻳﺮﺒﺗ: ﺶﯾﺎﺘﺳ
: 
ﻦﮑﺳﺍ: ﺖﺸﮔﺮﺑﻭﺖﻓﺭ
ﻥﺩﺎﻬﻧﻡﺎﻧ: ﺖﺳﺭﺩ
ﯼﺪﻨﺑﻁﺮﺷ: ﺖﯿﻌﺿﻭ, ﯼﺯﺎﺑﺶﺗﺁ, ﺭﺎﻤﻗ
ﯽﻨﻓﻅﺎﺤﻟﺯﺍ: ﯽﻨﻓ, ﯽﺳﺪﻨﻬﻣ
ﻩﺪﺷﯼﺮﭙﺳ: ﺭﻮﺒﻋ, ﻩﺪﻧﺎﻣﯽﻗﺎﺑ
ﺩﺎﺼﺘﻗﺍﻢﻠﻋ: ﺩﺎﺼﺘﻗﺍ
ﯽﺑﺮﺠﺗ: ﻪﺑﺮﺠﺗ
ﻦﺘﺷﺍﺩﻂﻠﺴﺗ: ﺩﺎﺘﺳﺍ
ﺕﺎﻐﯿﻠﺒﺗ: ﺩﻼﯿﻣﺯﺍﺪﻌﺑ
ﺭﺍﺪﺑﺎﺘﮐ: ﻪﻧﺎﺨﺑﺎﺘﮐ, 
ﺭﺎﺸﺘﻧﺍ: ﺵﺩﺮﮔ, ﻊﯾﺯﻮﺗ, ﻥﺩﺍﺩﺭﺎﺸﺘﻧﺍ, ﺭﺎﺸﺘﻧﺍ
ﻥﺪﻧﺍﺮﭼ: ﺵﺍﺮﺧ, ﯽﻤﺳﺍ
ﺯﺮﻓ: ﻑﺮﺣﺮﭘ
ﺖﯿﮐ: ﺕﺍﺰﯿﻬﺠﺗ, ﻪﺒﻌﺟ, ﻢﯿﻈﻨﺗ
ﺺﺼﺨﺘﻣ: ﺮﺘﮐﺩ, ﯽﺑﺮﻣ
ﻥﺩﺭﻮﺧﺲﯿﺧ: ﺐﯿﺷ, ﻥﺩﺮﮐﺭﺍﺩﺍﻭ
ﺐﯿﻗﺭ: ﺐﯿﻗﺭ
ﺖﻇﺎﻔﺣ: ﺖﻈﻓﺎﺤﻣ, ﯽﯾﻮﺟﻪﻓﺮﺻ, ﻥﺩﺍﺩﺖﻴﻤﻫﺍ
ﻞﮔﻭﻦﺠﻟ: ﻞﮔ, ﻭﺭﻩﺩﺎﻴﭘ, ﻥﺪﯿﻧﺎﮑﭼ
ﺶﻨﮐﺍﻭ: ﺱﺎﮑﻌﻧﺍ
ﺰﯿﮕﻧﺍﺮﺑﺶﻟﺎﭼ: ﺖﺨﺳ
ﯼﺮﻬﺷ: ﻥﺎﺘﺳﺮﻬﺷ
ﺭﺎﺴﻣﺮﺷ: ﻞﮑﺸﻣ
: 
ﯽﮔﺩﻮﻟﺍ: ﻩﺩﻮﻟﺁ, ﺩﺎﺴﻓ
ﯽﯾﺎﯿﻤﯿﺷﺩﺍﻮﻣ: ﯽﯾﺎﯿﻤﯿﺷ
ﻡﻮﺒﻟﺍ: 
ﻝﺎﺑﺲﯿﺑﯼﺯﺎﺑ: 
ﻥﺪﯿﺸﮐﻮﺑ: ﺲﻔﻧ
ﺭﺩﺎﻣ: ﺭﺩﺎﻣ
ﻞﻐﺑﺮﯾﺯﺏﻮﭼ: ﻥﺩﺮﮐﺖﯾﺎﻤﺣ
ﺖﺒﺛ: ﻂﺒﺿ, ﻥﺪﺷﻞﺧﺍﺩ
ﻝﻮﻠﺤﻣ: ﻥﺪﺷﺏﻭﺫ
ﮎﺎﻨﺳﺮﺗ: ﮎﺎﻨﺘﺸﺣﻭ, ﺰﯿﻣﺁﺪﯾﺪﻬﺗ
ﺺﺼﺨﺘﻣ: ﺱﺎﻨﺷﺭﺎﮐ, ﺺﺼﺨﺗ
ﻦﺘﺷﺍﺩﻕﺎﯿﺘﺷﺍ: ﻦﺘﺷﺍﺩﻞﻳﺎﻤﺗ, ﯼﺎﭼ
ﻡﺎﻤﺣ: ﻥﺍﻭ
ﺭﺎﻤﻗ: ﺭﺎﻤﻗ, ﯼﺯﺎﺑ, ﺍﺮﺟﺎﻣ, ﻁﺮﺷ
ﻝﺍﺮﮕﺘﻧﺍ: ﻡﺯﻻ, ﻪﭼﺭﺎﭙﮑﯾ
ﻥﺩﺮﺑﻦﯿﺑﺯﺍ: ﻦﺘﺷﺍﺩﺮﺑ, ﻦﺘﺸﮐ
ﻪﻤﯿﻤﺿ: ﯽﮕﺘﺴﺒﻟﺩ, ﯽﻓﺎﺿﺍ, ﯼﺮﻤﺘﺴﻣ
ﻩﺎﮕﺷﺯﺭﻭ: 
ﻞﻨﺳﺮﭘ: ﺪﻨﻣﺭﺎﮐ, ﻪﻣﺪﺧ
: 
ﻥﺩﺭﻭﺍﺭﺩﺵﺩﺮﮔﻪﺑ: ﻊﯾﺯﻮﺗ, ﻥﺩﺮﮐﺮﺘﻬﺑ, ﻥﺩﺍﺩﺭﺎﺸﺘﻧﺍ
ﻞﯿﻘﺛﺮﺟ: 
: 
: 
: 
ﻞﻣﺎﺷ: ﺪﺤﺘﻣ
: 
ﻩﺪﻨﺷﻭﺮﻓ: ﻩﺪﻨﺷﻭﺮﻓ, ﺵﻭﺮﻓﻩﺩﺮﺧ, ﺵﻭﺮﻓ
ﻥﺩﺮﮐﺖﯾﺫﺍ: ﯽﺒﺼﻋ, ﻥﺩﺮﮐﻪﻠﺧﺍﺪﻣ
: 
: 
ﻥﺪﺷﺮﺠﻔﻨﻣ: ﺭﺎﺠﻔﻧﺍ
ﺖﺸﻧ: ﺖﺸﻧ, ﻦﺘﺨﯾﺭ
ﻥﺎﮕﯾﺍﺭ: ﻥﺩﺮﮐﺩﺍﺯﺁ
ءﺰﺟ: ﺮﺻﺎﻨﻋ
ﺩﻮﺒﻤﮐ: ﻦﮐﺯﺎﺑ, ﻪﻠﯿﺒﻗ
ﻩﺪﻨﻨﻛﺖﺣﺍﺭﺎﻧ: ﯽﺒﺼﻋ, ﺪﻨﯾﺎﺷﻮﺧﺎﻧ, ﻦﯿﮕﻤﻏ, ﻝﻼﺘﺧﺍ
ﻦﮑﺴﻣ: ﻪﻧﺎﺧ
: 
ﯽﺴﮑﻋ: ﺯﺎﻓ, ﺮﯾﻮﺼﺗ, ﺱﺎﮑﻋ
ﻞﺻﺍ: ﻥﺩﺮﻛﺖﺑﺎﺛ
: 
ﺕﺎﻓﺁ: ﻩﺮﺸﺣ
ﺹﺮﻗ: ﺹﺮﻗ, ﭖﻮﺗ
ﺎﻫﻪﻧﺎﺳﺭ: ﺕﺎﻋﻮﺒﻄﻣ
ﻪﺑﺍﺮﺧ: ﯽﻫﺎﺒﺗ
ﻢﺴﺟ: ﻥﺪﺑ, ﻢﯿﻈﻨﺗ
ﻮﻨﻣ: ﺖﺳﺮﻬﻓ
ﯽﮕﺘﺴﮑﺷ: ﮎﺮﺗ, ﻥﺍﻮﺨﺘﺳﺍ
PI: ﻥﻮﮑﯿﻠﯿﺳ
: 
ﻦﻤﺠﻧﺍ: ﻥﺩﺮﮐﺥﺍﺭﻮﺳﻪﺘﻣﺎﺑ, ﻩﺎﮔﺩﺍﺩ
: 
ﺖﮐﺮﺣ: ﺖﻋﺮﺳ, ﺾﺒﻧ
ﺞﮐ: ﺩﻮﻋ, ﻩﺪﺷﻢﺧ, ﺮﺗﻭ, ﺐﯿﺷ
ﯽﺷﺎﮐ: ﺮﺟﺁ, ﻪﺒﻌﺟ
ﺮﮑﻫ: ﯽﯾﺎﯾﺭﺩﺩﺯﺩ
ﺏﺎﺘﮐﻪﺴﻔﻗ: ﻪﻧﺎﺨﺑﺎﺘﮐ, ﯽﺷﻭﺮﻔﺑﺎﺘﮐ
ﻪﺒﺳﺎﺤﻣ: ﺏﺎﺴﺣ, ﺱﻮﻨﯿﺴﮐ, ﻥﺩﺮﮐﻪﺒﺳﺎﺤﻣ, ﺏﺎﺴﺘﺣﺍﺎﺑ
ﻩﺪﻨﻨﻛﻪﻴﻬﺗ: ﻩﺪﻧﺯﺎﺳ
ﯽﻟﻮﭘ: ﻝﻮﭘ, ﻝﺩﺎﺒﺗ
ﺪﺸﮐﯽﻣﺮﯾﻮﺼﺗﻪﺑ: ﻥﺩﺮﮐﯽﻓﺮﻌﻣ, ﻥﺩﺮﮐﺲﮑﻌﻨﻣ
ﻡﺭﻮﺗ: ﻡﺭﻮﺗ
ﯼﺍﻪﯿﺷﺎﺣ: ﻪﺒﻟ, ﯽﻬﯾﺪﺑ, ﯽﺷﻭﺮﻓﻩﺩﺮﺧ
ﯼﺰﺘﻧﺎﻓ: ﯽﻟﺎﯿﺧ
: 
ﺰﭙﺷﺁ: ﻦﺘﺨﭘ, 
: 
ﻥﺩﺮﺑﻞﯿﻠﺤﺗ: ﻦﺘﻓﺭﻦﯿﺑﺯﺍ
ﻢﺠﺴﻨﻣ: ﺍﺪﮐﻮﻣ, ﯽﮕﺘﺳﻮﯿﭘ
: 
ﺎﺳﺎﺳﺍ: ﺕﺎﺣﻼﻄﺻﺍ, ﺖﺧﺎﺳﺮﯾﺯ, ﻪﯾﺎﭘ
ﯽﺑﺎﯾﺯﺎﺑ: ﺕﺎﺠﻧ, ﻪﺘﻓﺮﮔﺕﺎﺸﻧ, ﺖﺸﮔﺯﺎﺑ, ﺺﯿﺨﺸﺗ
ﯼﺪﻤﻋ: ﺍﺪﻤﻋ, ﺮﯿﮕﺑﺩﺎﯾ
ﯼﺯﺎﺠﻣ: ﯽﻌﻗﺍﻭ
ﺮﺒﺟ: ﯼﺮﺒﺟ
ﻩﺪﻧﺎﻣﺯﺎﺑ: ﻩﺩﺍﻮﻧﺎﺧ
ﺭﺎﺷ: ﻪﻧﺎﺧﺩﻭﺭ, ﻥﺎﯾﺮﺟ
ﯽﻣﻮﻤﻋ: ﻝﻮﻤﻌﻣ, 
ﯽﺘﺑﺎﻗﺭ: ﺐﯿﻗﺭ
ﮏﺷﺰﭙﻧﺍﺪﻧﺩ: ﺮﺘﮐﺩ
ﻥﺩﺍﺩﻥﺎﮑﺗ: ﯽﺸﮐﺙﺎﺛﺍ
ﯽﺳﺎﻨﺷﺖﺴﯾﺯ: ﯽﺘﺴﯾﺯ
: 
ﯽﻠﮑﻟﺍ: ﺖﺴﻣ, ﺏﺍﺮﺷ
: 
ﻥﺪﺷﻞﺋﺎﻗﺾﯿﻌﺒﺗ: ﮏﯿﮑﻔﺗ, ﺩﺎﻀﺘﻣ
ﺐﻠﻃﮓﻨﺟ: ﻝﺎﮑﯾﺩﺍﺭ, ﯽﺘﺴﯾﺭﻭﺮﺗ
ﯽﺗﺎﯿﺣ: ﻡﺯﻻ, ﻊﻃﺎﻗ, ﺖﯿﻤﻫﺍ
ﯼﺭﺍﺬﮔﺍﻭ: ﺭﺎﮐ, ﻦﯾﺮﻤﺗ, ﻪﻔﯿﻇﻭ
ﻪﯿﻤﻬﺳ: ﺯﺎﯿﺘﻣﺍ
ﮏﺗ: 
ﯼﺭﺎﻔﺣ: ﻝﺍﺩﻮﮔ, ﯼﺭﺎﻔﺣ, ﺮﮕﻨﺳ
ﻢﯿﺴﻠﮐ: ﻝﺎﺒﺗﻮﻓ
ﺖﺷﺍﺪﮔﺭﺰﺑ: ﻥﺩﺮﮐﺪﻋﺎﻘﺘﻣ
ﯽﺨﯾﺭﺎﺗ: ﯽﺨﯾﺭﺎﺗ
ﺭﻭﺩﻩﺍﺭﺯﺍﻪﺘﺷﺬﮔﺖﻔﺳ: 
ﯽﻤﺗﺍ: ﻪﺘﺴﻫ, ﯽﻤﺗﺍ
ﻞﺑﺎﻘﻣﺭﺩ: ﻞﺑﺎﻘﻣ, ﺯﺍﻞﺒﻗ, ﻦﻤﺷﺩ, ﻥﺩﺎﺘﺴﯾﺍ
ﻡﻼﺳ: ﺩﻭﺭﺩ, ﯼﺪﻣﺁﺵﻮﺧ, ﺕﺎﺠﻧ
ﻑﺬﺣ: ﻦﺘﺷﺍﺩﺮﺑ, ﻑﺬﺣ
ﺶﺨﺑﺶﻣﺍﺭﺁ: ﺵﺎﺑﻡﻭﺭﺁ, ﯽﺘﺣﺍﺭ
: 
: 
ﯽﺸﺨﺑﺮﺛﺍ: ﺭﺍﺬﮔﺮﻴﺛﺎﺗ, ﺮﺛﺍ, ﻪﺑﺭﺩﺎﻗ, ﯽﺳﺮﺘﺳﺩ
: 
ﺮﯾﺬﭘﺐﯿﺳﺁ: ﺱﺎﺴﺣ
ﻩﺍﺭﻩﺍﺭﻪﭼﺭﺎﭘ: ﻩﺍﺭﻩﺍﺭ, ﻂﺧ, ﺪﻧﺎﺑ, ﺎﻤﻨﯿﺳﻢﻠﯿﻓ
ﺖﯿﻓﺎﻔﺷ: ﻑﺎﻔﺷ
ﻮﻠﺟ: ﮏﺳﺎﻣ, ﯽﻧﻭﺮﯿﺑ
: 
ﻪﯿﻟﻭﺍﻪﻧﻮﻤﻧ: ﻝﺎﺜﻣ
ﻑﺍﺮﺤﻧﺍ: ﻪﻠﺑﺎﻘﻣ, ﻑﺍﺮﺤﻧﺍ
ﻪﻠﺑ: ﻊﻗﻮﻣﻥﻭﺍ, ﻩﺭﺁ, ﺎﻤﺷ, ﯽﺴﮐﻪﭼ
: 
ﻥﺩﺮﮐﺩﻭﺪﺤﻣ: ﻥﺩﺮﮐﯼﺮﯿﮔﻮﻠﺟ, ﻥﺩﺮﮐﻩﺎﺗﻮﮐ
ﮏﯿﺗ: ﺖﻣﻼﻋ, ﯽﺸﮐﺙﺎﺛﺍ
ﻩﺩﺎﯿﭘﺮﺑﺎﻋ: ﯼﻭﺭﻩﺩﺎﯿﭘ, ﺺﺨﺷ
ﻩﺮﻤﺧ: ﻥﺰﺨﻣ
ﺎﻋﺩﺍ: ﺶﻧﺯﺮﺳ, ﻥﺩﺮﮐﺭﺍﺮﺻﺍ
: 
ﻩﺪﺸﻧﻝﺮﺘﻨﮐ: ﻩﺍﻮﺨﻟﺩ
nullﺭﺍﺪﻘﻣ: ﺮﻔﺻ, ﯽﻟﺎﺧ
ﻁﻭﺮﺸﻣ: ﻪﺘﺴﺑﺍﻭ
ﯼﮊﻮﻟﻮﻨﮑﺗ: ﯽﻨﻓ
ﯽﺑﺎﯾﺭﺍﺯﺎﺑ: ﺕﺭﺎﺠﺗ
ﺮﮕﺷﻭﺎﮐ: ﯽﺑﺎﯾﺯﺭﺍ, ﻩﺭﺍﻮﻫﺎﻣ
: 
ﯼﺩﺎﺼﺘﻗﺍﺮﻈﻧﺯﺍ: ﺩﺎﺼﺘﻗﺍ
ﺲﻨﺟ: ﻥﺩﺮﮐﻪﺒﺳﺎﺤﻣ, ﺩﺮﻣﯽﻠﺳﺎﻨﺗﺖﻟﺁ, ﻪﻧ
ﺮﯾﺪﻣ: ﺮﯾﺪﻣ, ﯽﻟﻮﺘﻣ
ﻩﺪﻨﻨﮐﮎﺎﭘ: ﺕﻭﺍﺮﻃﺎﺑ, 
ﻥﺪﯿﺸﮐﺮﯾﻮﺼﺗ: ﻥﺩﺮﮐﯽﻓﺮﻌﻣ, ﯽﻧﻻﻮﻃ
ﻩﻮﻧ: ﻩﻮﻧ, ﺭﺩﺍﺮﺑﺎﯾﺮﻫﺍﻮﺧﺮﺴﭘ
ﻭﺩ: ﻭﺩ, ﻮﻠﻗﻭﺩ
: 
ﺰﺘﻨﺳ: ﻥﺩﺮﮐﺐﺼﻧ, ﻢﯿﻈﻨﺗ
ﺐﯿﺠﻋﻭﺐﯾﺮﻏ: ﺐﻳﺮﻏﻭﺐﻴﺠﻋ
: 
ﻩﺪﻨﻨﮐﺖﺳﺍﻮﺧﺭﺩ: ﺩﺰﻣﺎﻧ
ﯽﻧﺎﺑﺯ: ﻥﺎﺑﺯ
ﺐﺴﭼﺮﺑ: ﺖﻣﻼﻋ
ﻩﺩﺎﻌﻟﺍﻕﻮﻓ: 
: 
: 
: 
ﻥﺩﺮﺑﻻﺎﺑ: ﻥﺩﺮﮐﺪﻨﻠﺑ, ﻦﺘﻓﺭﺶﯿﭘ
: 
ﻩﺩﺎﻌﻟﺍﻕﻮﻓ: ﺎﺒﯾﺯ, ﯽﻌﯿﺒﻃﺮﯿﻏ
ﯽﺑﺎﯾﺯﺭﺍ: ﯽﺑﺎﯾﺯﺭﺍ, ﻥﺰﺑﺱﺪﺣ
ﺎﯾﻮﭘ: ﺕﺭﺪﻗ, ﯽﮑﯿﻣﺎﻨﯾﺩ
ﻥﺩﺮﮐﺮﻈﻧﺪﯾﺪﺠﺗ: ﯽﺳﺭﺮﺑ
ﻦﺘﺴﮑﺷﻢﻫﺭﺩ: ﻢﯿﺴﻘﺗ, ﻁﻮﻘﺳ, ﻞﯿﻠﺤﺗ, ﯽﮔﺪﯿﺳﻮﭘ
ﻩﺪﻨﻨﮐﻪﺘﺴﺧ: ﻪﺘﺴﺧ
ﺲﯾﺩﺮﭘ: ﺞﻟﺎﮐ, ﻪﺳﺭﺪﻣ
: 
ﻪﻣﺎﻧﻥﺎﯾﺎﭘ: ﻪﻣﺎﻧﻥﺎﯾﺎﭘ
ﯼﺭﺎﻣﺁ: ﻡﺎﻗﺭﺍ, ﯼﺭﺎﻣﺁ
ﻪﻟﻮﻣﺮﻓﻭﻦﯾﻭﺪﺗ: ﻥﺩﺮﮐﻩﺩﺎﻣﺁ, ﯼﺪﻨﺑﻝﻮﻣﺮﻓ
ﭻﯾﻭﺪﻧﺎﺳ: ﻥﺎﻧ
pluractional: 
ﮏﯾﺮﺤﺗ: ﻥﺩﺮﮐﻞﯿﻬﺴﺗ, ﻥﺎﺠﯿﻫ, ﮏﯾﺮﺤﺗ, ﻡﺎﻬﻟﺍ
ﺭﻮﺴﻧﺎﺳ: ﯽﭼﺭﻮﺴﻧﺎﺳ
ﻥﺩﺮﮐﺰﻬﺠﻣ: ﻩﺪﻨﻨﮐﻞﯿﻤﮑﺗ, ﻥﺩﺮﮐﻩﺩﺎﻣﺁ
ﻥﺩﺮﮐﺩﺰﻣﺎﻧ: ﺪﻫﺩﯽﻣﺩﺎﻬﻨﺸﯿﭘ
ﻪﻟﺩﺎﻌﻣ: ﺕﻻﺩﺎﻌﻣ, ﻥﺎﯿﺑ
ﺶﺨﺑ: ﺶﺨﺑ, ﻂﺴﺑ
ﻥﺩﺮﮐﻮﻐﻟ: ﻪﺿﺍﺮﻗ, ﯼﺪﯿﻣﺍﺎﻧ, ﻪﮐﻭﺮﺘﻣ
ﺮﺘﻣ: ﻦﺘﻓﺮﮔﻩﺯﺍﺪﻧﺍ
ﯽﺴﺣﯽﮐﺭﺪﻣﺖﻟﺎﺣ: 
: 
ﻥﺩﺮﮐﻩﺩﺮﺴﻓﺍ: ﻥﺩﺮﮐﻢﺘﺳ
ﺎﻗﺁ: ﺎﻗﺁ, ﺩﺎﺘﺳﺍ
ﯼﺯﺎﺳﺯﺎﺑ: ﯼﺯﺎﺳﺯﺎﺑ
ﻪﺘﻓﺮﺸﯿﭘ: ﻩﺪﯿﭽﯿﭘ, ﻥﺭﺪﻣ
ﻦﺘﺨﯾﺭﻥﻭﺮﯿﺑ: ﻪﯿﻠﺨﺗ
ﯽﻧﺎﻬﮔﺎﻧﺶﺸﮐﺎﯾﺖﮐﺮﺣ: ﻦﺘﺧﺍﺪﻧﺍﻻﺎﺑﺍﺭﻪﻧﺎﺷ
ﺐﺳﺎﻨﻣﺎﻧ: ﻂﺒﺗﺮﻣﺮﯿﻏ, ﻒﺳﺎﺗﻪﯾﺎﻣ, ﺐﺳﺎﻨﻣﺎﻧ
ﺏﻮﺳﺭ: ﻥﺩﺮﮐﻊﯾﺮﺴﺗ
ﺶﻧﺯﺮﺳ: ﺮﯿﻘﺤﺗ, ﺶﻧﺯﺮﺳ
ﺮﮕﯾﺩﻉﻮﻧ: ﻒﻠﺘﺨﻣ, ﻪﻨﯾﺰﮔ
ﻥﺩﺮﻛﺺﺨﺸﻣ: ﯽﻋﺎﺟﺭﺍ, ﻊﻃﺎﻗ
ﻥﺩﺮﮐﺩﺎﻘﺘﻧﺍ: ﺩﺎﻘﺘﻧﺍ, ﺪﯾﺩﺯﺎﺑ
: 
ﯽﮕﺘﺴﺧ: ﯼﺭﻮﺨﻟﺩ, ﯽﺘﺨﺑﺪﺑ
ﻥﺩﺮﮐﯼﺭﺎﮑﻤﻫ: ﯼﺭﺎﮑﻤﻫ, ﯽﮕﺘﺳﻮﯿﭘ, ﯽﻧﻭﺎﻌﺗ
ﺝﺭﺎﺧ: ﯽﺟﺭﺎﺧ
ﻞﯿﻠﺤﺗﻭﻪﯾﺰﺠﺗ: ﻞﯿﻠﺤﺗ
: 
ﻥﺍﺭﺎﺑﺵﺭﺎﺑ: ﻥﺍﺭﺎﺑ
ﺎﻤﯿﭘﺍﻮﻫ: ﻩﺪﻧﺮﭘ, ﻢﯿﻈﻨﺗ, ﻦﺘﻓﺮﮔﺝﻭﺍ
ﻊﻃﺎﻘﺗ: ﻝﺎﺼﺗﺍ
ﺪﻨﺗ: ﺰﯿﺗ
: 
ﯼﺮﯾﺬﭘﻑﺎﻄﻌﻧﺍ: ﯽﻋﺎﺠﺗﺭﺍﺖﯿﻠﺑﺎﻗ
: 
ﮏﺷﻮﻣ: ﮏﺷﻮﻣ
ﺪﯿﻗ: ﻪﻣﺎﻧﺖﻛﺎﭘ
: 
ﯽﺗﺎﺒﺛﯽﺑ: ﻥﺍﺯﺮﻟ, ﯼﺭﺍﺪﯾﺎﭘﺎﻧ
ﺖﯿﻣﻭﺮﺤﻣ: ﻥﺩﺮﮐﻡﻭﺮﺤﻣ, ﺭﺮﺿ, ﺶﯿﻧ
ﺪﯿﻟﻮﺗ: ﻥﺩﺮﮐﺪﯿﻟﻮﺗ, ﻞﻌﺟ, ﻥﺩﺮﮐﻩﺩﺎﻣﺁ
ﺐﯾﺮﻘﺗ: ﯽﺒﯾﺮﻘﺗ, ﻥﺰﺑﺱﺪﺣ
: 
ﻪﯿﺣﻭﺭ: ﺭﺍﺪﯿﺑ, ﯽﻗﻼﺧﺍ, ﯽﻨﻫﺫ
ﻦﯿﺑﺵﻮﺧ: ﺪﯿﻣﺍ, ﻦﺘﺷﺍﺩﺩﺎﻘﺘﻋﺍ
ﻥﺩﺮﮐﯼﺪﻨﺑﻪﺘﺳﺩ: ﯼﺯﺎﺳﺐﺗﺮﻣ, ﻊﯾﺯﻮﺗ
ﯽﻠﯿﺼﺤﺗﻪﻣﺎﻧﺮﺑ: ﻩﺭﻭﺩ, ﻪﺴﻠﺟﺭﻮﺘﺳﺩ
ﻪﻧﺎﺧﺯﺍﻥﻭﺮﯿﺑ: ﯽﻧﻭﺮﯿﺑ
ﻥﺩﺍﺩﻥﺎﺸﻧﺶﻨﮐﺍﻭ: ﻞﻤﻌﻟﺍﺲﻜﻋ, ﻡﺎﺠﻧﺍ
ﻂﺧ: ﯽﻄﺧﻪﺨﺴﻧ, ﻂﺧ, ﺱﺪﻘﻣﺏﺎﺘﮐ
ﺪﯾﺪﻬﺗ: ﻥﺩﺮﮐﯼﺫﺎﺧﺍ
: 
ﻩﺰﯾﺎﺟ: ﻩﺰﯾﺎﺟ, ﻪﻤﯿﺑﻖﺣ, ﯽﻓﺎﺿﺍ
ﺮﮕﻫﺭﺎﺷﺍ: ﻥﺯﻮﺳ
ﯽﯾﺍﺭﺍﺩ: ﮎﻼﻣﺍ, ﺭﻮﻀﺣ, ﺖﺨﺘﯾﺎﭘ،ﻪﯾﺎﻣﺮﺳ, ﻊﺑﺎﻨﻣ
: 
ﯼﺮﯾﺬﭘﺮﯿﯿﻐﺗ: ﻒﻠﺘﺨﻣ, ﻥﺩﺍﺩﺮﯿﯿﻐﺗ
ﺎﺘﻟﺩ: 
: 
ﻡﺎﻬﺑﺍ: ﻢﻬﺒﻣ, ﺰﯿﮕﻧﺍﺮﺑﺚﺤﺑ, ﺪﯾﺩﺮﺗ, ﻢﺧﻭﭻﯿﭘ
ﺲﻧﺍﺮﺗ: 
ﯽﺜﻨﺧ: ﯽﺜﻨﺧ, ﻥﺍﻮﯿﺣ
ﺺﻘﻧ: ﯽﻧﺍﻮﺗﺎﻧ, ﺭﺮﺿ, ﻊﻧﺎﻣ
ﯽﺳﺎﮑﻋ: ﺮﯾﻮﺼﺗ
ﺩﻮﺒﻤﮐ: ﺵﺮﺑ, ﻡﺪﻋ, ﻪﻠﯿﺒﻗ
ﯽﯾﺎﺟﻪﺑﺎﺟ: ﻥﺩﺮﮐﻦﯾﺰﮕﯾﺎﺟ
: 
: 
ﭺﺭﺎﻗ: ﯼﺮﺘﮐﺎﺑ, ﯽﮐﺍﺭﻮﺧﭺﺭﺎﻗ, ﺮﺘﭼ
ﯼﺪﻨﺑﻪﻠﻤﺟ: ﯼﺪﻨﺑﻝﻮﻣﺮﻓ, ﻦﺘﻣ, ﻩﮊﺍﻭ
ﻞﺗﺎﺷ: ﻞﻘﻧﻭﻞﻤﺣ
: 
ﺪﺑﺎﯾﻞﻣﺎﮑﺗ: ﻥﺪﺷﺎﻓﻮﮑﺷ
ﻥﺩﻮﻟﺎﭘ: ﺕﺎﺣﻼﺻﺍ, ﻥﺩﺮﮐﻪﯿﻔﺼﺗ
ﺕﺎﻤﻠﭙﯾﺩ: ﺮﯿﻔﺳ
ﺯﺎﻏﺁ: ﻥﺩﺮﮐﯽﻓﺮﻌﻣ, ﻉﻭﺮﺷ
: 
ﻦﺘﺴﮑﺷ: ﺢﻳﺮﻔﺗﮓﻧﺯ
: 
: 
ﻕﺎﺸﻨﺘﺳﺍ: ﺲﻔﻧ
ﻥﺩﺮﮐﺐﯿﮐﺮﺗ: ﻞﻣﺎﺷ, ﻦﺘﺧﺎﺳﺎﻫﺭ
ﺵﺍﻮﮑﺳﺍ: ﻲﻳﺍﻮﻠﺣﻭﺪﻛ
ﻩﺪﻨﻫﺩﯼﺍﺭ: ﯽﺗﺎﺑﺎﺨﺘﻧﺍﻩﺯﻮﺣ
ﻥﻮﯿﺳﺍﺭﺪﻓ: ﻝﺍﺭﺪﻓ, ﺪﺤﺘﻣ
ﺮﺸﯿﻓ: ﺕﻮﺒﮑﻨﻋ
ﻥﺩﺮﮐﯽﻟﺎﺧ: ﻪﯿﻠﺨﺗ
ﺖﻧﻮﮑﺳﻞﺤﻣ: ﻩﺎﻨﭘﻥﺎﺟ
ﻥﺪﯿﺸﮐﻥﻭﺮﯿﺑ: ﻥﺩﺯﻢﻬﺑ, ﻥﺩﺮﮐﺭﺍﺩﺍﻭ
ﯽﻈﻓﺎﺣﺍﺪﺧ: ﯽﻈﻓﺎﺣﺍﺪﺧ
ﻥﺩﺮﮐﺏﺍﺮﺧ: ﻦﺘﻓﺭﻦﯿﺑﺯﺍ, ﯽﻫﺎﺒﺗ
ﻥﻮﯾﺰﯾﻮﻠﺗ: ﻥﻮﯾﺰﯾﻮﻠﺗ
: 
ﻁﻮﻠﺨﻣ: ﻮﮕﺘﻔﮔﻭﺚﺤﺑ
ﺐﺳﺍﻞﻌﻧ: ﺐﺳﺍ
ﺝﺎﺟﻮﻋﺍ: ﻑﺍﺮﺤﻧﺍ, ﻥﺩﻮﺑﻥﺍﺩﺮﮔﺮﺳ, ﻒﯾﺮﺤﺗ
: 
ﻥﺩﺯﻢﻬﺑﺕﺪﺷﺎﺑ: ﻢﺘﺷﻭﺏﺮﺿ
ﻁﻮﺑﺮﻣ: ﻥﺪﺷﺎﺟ, ﻪﺟﻮﺗ
ﯽﻌﺑﺎﺗ: ﯽﻠﻤﻋ, ﺭﺎﮐ
ﯽﻟﻮﮑﻟﻮﻣ: ﻝﻮﮑﻟﻮﻣ, ﯽﻤﺗﺍ
: 
ﻥﺩﺮﮐﺎﺠﺑﺎﺟ: ﻥﺩﺮﮐﺭﺎﻨﮐﺮﺑ, ﻥﺩﺮﮐﻦﯾﺰﮕﯾﺎﺟ
ﯼﺭﺎﺘﺨﻣﺩﻮﺧ: ﻝﻼﻘﺘﺳﺍ
ﺭﺎﯿﺧ: ﻪﻨﯾﺰﮔ
ﯽﺳﺎﻨﺷﺭﺎﮐ: ﻪﯾﺎﭘ, ﻮﺠﺸﻧﺍﺩ
ﻑﺍﺮﮔ: ﯽﻧﺎﻣﺯﺎﺳﺕﺭﺎﭼ, ﻪﺸﻘﻧ
ﻥﺩﺮﮐﺏﻭﺬﺠﻣ: ﻥﺩﺮﮐﺮﯿﺳﺍ, ﻦﺘﺧﺍﺪﻧﺍﺖﺳﺩﺍﺭﯽﺴﮐ
ﺏﺍﺬﺟ: ﻞﮕﺷﻮﺧ, ﻦﯾﺮﯿﺷ
ﯽﻤﮑﺷ: ﻩﺪﻌﻣ
: 
: 
ﺩﺍﻮﺳ: ﺕﻼﯿﺼﺤﺗ, ﺖﯿﻠﺑﺎﻗ
ﻥﺯﺖﻣﺪﺨﺸﯿﭘ: ﺭﺍﺰﮕﺘﻣﺪﺧ, 
ﯽﺒﯿﮐﺮﺗ: ﯽﻋﻮﻨﺼﻣ
ﯽﺑﺮﻣ: ﯽﺑﺮﻣ
ﻭﺮﺴﻨﮐ: ﯼﺯﺎﺳﻩﺮﯿﺧﺫ, ﯽﯾﻮﺟﻪﻓﺮﺻ, ﺖﻈﻓﺎﺤﻣ, ﻆﻔﺣ
ﻪﻟﺎﺑﺯ: ﻪﺿﺍﺮﻗ, ﻪﻟﺎﺑﺯ, ﯽﻨﺘﺨﯾﺭﺭﻭﺩ, ﻦﯾﺮﺗﺪﺑ
: 
ﺲﮑﻋ: ﺮﯾﻮﺼﺗ, ﺲﮑﻋ
ﯽﺳﺭﺩﺏﺎﺘﮐ: ﯼﺎﻤﻨﻫﺍﺭﻪﭽﺑﺎﺘﮐ, ﺏﺎﺘﮐ
: 
ﻥﺩﺮﮐﯽﮑﯾ: ﺖﯾﻮﻘﺗ, ﻡﺎﻏﺩﺍ
ﺩﻭﺪﺤﻣ: ﻥﺩﺮﮐﯼﺫﺎﺧﺍ
ﻥﺍﺩﺩﺎﺼﺘﻗﺍ: ﺩﺎﺼﺘﻗﺍ
ﻥﺩﺭﻮﺧﻝﻮﻟ: ﻝﻮﺻﺍﻭﺍﺩﺍ
ﺪﯾ: ﯽﻧﺪﻌﻣ
ﻩﺩﻮﻟﺁ: ﺖﻧﻮﻔﻋ, ﻩﺩﻮﻟﺁ
ﻦﯿﻨﺟﻂﻘﺳ: ﻦﯿﻨﺟﻂﻘﺳ, ﻢﮐ
ﺡﺍﺮﻃ: ﺺﺨﺸﻣ
ﻻﻭﺍ: ﻝﻭﺍ, ﺮﮔﺯﺎﻏﺁ
ﻥﺩﺮﮐﻥﺎﻬﻨﭘ: ﺢﺷﺮﺗ, ﻥﺩﺮﮐﯽﻔﺨﻣ
ﺲﮑﯿﻧﻮﯾ: 
ﺰﻨﮕﻨﻣ: ﯽﻧﺪﻌﻣ
ﺝﺎﻨﻔﺳﺍ: ﻦﯾﺪﻟﺍﻭ
ﺪﯾﺪﺷ: ﺪﯾﺪﺷ, ﯽﺒﺼﻋ
ﻩﺪﻨﻨﮐﺪﻋﺎﻘﺘﻣ: ﯽﺸﯾﺎﻤﻧ
ﻪﻣﺎﻧﺮﺑ: ﯼﺩﺮﺑﺭﺎﮐﯼﺎﻫﻪﻣﺎﻧﺮﺑ, ﺲﯾﻮﻧﻪﻣﺎﻧﺮﺑ
ﺭﺎﮐﺯﺎﻏﺍ: ﻝﻭﺍ, ﻉﻭﺮﺷ
ﻡﺭﺍﺰﻫ: ﺭﺍﺰﻫ
ﯽﻠﺧﺍﺩ: ﯽﻠﺧﺍﺩ, ﻖﯿﻤﻋ, ﻩﺪﺷﻩﺩﺍﺩﺶﺷﻮﭘ
ﻝﺎﻄﺑﺍ: ﻥﺩﺮﮐﻡﻭﺮﺤﻣ
: 
ﻪﻨﻣﺍﺩ: ﻥﺩﺍﺩﺭﺎﺸﺘﻧﺍ
: 
ﺪﻌﺑ: ﺖﻬﺟ, ﯼﺪﻌﺑ, ﺪﻌﺑ, ﺱﺎﯿﻘﻣ
ﺱﺪﻘﻣﺏﺎﺘﮐ: ﺱﺪﻘﻣﺏﺎﺘﮐ
ﯽﻣﻮﺘﻧﺍﻮﮐ: ﺫﺎﺨﺗﺍ, ﺶﺨﺑ
ﺮﺘﺳﻮﭘ: ﻢﭼﺮﭘ
ﻥﺪﯿﺸﺨﺑﺖﻋﺮﺳ: ﻥﺩﺮﮐﻊﯾﺮﺴﺗ, ﺖﻋﺮﺳ
ﺪﯾﺪﺸﺗ: ﺖﯾﻮﻘﺗ, ﻦﻣﺰﻣ
ﯼﺭﺍﺬﮔﻥﺎﺸﻧ: ﺖﻣﻼﻋ
ﻻﻮﻤﻌﻣ: ﻝﻮﻤﻌﻣ, ﻊﻗﺍﻮﻣﺮﺘﺸﯿﺑ, ﺹﻮﺼﺨﺑ
ﺪﻬﻌﺗ: ﻩﺪﻋﻭ
ﻒﺻ: ﻡﺩ, ﺐﯿﺗﺮﺗ, ﺮﺿﺎﺣﻝﺎﺣﺭﺩ
ﺏﻼﻗ: ﭗﯿﻠﮐ, ﺞﻧﺭﺁ, ﺏﻼﻗ, ﯽﻣﺎﺣ, ﻥﺩﺮﮐﺖﯾﺎﻤﺣ, ﺰﺘﻧﺍﺮﭘ
: 
: 
ﺱﻮﮑﻌﻣ: ﺲﮑﻋﺮﺑ, ﯽﮕﻧﻭﺭﺍﻭ, ﻝﻮﻐﺸﻣ
ﻥﺪﺷﺭﺎﺨﺑ: ﻥﺪﺷﺏﻭﺫ, ﻩﺯﺎﯿﻤﺧ
ﯼﺩﺭﻮﻧﺍﻮﻫ: ﻮﺟ, ﺍﻮﻫ, ﺯﺍﻭﺮﭘ, ﻝﺎﺑ
ﻁﺎﺒﺗﺭﺍ: ﻝﺩﺎﻌﺘﻣ, ﻪﺴﯾﺎﻘﻣ, ﻁﺎﺒﺗﺭﺍ
ﯽﻣﻮﻗ: ﯽﻠﻣ
ﯽﻄﺧ: ﻩﺩﺎﺳﻡﺩﺁ
ﻥﺩﺮﮐﻩﺩﺮﺸﻓ: ﭗﯾﺯ, ﺎﺑﺮﻣ
ﻥﺩﺮﮐﻩﺪﯾﺮﺑﻩﺪﯾﺮﺑ: ﺵﺮﺑ
ﺶﯾﺎﺳﺮﻓ: ﯽﮔﺪﯿﺳﻮﭘ, ﻥﺩﺍﺩﺮﺟ
ﺮﯾﻭﺰﺗﻭﻪﻠﯿﺣﯼﻭﺭ: ﯼﺮﮔﻪﻠﯿﺣ, ﻩﺪﺷﺖﺳﺭﺩﻪﻧﺍﺩﺎﺘﺳﺍ, ﻩﺪﯿﭽﯿﭘ, ﺖﺨﺳ, ﻪﺘﺷﺮﻓ
ﺕﺎﯿﺻﻮﺼﺧ: ﻥﺩﺮﮐﺺﺨﺸﻣ
ﻥﺩﻮﻤﻧﻪﻓﺎﺿﺍ: ﻥﺩﺮﮐﻞﺼﺘﻣﻢﻫﺎﺑ, ﺕﺍﺯﺍﻮﻣﻪﺑ, ﻥﺩﺮﮐﺭﺍﺩﺍﻭ
ﯼﺪﻨﺑﺮﮑﯿﭘ: ﻊﺿﻭ, ﯼﺭﺎﺘﺧﺎﺳ, ﮊﺎﺘﻧﻮﻣ, ﯼﺪﻨﺑﺐﯿﮐﺮﺗ
ﻞﺑﺎﻘﺘﻣﺮﺛﺍ: ﻩﺮﮐﺍﺬﻣ, ﻭﻒﮐ, ﻁﺎﺒﺗﺭﺍ, ﻞﺑﺎﻘﺘﻣ
ﯽﻤﮐ: ﻢﺠﺣ
ﯽﯾﺍﺮﮔﻥﻭﺭﺩ: ﺮﮕﻧﻪﺘﺷﺬﮔ
ﻕﺮﺷ: ﻕﺮﺷ, ﻡﺩﻩﺪﯿﭙﺳ
ﻪﻔﻄﻧ: ﻪﻧﺍﺩ
ﯼﺯﺎﺳﻮﺠﺑﺍ: ﻪﻧﺎﺧﺭﺎﮐ
ﻥﺩﺮﮐﻩﺩﺎﺳ: ﻥﺩﺮﮐﻞﯿﻬﺴﺗ
ﺪﯿﯾﺎﺗ: ﻥﺩﺮﮐﺖﯾﺎﻤﺣ, ﺪﯿﯾﺎﺗ
: 
ﺭﺎﺒﺘﻋﺍ: ﯼﺭﺍﺩﺎﻓﻭ, ﻥﺎﻨﯿﻤﻃﺍﺖﯿﻠﺑﺎﻗ, ﺭﺎﺒﺘﻋﺍ
: 
ﯼﺭﺎﮑﺑﺍﺮﺧ: ﯽﻫﺎﺒﺗ
ﯼﻭﺰﻨﻣ: ﻢﻫﺯﺍﺍﺪﺟ
ﻑﺍﺮﺤﻧﺍ: ﯽﮔﺪﻧﺍﺭ, ﻑﺍﺮﺤﻧﺍ, ﺐﺼﻌﺗ
ﻖﯾﺭﺰﺗ: ﻥﺯﻮﺳ, ﻦﺴﮐﺍﻭ
ﻥﺩﺮﮐﺮﯾﺰﮔﺎﻧ: ﻥﺩﺮﮐﯼﺫﺎﺧﺍ
ﻝﺪﻨﺻ: ﺶﻔﮐ
ﻪﮑﺗ: ﻩﺩﻮﺗ, ﻪﺷﺍﺮﺗ, ﺪﻨﺑ, ﻂﺴﺑ
ﺕﺎﺑﻮﺒﺣ: ﺕﺎﺑﻮﺒﺣ
ﻑﺮﻇ: ﺭﺍﺰﺑﺍ, ﻥﺰﺨﻣ, ﻥﺍﺪﻠﮔ
: 
ﺕﺮﺟﺎﻬﻣ: ﭺﻮﮐ, ﻥﺩﻮﺑﻥﺍﺩﺮﮔﺮﺳ, ﯽﺸﮐﺙﺎﺛﺍ, ﻦﺘﻓﺭ
ﻥﺎﮔﮊﺍﻭ: ﺕﺎﺣﻼﻄﺻﺍ
ءﺍﺰﺟﺍ: ﺕﺎﻧﺎﮑﻣﺍ, ﺮﺻﺎﻨﻋ, ﻢﯿﺴﻘﺗ
ﻪﯿﺑﺎﺨﺘﻧﺍﻩﺯﻮﺣ: ﯽﺗﺎﺑﺎﺨﺘﻧﺍﻩﺯﻮﺣ
ﻥﺩﺮﮐﮎﺎﭘ: ﻦﺘﺷﺍﺩﺮﺑ, ﻦﺘﻓﺭﻦﯿﺑﺯﺍ
ﻥﺩﺮﮐﺖﻃﺎﺳﻭ: ﻥﺩﺍﺩﯽﺘﺷﺁ
ﯼﺭﺍﺩﻪﯾﺎﻣﺮﺳ: ﺭﺍﺩﻪﯾﺎﻣﺮﺳ
ﯼﺭﺍﺪﻠﮕﻨﺟ: ﻞﮕﻨﺟ
ﯽﮑﺳﺍ: ﻥﺩﺮﮐﯼﺯﺎﺑﺖﯿﮑﺳﺍ
ﮎﺮﻤﮔﺯﺍﻻﺎﮐﺺﯿﺧﺮﺗ: ﺭﺎﻤﻗ, ﻩﺯﺎﺟﺍ
ﺭﻭﺎﺸﻣ: 
: 
ﯽﺑﺎﺨﺘﻧﺍ: ﻥﺩﺮﻛﺏﺎﺨﺘﻧﺍ, ﺏﺎﺨﺘﻧﺍ
ﺎﺘﺴﯾﺍ: ﺖﺑﺎﺛ
ﺍﺮﮕﻤﻫ: ﻡﺎﻏﺩﺍ, ﺰﮐﺮﻤﺗ
ﯽﻧﺎﻬﺟ: ﻲﻠﻠﻤﻟﺍﻦﻴﺑ, ﻥﺎﻬﺟ, ﺮﯿﻐﺘﻣ
ﻦﺘﺧﺍﺪﻧﺍﻥﻭﺮﯿﺑ: ﻥﺩﺮﮐﺭﺎﻨﮐﺮﺑ, ﺯﻭﺰﮔﺍ
: 
ﻪﺤﻧﺎﺳ: ﻑﺩﺎﺼﺗ, ﯽﻧﺎﺑﺮﻗ, ﯽﮔﺪﯾﺩﺐﯿﺳﺁ
ﻪﺷﺎﺑ: ﺮﺑﺍﺮﺑ, ﺭﺎﯿﺴﺑ, ﺏﻮﺧﺭﺎﻴﺴﺑ
ﯽﻠﻤﻋ: ﯽﻠﻤﻋ, ﻦﯿﺑﻊﻗﺍﻭ, ﻝﻮﻐﺸﻣ
ﺭﻭﺍﺩ: ﻥﻮﻧﺎﻗ, ﯽﺿﺎﻗ
ﻝﻮﻤﺷ: ﻂﺒﺿ, ﻞﻣﺎﺷ
ﻊﻔﻨﯾﺫ: ﻩﺪﻨﻨﮐﻩﺩﺎﻔﺘﺳﺍ, ﺩﻮﺳ
ﻞﯿﺴﻧﺍﺮﻔﯾﺩ: ﻒﻠﺘﺨﻣ
ﻥﺩﺍﺩﻥﻭﺮﯿﺑ: ﺲﻔﻧ
ﻪﺿﻮﺣ: ﺏﺍ
ﯽﻧﺩﺮﮐﺐﺼﻧﻡﺯﺍﻮﻟ: ﻕﺎﺒﻄﻧﺍ, ﺕﺍﺰﯿﻬﺠﺗ, ﺕﻻﻮﺼﺤﻣ
: 
ﺐﺼﻧ: ﻥﺩﺮﮐﺐﺼﻧ, ﺩﺎﺠﯾﺍ
ﯽﺘﻨﺳﺭﻮﻃﻪﺑ: ﺖﻨﺳ
ﺱﺭﺩﺱﻼﮐ: ﺱﻼﮐ
ﺮﻳﺮﺤﺘﻟﺍﻡﺯﺍﻮﻟ: ﺕﺍﺰﯿﻬﺠﺗ, 
ﻩﻮﻘﻟﺎﺑﺭﻮﻃﻪﺑ: ﺖﯿﻠﺑﺎﻗ
ﻞﮑﺗﻭﺮﭘ: ﯼﺭﺎﮑﻤﻫﺩﺍﺩﺭﺍﺮﻗ
ﻪﻠﺿﺎﻓﻭﻪﻌﻣﺎﺟﺏﺎﺴﺣ: ﺏﺎﺴﺣ
ﮒﺭﺰﺑﻩﺩﻭﺭ: ﻪﻄﻘﻧ
ﻡﺮﮔ: ﻡﺮﮔ, ﻦﻤﭼ
ﻦﯾﺰﻨﺑ: ﻞﯿﺋﻭﺯﺎﮔ, ﺖﺸﮔ
: 
ﻥﺍﻮﺟﻮﻧ: ﻥﺍﻮﺟ
ﯼﺭﺎﺸﻋﺍ: ﺖﯿﻠﻗﺍ
ﻥﺩﺮﮐﻁﻮﻠﺨﻣ: ﺭﺎﺸﻓ, ﻞﮑﺸﻣ
ﻡﻮﯾﺩﺍﺭ: 
ﻞﻤﮑﻣ: ﻩﺪﻨﻨﮐﻞﯿﻤﮑﺗ
ﺎﻤﯿﭘﺍﻮﻫ: ﻩﺪﻧﺮﭘ, ﻢﯿﻈﻨﺗ, ﻦﺘﻓﺮﮔﺝﻭﺍ
ﺩﻭﺪﺣﺭﺩ: ﻩﺭﺎﺑﺭﺩ, ﯽﺒﯾﺮﻘﺗ, ﻝﺎﺳ
ﻦﻣﺎﺿ: ﺖﻧﺎﻤﺿ
ﻩﻮﻗﻍﺍﺮﭼ: ﻥﺩﺯﻕﺮﺑ
ﻥﺍﺪﻤﭼ: ﻪﺒﻌﺟ, ﻥﺍﺪﻤﭼ
ﻪﻟﺩﺎﺒﻣ: ﻝﺩﺎﺒﺗ
: 
ﯼﺭﺎﯿﺘﺧﺍ: ﯽﺷﺭﺎﻔﺳ, ﻩﺍﻮﺨﻟﺩ, ﻪﻨﯾﺰﮔ
ﺭﺍﺮﮑﺗ: ﺭﺮﮑﻣ
ﺲﯾﺮﺗﺎﻣ: ﻩﺪﻌﻣ
ﺮﯾﻮﺼﺗ: ﻪﻧﺎﺷ, ﺮﯾﻮﺼﺗ
ﺶﯿﭘ: ﻕﺮﺷ, ﺯﺍﻞﺒﻗ, ﺭﺍﺰﻔﻠﻋ, ﻼﺒﻗ, ﺖﻐﻟﮓﻨﻫﺮﻓ
ﯽﻬﮔﺁ: ﺩﻼﯿﻣﺯﺍﺪﻌﺑ
ﻝﻮﺒﻗﻞﺑﺎﻗﺮﯿﻏ: ﺐﺳﺎﻨﻣﺎﻧ
ﮊﺎﺳﺎﻣ: 
ﻥﺩﺮﮐﺲﺣﯽﺑ: ﻥﺩﺮﮐﺕﺎﻣ, ﻥﺪﺷﻪﮐﻮﺷ
ﻉﻮﻗﻭ: ﺐﯿﺷ
ﯽﻧﻮﮕﻧﺮﺳ: ﻦﺘﺨﯾﺭ, ﺐﻠﻗ
ﯽﺴﺣ: ﺱﺎﺴﺣﺍ
ﻉﺎﻤﺟﺍ: ﯼﺭﺎﮑﻤﻫﺩﺍﺩﺭﺍﺮﻗ
ﻥﺩﺮﮐﺕﺭﺎﻈﻧ: ﺖﯾﺮﯾﺪﻣ, ﺭﻮﺘﯿﻧﺎﻣ, ﺲﯿﻠﭘ, ﻥﺪﺷﻥﺍﺰﯾﻭﺁ
ﻥﺩﻮﺑﯼﺰﯿﺟﻪﻨﯿﻣﺯ: ﻪﯾﺎﭘ
: 
ﺪﻧﻮﯿﭘ: ﻝﺩﺎﺒﺗ
ﻡﻮﯿﻨﯿﻣﻮﻟﺁ: ﻡﻮﯿﻨﯿﻣﻮﻟﺁ
: 
ﯽﯾﺍﻮﻧﺎﻧ: ﯼﺭﺎﮑﯿﺑ, 
ﻥﺎﺳﻮﻧ: ﻥﺎﺳﻮﻧ
ﯼﺯﺎﺳﻪﯿﺒﺷ: ﯼﺯﺎﺳﻪﯿﺒﺷ, ﻥﺩﺮﮐﻞﻌﺟ, ﻥﺩﺮﮐﯽﺴﯾﻮﻧﻭﺭ
: 
ﻥﺩﺮﮐﻩﺪﯿﭽﯿﭘ: ﻩﺪﯿﭽﯿﭘ
ﯽﺑﺮﻣ: ﯽﺑﺮﻣ, ﺭﻭﺎﺸﻣ
ﻥﺍﺪﺳ: ﻊﻗﻮﻣﻥﻭﺍ, 
ﻑﺎﮑﺷ: ﺡﺎﺘﺘﻓﺍ
ﻥﺩﺮﮐﯼﺭﺎﮑﺘﺳﺩ: ﯼﺭﺎﮐﺖﺳﺩ, ﻥﺩﺯﻢﻬﺑ, ﻍﻭﺭﺩ
: 
ﺭﺍﻮﺧﻩﺎﯿﮔ: ﯼﺰﺒﺳ
ﺭﺎﺠﻨﻫ: ﺕﺎﺼﺨﺸﻣ, ﻥﻮﻧﺎﻗ
ﺶﭙﺷ: ﺎﻬﻧﺍﺪﻧﺩ
ﻭﺮﺘﻣ: ﻞﻧﻮﺗ
ﯽﺴﻔﻨﺗ: ﺲﻔﻧ
ﺶﻬﺟ: ﻥﺩﺍﺩﺮﯿﯿﻐﺗ, ﻞﯾﺪﺒﺗ
ﯼﺭﺍﻮﻠﺷﺮﯾﺯ: ﯽﻧﺎﺘﮐﻪﭼﺭﺎﭘ
ﻥﻮﯾ: 
ﻡﺩﻮﻣ: 
ﺏﺎﺘﺷ: ﻥﺩﺮﮐﻞﯿﻬﺴﺗ
ﻕﺍﺮﺘﻓﺍ: ﮏﯿﮑﻔﺗ, ﻕﺮﻓ, ﺩﺎﻀﺘﻣ
ﺭﺩﻥﺩﺮﺑﺖﺳﺩ: ﻞﻌﺟ, ﻒﯾﺮﺤﺗ
ﯽﻠﺼﻓ: ﻞﺼﻓ
: 
ﺮﺸﻧ: ﺯﻭﺰﮔﺍ, ﺶﺑﺎﺗ
ﯽﯾﺎﺘﺳﻭﺭ: ﯽﯾﺎﺘﺳﻭﺭ
ءﺎﻤﻏﺍ: ﻝﻮﮔﺮﯾﻭ
: 
ﻥﺩﺮﮐﺱﻮﮑﻌﻣ: ﯽﮕﻧﻭﺭﺍﻭ, ﻞﺑﺎﻘﻣ
: 
: 
: 
: 
ﺖﺳﺮﭘﺮﺳ: ﻩﺪﻨﻨﮐﻩﺪﻫﺎﺸﻣ, ﯼﺎﻤﻨﻫﺍﺭﻪﭽﺑﺎﺘﮐ
ﻮﯾﻭﻭﺮﮑﯾﺎﻣ: 
ﯽﺳﺮﺑﺎﺴﺣ: ﯽﺳﺭﺮﺑ
: 
: 
ﯼﻭﺭﻩﺩﺎﯿﭘ: ﻦﺘﻓﺮﮔﺝﻭﺍ, ﻥﺩﻮﺑﻥﺍﺩﺮﮔﺮﺳ, ﻥﺩﺮﮐﺪﻨﻠﺑ, ﯼﻭﺭﻩﺩﺎﯿﭘ, ﻥﺩﺍﺩﺶﯾﺍﺰﻓﺍ
ﺶﮐﻪﻟﻮﻟ: ﺮﮔﺖﻌﻨﺻ, 
ﻥﺎﮑﻣ: ﻪﻄﻘﻧ, ﺖﯿﻌﻗﻮﻣ
ﺕﺎﯿﺣﺪﯾﺪﺠﺗ: ﻥﺪﻣﺁﺎﯿﻧﺪﺑ, ﻩﺯﺎﺗﻢﺴﺟﺭﺩﺦﺳﺎﻨﺗ
ﯼﺩﺎﺼﺘﻗﺍﻥﺍﺮﺤﺑ: ﺩﺎﺼﺘﻗﺍ
: 
ﺕﺭﺎﻏ: ﺕﺭﺎﻏ
ﻒﯿﺗﻮﻣ: ﻉﻮﺿﻮﻣ
ﺭﺎﻌﺷ: ﺭﻮﺒﻋﺰﻣﺭ
ﻡﺎﻏﺩﺍ: ﯼﺭﺎﮑﻤﻫ, ﻡﺎﻏﺩﺍ
: 
ﯽﻧﺍﻮﻏﺭﺍ: ﺶﻔﻨﺑﮓﻧﺭ
ﻥﺪﻧﺎﺳﺭﻞﻗﺍﺪﺣﻪﺑ: ﻦﯾﺮﺘﻤﮐ, ﮏﯾﺭﺎﺑ, ﻢﮐ
: 
ﯽﻧﻮﮑﺴﻣ: ﻩﺎﻨﭘﻥﺎﺟ, ﻦﮐﺎﺳ
ﺩﺪﻋ: ﻝﺎﺘﯿﺠﯾﺩ, ﺩﺪﻋ, ﺢﯿﺤﺻﺩﺪﻋ
ﻩﺰﻣﺭﻮﺷ: ﮏﻤﻧ
: 
ﯼﺩﯽﺳ: 
ﺯﺍﺩﺮﭘﻪﯾﺮﻈﻧ: ﻪﯾﺮﻈﻧ
ﻡﻮﯾﺭﺍﻮﮐﺁ: ﯽﻫﺎﻣ
ﺦﯿﺳ: 
ﺶﺸﮐ: ﻥﺩﺮﮐﺭﺍﺮﺻﺍ
ﺕﺎﺠﻧﺮﺘﭼ: ﺮﺘﭼ
ﺮﺘﻤﻬﻣ: ﻡﺯﻻ, ﺹﻮﺼﺨﺑ
ﯽﻠﮐﺭﻮﻃﻪﺑ: ﻪﻤﻫ, ﺖﺷﺭﺩ, ﺮﺗﻭ
ﻥﺪﺷﺪﺳﺎﻓ: ﻒﯾﺮﺤﺗ
mirative: 
ﮏﯿﻣﺎﻨﯾﺩ: ﯽﮑﯿﻣﺎﻨﯾﺩ, ﺖﻋﺮﺳ, ﯽﺳﺎﻨﺷﺮﯿﮕﻬﻤﻫ
ﯽﺴﻨﺟﺕﻼﯾﺎﻤﺗ: ﯽﺴﻨﺟ
ﺎﺗﺪﻤﻋ: ﯼﺩﺎﯾﺯﺪﺣﺎﺗ
ﻡﺎﻬﺳﺭﺍﺰﮔﺭﺎﮐ: 
ﺮﮕﻨﻠﺗ: ﻞﺑﺎﻘﻣ
: 
ﻩﺩﻭﺭ: ﻩﺩﻭﺭﻭﻝﺩ
ﯼﺮﯾﻮﺼﺗ: 
: 
ﯽﺳﺎﻨﺷﻥﺎﺘﺳﺎﺑ: ﯽﺳﺎﻨﺷﻥﺎﺘﺳﺎﺑ
ﻲﻨﻴﻣﺯﻡﺍﺩﺎﺑ: ﺕﺎﺑﻮﺒﺣ
ﻝﺪﺑ: ﯼﺮﻤﺘﺴﻣ, ﺖﺸﮕﯾﺎﺟ
ﺯﺎﮔﻕﺎﺟﺍ: ﻕﺎﺟﺍ, ﻪﻧﺎﺧﺰﭙﺷﺁ, ﻥﺍﺪﻠﮔ
ﺭﺍﻮﻠﺷ: ﺭﺍﻮﻠﺷ
ﺺﺧﺎﺷ: ﺺﺧﺎﺷ
: 
ﺭﺍﺩﺍﺭ: 
ﯽﺳﺪﻨﻫ: ﻪﺳﺪﻨﻫ
ﯽﻠﮐﺪﯾﺩ: ﯽﻠﮐﺡﺮﻃ, ﺮﺼﺘﺨﻣ
ﻉﻼﻃﺍ: ﻥﺩﺮﻛﻙﺭﺩ, ﮎﺭﺩ
: 
ﯽﻔﯿﮐ: ﺖﯿﻔﯿﮐ
ﻩﺰﻧﺎﭙﻤﺷ: ﻥﻮﻤﯿﻣ
: 
ﻪﭽﺑﺎﺘﮐ: ﻩﻭﺰﺟ, ﯼﺎﻤﻨﻫﺍﺭﻪﭽﺑﺎﺘﮐ, 
ﮏﯿﺘﻧﮊ: ﯽﮑﯾﮊﻮﻟﻮﻓﺭﻮﻣ, ﮏﯿﺘﻧﮊ, ﻥﮊ
ﻩﺪﻨﻨﮐﺖﮐﺮﺷ: ﻥﺩﺮﮐﻞﺻﻭ, ﺶﻘﻧ, ﯽﻔﺻﻭﻪﺟﻭ
: 
ﻪﻋﻮﻤﺠﻣ: ﺩﺍﺪﻌﺘﺳﺍ, ﺭﺍﺰﻓﺍﻡﺮﻧ
: 
: 
: 
ﻥﺪﻧﺎﺧﺮﭼ: ﺵﺩﺮﮔ, ﯼﺯﺎﺑ
: 
ﺡﺮﻃ: ﻥﺎﻣﺯﺎﺳ, ﺡﺮﻃ, ﻊﺿﻭ, ﺖﺸﮕﯾﺎﺟ, ﻮﺤﻧ
ﺯﺎﺑﺲﻨﺠﻤﻫ: ﺍﺮﮕﺴﻨﺠﻤﻫ
: 
ﺪﻨﺳ: ﻦﯿﮔﻼﭘ, ﻝﻮﺻﻭﻡﻼﻋﺍ
ﺮﮔﺮﺒﻤﻫ: 
ﻮﯾﺭﺎﻨﺳ: ﺯﺍﺪﻧﺍﻢﺸﭼ, ﺖﯿﻌﻗﻮﻣ
ﻪﯿﻀﻗ: ﻪﻠﻤﺟ, ﻪﯾﺮﻈﻧ
ﻥﺩﺮﺑﻻﺎﺑ: ﻥﺩﺍﺩﺶﯾﺍﺰﻓﺍ
: 
: 
ﯽﺑﺎﯾﺯﺭﺍ: ﯽﺑﺎﯾﺯﺭﺍ, ﺺﯿﺨﺸﺗ, ﻥﺰﺑﺱﺪﺣ
ﯽﺘﺧﺎﻨﺷ: ﺺﯿﺨﺸﺗ, ﯽﻨﻫﺫ
ﻥﺩﺮﻛﮓﻨﻫﺎﻤﻫ: ﺕﺎﺼﺘﺨﻣ
ﻥﺩﺮﮐﺢﯾﺮﺼﺗ: ﻩﺪﺷﺖﺳﺭﺩﻪﻧﺍﺩﺎﺘﺳﺍ, ﺢﯿﺿﻮﺗ
ﯽﻤﺳ: ﻢﺳ
ﺪﯿﮐﺎﺗ: ﺱﺮﺘﺳﺍ, ﻥﺩﺮﮐﺭﺍﺮﺻﺍ
ﺩﻮﮐﺭ: ﻥﺍﺮﺤﺑ, ﺐﯿﺷ
ﺎﻣﺎﮔ: 
ﻥﺩﺮﮐﻪﯿﻬﺗ: ﺖﻣﺪﺧ, ﻩﺪﺷﻪﺋﺍﺭﺍ, ﻥﺩﺍﺩﻥﺎﻨﯿﻤﻃﺍ, ﻩﺪﺷﺮﭘ
ﺎﻘﯾﺮﻓﺍﺭﺩﯽﻓﺎﺸﺘﮐﺍﺖﺣﺎﯿﺳ: 
ﻡﻭﺎﻘﻣ: ﻦﻣﺰﻣ, ﻡﻭﺍﺪﻣ, ﺖﻣﻭﺎﻘﻣ, ﻥﻮﺼﻣ
ﺮﺼﺘﺨﻣﮎﺍﺭﻮﺧ: ﺖﺴﺗﻥﺎﻧ
ﺎﻤﻨﯿﺳ: ﺎﻤﻨﯿﺳﻢﻠﯿﻓ, ﺎﻤﻨﯿﺳ
: 
ﺏﺁﺮﻴﺷ: ﻪﻟﻮﻟ, ﻪﻧﺎﺧﺭﺎﮐ
ﺮﮕﻧﺎﺸﻧ: ﺖﻣﻼﻋ
ﯼﺭﺎﺨﺑ: 
ﯽﻧﻮﻣﺍﺮﯿﭘ: ﻑﺍﺮﻃﺍ, ﯼﺍﻪﻘﻄﻨﻣ
ﻩﺪﻨﻨﮐﺭﺎﻬﻇﺍ: ﺺﺨﺸﻣ, ﯼﺪﻨﺴﻣ, ﻊﻃﺎﻗ, ﻖﺷﻪﻠﮐ
ﻩﺮﮔ: ﻝﺎﺼﺗﺍ, ﻩﺮﮔ
ﻥﺍﻮﻨﻋ: ﻂﺧ
ﻕﺎﭼ: ﻢﯿﺨﺿ
ﻥﺩﺮﮐﻖﯾﺮﻔﺗ: ﻦﺘﺷﺍﺩﺮﺑ, ﻥﺩﺮﮐﻡﻭﺮﺤﻣ, ﻥﺩﺮﮐﺎﻬﻨﻣ
ﺮﮕﻠﯿﻠﺤﺗ: ﺡﺍﺮﺟ
ﻡﺯﻻ: ﻡﺯﻻ
ﺪﯾﺮﺧﺰﮐﺮﻣ: ﺖﮐﺭﺎﻣﺮﭘﻮﺳ, ﺕﻻﻮﺼﺤﻣ
: 
ﯽﯾﺍﺮﮕﻤﻫ: ﻥﺩﺍﺩﺮﯿﯿﻐﺗ
ﻥﺍﺭﺍﺪﻣﺎﻬﺳ: ﮏﯾﺮﺷ, ﻁﺮﺷ
ﻥﺩﺮﮐﻪﺻﻼﺧ: ﻥﺩﺮﮐﻩﺎﺗﻮﮐ
ﯽﻠﺳﺎﻨﺗﻩﺎﮕﺘﺳﺩ: ﯼﺭﻭﺭﺎﺑ
ﭻﯿﭘﺭﺎﻣ: ﭻﯿﭘﺭﺎﻣ, ﻥﻭﺰﻠﺣ, ﺪﻌﺠﻣ
: 
ﯽﻨﯾﺮﯿﺷ: ﺖﯾﻮﮑﺴﯿﺑ, ﮏﯿﮐ
ﺎﺘﺑ: 
ﻥﺩﺮﮐﺩﺎﺑ: ﻡﺭﻮﺗ
ﮏﯿﻧﻭﺮﺘﮑﻟﺍ: ﮏﯿﻧﻭﺮﺘﮑﻟﺍ
ﯽﺴﯾﻮﻧﺯﺎﺑ: ﻥﺩﺮﮐﯽﺴﯾﻮﻧﻭﺭ
ﻩﺎﮕﺸﯾﺎﻣﺯﺁ: ﻩﺎﮕﺸﯾﺎﻣﺯﺁ
ﯼﺍﻪﻓﺮﺣ: ﻪﻓﺮﺣ, ﺭﺎﮐ, ﻁﺎﺒﺗﺭﺍ
: 
ﺐﯿﺷ: ﻞﯾﺎﻣ, ﺐﯿﺷ
: 
ﮓﻧﺭﺎﮕﻧﺭ: ﮓﻧﺭ
ﺶﺷﻮﭘ: ﻩﺪﺷﻩﺩﺍﺩﺶﺷﻮﭘ, ﻦﺴﮐﺍﻭ, ﻥﺩﺍﺩﺖﻴﻤﻫﺍ, ﻮﺘﭘ, ﻒﻘﺳ, ﻪﺟﻮﺗ, ﻢﺠﺣ
ﯼﺮﯿﮔﺭﺩ: ﻥﺩﺮﮐﻞﺻﻭ, ﺖﮐﺭﺎﺸﻣ
: 
ﯼﺯﺎﺠﻣﯼﺎﻀﻓ: ﺮﺑﺍ
: 
: 
: 
ﺖﻬﺟ: ﺖﻬﺟ, ﻞﯾﺎﻤﺗ, ﺖﯿﻌﻗﻮﻣ
ﻪﯾﺰﺠﺗ: ﯽﻠﯿﻠﺤﺗ, ﻞﯿﻠﺤﺗ
ﺖﻤﺴﻗﺝﺭﺎﺧ: ﺖﯿﻠﺑﺎﻗ, ﺭﺍﺪﻘﻣ
ﻦﺘﺧﺎﺳ: ﻥﺩﺮﮐﺪﯿﻟﻮﺗ
ﯽﺗﺭﺍﺮﺣ: ﺖﻔﻧ
ﻪﺸﯿﻠﮐ: ﺎﻨﺜﺘﺳﺍ
ﯽﻄﯿﺤﻣﺖﺴﯾﺯ: ﺯﺍﺪﻧﺍﻢﺸﭼ, ﯽﺳﺎﻨﺷﻡﻮﺑ, ﻑﺍﺮﻃﺍ
ﯼﮊﻮﻟﻮﻨﮑﺗ: ﯽﻨﻓ
ﺎﻤﮕﯿﺳ: 
ﻩﺪﻧﺎﻣﯽﻗﺎﺑ: ﯽﻗﺎﺑ, ﯽﮕﻧﻭﺰﻓﺍ
ﯽﯾﺍﺪﺟ: ﻢﻫﺯﺍﺍﺪﺟ
ﻥﻮﯿﻣﺎﮐ: ﻥﻮﯿﻣﺎﮐ
: 
: 
ﻩﺎﮕﺷﺯﺭﻭ: ﻩﺯﻮﺣ
ﺍﺰﯾﻭ: 
: 
ﯽﮕﻨﻫﺎﻤﻫ: ﺕﺎﺼﺘﺨﻣ
ﯼﺮﺘﮐﺎﺑ: ﯼﺮﺘﮐﺎﺑ
: 
ﯼﺯﺎﺳﻩﺩﺎﯿﭘ: ﯼﺯﺎﺳﻩﺩﺎﯿﭘ
ﯽﻗﺎﺒﻄﻧﺍ: ﻪﻨﯿﻬﺑ, ﻕﺎﺒﻄﻧﺍ
ﺱﺎﻨﺷﺖﺴﯾﺯ: ﺪﻨﻤﺸﻧﺍﺩ
: 
ﻂﺑﺍﺭ: ﻁﺎﺒﺗﺭﺍ, ﺢﻄﺳ
ﻡﻮﯾﺩﻻﺎﭘ: ﻥﺩﺍﺩﻥﺎﻨﯿﻤﻃﺍ
ﯽﺘﺷﺍﺪﻬﺑﻭﯽﺸﯾﺍﺭﺁﻡﺯﺍﻮﻟ: ﻦﯿﯾﺰﺗ, ﺶﯾﺍﺭﺁ, 
ﻥﺩﺮﮐﻆﻔﺣ: ﻪﻈﻓﺎﺣ, ﯽﯾﻮﺟﻪﻓﺮﺻ, ﻥﺩﺭﻭﺁﺩﺎﻳﻪﺑ, ﻥﺪﯿﻤﻬﻓ
ﯽﮕﻧﺭﺩﺍﺪﻣﺎﺑﯽﺷﺎﻘﻧ: 
ﯽﺼﯿﺨﺸﺗ: ﺺﯿﺨﺸﺗ, ﻪﻧﺎﺸﻧ, ﻞﯿﻠﺤﺗ
ﺏﺎﺒﮐ: 
: 
ﻩﺩﺍﺩﻮﺑﺕﺭﺫ: 
: 
: 
ﯽﻨﻤﺿﺖﻟﻻﺩ: ﯽﯾﺎﻨﻌﻣ, ﻒﯾﺮﻌﺗ
: 
ﺱﻭﺭﺩﻞﺼﻓﺮﺳ: ﻩﺪﯿﮑﭼ
: 
: 
ﻝﺎﻘﺘﻧﺍ: ﻂﺧ, ﯽﯾﺎﺑﺭﻡﺩﺁ, ﻞﻘﻧﻭﻞﻤﺣ, ﺵﺩﺮﮔ, ﯽﮕﻧﻭﺭﺍﻭ
ﻥﻮﯿﻠﯿﻣ: ﻥﻮﯿﻠﯿﻣ
ﺎﮔﻮﯾ: 
ﻥﺎﻣﺭﺩ: ﻥﺎﻣﺭﺩ
ﺖﺴﯿﻟﺎﻧﻮﯿﺳﺎﻧ: ﯽﻠﻣ
ﯽﻠﺻﺍﺮﯿﺴﻣ: ﻝﻮﻤﻌﻣ, ﺪﯿﻠﮐ
ﺭﺍﺩﺎﻨﻌﻣ: ﻦﺘﺷﺍﺩﺭﻮﻈﻨﻣ, ﻢﻬﻣ, ﯽﯾﺎﻨﻌﻣ
ﺯﺎﺳﻞﮑﺸﻣ: ﻞﮑﺸﻣ
: 
: 
ﺯﺎﺟ: 
ﯽﻌﻤﺳ: ﺍﺪﺻ
: 
: 
: 
: 
ﺯﺎﺳﻭﺖﺧﻮﺳ: ﺮﯿﻔﺳ
ﯼﺭﻮﺗ: ﺏﻭ, ﻪﺒﻌﺟ, ﻪﮑﺒﺷ
: 
ﯽﯾﺎﻀﻓ: ﻮﺟ, ﯼﺪﻌﺑ, ﻪﻧﺎﮔﺍﺪﺟﺭﻮﻃﻪﺑ
ﺺﺼﺨﺗ: ﺱﺎﻨﺷﺭﺎﮐ, ﺺﺼﺨﺗ
: 
ﯽﺑﺎﺗﺯﺎﺑ: 
ﻪﺘﻔﻫﺮﺧﺁ: ﻪﺒﻨﺷﺯﻭﺭ
ﻥﺎﺤﺘﻣﺍ: ﻞﯿﺼﺤﺘﻟﺍﻍﺭﺎﻓ, ﻥﺎﺤﺘﻣﺍ, ﻥﺩﺮﻛﺵﻼﺗ
ﻪﺘﺴﺴﮔ: ﻢﻫﺯﺍﺍﺪﺟ
ﺭﺎﻬﻣ: ﯼﺭﺍﺩﺯﺎﺑ, ﻥﺩﺮﮐﯼﺮﯿﮔﻮﻠﺟ, ﻥﺩﺮﮐﻊﻄﻗ
ﺕﺍﺪﻨﺘﺴﻣ: ﯼﺎﻤﻨﻫﺍﺭﻪﭽﺑﺎﺘﮐ
ﺖﻠﻜﻴﺳﺭﻮﺗﻮﻣ: ﺭﻮﺗﻮﻣ
ﺩﻭﺮﺳ: 
ﺪﻨﭼ: ﺶﯿﺑ, ﺭﺎﯿﺴﺑ
ﯽﻠﯿﺼﺤﺗﻡﺮﺗ: ﻪﺴﻠﺟ
ﻡﺮﮔ: ﺖﺑﻮﻃﺭ, ﻡﺮﮔ
ﻦﻴﺋﻭﺮﻫ: 
ﯽﺳﺎﻨﺷﺖﺨﯾﺭ: ﯽﮑﯾﮊﻮﻟﻮﻓﺭﻮﻣ, ﯽﺑﺮﺠﺗﻡﻮﻠﻋ, ﻥﺪﺷﻞﻴﻜﺸﺗ
: 
ﻥﺩﺍﺩﺺﯿﺨﺸﺗ: ﺺﯿﺨﺸﺗ, ﻥﺪﯿﻤﻬﻓ
ﺮﻨﮑﺳﺍ: ﺮﮔﺭﻭﺮﻣ
ﮏﯿﻓﺍﺮﮔ: ﯽﻧﺎﻣﺯﺎﺳﺕﺭﺎﭼ, ﯽﮑﯿﻓﺍﺮﮔ
ﺮﻧﻭﺮﮐﻕﻭﺮﻋ: ﯼﺭﺎﻤﯿﺑ, ﺐﻠﻗ
ﯽﻧﺎﮕﯾﺎﺑ: ﻞﯾﺎﻓ
ﺎﺘﺗ: 
ﻪﻬﺟﺍﻮﻣ: ﻪﺴﯾﺎﻘﻣ, ﮎﺎﮑﻄﺻﺍ
ﯼﺭﺎﺑ: ﻥﻮﯿﻣﺎﮐ
ﻪﻨﯿﻬﺑ: ﻪﻨﯿﻬﺑ, ﯽﻟﺎﻋ, ﮏﯿﺳﻼﮐ, ﻦﯾﺮﺘﻤﮐ
ﺎﺳﺎﺳﺍ: ﺕﺎﺣﻼﻄﺻﺍ, ﯼﺩﺎﯾﺯﺪﺣﺎﺗ
ﻱﺭﺍﻮﺳﻪﺧﺮﭼﻭﺩ: ﺵﺩﺮﮔ, ﻪﺧﺮﭼﻭﺩ
ﻩﺰﯿﮕﻧﺍ: ﻡﺎﻬﻟﺍ, ﮏﯾﺮﺤﺗ
ﺩﺮﮔﻮﮔ: ﺩﺮﮔﻮﮔ
ﯽﺗﺎﯿﻠﻤﻋ: ﯼﺭﺎﮐﺖﺳﺩ, ﻞﻤﻋ, ﻩﺭﺎﺑﻭﺩﻉﻭﺮﺷ, ﻥﺪﯾﻭﺩ
ﺮﯿﺴﻣ: ﺮﯿﺴﻣ
ﻁﺎﺒﺗﺭﺍ: ﺖﯿﻤﻫﺍ, ﻁﺎﺒﺗﺭﺍ
ﯼﺭﺎﺟﻁﺎﺒﺗﺭﺍﺮﮕﻧﺎﺸﻧ: 
ﻪﺧﺮﭼﻭﺩ: ﻪﺧﺮﭼﻭﺩ, ﺥﺮﭼ
ﺩﻮﻤﻨﻫﺭ: ﯽﺸﯾﺎﻤﻧ, ﯽﻋﺎﺟﺭﺍ
ﯽﯾﺎﻤﯿﭘﺍﻮﻫ: ﻩﺪﻧﺮﭘ, ﺍﻮﻫ, ﻥﺎﻣﺯﺎﺳ, ﻦﺘﻓﺮﮔﺝﻭﺍ
: 
ﺮﺘﯿﻟ: ﺮﺘﯿﻟ
ﻝﺎﺒﺘﮑﺴﺑ: ﺪﺒﺳ
: 
ﻥﺩﺮﮐﺪﺤﺘﻣ: ﻡﺎﻏﺩﺍ, ﻥﺩﺍﺩﯽﺘﺷﺁ
ﺩﻮﺟﻭﻦﯾﺍﺎﺑ: ﻊﻗﻮﻣﻥﻭﺍ, ﻪﮑﯿﻟﺎﺣﺭﺩ
ﺖﻟﺎﺣ: ﻥﺩﺎﺘﺴﯾﺍ, ﺖﯿﻌﻗﻮﻣ, ﺪﻨﺑ, ﯽﮔﺪﻧﺍﺭ, ﺶﻘﻧ
ﻞﻗﺍﺪﺣ: ﻦﯾﺮﺘﻤﮐ, ﻢﮐ
ﯼﺎﻬﺧﺮﭼ: ﺵﺩﺮﮔ
ﻪﯾﻻ: ﻝﻮﮑﻟﻮﻣ, ﺢﻄﺳ
: 
: 
: 
ﺏﺁﺮﯾﺯ: ﻪﮐﻡﺍﺪﮐﺮﻫ
: 
ﺺﻗﺎﻧ: ﺐﺳﺎﻨﻣﺎﻧ
ﺺﺼﺨﺗ: ﻪﺑﺮﺠﺗ, ﺺﺼﺨﺗ
: 
ﻡﺭﺁ: ﺖﻣﻼﻋ, 
ﻥﻮﮑﯾﺁ: ﻪﺸﻘﻧ, ﺖﻣﻼﻋ
ORD: 
ﻥﻭﺮﺘﮑﻟﺍ: ﮏﯿﻧﻭﺮﺘﮑﻟﺍ
ﯽﻠﻣﺎﻌﺗ: ﻭﻒﮐ, ﻞﺑﺎﻘﺘﻣ
ﺍﺪﺘﺑﺍﺭﺩ: ﻝﻭﺍ
ﯼﺭﺎﮑﺑﺍﺮﺧ: ﻦﺘﻓﺭﻦﯿﺑﺯﺍ
ﻞﻣﺎﻌﺗ: ﻩﺮﮐﺍﺬﻣ, ﻁﺎﺒﺗﺭﺍ, ﻥﺩﺮﮐﯽﻋﺎﻤﺘﺟﺍ
ﯽﺿﺎﯾﺭ: ﺕﺎﯿﺿﺎﯾﺭ
ﯽﻨﯿﻨﺟ: ﻪﺘﺴﻫ
ﻥﺩﺮﮐﻦﯾﻮﻧ: ﻥﺭﺪﻣ
ﻭﺭﻮﯾ: 
ﯽﻃﺍﺮﻓﺍ: ﻝﺎﮑﯾﺩﺍﺭ, ﯽﺘﺴﯾﺭﻭﺮﺗ
ﯽﻨﻤﺠﻧﺍ: ﻥﻭﺎﻌﻣ
ﺭﺰﯿﻟ: 
ﺵﺎﺷ: ﺭﺍﺭﺩﺍ
: 
ﻥﺪﺷﻊﻤﺟ: ﻦﺘﻓﺮﯾﺬﭘ
: 
ﻪﺷﺎﺑ: ﺭﺎﯿﺴﺑ, ﺏﻮﺧﺭﺎﻴﺴﺑ
ﻦﺗﯽﻫﺎﻣ: ﻦﺤﻟ, 
: 
ﻥﺩﺯﺪﯾﺪﺷﻭﺪﻨﺗﻪﺑﺮﺿ: ﺖﻗﺮﺳ
ﺪﻨﻣﺩﻮﺳ: ﺍﺪﻤﻋ
ﻪﻤﯿﻧ: ﻩﺍﺭﻪﻤﯿﻧ, ﺵﻭﺮﻓ, ﻥﺩﺮﮐﺏﺎﯿﺳﺁ, ﺽﺮﻋ
ﻒﻔﺨﻣ: ﺮﺼﺘﺨﻣ
initialism: 
ﺎﻤﺳﻼﭘ: 
: 
ﯽﺒﯿﺗﺮﺗ: ﻝﺎﺼﺗﺍ
ﯽﺒﺼﻋ: ﯽﺒﺼﻋ
ﻒﻟﺎﺨﻣ: ﻥﺩﺮﮐﺖﻣﻭﺎﻘﻣ, ﺖﻣﻭﺎﻘﻣ, ﺐﯿﻗﺭ, ﻞﺑﺎﻘﻣ
: 
ﻡﺎﻏﺩﺍ: ﯼﺯﺎﺳﻡﺎﮕﻤﻫ, ﯽﮕﺘﺳﻮﯿﭘ, ﻥﺩﺮﮐﻞﺻﻭ, ﻝﺎﮑﯾﺩﺍﺭ
ﺲﮑﻓ: 
ﮏﻣﮏﮐ: ﻪﻄﻘﻧ
ﻝﺎﻤﯾﺰﮔﻭﺮﭘ: ﮏﯾﺩﺰﻧ
: 
ﺍﺬﻏﺶﯿﭘ: 
ﯼﺬﻐﻣﻩﺩﺎﻣ: ﯽﻧﺪﻌﻣ
ﺢﺿﺍﻭﺮﯿﻏ: ﻢﻬﺒﻣ, ﻑﺎﻔﺷ
: 
ﻢﺧﺯ: ﻥﺪﺷﻪﮐﻮﺷ, ﯽﮔﺪﯾﺩﺐﯿﺳﺁ, ﻢﺧﺯ
: 
: 
SWOP: ﻝﺩﺎﺒﺗ
ﺎﻫﻪﻣﺎﻧﺯﺮﻫ: 
: 
ﯽﺑﺎﯾﺯﺭﺍ: ﯽﺑﺎﯾﺯﺭﺍ, ﻥﺰﺑﺱﺪﺣ
ﺎﻧﺎﻣ: ﯽﻨﻫﺫ
preterite: 
ﻢﺋﺎﻗﺪﻌﺑ: ﺕﺎﺼﺘﺨﻣ
ﻑﺍﺮﺤﻧﺍ: ﻒﯾﺮﺤﺗ
: 
ﻥﻮﻠﮐ: ﻪﺨﺴﻧ
ﺞﻨﺳﻥﺎﻣﺯ: ﺖﻗﻮﻣ, 
: 
ﻡﺍﻭﺩﻞﺑﺎﻗ: ﺩﻮﺳ
: 
: 
ﯼﺮﯿﮔﻥﺎﺒﯿﺘﺸﭘ: ﻞﺣﺎﺳ
: 
ﺯﺍﺪﻧﺍﺐﻤﺑ: ﺰﯿﻣﺁﺖﻧﻮﺸﺧ
: 
ﯼﺯﺎﺳﺪﻨﻧﺎﻤﻫ: ﻪﺨﺴﻧ, ﻩﺪﺑﺏﺍﻮﺟ
: 
ﯽﻧﺎﻧﻮﯾﯼﺎﺒﻔﻟﺍﻑﺮﺣﻦﯿﻤﻫﺩﺯﺎﯾ: 
ﯽﺸﻨﮐﺍﻭ: ﻞﻤﻌﻟﺍﺲﻜﻋ
: 
ﺮﺘﺧﺩﺖﺳﻭﺩ: ﮏﯾﺮﺷ, ﺮﺘﺧﺩ
ﯽﻧﺎﻣﺯﻝﻭﺪﺟ: ﻥﺎﻣﺯ, ﻊﺿﻭ
ﯼﻮﺤﻧ: ﻮﺤﻧ
: 
: 
ﻥﺩﺮﮐﺖﯿﺒﺜﺗ: ﺖﺑﺎﺛ, ﺕﺎﺒﺛ
ﻒﻟﺎﺨﻣ: ﺐﯿﻗﺭ
ﺩﺭﻮﺧﺯﺎﺑ: ﻞﻤﻌﻟﺍﺲﻜﻋ, ﺪﻫﺩﯽﻣﺩﺎﻬﻨﺸﯿﭘ, ﺖﺤﯿﺼﻧ
: 
ﯽﻟﺪﮑﯾ: ﯼﺩﺭﺪﻤﻫﺯﺍﺮﺑﺍ, ﻥﺩﺮﻛﻙﺭﺩ
: 
ﺭﻮﺑ: ﻝﺍﺩﻮﮔ
ﻪﻣﺎﻨﺸﺳﺮﭘ: ﻥﺎﺤﺘﻣﺍ
ﻥﺩﺯﮓﻧﺯ: ﻥﺩﺯﮓﻧﺯ
ﯽﺳﺎﯿﻗ: 
ﺮﺘﻤﯿﻠﯿﻣ: ﺮﺘﻤﯿﻠﯿﻣ
ﯽﻧﺎﺳﺭﺯﻭﺭﻪﺑ: ﺕﺎﺣﻼﺻﺍ
: 
ﺮﺴﮐﺕﺭﻮﺻ: ﻝﻮﮑﻟﻮﻣ
ﺕﺎﺑﺭ: 
ﯽﯾﺎﭘﺮﺑ: ﻥﺩﺮﮐﻩﺩﺎﻣﺁ, ﺩﺎﺠﯾﺍ
ﺯﺎﺳﻭﺭﺍﺩ: 
ﯽﻧﺍﻭﺭ: ﯼﺮﮑﻓ, ﯽﻨﻫﺫ
ﺪﻣﺁﻭﺖﻓﺭ: ﺮﻬﺷﻪﻣﻮﺣ, 
ﻡﺭﺪﻨﺳ: ﯼﺭﺎﻤﯿﺑ, ﻪﻧﺎﺸﻧ
: 
ﻮﮕﻟﺍ: ﯽﮐﺍﺭﺩﺍ, ﻝﺎﺜﻣ
: 
: 
: 
: 
ﻪﻨﯿﻣﺁ: 
ﻩﺪﺷﯼﺭﺎﺠﺣﻥﺎﺸﻧﺎﯾﺖﻣﻼﻋ: 
aorist: 
ﻥﺩﺮﮐﻝﺎﻌﻓ: ﻡﺎﺠﻧﺍ, ﻞﻤﻋ
ﮏﭼﻮﮐ: ﻒﯿﻄﻟ, ﻦﻓﻭﺮﮑﯿﻣ
: 
ﯽﻓﺩﺎﺼﺗﺕﺭﻮﺻﻪﺑ: ﯽﻓﺩﺎﺼﺗ, ﻪﺑﺩﺭﻮﻣ, ﻡﻭﺍﺪﻣ
: 
ﺩﺮﻃ: ﻢﻫﺯﺍﺍﺪﺟ, ﻢﯾﺮﺤﺗ
: 
ﯽﻨﯿﺑﺶﯿﭘﻞﺑﺎﻗ: ﻥﺰﺑﺱﺪﺣ
ﺭﺎﻣﺁ: ﻡﺎﻗﺭﺍ
ﻥﺎﮕﯾﺍﺭﺭﺍﺰﻓﺍﻡﺮﻧ: 
ﻪﻋﻮﻤﺠﻣﺮﯾﺯ: ﺶﺨﺑ
ﯽﺳﺎﻨﺷﺵﻭﺭ: ﺮﯿﺴﻣ, ﮏﯿﺘﮐﺎﺗ, ﺭﺎﺑﮏﯾ
ﯼﺮﻨﻫﺮﺛﺍ: ﺭﺎﮐ, ﻪﻧﺍﺪﻨﻣﺮﻨﻫ
ﺍﺰﺘﯿﭘ: 
ﯽﭘﺭﺩﯽﭘ: ﺐﯿﺗﺮﺗ
ﯽﺳﺎﻨﺷﻥﺎﺑﺯ: ﯽﺑﺮﺠﺗﻡﻮﻠﻋ
ﻦﺘﺷﺍﺩﻪﮕﻧ: ﻦﺘﺷﺍﺩﻪﮕﻧ, ﻥﺩﺮﮐﺐﺣﺎﺼﺗ
ﻡﻮﯾﺪﯾﺮﯾﺍ: 
: 
ﯼﺯﺎﺳﯽﺘﻌﻨﺻ: ﻥﺩﺮﮐﯽﺘﻌﻨﺻ, ﯽﺘﻌﻨﺻ
ﺮﺘﻣﻮﻠﯿﮐ: ﺮﺘﻣﻮﻠﯿﮐ
ﯽﺘﯿﻠﻣﺪﻨﭼ: ﻲﻠﻠﻤﻟﺍﻦﻴﺑ
ﺶﮐﻪﺸﻘﻧ: ﻩﺍﺭﻩﺍﺭ, ﺡﺮﻃ
ﻮﮕﺘﻔﮔ: ﻁﺎﺒﺗﺭﺍ
ﯽﯾﺎﻤﻧ: ﻥﺍﻮﺗ
ﮎﺍﺮﺘﺷﺍﺭﺍﺰﺑﺍ: 
ﻦﺗﺭﺎﮐ: ﺍﻮﻘﻣ, ﻪﺒﻌﺟ, 
ﻢﯾﺮﺳ: 
ﺲﻧﺎﺠﺘﻣ: ﻪﻧﺎﺘﺳﻭﺩ
ﯼﺭﺍﺬﮔﺭﺎﺑ: ﺩﻮﻠﻧﺍﺩ
ﻩﻭﮋﭘﺶﻧﺍﺩ: ﺪﻨﻤﺸﻧﺍﺩ
ﻥﺩﺍﺩﺹﺎﺼﺘﺧﺍ: ﻊﯾﺯﻮﺗ, ﯽﻓﺎﮑﺷﺪﺒﻟﺎﮐ, ﻪﻣﺍﺩﺍ
ﺡﺮﻃ: ﯼﺎﻤﻨﻫﺍﺭﻪﭽﺑﺎﺘﮐ, ﻩﺍﺭﻩﺍﺭ, ﺡﺮﻃ, ﻪﺨﺴﻧ, 
-ish: 
ﻪﻧﺎﻤﯿﭘ: ﺐﯾﺮﺿ
: 
: 
ﻝﺎﺒﺗﻮﻓ: ﻝﺎﺒﺗﻮﻓ
ﻖﺣ: ﺖﺳﺭﺩ
ﯽﻗﺎﺑ: ﯽﻗﺎﺑ, ﻩﺪﻧﺎﻣﯽﻗﺎﺑ, ﻥﺩﺮﮐﻊﻤﺟ
: 
ﺮﺘﻣﺍﺭﺎﭘ: ﺮﺻﺎﻨﻋ
ﻭﺮﮐﺎﻣ: ﯽﻟﺎﻋ, ﺖﺷﺭﺩ
ﻡﻭﺩﻪﺟﺭﺩ: ﯼﺎﭼ
ﺭﺍﺪﯾﺎﭘ: ﺖﺑﺎﺛ, ﻝﺩﺎﻌﺘﻣ
ﯼﺎﻬﻟﺩﺎﺒﻣ: ﻝﺩﺎﺒﺗ
ﻦﺘﺧﺎﺳﻪﻨﯿﺸﯿﺑ: ﻦﯾﺮﺘﺸﯿﺑ
: 
ﯽﺑﺮﺠﺗ: ﻪﺑﺮﺠﺗ
: 
: 
: 
: 
URL: 
: 
ﯼﺩﻮﺧ: ﯽﻠﺧﺍﺩ, ﻮﻀﻋ
ﻦﺗ: ﻦﺤﻟ
: 
ﻥﻮﺌﻧ: 
: 
: 
ﯼﺭﺎﮕﻧﺰﻣﺭ: ﯼﺭﺍﺬﮔﺰﻣﺭ
ﺪﺣﺍﻭ: ﺪﺣﺍﻭ, ﻢﺠﺣ
ﺪﯿﻔﺴﺑﻞﯾﺎﻣﯽﺑﺍﻭﺖﺨﺳﯼﺰﻠﻓﺮﺼﻨﻋ: 
ﻢﯾﺰﻧﺁ: ﺮﻤﺨﻣ
ﺎﺘﺳﺎﭘ: 
: 
ﻥﺩﺮﮐﯽﻨﯿﭼﻪﺷﻮﺧ: ﺖﻗﺮﺳ
ﻒﯿﮐ: 
ﻩﺎﮕﺑﺍﻮﺧ: ﻩﺎﻨﭘﻥﺎﺟ
: 
ﻝﺍﻭﺮﯾﺎﻓ: 
ﻥﺍﻮﺟﻮﻧ: ﻥﺍﻮﺟ
ﻩﺰﯿﮕﻧﺍﺩﺎﺠﯾﺍ: ﻡﺎﻬﻟﺍ
ﻪﺘﺴﺟﺮﺑ: ﺖﻣﻼﻋ
ﻥﺩﺮﮐﯽﺜﻨﺧ: ﻦﺘﻓﺭﻦﯿﺑﺯﺍ, ﻥﺩﺮﮐﻡﻭﺮﺤﻣ, ﯽﻔﻨﻣ
ﺮﺴﭘﺖﺳﻭﺩ: ﮏﯾﺮﺷ, ﺖﺳﻭﺩ
ﺭﻮﺘﮐﺍﺭ: ﻞﻤﻌﻟﺍﺲﻜﻋ
: 
ﯼﺭﺎﺘﻓﺭ: ﺭﺎﺘﻓﺭ
ﺭﻭﺮﻏ: ﺭﻭﺮﻏ
: 
: 
ﻡﻮﯿﻧﻮﺗﻮﻠﭘ: 
WWW: 
ﯽﻗﺮﺑﻪﻠﭘ: 
ﻡﺮﮑﺸﺘﻣ: ﺮﮑﺸﺗ
ﻖﯾﺮﻏﺕﺎﺠﻧ: 
ﺮﮑﻔﺘﻣﺰﻐﻣ: ﺰﻐﻣ, ﺡﻭﺭ, ﺩﺎﺘﺳﺍ
: 
ﻢﯾﺮﺘﯾﺍ: 
ﺖﺴﯾﺯﻂﯿﺤﻣ: ﯽﺳﺎﻨﺷﻡﻮﺑ
ﺮﺟﺎﻬﻣ: ﺮﺟﺎﻬﻣ, ﯽﺗﺍﺮﻤﻌﺘﺴﻣ
ﭖﺎﺗﭗﻟ: ﺭﻭﺩ, ﻩﺍﺮﻤﻫﻦﻔﻠﺗ, ﮎﻮﺑﺕﻮﻧ
ﺪﺷﺭﺍﯽﺳﺎﻨﺷﺭﺎﮐ: ﻝﺎﺘﺴﭘﺕﺭﺎﮐ
ﻥﺩﺍﺩﺭﺍﺮﻗ: ﺐﯿﺷ, ﻦﺘﺧﺎﺳﺎﻫﺭ
ﯽﭙﮐﻮﺘﻓ: ﻪﺨﺴﻧ, ﺮﯾﻮﺼﺗ
ﺖﺸﮔﺯﺎﺑ: ﺐﺗﺍﺮﻣﻪﻠﺴﻠﺳ
ﻪﻣﺎﻧﺮﺳ: ﻪﻣﺎﻧ, 
: 
ﻥﻮﮔﺭﺁ: 
ﺭﺎﺟﺰﻧﺍ: ﺱﺮﺗ
: 
ﻝﺎﻌﻓ: ﻞﻤﻋ
ﯽﯾﻮﺸﻓﺮﻇﻦﯿﺷﺎﻣ: 
ﺕﺮﺷﯽﺗ: ﻦﻫﺍﺮﯿﭘ
ﺱﺎﻨﺸﻧﺎﻣﺭﺩ: ﺮﺘﮐﺩ, ﻥﺎﻣﺭﺩ
ﺐﻧﺎﺠﻣﻂﺧ: 
ﯽﺘﺸﭘﻪﻟﻮﮐ: 
ﺎﻫﮏﻠﮑﺷ: ﻝﺎﺤﺷﻮﺧ
ﯽﯾﺎﯾﺭﺩﯼﺍﺬﻏ: ﺎﯾﺭﺩ, 
: 
: 
ﻢﻬﻣﯽﻠﯿﺧﺭﺍﺩﻪﯾﺎﻣﺮﺳ: ﻩﺎﺷﺩﺎﭘ, ﻪﻠﮔ
ﯽﮕﺘﺨﯿﮕﻧﺍ: ﻥﺎﺠﯿﻫ, ﺖﺷﺭﺩ
ﻡﺎﮕﻤﻫ: ﯼﺯﺎﺳﻡﺎﮕﻤﻫ, ﯽﯾﻮﺸﻓﺮﻇﮏﻨﯿﺳ
ﻑﻭﺮﺣﮏﺒﺳ: ﺱﺪﻘﻣﺏﺎﺘﮐ, ﺎﺠﻫ
ﯼﺪﯿﺳﺍ: ﺪﯿﺳﺍ
: 
: 
ﯽﻧﺎﻣﺭﺩﯽﻤﯿﺷ: ﯽﯾﺎﯿﻤﯿﺷ
ﯼﻮﻐﻟ: ﺖﻐﻟﮓﻨﻫﺮﻓ, ﻩﮊﺍﻭ
ﻪﻧﺎﻤﯿﭘ: ﺝﺮﺨﻣ
ﻥﻮﺗﻭﺮﭘ: 
ﻞﺴﮑﯿﭘ: 
: 
ﺭﺩﻦﺘﺴﮑﺷ: ﺢﻳﺮﻔﺗﮓﻧﺯ
ﺭﺍﺩﺥﺮﭼﯽﻟﺪﻨﺻ: 
: 
ﻩﺎﮕﺷﺩﺮﮔ: ﺮﯿﺴﻣ, ﻭﺭﻩﺩﺎﻴﭘ, ﻩﺩﺎﯿﭘﺮﺑﺎﻋﻂﺧ, 
XML: 
ﯼﺪﻨﺑﻪﻘﺒﻃ: ﯼﺯﺎﺳﺐﺗﺮﻣ
ﻩﺪﻧﺭﺩ: ﯽﭼﺭﺎﮑﺷ
: 
ﺪﺟﻮﻣﻭﻭﺮﺸﯿﭘ: ﻡﺎﮕﺸﯿﭘ
ﺲﯿﺋﺭ: ﺮﺳ, ﺲﻴﺋﺭ
: 
ﻡﻮﯿﻟﺎﮔ: 
ﻩﻭﺰﺟ: ﻩﻭﺰﺟ
ﮏﯿﺗﺎﻣﺰﯾﺭﺎﮐ: ﻥﻮﺴﻓﺍ
ﻩﺪﻧﺮﯿﮔﻢﯿﻤﺼﺗ: ﺺﺨﺸﻣ
: 
ﻢﯾﺪﻧﺎﮑﺳﺍ: ﻢﯾﺭﻮﻠﺗ
ﯼﺪﻨﺑﺮﮑﯿﭘ: ﺖﯾﺮﯾﺪﻣ, ﯼﺪﻨﺑﺐﯿﮐﺮﺗ
ﯽﺒﺼﻋﻪﺘﺧﺎﯾ: 
ﺮﺗﻭﺭ: 
ﺎﻤﻨﻫﺍﺭ: ﯼﺎﻤﻨﻫﺍﺭﻪﭽﺑﺎﺘﮐ
ﻥﺩﺮﮐﺽﺮﻓ: ﺪﯿﻨﮐﺽﺮﻓ
ﻝﺎﺒﯿﻟﺍﻭ: 
ﺖﺟﺪﯾﻭ: 
ﯽﯾﺍﺩﺯﻝﺎﮑﺷﺍ: ﻝﺎﺑﺮﻏ
ﻪﻧﺎﺧﺩﺮﺳ: ﻝﺎﭽﺨﯾ
ﺩﺪﺠﻣﯼﺯﺍﺪﻧﺍﻩﺍﺭ: ﻩﺭﺎﺑﻭﺩﻉﻭﺮﺷ
: 
ﺪﻧﺎﺑﯼﺎﻨﻬﭘ: ﺪﻧﺎﺑﯼﺎﻨﻬﭘ
ﻥﻭﺮﺗﻮﻧ: 
: 
ﯽﻧﺎﻬﮔﺎﻧﻭﺮﮑﺑﺮﮑﻓ: ﻡﺎﻬﻟﺍ, ﻪﺸﯾﺪﻧﺍ
: 
ﺭﺍﺮﮑﺗ: ﻪﺨﺴﻧ, ﻞﻌﺟ
: 
ﺮﺘﺴﻣﺏﻭ: 
ﯽﻧﺍﺮﮕﻧﻭﺖﺸﺣﻭﺱﺎﺴﺣﺍ: ﺱﺮﺗ, ﺲﭘﺍﻮﻟﺩ
ﺲﺑﺶﺗﺁ: ﻪﮐﺭﺎﺘﻣ
ﻥﺩﺮﮐﯽﻧﺎﻬﻨﭘ: ﯼﺭﺍﺬﮔﺰﻣﺭ
ﻞﻣﺎﻋﻢﺘﺴﯿﺳ: 
ﻩﺎﺒﺘﺷﺍ: ﻑﺬﺣ, ﻩﺎﺒﺘﺷﺍ, ﺵﺰﻐﻟ
ﮏﯿﺘﺳﺍﯼﻮﺟ: 
ﺭﺩﺍﺮﺑﻭﺮﻫﺍﻮﺧ: ﺭﺩﺍﺮﺑ
ﻩﺪﻨﻨﮐﻡﺮﻧ: 
ﯼﻮﮕﻨﺨﺳ: ﻮﮔﺪﻨﻠﺑ, ﻩﺪﻨﯾﺎﻤﻧ
ﻪﻨﮕﻨﻣ: ﭗﯿﻠﮐ, 
ﻢﯿﻨﯿﺘﮐﺍ: 
ﯼﺪﻧﻼﻨﻓﺭﺎﺨﺑﻡﺎﻤﺣ: 
ﯽﺳﺭﺍﻭ: ﯽﺳﺭﺮﺑ, 
ﻞﺧ: ﯽﻌﯿﺒﻃﺮﯿﻏ
ﻥﺩﻮﺑﺭ: ﯽﯾﺎﺑﺭﻡﺩﺁ, ﻥﺩﺯﻢﺨﺷ
ﺰﻠﻓﺮﯿﻏ: ﺰﻠﻓﻪﺒﺷ
: 
ﻢﯿﺑﺮﺘﯾﺍ: 
: 
ﺖﯾﺎﺑﺎﮕﯿﮔ: 
ﻥﻭﺩﺍﺭ: 
ﺩﺎﻘﺘﻧﺍ: ﺩﺎﻘﺘﻧﺍ
: 
ﺪﻨﺑﺮﻤﮐ: ﺪﻧﺎﺑ
ﻝﺎﺤﺷﻮﺧ: ﻝﺎﺤﺷﻮﺧ, ﺭﺍﺩﻩﺪﻨﺧ, ﻪﻨﯾﺰﮔ
: 
: 
venitive: 
mudita: 
mindstream: 
ﯼﺭﺎﺒﺘﻋﺍﺕﺭﺎﮐ: ﺭﺎﺒﺘﻋﺍ
ﻡﻮﯾﺮﻫﻮﺑ: 
ﺐﺠﻌﺘﻣ: ﻥﺩﺮﮐﺕﺎﻣ
exclamative: 
ﯽﺒﯿﻏﺮﺗ: 
ﻥﺩﺮﮐﺝﺍﺮﺧﺍ: ﻥﺩﺮﮐﺭﺎﻨﮐﺮﺑ
converb: 
QWERTY: 
: 
ﻦﯾﻭ: 
: 
ﺵﺩﺮﮔ: ﺵﺩﺮﮔ, ﻥﺩﺮﮐﺥﺍﺭﻮﺳﻪﺘﻣﺎﺑ
ﯽﻧﻮﻔﻋ: ﺖﻧﻮﻔﻋ
ﻥﻮﺘﭙﯾﺮﮐ: 
: 
yaor: 
ﻪﻧﻭﺭﺍﻭ: ﺖﺸﮔﺯﺎﺑ
ﺭﻭﺪﯾﺮﮐ: ﻦﻟﺎﺳ
ﻝﺎﺼﺗﺍ: ﻦﯿﮔﻼﭘ, ﯽﮕﺘﺴﺒﻟﺩ, ﻝﺎﺼﺗﺍ, ﺰﯾﺮﭘ
ﻢﯾﺮﻨﺘﯿﻣ: 
ﺮﻬﻇﺯﺍﺪﻌﺑ: ﺮﻬﻇﺯﺍﺪﻌﺑ, ﺐﺷ
ﻪﻧﺎﻧﺯ: ﻪﻧﺎﻧﺯ
: 
ﻥﺩﺮﮐﮏﭼ: ﯽﺳﺭﺮﺑ, 
ﻢﯿﮔﺭﻮﺑ: 
: 
ﻢﯿﺴﻧﺭﻻ: 
ﺩﻮﺑﺪﻫﺍﻮﺧ: 
: 
ﻥﺍﺩﺎﻧ: ﻞﻬﺟ, ﻖﻤﺣﺍ
: 
ﺎﻬﻬﻤﺟﺮﺗﯼﺎﻤﻨﻫﺍﺭﯽﻬﺤﻔﺻ: 
ﻥﺩﺮﮐﻂﺒﺗﺮﻣ: ﺏﻼﻗ
RECURSE: 
railcarﺖﻌﻨﺻ: 
ﺮﯾﺪﻣ: ﻩﺪﻨﻨﮐﻞﯿﻬﺴﺗ, ﺮﯾﺪﻣ
: 
ﮒﺍﺩﺕﺎﻫ: ﺲﯿﺳﻮﺳ
ﯽﺑﻮﺧ: ﺍﻮﻘﺗ
usitative: 
ﻢﯿﻨﻓﺎﻫ: 
ﻡﺎﻤﺣﻥﺍﻭ: ﻥﺍﻭ
ﺖﺒﺴﻧ: ﻝﺩﺎﻌﺘﻣ, ﻁﺮﺷ, ﺶﺨﺑ, ﻂﺴﺑ
ﻪﺘﻓﺮﺸﯿﭘﺮﺒﺟ: 
ﺍﺭﺎﺴﻣﺎﺳ: 
ﮏﻨﯿﻟ: ﻦﺘﻣﺮﺑﺍ
ﯽﮑﯾﻭ: 
deixis: 
ﻪﻣﺎﻨﺸﻫﻭﮋﭘ: ﻩﻭﺰﺟ, ﺕﺎﻋﻼﻃﺍ
ﯽﯾﺎﻀﻗﯼﻮﻋﺩ: ﯽﻧﻮﻧﺎﻗﺩﺮﮕﯿﭘ, ﻉﺍﺰﻧ, ﻩﺎﮔﺩﺍﺩ
ﮏﯿﮑﻔﺗ: ﻢﯿﺴﻘﺗ, ﯽﮔﺪﯿﺳﻮﭘ, ﮏﯿﮑﻔﺗ, ﻞﯿﻠﺤﺗ
ﺺﻟﺎﺧ: 
ﻢﯿﻤﻟﻮﻫ: 
ﻥﺎﺳﺁ: ﯽﻧﺎﺳﺁﻪﺑ
: 
ﻩﺪﻨﻨﮐﻩﺮﯿﺧ: ﻥﺩﺮﮐﺕﺎﻣ, ﻪﺟﻮﺗﻞﺑﺎﻗ
ﻥﺩﺍﺩﻥﺍﻭﺎﺗ: ﺖﺧﺍﺩﺮﭘ
ﻦﺘﻓﺎﺑﻭﻥﺪﯿﺑﺎﺗﻢﻬﺑ: ﻩﺮﮔ
ﻩﺪﻨﻫﺩﺭﺍﺪﺸﻫ: ﮎﺎﻨﺘﺸﺣﻭ, ﺲﭘﺍﻮﻟﺩ
ﻥﺩﺍﺩﻥﺎﺸﻧﻥﺎﺠﯿﻫ: 
ﺺﯿﺼﺨﺗ: ﻡﺎﻬﺳﺩﻮﺳ, ﯼﺮﻤﺘﺴﻣ
ﺎﺑﻖﺑﺎﻄﻣ: ﻦﯿﻣﻭﺩ, ﺖﺸﮔﺯﺎﺑ
ﻂﻠﺴﺗ: ﺮﺛﺍ, ﺕﺭﺪﻗ
ﺖﺴﮐﺩﺎﭘ: 
ﺐﻨﺟ: ﺪﻌﺑ
ﺮﮕﯾﺪﮑﯾ: ﺮﮕﯾﺩﯽﮑﯾ, ﻞﺑﺎﻘﺘﻣ
andative: 
ﻡﺮﺟﺪﺣﺍﻭ: 
ﺖﺳﺮﻬﻓ: ﺖﺳﺮﻬﻓ, ﺰﯿﻣ, ﯽﻧﺎﻣﺯﺎﺳﺕﺭﺎﭼ
ﯽﯾﺎﺳﺎﻨﺷﻞﺑﺎﻗ: ﺖﯾﻮﻫ
ﺝﻭﺮﺧ: ﺪﺳﺭﯽﻣﺮﻈﻧﻪﺑ, ﺝﻭﺮﺧ, ﯽﺴﯿﻋﯽﻠﺠﺗﻭﺭﻮﻬﻇ
ﻆﻓﺎﺣﺍﺪﺧ: ﯽﻈﻓﺎﺣﺍﺪﺧ
: 
ﻩﺭﺎﺟﺍ: ﻥﺩﺮﮐﻩﺭﺎﺟﺍ
ﺐﻧﺎﺟﺯﺍﺩﺭﻮﻣ: ﻪﺑﺩﺭﻮﻣ
.ﻩﺮﯿﻏﻭ: ﺭﺎﺘﯿﮔ
patientive: 
ﯽﻘﯾﺪﺼﺗ: ﻡﺮﻧ
: 
ﯽﻌﯾﺯﻮﺗ: ﻊﯾﺯﻮﺗ, ﻩﺪﻨﻨﮐﻊﯾﺯﻮﺗ
ﯽﺳﺎﻨﺷﻥﺎﺘﺳﺎﺑ: ﯽﺳﺎﻨﺷﻥﺎﺘﺳﺎﺑ
: 
ﻡﻮﯿﻨﺑﻭﺩ: 
ﻡﻮﯿﻤﯾﺩﻮﺌﺳﺍﺮﭘ: 
: 
ﺯﺍﯼﺍﺪﺟ: ﺰﺠﺑ
: 
: 
: 
ﺖﯾﺎﺑﺍﺰﮔﺍ: 
: 
ﻡﻮﯿﻣﺮﻓ: 
: 
ﻡﻮﯿﺑﺮﺗﻢﺗﺍ: ﻡﻮﯾﺩﻭﺭﻢﺗﺍ
ﻖﯾﺭﺰﺗ: ﻥﺩﺮﮐﯽﻓﺮﻌﻣ
ﯽﺷﺎﻘﻧﻡﻮﺑ: ﻪﭼﺭﺎﭘ, ﺏﻭ, ﯽﻧﺎﺘﮐﻪﭼﺭﺎﭘ
ﭗﻣﺖﯿﺑ: 
ﺍﺮﻫﺎﻇ: ﺍﺮﻫﺎﻇ, ﺪﯾﺎﺷ, ﺪﯿﻨﮐﺽﺮﻓ
ﻢﯾﺪﻨﯾﺍ: 
ﻢﯾﺯﻭﺮﭙﺴﯾﺩ: 
: 
ﻭﺭﺩﺎﮔﻭﻭﺁﺭﺩ: 
ﺭﻮﺗﻮﻣ: ﺭﻮﺗﻮﻣ
: 
ﻢﯿﻟﻮﺗﻢﺗﺍ: ﻡﻮﯾﺩﻭﺭﻢﺗﺍ
ﯼﺎﺠﺑ: ﯼﺎﺠﺑ
ﻪﺘﺴﺸﻧﺯﺎﺑ: ﻪﺘﺴﺸﻧﺯﺎﺑ
ﻢﯿﻨﯿﻟﻭﺩﺎﮔ: 
ﺎﻫﯼﮋﺗﺍﺮﺘﺳﺍ: ﯼﮋﺗﺍﺮﺘﺳﺍ
ﻡﺯﻻ: ﻡﺯﻻ
ﯼﺩﯼﻭﯼﺩ: 
ﺏﺍﺭ: 
ﻉﺎﻌﺷ: ﻪﻌﺷﺍ
ﺩﺎﺘﺳﺍ: ﺩﺎﺘﺳﺍ
ﯽﻗﺎﻔﺗﺍ: ﯽﻓﺩﺎﺼﺗ
ﻪﻧﺍﺩﺍﺯﺁ: ﻞﺷ, ﻥﺩﺮﮐﺩﺍﺯﺁ, ﻞﻘﺘﺴﻣﺭﻮﻃﻪﺑ, ﺖﯿﻌﻗﻮﻣ
: 
ﻪﺒﺳﺎﺤﻣ: ﺮﺗﻮﯿﭙﻣﺎﮐ, ﺏﺎﺴﺣﻦﯿﺷﺎﻣ, ﻥﺩﺮﮐﻪﺒﺳﺎﺤﻣ
: 
ﻥﺍﺯﺭﺍ: ﻢﮐ, ﺪﯾﺮﺧ
ﻩﺪﻨﻨﮐﻡﺮﮔﺮﺳ: ﺖﺴﻫﺐﻟﺎﺟ, ﺭﺍﺩﻩﺪﻨﺧ, ﺖﺷﺯ
ﻱﺯﺎﺳﻪﻨﻴﻬﺑ: ﻕﺎﺒﻄﻧﺍ
ﮏﯿﺗﺍﺮﮐﻭﺭﻮﺑ: ﯼﺭﻻﺎﺳﻥﺍﻮﯾﺩ, ﯽﻤﺳﺭ
ﻡﺯﻻ: ﻡﺯﻻ
: 
ﯽﻧﺎﻤﯾﺭ: 
ﻢﯾﺭﻮﺗﻢﺗﺍ: ﻡﻮﯾﺩﻭﺭﻢﺗﺍ
ﻥﺎﺷﺩﻮﻨﺸﺧﺎﻧ: ﺩﺭ
ﺐﺠﻌﺗﯼﺎﺟ: ﻥﺩﺮﮐﺮﯿﮕﻠﻓﺎﻏ
ﯽﺴﯾﻮﻧﻪﻣﺎﻧﺮﺑ: ﯼﺭﺍﺬﮔﺰﻣﺭ, ﮓﻧﺭ
ﻢﯿﻨﯿﺘﮐﺎﺗﻭﺮﭘ: 
ﻩﺮﯿﺟ: ﺭﺍﺪﻘﻣ
: 
ﻪﻧﺎﺧﺐﺣﺎﺻ: ﺎﻣﺮﻓﺭﺎﮐ
ﺯﺍ،ﺍﺪﺟﻢﻫﺯﺍ: ﺰﺠﺑ
: 
ﯽﺘﺳﻭﺩ: ﻪﻧﺎﺘﺳﻭﺩ
ﺶﮐﻒﻠﻋ: ﻢﺳ
affineﻪﺑ: 
: 
ﻪﺧﻮﺟ: ﺪﻧﺎﺑ
ﻪﻧﻮﮔ: ﯼﺯﺎﺑ
: 
: 
: 
ﻩﺪﻨﻨﮐﻡﺮﮔﺮﺳ: ﺖﺴﻫﺐﻟﺎﺟ, ﯽﻣﺮﮔﺮﺳﻭ​​ﺢﯾﺮﻔﺗ, ﺭﺍﺩﻩﺪﻨﺧ
: 
: 
ﺮﯾﻮﺼﺗ: ﺶﯾﺎﻤﻧ
: 
ﻩﺯﺭﺎﺒﻣ: ﮓﻨﺟ
: 
ﻥﺩﺍﺩﻩﺯﺎﺟﺍ: ﺪﯿﯾﺎﺗ, ﯽﻤﺳﺭ
ﯽﻧﺍﺭﺎﺑﺱﺎﺒﻟ: 
ﻒﻟﺎﺨﻣ: ﻥﺩﺮﮐﺖﻣﻭﺎﻘﻣ, ﻞﺑﺎﻘﻣ, ﯽﮕﻧﻭﺭﺍﻭ, ﺩﺎﻀﺘﻣ
ﻢﯿﻠﺑﻮﻧ: 
ﻖﻘﺤﻣ: ﺪﻨﻤﺸﻧﺍﺩ, ﻩﺎﮔﺍﺭﺎﮐ
: 
ﻩﺪﻧﺯﺎﺳ: ﯼﺪﻨﺑﻝﻮﻣﺮﻓ
ﺯﺍﺝﺭﺎﺧ: ﺰﺠﺑ
ﻞﻤﺣﻞﺑﺎﻗ،ﺵﻮﻣﺎﺧ: 
ﺰﻐﻟ: 
ﺵﺮﯾﺬﭘﻝﻮﺌﺴﻣ: ﻩﺪﻧﺮﯿﮔ, 
ﺏﺎﺘﻓﺁﺪﺿﯼﺎﻫﻡﺮﮐ: ﺏﺎﺘﻓﺍﺭﻮﻧ, 
ﻉﻮﺿﻮﻣﺩﺭﻮﻣ: ﻉﻮﺿﻮﻣﺩﺭﻮﻣ
: 
: 
ﺖﺸﮕﻧﺍﺺﺧﺎﺷ: ﺺﺧﺎﺷ
: 
: 
ﻪﻧﺍﺩﺮﻣ: ﺮﻧ
ﻞﮑﺷ: ﺖﻬﺟ, ﺖﻤﺳ
ﺵﺮﺘﺴﮔ: ﻩﺩﻭﺪﺤﻣ
ﮏﻠﻣﺐﺣﺎﺻ: ﻪﺘﺷﺮﻓ
ﻢﯿﺴﻧﺍﺮﻓ: 
ﺖﻋﺎﺳ: ﻪﻄﻘﻧ, ﺖﺒﺳﺎﻨﻣ, ﺮﻌﺷ
ﯼﺯﺎﺳﺍﺪﺟ: ﻊﯾﺯﻮﺗ
arctan: 
: 
ﺪﻘﺘﻨﻣ: ﯽﭼﺭﻮﺴﻧﺎﺳ
ﺪﻌﺑ: ﻝﻭﺍ, ﺪﻌﺑ, ﻦﺘﺷﺍﺩﻪﮕﻧ
ﯽﺘﻧﺮﺘﻨﯾﺍﺖﯾﺎﺳ: ﯽﺘﻧﺮﺘﻨﯾﺍﺖﯾﺎﺳ
: 
ﺢﻠﺴﻣ: ﻥﺩﺮﮐﺡﻼﺳﻊﻠﺧ
ﻞﺴﻧ: ﺎﻨﺷﺁ, ﻩﻮﻧ, ﻞﺴﻧ
ﻒﺻﺍﻭ: ﺢﯿﺿﻮﺗ
ﻩﺍﺮﻤﻫﻦﻔﻠﺗ: ﻩﺍﺮﻤﻫﻦﻔﻠﺗ
ﺶﯾﺍﺭﺁ: ﺶﯾﺍﺭﺁ
IMPORTE: 
: 
ﻥﺩﺍﺩﻡﺎﻨﺷﺩ: ﻩﺎﺒﺘﺷﺍ, ﻥﺩﺮﮐﻢﺘﺳ, ﺖﻗﺮﺳ
: 
verbalizer: 
: 
: 
ﺎﻀﻓﺮﮕﻧﺎﺸﻧ: 
ﯼﺎﻨﺜﺘﺳﺍﻪﺑ: ﺰﺠﺑ, ﻪﻠﻤﺟﺯﺍ
ﺖﻟﻭﺩﺮﮕﻧﺎﺸﻧ: 
ﺎﻬﺑﺎﺼﺘﻋﺍ: 
: 
ﻦﯿﺗﺎﺘﺳﺍ: 
ﯼﺮﮕﯾﺩﺮﮔﺍ: 
ﯽﻋﺎﻤﺘﺟﺍ: ﯽﻋﺎﻤﺘﺟﺍ
ﻢﯾﺭﻮﮐ: 
ﯽﺼﺨﺸﻣﺯﺮﻣﻭﺪﺣ: ﻢﻫﺯﺍﺍﺪﺟ
: 
ﺩﺭﺍﺪﻧﺎﺘﺳﺍ: ﺕﺎﺼﺨﺸﻣ
ﻥﺩﺮﮐﻡﺎﻤﺗﺍﺭﻝﻮﻗﻞﻘﻧ: ﻝﻮﻗﻞﻘﻧ
ﺖﯾﺎﻤﺣ: ﯽﻠﯿﺼﺤﺗﺱﺭﻮﺑ, ﻥﺩﺍﺩﺖﻴﻤﻫﺍ
ﮓﻨﺟﻥﺍﺪﯿﻣ: ﮓﻨﺟ
ﯼﺩﺎﻬﻧ: ﯼﺭﺎﺘﺧﺎﺳ
ﻦﯾﺭﻮﻠﻓﻢﺗﺍ: ﻡﻮﯾﺩﻭﺭﻢﺗﺍ
ﺰﯿﻤﻣ: ﺐﺳﺎﺤﻣ, ﺮﮑﺸﺗ
ﺭﻮﻣﻮﺗ: ﺭﻮﻣﻮﺗ
ﯽﺸﺣﻭﺕﺎﻧﺍﻮﯿﺣ: ﺖﻌﯿﺒﻃ, ﯽﺸﺣﻭ
ﻪﺘﻓﺎﯾ: ﺩﺎﺠﯾﺍ
: 
: 
ﻦﺘﺷﺍﺩﺕﺩﺎﻋ: ﯽﺷﺭﺎﻔﺳ
ﯼﺍﻪﻈﺣﻼﻣﻞﺑﺎﻗ: ﯼﺩﺎﯾﺯﺪﺣﺎﺗ, ﯽﻓﺎﮐ
ﯽﻃﺎﺒﺗﺭﺍ: ﻁﺎﺒﺗﺭﺍ, ﻑﺮﺣﺮﭘ
ﯽﭼﺎﻧﻮﺒﯿﻓ: 
ﻡﻮﯾﺪﯿﺑﻭﺭﻢﺗﺍ: ﻡﻮﯾﺩﻭﺭﻢﺗﺍ
ﻢﺘﯿﺗﻮﻟ: 
ﻥﺩﺮﮐﺭﺎﮐ: ﻦﯾﺮﻤﺗ, ﺭﺎﮐ, ﻩﺪﺷﺖﺳﺭﺩﻪﻧﺍﺩﺎﺘﺳﺍ
ﻪﯾﺭﻮﻓﻞﯾﺪﺒﺗ: ﺭﻭﺭﺎﺑ
ﻩﺩﺮﮐﻞﯿﺼﺤﺗ: ﺕﻼﯿﺼﺤﺗ, ﺏﺩﺍﺎﺑ
ﻢﯿﻧﺮﻔﯿﻟﺎﮐ: 
ﻢﯿﻧﺎﺘﺸﻧﺍ: 
: 
ﺪﯾﺎﺑ: ﺪﯾﺎﺑ, ﻪﻔﯿﻇﻭ
ﻢﯾﻮﻟﺪﻨﻣ: 
ﺖﻓﺮﺸﯿﭘ: ﻦﺘﻓﺭﺶﯿﭘ, ﯽﻠﻣﺎﮑﺗ
ﻩﺍﺮﻤﻫﻦﻔﻠﺗ: ﻩﺍﺮﻤﻫﻦﻔﻠﺗ
ﺭﺩﺩﺭﻮﻣ: ﻪﺑﺩﺭﻮﻣ
: 
ﻩﺩﺎﻌﻟﺍﻕﻮﻓ: ﺭﺎﯿﺴﺑ
ﯽﺒﯾﺮﻘﺗ: ﯽﺒﯾﺮﻘﺗ
ﯽﻘﻄﻨﻣ: ﻥﺍﺪﻤﭼ
ﻩﺪﻧﻮﺷﺩﺭﺍﻭ: ﯽﻔﺻﻭﻪﺟﻭ
ﻖﻠﻌﺗ: 
ﻢﯿﭘﻭﺭﺍ: 
TOPOS: 
ﺮﻧﻮﺗ: ﺮﻫﻮﺟ, 
ﻡﻮﯾﺭﺎﻣﺎﺳ: 
anticausative: 
: 
: 
relativizer: 
: 
ﯽﻠﻤﻋ: ﯽﻠﻤﻋ, ﻦﺘﻓﺮﮔ
ﻥﺩﺮﮐﻪﻓﺎﺿﺍ: ﻥﺩﺮﮐﺮﺘﻬﺑ
ﯽﺗﺎﺳﺎﺴﺣﺍ: ﯼﺮﯿﺴﻣﺮﮔ
ﻪﻠﺌﺴﻣ: ﻞﮑﺸﻣ, ﻩﺩﺎﻣ
ﻡﻮﯿﻟﺎﺗﻢﺗﺍ: ﻡﻮﯾﺩﻭﺭﻢﺗﺍ
ﺥﺎﺑﺪﻠﮔ: 
ﻡﻮﯾﺩﺎﻧﺍﻭﻢﺗﺍ: ﻡﻮﯾﺩﻭﺭﻢﺗﺍ
ﻝﺎﺘﮐﺮﻓ: 
ﺖﻟﺎﺠﺧ: ﻡﺮﺷ, ﻞﮑﺸﻣ, ﯽﺠﯿﮔ
ﺎﻣﺮﻓ: 
ﻡﻮﯿﻧﻮﻠﭘﻢﺗﺍ: ﻡﻮﯾﺩﻭﺭﻢﺗﺍ
: 
ﻞﻤﮑﻣ: ﻩﺪﻨﻨﮐﻞﯿﻤﮑﺗ, ﯽﻓﺎﺿﺍ
ﯼﺪﻨﺑﻪﺘﺴﺑ: ﻪﺘﺴﺑ, ﻭﺭﻩﺩﺎﻴﭘ
ﺖﯿﺣﻼﺻ: ﻪﺑﺭﺩﺎﻗ, ﻩﺎﮔﺩﺍﺩﻦﯾﺍﺖﯿﺣﻼﺻ, ﻂﯾﺍﺮﺷﺪﺟﺍﻭ, ﺖﯿﻠﺑﺎﻗ
ﮒﻼﺑﻭ: 
ﺕﺎﯿﺒﯿﮐﺮﺗ: ﯽﺒﯿﮐﺮﺗ
ﺱﺭﻮﻏﺎﺜﯿﻓ: 
ﻖﻳﺮﻃﺯﺍ: ﺭﻮﺒﻋ
ﺺﻗﺭ: ﯼﺯﺎﺑ, ﺺﻗﺭ
ﺐﻟﺎﺟ: ﺖﺴﻫﺐﻟﺎﺟ, ﺮﯾﺬﭙﻟﺩ, ﻩﺩﺎﻣ
ﻪﻌﺳﻮﺗ: ﯽﻠﻣﺎﮑﺗ, ﻦﺘﻓﺭﺶﯿﭘ
circumfix: 
ﻞﮑﺸﻣ: ﻞﮑﺸﻣ, ﺭﺮﺿ
: 
: 
ﻩﺪﻨﻨﮐﻦﯿﻣﺎﺗ: ﻥﺩﺮﻛﻚﺷ, ﯽﻣﺎﺣ
ﻊﯾﺯﻮﺗ: ﻊﯾﺯﻮﺗ
ﯽﺳﻮﺳﺎﺟﯼﺎﻫﺭﺍﺰﻓﺍﻡﺮﻧ: 
ﻪﺒﺣﺎﺼﻣ: ﺭﺎﮕﻧﺮﺒﺧ
: 
ﻥﻮﻧﺰﮔ: 
ﺥﺮﺴﺑﻞﯾﺎﻣﻩﻮﻬﻗ: ﻱﺍﻩﻮﻬﻗ
schadenfreude: 
ﻦﯿﻤﮐ: ﻩﺎﮕﻧﺎﻬﻧ
: 
: 
: 
ﻥﺩﻮﺑﻞﻣﺎﺷ: 
: 
ﺎﺑﻭﺎﻨﺘﻣ: ﯼﺎﺠﺑ
ﯽﮕﯾﺎﺴﻤﻫ: ﻑﺍﺮﻃﺍ, ﻩﺪﻧﺯ
ﻡﻮﯾﺩﺭﻮﻓﺭﺩﺍﺭ: 
ﻥﺍﺰﯿﻣﺮﮕﻧﺎﺸﻧ: 
ﯼﺍﻩﺯﻭﺮﯿﻓ: ﯽﺑﺁ
ﻪﯾﺰﺠﺗﻭﺩﺎﺤﺗﺍ: 
ﯼﺮﯾﺬﭘﻩﺭﺎﻤﺷ: 
ﯽﻋﺎﻤﺘﺟﺍﺮﮕﻧﺎﺸﻧ: 
ﯽﺜﻨﺧﺲﻨﺟ: ﻪﻧﺍﺩﺮﻣﺲﻨﺟ
ﯽﮑﯿﺘﻧﮊ: ﻥﮊ, ﮏﯿﺘﻧﮊ
: 
ﺭﺍﺰﻓﺍﻡﺮﻧﺕﺭﺎﺒﻋ: ﺭﺍﺰﻓﺍﻡﺮﻧﻪﻠﻤﺟ
ﺭﻮﻧﺖﻋﺮﺳ: 
ﻢﯿﻤﻌﺗ: ﻥﺩﺍﺩﻢﯿﻤﻌﺗ
ﻩﺪﻨﻨﮐﻪﺋﺍﺭﺍ: ﻩﺪﻨﻨﮐﻞﯿﻬﺴﺗ, ﻩﺪﻨﻫﺩ, 
ﻡﻮﯿﺘﻧﻭﺮﺘﺳﺍﻢﺗﺍ: ﻡﻮﯾﺩﻭﺭﻢﺗﺍ
ﻩﺪﻧﺯﺍﺩﺮﭘ: ﺵﺯﺍﺩﺮﭘﻝﺎﺣﺭﺩ
ﻢﺧ: ﻩﺪﺷﻢﺧ, ﻥﺩﺮﮐﻢﺧ, ﻥﺪﺷﻻﻭﺩ
complementizer: 
ﺮﺟﺎﺗ: ﺕﺭﺎﺠﺗﺺﺨﺷ, ﺮﺟﺎﺗ
: 
: 
ﮓﻧﺍﺪﺸﺷ: ﻪﻧﺎﮔﻪﭽﺑ
ﻩﺩﺎﻌﻟﺍﻕﻮﻓ: ﺭﺎﯿﺴﺑ
ﻢﯿﻠﮐﺮﺑ: 
ﻡﻮﯿﮑﯾﺮﻣﺁ: 
: 
ﯽﻠﯿﻣﺎﻓﺖﺒﺴﻧﺩﺭﻮﻣ: ﯽﻠﯿﻣﺎﻓﺖﺒﺴﻧﺩﺭﻮﻣ
: 
ﻢﯿﻨﺗﻭﺭﻢﺗﺍ: ﻡﻮﯾﺩﻭﺭﻢﺗﺍ
ﺲﻔﻨﺗ: ﻥﻮﺼﻣ, ﺲﻔﻧ
ﺪﯾﺎﺑ: ﺪﯾﺎﺑ
ﻥﺩﺮﮐﯽﻓﺩﺎﺼﺗ: ﯽﻓﺩﺎﺼﺗ
ﻝﺎﺜﻣﻥﺍﻮﻨﻋﻪﺑ: ﯽﻨﻌﯾ
ءﺍﺮﺟﺍ: ﯼﺯﺎﺳﻩﺩﺎﯿﭘ
ﻡﻮﯿﻧﻮﺘﭙﻧ: 
ﻒﻟﺎﺨﻣ: ﻥﺩﺮﮐﺖﻣﻭﺎﻘﻣ, ﻞﺑﺎﻘﻣ, ﺩﺭ, ﺖﻣﻭﺎﻘﻣ, ﻊﻓﺍﺪﻣ
ﻪﯿﻟﺎﻓﺎﻀﻣﺩﺭﻮﻣ: ﻪﯿﻟﺍﻑﺎﻀﻣﺖﻟﺎﺣﺩﺭﻮﻣ
ﻩﺪﻨﻨﮐﻥﺍﺮﮕﻧ: ﺲﭘﺍﻮﻟﺩ, ﻥﺩﺍﺩﺖﻴﻤﻫﺍ
: 
nominalization: 
ﻥﺎﻬﺟﻊﯿﺳﻭﺏﻭ: 
ﻑﺪﻫﺩﺭﻮﻣ: ﺪﺼﻘﻣﺩﺭﻮﻣ
: 
ﻉﺎﻓﺩ: ﻥﺩﺍﺩﺖﻴﻤﻫﺍ, ﺖﻈﻓﺎﺤﻣ
ﺩﺯﺩ: 
ﻥﻮﺳﺍﻮﭘ: ﻢﺳ
: 
ﺵﺮﺘﺴﮔ: ﻊﯾﺯﻮﺗ, ﻦﺘﺧﺎﺳﺎﻫﺭ
accompanier: 
: 
ﻥﺩﺮﮐﻪﻤﺟﺮﺗ: ﻪﻤﺟﺮﺗ
ﻞﺻﺎﻓﺪﺣ: ﯽﻠﮐﺡﺮﻃ, ﻥﺪﺷﻞﻴﻜﺸﺗ
ﯽﺘﯿﻨﻣﺍﺮﯾﻮﺼﺗ: 
ﺲﮑﭽﯿﻫ: ﯽﭼﭻﯿﻫ
: 
ﺮﻔﺳ: ﺪﯾﺩﺯﺎﺑ, ﺮﻔﺳ
ﯽﯾﺎﺗﻪﺳ: 
: 
ﻥﺩﺍﺩﺖﺳﺩﺯﺍ: ﺵﺮﺑ, ﻪﻧ
ﻥﺪﯾﻭﺎﮐ: ﯼﺭﺎﻔﺣ
: 
ﺲﯾﻮﻧﮒﻼﺑﻭ: 
: 
ﻪﻓﺮﺳ: ﻥﺩﺮﮐﻪﻓﺮﺳ
: 
ﯼﺎﻫﺮﯿﻐﺘﻣ: ﺮﯿﻐﺘﻣ, ﻝﺎﻤﺘﺣﺍ
ﻩﺩﺮﺘﺴﮔﺭﻮﻃﻪﺑ: ﺽﺮﻋ, ﻦﻬﭘ, ﻥﺩﺮﮐﻦﻬﭘ
ﻍﺮﻣﻢﺨﺗﻩﺪﯿﻔﺳ: ﻦﻴﺌﺗﻭﺮﭘ
: 
ﻥﺍﺮﮔﺖﻟﺎﺣ: ﻥﺍﺮﮔﺖﻟﺎﺣ
ﻩﮊﺍﻭﺪﯿﻠﮐ: ﯽﻠﺻﺍ
ﯽﯾﺎﺗﻭﺩ: ﯽﯾﺎﺗﻭﺩ
: 
ﻥﺩﺍﺩﺮﯿﯿﻐﺗﺯﺍﻪﻌﻗﺍﻭ: 
ﺭﻮﺘﮐﮊﻭﺮﭘ: 
ﻢﯿﻘﺘﺴﻣﺮﯿﻏﻑﺪﻫ: ﻢﯿﻘﺘﺴﻣﻑﺪﻫ
ﻪﯿﻟﺎﻓﺎﻀﻣﺩﺭﻮﻣ: ﻪﯿﻟﺍﻑﺎﻀﻣﺖﻟﺎﺣﺩﺭﻮﻣ
attenuative: ﯽﮔﺪﯿﺳﻮﭘ
resultative: 
: 
ﻢﯿﺳﺎﻫ: 
: 
ﯼﺰﯾﺭﻥﻮﺧ: ﻥﻮﺧ
ﻖﺑﺎﻄﺗ: ﻥﺪﺷﺎﺟ
ﯽﻨﯿﺸﻧﺐﻘﻋ: ﻥﺪﺷﺕﺮﭘ, ﺖﻓﺮﺴﭘ, ﻪﺘﺴﺸﻧﺯﺎﺑ, ﺎﻔﻌﺘﺳﺍ
: 
ﻥﺁﺯﺍﺪﻌﺑ: ﻩﺪﻨﯾﺁ, ﻊﻗﻮﻣﻥﻭﺍ, ﯽﮔﺯﺎﺗﻪﺑ, ﺪﻌﺑ
ﯼﺎﯾﺎﻀﻗ: ﯽﻧﻮﻧﺎﻗ
ﯽﻃﺮﺷﻪﺟﻭﺖﻟﺎﺣ: ﻁﻭﺮﺸﻣﺖﻟﺎﺣ, ﯽﯾﺎﻨﻤﺗﺖﻟﺎﺣ
ﻪﻌﺟﺍﺮﻣ: ﻥﺩﺮﮐﯽﻓﺮﻌﻣ
ﻪﺘﺴﺸﻧﺯﺎﺑ: ﻪﺘﺴﺸﻧﺯﺎﺑ
ﺩﺭﻮﺑﺖﯿﮑﺳﺍ: 
: 
ﻕﺮﺑﻦﯿﺴﻨﮑﺗ: ﮏﯿﻧﻭﺮﺘﮑﻟﺍ, 
: 
ﻪﺘﺳﺩ: ﻁﻼﺘﺧﺍ, ﮏﯿﻠﮐ
ﻥﺪﻧﺍﻮﺧﻂﻘﻓﻪﻈﻓﺎﺣ: 
: 
ﯽﻨﺘﺴﺑ: ﺦﯾ, ﻡﺮﮐﮓﻧﺭ
: 
ﺖﺨﺗﺐﻟﻑﻭﺮﻇ: 
ﻩﺪﻨﻨﮐﻡﺮﮔﺮﺳ: ﯽﻣﺮﮔﺮﺳﻭ​​ﺢﯾﺮﻔﺗ, ﺪﻨﻣﺮﻨﻫ
ﯼﺍﻪﻓﺮﺣﻭﯽﻨﻓ: ﺺﺼﺨﺗ, ﻪﻓﺮﺣ
ﻩﺯﺎﺗ: ﺕﻭﺍﺮﻃﺎﺑ, ﯽﮔﺯﺎﺗﻪﺑ, ﻪﺸﯾﺭ
ﻦﺘﻓﺭﻻﺎﺑ: ﯼﺩﺭﻮﻧﮓﻨﺳ
: 
ﻥﺎﯾﺩﺍﺭ: 
ﻢﯿﺑﺭﺍ: 
ﻥﺩﺭﻮﺧﻢﺴﻗ: ﺪﻨﮔﻮﺳ, ﺮﯿﮕﯾﺎﺟ
ﮎﺰﺑ: 
ﻝﺩﻮﮔﺭﺩ: 
: 
: 
ﯼﺪﻨﺑﺮﮑﯿﭘ: ﯼﺭﺎﺘﺧﺎﺳ
ﺮﺘﻣﯽﺘﻧﺎﺳ: ﺮﺘﻣﯽﺘﻧﺎﺳ, 
: 
ﺏﻮﺧﯽﻠﯿﺧ: ﺮﺑﺍﺮﺑ, ﺭﺎﯿﺴﺑ
ﯼﺩﻭﺯﻪﺑﻩﺪﻨﯾﺁﺖﻔﺳ: 
: 
ﺖﯾﺎﺑﺍﺮﺗ: 
ﻪﻠﺑﺎﻘﻣ: ﺩﺎﻀﺘﻣ, ﻪﻠﺑﺎﻘﻣ
coreference: 
ﺮﮑﻨﯿﻟ: ﯽﮕﺘﺳﻮﯿﭘ
: 
ﻪﻓﺎﺿﺍﻑﺮﺣﺩﺭﻮﻣ: ﯽﻠﻋﺎﻓﺩﺭﻮﻣ
: 
ﻪﻨﻣﺍﺩﻡﺎﻧﻢﺘﺴﯿﺳ: 
ﺎﻬﻨﺗﻞﻤﻋﻞﻌﻓ: 
ﻢﯿﻧﺎﺘﻧﻻ: ﻢﯾﺭﻮﻠﺗ
: 
ﻥﺍﺰﯿﻣﺯﺍﻩﺩﺎﻣ: 
: 
ﺭﻭﺩﻩﺍﺭﺯﺍﻩﺪﻨﯾﺁﺖﻔﺳ: 
: 
enumerativeﻪﮐ: 
: 
ﻥﺩﺯﻑﻻ: ﺵﺎﭘﻭﺖﺨﯾﺭ
ﻊﯿﺳﻭ: ﻥﺩﺮﮐﻦﻬﭘ, ﻦﻬﭘ, ﺽﺮﻋ, ﻪﺷﻮﮔ
ﯽﻓﺩﺎﺼﺗﯽﺳﺮﺘﺳﺩﻪﻈﻓﺎﺣ: 
: 
ﻩﺭﺎﻤﺷﺭﻭﺎﻨﺷﺰﯿﻤﻣ: 
ﻝﺎﺳﺪﻨﭼ: 
ﮓﻨﯿﺸﯿﻓ: 
: 
ﻪﺘﺷﺬﮔﻝﺎﻌﻓﺮﯿﻏﯽﻔﺻﻭﻪﺟﻭ: 
ﯼﺰﮐﺮﻣﺵﺯﺍﺩﺮﭘﻝﺎﺣﺭﺩﺪﺣﺍﻭ: 
ﯽﻧﺎﮑﻣﯽﺘﯾﺍﺪﻫﺩﺭﻮﻣ: 
ﺍﺭﺮﮑﻣﻪﺘﺳﺍﻮﺧﺶﺳﺮﭘ: 
