hnit	infinitiivi
hnak	nominatiivitapaus
hkak	akkusatiivitapaus
htak	aihetapaus
hpap	isä
hmam	äiti
hyat	vanhempien
hcan	Hei
hwik	vocativetapaus
hsuc	kantaisä
htat	isovanhempi
hcac	nälkäinen
hnik	genetiivitapaus
hcit	adjektiivi
hwan	ja
hman	minulle
hnan	sinä
hwam	meille
htit	se
htac	määränpäätapaus
htik	datiivitapaus
hyit	REALISmieliala
htim	deonticmieliala
hcut	ehdollinenmieliala
hsit	episteemisetmieliala
hyak	instrumentaalinentapaus
htan	sisustakonteksti
hpan	henkilökonteksti
htin	riippumatonlauseke
hyan	riippuvainenlauseke
hfap	perfektiivinennäkökohta
hkat	ohijännittynyt
hnin	maskuliini-sukupuoli
hmak	komitatiivitapaus
hnat	esittääjännittynyt
hpak	benefactivetapaus
swik	essiivitapaus
htut	negatorykvantisointi
hsan	pinta-konteksti
hpin	adpositionaltapaus
hwin	sijaintitapaus
hkan	tilakonteksti
hnac	tapatapaus
hyut	kysyvämieliala
hnam	jatai
hkit	XOR-
hsuk	lähdetapaus
hpik	ablatiivitapaus
hcat	läheisyys
hmat	demonstratiivinen
hkuk	lausekehännän
hlan	mutta
hsut	kaikki
hyin	yleismaailmallinenkvantisointi
hcin	naisellinensukupuoli
hpac	monikkomäärä
hyik	yksi
htic	niiden
hkik	Kuka
tcat	tulevaisuusjännittynyt
hsin	sosiaalinenkonteksti
hkac	milloin
hmip	imperfectivenäkökohta
klan	siellä
hlak	suhteellinentapaus
hlik	illatiivitapaus
htam	direktiivimieliala
hlat	valinnainenkvantisointi
hkam	mitä
hwat	kysymyssana
htap	copula
hpat	henkilö
nyan	uros-
hkas	voisi
tcan	muut
hnuc	määrä
twit	itsevarmakvantisointi
hsak	aikakonteksti
htuk	ajallinentapaus
htun	vain
htum	hortativemieliala
hyip	takautuvanäkökohta
hlit	tahallisuuttamieliala
pcic	täytyy
tyut	kaksi
hsat	nähdä
hkut	tietää
hcic	alas
hcap	jälkeen
hpam	ensimmäinen
hlac	riistäähallinta
hkap	eiikinä
hnic	luovuttamatonhallinta
tyat	vanha
tcit	neuvottelevamieliala
tcin	päivä
hlam	tulla
hwak	vokaali
hkin	mennä
lwak	perlativetapaus
hpip	etenevänäkökohta
lyan	pitkä
hsac	sanoa
kyan	miten
htas	uudelleen
hsic	tässä
hcik	ajatella
hcak	allekonteksti
hfan	löytyi
hsun	käsi
hyac	myös
nwan	nuori
tyit	vastaan
tlan	jumala
twak	delativetapaus
hmin	eimitään
hyas	kerran
hlap	semelfactivenäkökohta
kcac	vasen
hyic	saha
hcas	talo
hwac	maailman-
tyin	kolme
hnun	neo
hcuk	fokus
pyan	rakkaus
hsis	aina
hyam	yö-
hyap	kuningas
hkic	välillä
hmas	mieli
cyit	sydän
pluc	paucalmäärä
kyik	koska
ksak	kausaalinentapaus
tcun	tehty
hnim	nimi
tsan	asianmukainensubstantiivi
klac	maa
hpun	pyysi
cyat	näkyvätodistusarvo
pcac	paremmin
hmac	hetki
hnas	eipysty
hwic	vesi
twim	desiderativemieliala
kwan	valo
tlat	sana
tyan	ovi
hsas	aamu
syat	asti
twik	terminativetapaus
hpit	valkoinen
pcan	raha
hyis	huono
mwan	kuolema
hfam	muoto
nwik	inessiivitapaus
kcat	yhdessä
tsac	usein
pyat	ystävä
psan	puoli
hpim	pakottavamieliala
hyuc	pyöristää
hfat	lähetetty
hcis	vaimo
kcan	uskoa
hsik	julkinen
htus	osavaltiokonteksti
hpas	poika
clat	lapset
tyak	siten
cwan	toivoa
syin	rakas
hkuc	korkea
tyac	lukea
syit	kaupunki
hlic	jo
hfit	factivetodistusarvo
tcac	tyttö
hcun	kuulla
ksan	vähiten
hyaf	ehkä
kyat	todellakin
tcic	elin
hwit	palata
cwat	ilma
hfaf	laki
hput	auttaa
lyat	kirje
ksas	neljä
hpic	optativemieliala
hfuk	antaapotkut
hcam	tunnin
twat	sota-
kyak	useat
tlit	toinen
pcin	takana
hmut	menetetty
clan	tuhat
hfac	perhe
twan	sielu
hwas	kysymys
syan	totuus
htis	tehdä
tsat	mahdollinenmieliala
lwik	allativetapaus
nyin	ihmisentoiminnastasukupuoli
hfak	viisi
tcak	samaaihemerkki
htuc	eriaihe
hnap	vastaus
hmit	meri
hcuc	pelko
pcat	ymmärtää
syas	ehdot
hcaf	epäillä
twut	dubitativemieliala
hkis	musta
tlak	tuoda
hyus	kaunis
nyit	järjestellä
htip	kymmenen
ksis	tarina
hpuk	kirja
hlin	elektroninen
hkun	tili
lyas	kiinnostaa
lyit	kirjoittaa
pwat	vuode
hnis	ikä
hnut	vaihtoehtoisenehdollinen
slas	taide
hwis	Vialistapaus
pyak	veli
lyin	linja
tyas	taulukko
hyun	joki
kyac	silmä
tfan	yhtäkkiä
kcin	syvä
hmuc	tarkoitus
cyac	veri
hmap	ruusu-
tlin	kylmä
hyif	eteenpäin
tyam	myöhään
hnaf	olettaa
hkip	lähes
myan	minun
tsin	tuntemus
hkup	kopioida
hsam	aviomies
hlis	kuusi
cwit	elävä
cyan	rauha
myat	muistaa
tyic	luonnollinen
hfut	pudota
swas	palvelu
hsap	paitsi
pcit	tekijänoikeus
hyim	armeija
kyas	hevonen
plic	tulevaisuus
pcak	länsi
hpis	maksaa
hyuk	punainen
hwun	kulta-
twin	halu
plan	pelata
hpus	toimisto
syun	hallitus
kyic	kirkko
htaf	vahvuus
hlun	pituus
kyin	yritys
kyis	paperi
mlan	todennäköisyys
hcim	erityisesti
cyas	karhu
twac	ikkuna
nyat	kauneus
hcus	jälkimmäinen
htup	tulli
htif	etäisyys
pyas	jalka
hlas	villi
ksin	vihreä
hmaf	vaivata
myac	hymy
hsim	nukkua
kyit	lainattu
kwik	quotativetapaus
fwan	vierailla
slan	seurata
psit	läsnäolo
hmic	makea
hmuf	suu
hfin	rikas
tcam	vihollinen
psuk	rikki
kcap	laiva
pwan	täydellinenhenkilö
hfic	vaikutus
tcuc	näyttää
hkim	salaisuus
pyin	Olehyvä
pwit	precativemieliala
pyit	kohteliasilmoittautua
cwak	paha
myak	maaliskuu
tcas	paikkoja
hlaf	pysyä
psat	sensijaan
nlan	sininen
psac	mahdoton
kcuk	koulu
kcit	naimisissa
kcak	ruoka
syis	kaksikymmentä
tlac	hiljainen
hcip	mahdollinennäkökohta
kwin	antaminen
tsit	pysäytetty
pyac	kieli
hsus	viikko
hcup	sali
cyap	ihme
tfin	syntynyt
fyat	tuomioistuin
hnip	genomisennäkökohta
tsak	kunnioittaminen
tlas	arvoinen
syuc	puu
plat	seinä
cyak	taivas
twip	inchoativenäkökohta
mlat	komento
swit	jussivemieliala
mwas	kuukausi
hwaf	täydellinen
tyap	kokea
ksac	olosuhteet
syac	tuore
hnuk	herttua
kwak	katettu
tyuk	itään
pwac	kivi
hkif	jalo
nyac	suunta
cyis	tuoli
tyuc	odotus
tsun	kylä
tyik	ollasamaamieltä
hnum	sallivamieliala
slak	menestys
tsic	yrittää
slat	mäki
hmik	musiikki
hkus	itkeä
hsip	seitsemän
hpaf	yksityinen
nwas	uutiset
tfac	näkymä
fyan	puutarha
cwas	alkaa
hfik	jakelutapaus
lyac	oppia
syik	poliittinen
clin	henri
cyin	valhe
tsas	heittää
cyik	auktoriteetti
tlap	lattia
cyam	kesä
tcut	uskonto
tcap	paeta
hlut	kirjailija
pyun	ruskea
tcuk	kipu
swan	kevät
hmun	pehmeä
kyun	nurkka
nyak	tavaramerkki
tsis	oikeudenmukaisuus
psas	tuottaa
cyaf	nauraa
hwut	unohtaa
hyup	Eurooppa
hwap	kahdeksan
psak	ohimenevä
kyap	kauhea
pyic	edellytetään
hmim	keskikokoinen
hsaf	hengitys
hmis	viisas
hsum	omistushaluinenmerkki
ksat	miellyttävä
ksit	hauta
tsap	saari
kyam	leiri
tcum	koskettaa
cyun	onni
psic	ranta
tyun	verkkotunnuksen
mwit	commissivemieliala
tlut	aste
myit	talvi-
kfan	käytös
slac	juoksu
myin	minuutti
tyip	johtaa
klas	lasi-
pfat	lauta
cyic	turha
swam	asiat
syam	turvallinen
tsut	lääkäri
hlip	completivenäkökohta
kcas	pimeys
nyun	lämmin
hpuc	juoda
tlam	esimerkki
hfun	suututtaa
tsik	huolimatta
tsam	suoraan
hmup	hattu
klak	koira
slin	hopea-
swac	palvelija
kcam	ylpeys
pyik	kouluttaa
myut	moraalinen
syak	astua
swat	miekka
kyuk	hyökkäys
clac	terveys
tyaf	kohta
swic	sosiaalinen
tfit	maksunpalautus
hkaf	virallinen
pcas	silmäys
nyam	kunnia
tfat	kaksitoista
pcut	kihloissa
pwin	viini
mwat	maku
fyac	rauta-
syap	jakaa
myap	käydäkauppaa
hyum	käyttämällä
fwak	tuomari
klat	kapteeni
twap	lakkaaminennäkökohta
kcic	utelias
kwic	ulkomainen
hnif	vahvistussana
myun	merkitys
tlic	vihdoin
cyuk	kaula
syut	vapaus
pfan	sivut
kyuc	kuiva
pcap	syrjään
tfak	todistusarvo
tcik	todistusarvotapaus
twun	kaukainen
tyis	edistyminen
nyap	kapea
plit	rakentaminen
hpif	sivu
pwic	pitämällä
syic	surullinen
tsip	synti
syim	sairas
tcis	rehellinen
pcun	pankki
ksap	hyväksyä
lyam	virta
tcaf	huolellisesti
kwac	korva
hpup	leipä
kcut	valita
nwam	eläin
hsup	ZoicKahvisukupuoli
nwit	eventivemieliala
tcim	samatapahtumamerkki
tlik	multiplikatiivinentapaus
kyus	ylittää
hmus	paksu
kfat	uskaltaa
nwat	kasvaa
myic	sade
hpum	pinta-
swut	pyhä
clis	heinäkuu
mwun	muoti
hfas	tiedosto
cwac	olkapää
kwat	mukavuus
nwac	kukaan
tcip	haluttu
kfac	ruoho
hmuk	piirtää
plin	aukko
kwun	kesäkuu
mlik	kalastaa
klin	pääoma
pfut	rinta
twam	väite
fyin	kulu
nlit	sinun
mlin	miljoona
pyut	rukoilla
hluk	väsynyt
ksut	tappaa
cyut	varjo
psin	paino
kcis	harmaa
pyam	rohkea
mwac	vakuuttunut
klam	kertominen
ksam	kansallinen
hfip	heikko
klik	laakso
hkum	keinottelevamieliala
clas	keltainen
cyuc	lämpö
mlac	jäännökset
syip	yhtä
pwak	laatikko
tcif	terävä
psip	periaate
ksik	seuraus
tsim	kausi
flan	tiede
pcam	ilmeisesti
kcun	porausreikä
ksuk	setä
mlit	lista
pcik	vaarallinen
kwas	elokuu
hluc	suosittu
klit	tuntematon
flak	tuttu
fyit	tuttuilmoittautua
lwat	lukija
plun	kävely
twas	kahdesti
pcis	pappi
fyas	haavoittunut
nlat	palatsi
myuk	typerys
pfak	suosia
tcuf	yhdeksän
cwap	myötätunto
plac	räjähtää
pyap	laskemisesta
lyic	pukeutunut
hcum	melu
lwit	kirjallisuus
tsuk	arvo
hfup	myrsky
kcik	tasku-
nwap	marraskuu
tyim	joulukuu
psaf	poissaolo
nlac	väestö
kyaf	kiittää
slis	sarja
pyaf	lintu
mlak	omistaja
kwut	takki
hwuc	suhteet
pyis	nopeasti
twuc	polttaatupakkaa
nwak	tammikuu
mlic	kone
tlis	hampaat
ksun	palaa
clam	häpeä
klaf	laatu
clit	rengas
fyak	lauseke
fyam	lausekemerkki
kwap	neliö-
hwip	sunnuntai
psis	runous
pwut	ennaltamäärätty
kyim	ostaa
clic	kentät
pyip	huhtikuu
kfap	lokakuu
psut	esineet
kcuc	katkera
nlap	orja
hsok	löysä
htet	teksti
hbat	pahin
hrit	luotto
hzit	ominaisuudet
hpet	viisitoista
krac	julma
hduc	pöly
hrik	käytännön
hron	väri
hnus	nenä
hric	ystävällinen
srik	toimittaa
hten	eilen
tlet	hesternaljännittynyt
slap	epäonnistua
hban	pitääpäällä
hdat	sokea
fran	lentää
hdan	paholainen
htec	vähitellen
hmon	tehtävä
cran	uhrata
hran	omatunto
hmos	ministeri
nrit	energia
hcet	vihata
hset	keskusta
hrin	järkeväsukupuoli
hcot	nauttia
hrip	lyhyt
htep	palvonta
hcif	iho
hrat	katto
kran	kruunu
hkon	linna
tran	epätoivo
hmif	maili
trin	ympyrä
hgin	vankila
hkop	kuppi
hcen	jäsen
swin	siviili-
hrac	kaikkialla
hris	asiakassuhde
hbin	tulossa
hmot	liha
hdut	maito
hwen	kasviperäistäsukupuoli
nran	harvinainen
hbac	serkku
crut	silta
hsoc	kalusto
hsom	suolaa
nris	viaton
hbit	välttää
crin	ihailu
rwin	kuningatar
hgut	laskea
hdas	tanssi
hnot	hotelli
hdin	täyttää
hton	vanki
hdak	myymälä
hlet	portaat
hson	Anteeksi
hgek	homo
hras	hiekka
hsep	syyskuu
hbic	pilata
hlen	lisenssi
hcon	riittävästi
hgit	todistaja
kfon	keittiö
hbak	myydä
tlim	hoito
hsot	nopeus
kyut	tietokone
hnen	ikuinen
htek	kirjasto
hzan	sisältävä
hbis	pohja
hbun	sekaannus
kcus	kokki
hgat	aavikko
hwus	suudella
hbif	jää
hbot	pallo
hrut	perustelu
hdit	siunausmieliala
hdis	syyllinen
hjan	rankaiseminen
plis	valvoa
hgan	piilottaa
hsen	retkikunta
nrin	oppimaton
hyen	pilvi
frif	helmikuu
hdik	tauti
hnek	aloitetapaus
hbam	täti
hmen	nöyrä
hdip	myöhässäpakottava
prat	raportoitutodistusarvo
hdet	keskiyö
hjit	sormi
hmoc	jonnekin
pran	lehdistö
kcec	alue
hken	viimeaikoina
hloc	surumielinen
hrak	henkilöstö
htes	tuijottaa
rwan	palkinto
hdon	lahjoittaa
htot	otsa
hnet	enkeli
hdun	yksikkö
croc	virhe
hlon	valjeta
hyec	lammas
hjin	kärsivällisyys
hrec	viite
mran	maissi
htos	enemmistö
hcos	toimenpiteet
hkoc	sillointällöin
hlif	voitto
clak	sokeri
hjat	ihmiskunta
tram	kehys
hdic	levy
hkok	yksinäinen
srat	taiteilija
crak	viehätys
hmet	email
hden	päätös
gran	kuvernööri
crac	haara
hjac	innostusta
hdim	induktiivinenmieliala
hcok	kiire
hyet	öljy
pwap	putki
trat	painaa
tcot	kiintoaineen
hdoc	Oi
hren	esitelmäkonteksti
tcon	keskipäivä
krin	hytti
plam	hälytys
hnes	hermostunut
tcen	havainto
hsek	näkökohta
plik	sovelletaan
slik	silkki
hfen	sentti
hgen	agentti
hnon	liitto
crik	helvetti
tcet	viallinen
mrat	sekoitettu
hdam	kehotusmieliala
hgac	kunnianhimo
htoc	jollakintavalla
hdac	neuvo
nwin	perustuslaki
srit	väline
hret	lujasti
nlin	verkossa
hzat	vuorovesi
klic	college
hkek	pyrstö
nric	sukupolvi
hgic	tungosta
hgak	kissa
trit	suoraantodistusarvo
tyot	sopimus
hnok	sisällys
crit	hylätty
slen	yksitoista
srin	vaisto
hpok	heimo
hyot	levotonmieliala
cric	suoja
hruc	töykeä
cwin	ratsastus
hzak	ravistaa
dyit	teollisuus
hpec	ammatti
nras	sairaanhoitaja
hcec	opetus
hbut	kengät
hmec	epämääräinen
twot	toimintaa
crat	lauantai
hkot	kapasiteetti
hnec	auringonpaiste
hwuf	leski
cren	vuodattaa
nrat	tähti
hget	vieras
hbik	siunata
brin	sisempi
hpot	saatavissa
trac	vastus
prac	johtua
hcoc	ontto
hpon	maakunta
hwim	sivistys
dwan	ripustaa
cwok	järkyttää
hdok	ajo-
crun	aarre
hzik	siemen
hrot	viimeaikainenohijännittynyt
hket	hereillä
hcek	huonekalut
hrop	köysi
mrac	seikkailu
byit	juhla
trak	vuotuinen
hzin	eteläinen
sric	seremonia
clik	metsästys
trap	liberaali
hrim	kristinusko
hrus	prinsessa
blat	alttari
cyon	pienenpieni
hwep	verkko
krat	kardinaali
tris	violetti
kcot	kerätä
hben	vaalit
trik	humalassa
kfit	hissi
tcec	vaihtaakeskenään
nrik	selväartikla
grat	keisari
dran	hallinto
hpen	aiemmin
cluk	ruma
nrac	harmiton
ryin	koulutus
hrun	rulla
nwic	tuuma
slit	ammu
gzat	sanomalehti
krot	leikkaus
drit	parta
hzis	repiä
hdap	kahdeksantoista
sris	historiallinen
mrut	brutto
nyik	muta
bran	morsian
drat	riippua
djan	jättiläinen
glat	yksinkertaisuus
hpoc	syksy
pras	huntu
hgot	keräys
tret	teatteri
tras	vertailu
rwit	kilpailija
hfon	muodostavat
klot	valmentaja
hmum	huumori
drac	esitelmä
rwas	romaani
tset	kosto
hdot	distaalinendemonstratiivinen
ryut	mustasukkainen
hwon	kutsu
byat	palanut
flac	salama
prot	muotokuva
crek	ehdottaa
htok	konflikti
htop	kirous
prit	imprecatorymieliala
hces	avuton
klup	maila
hnos	tulva
dwin	välinpitämättömyys
prin	horisontti
mrit	assumptivemieliala
tcoc	jyrkkä
hcom	harmonia
grit	ukkonen
tlot	lapsuus
hgik	polvi
hwes	tajuton
hzac	keskinäinen
hsec	ohjelmisto
tson	laitokset
ryit	kuitti
dlin	kuri
slip	lipsahdus
klon	vallankumous
hfim	maanviljelijä
hpom	foorumi
cyen	opiskelija-
hgec	luola
hroc	perinne
srac	esittää
ryat	tragedia
kcen	neitsyt-
hbap	jäähyväiset
krik	kritiikki
krap	puuvilla
fwat	sairaala
kcet	vuokrata
hgas	kaasu
pfin	väistämätön
dlit	lehti
ryan	käännös
sran	hautajaiset
mrin	jauhot
hram	romanttinen
dlan	dollari
hzas	pila
hsos	kuusitoista
klen	siirtomaa
gyin	siipi
hsif	leijona
cluc	ovela
prip	valmistelu
hzut	sumu
dwat	lääketiede
krit	lukeakorjausvedoksia
sras	pesä
hses	neljätoista
brat	vastalause
flat	happo
hjic	nimittäin
slic	ase
hbuc	käyttäjä
tron	oranssi
byan	kylpy
hrif	primitiivinen
tlip	perustaa
blan	kori
kris	sihteeri
hyon	sillävälin
tren	tänään
dlat	hodiernaljännittynyt
hzic	myrkyttää
tfic	kivääri
tlen	lahjakkuus
hlim	ilmasto
dyat	perämies
kcon	ilmestys
dlac	pestä
krak	tunnustus
hbas	järjettömyys
hkec	kivihiili
hrek	palauttaa
hkos	kanootti
hwif	vara-
tric	väliaikainen
hdep	delimitativenäkökohta
mwak	kasa
ksot	luu
hnoc	maanantai
nlas	tiistai
brac	keskiviikko
frap	liittovaltion-
pfit	edustaja
pcoc	napa
lyen	liinavaatteet
swak	pesuallas
pcen	presidentti
brit	verinen
hwec	piiritys
hwet	vatsa
hlos	yläkerrassa
hbon	vaihteleva
pcon	messinki
hsem	huippukokous
lwac	halpa
tsos	kilpailu
kwen	yksinomainenhenkilö
trun	lasku
trut	patsas
hrap	tykistö
hgap	pidätys
trot	lämpötila
grin	naapuruus
hjak	omaksua
hpek	pakata
hlus	peura
hwos	makuuhuone
tsuc	pensas
pcuc	päästö
cris	perillinen
clun	tammi-
hpes	epämiellyttävä
nlet	keskeneräinen
hrom	ohjelmoida
pyon	piano
swet	suostutella
dric	näkymätön
tyen	tunnettu
hruk	julmuus
frat	määritetty
hyoc	houkutus
hlep	telicnäkökohta
nrot	kansainvälinen
nret	väkivaltaisesti
hfif	filosofi
pfic	edustus
hmek	herkkä
hfec	hyvinvointi
myik	kalastus
truc	varastaa
tcop	huuli
rwic	jäädäeläkkeelle
htom	talous
glan	galleria
pren	yhdensuuntainen
hlek	atelicnäkökohta
nrak	maanosa
truk	lyödä
hjim	ehkäisevämieliala
rwat	solmio
hcep	solu
dyan	muna
jrat	keinotekoinen
nren	inspiraatio
ksic	kriisi
tsoc	etsiä
lwan	lounas
hpos	mänty
hcuf	Työnnä
tcus	haastaaoikeuteen
pset	pidentää
hkep	kupari-
swis	merimies
prim	keisarillinen
trip	ruoska
cras	paita
swap	lakaista
syet	luonnos
htof	varas
clen	kanava
kwit	persoonallisuus
klok	ylimäärä
hrok	uudistaa
hguc	jano
kcim	uhkaava
hpem	palmu
psik	kaiutin
frit	kynnys
cret	jälkiä
mrak	keihäs
syen	istunto
tcup	kostea
hyek	matkustaja
trim	tina
plak	valitus
hyok	kulma
hgam	lehmä
hmok	mylly
jrac	kartta
kloc	kaulus
gyit	tarkoituksella
hbip	olut
mlet	sametti
lyap	väärinkäyttö
cwen	parvi
bwan	veljentytär
tses	kolmetoista
jrit	perustella
nlak	käsikirjoitus
sron	soturi
cruc	perjantai
broc	harjata
dlot	download
krim	kerma
pric	piki
prut	tuomaristo
hgon	jäädytetty
sram	kirjaimellisesti
pfot	pannu
hlot	suunnitellut
djin	kolikko
hlok	harppaus
hpep	omena
hwot	kierretty
dlak	pohtia
brik	merkitä
nlis	litteroida
hbet	veto
pris	virus
hjik	vieraanvaraisuus
blit	lapsellinen
hjap	kaapu
tfik	heijastaa
hdaf	saavuttaa
hpop	ooppera
kcaf	piilossa
kcoc	kyynärpää
hrum	korjaus
cyim	epäilyttävä
dyic	koulutus-
hgoc	kuoppa
drak	häiriö
plas	suosionosoitukset
byin	binaarinen
hzap	luostarikirkko
nlot	uskollisuus
mrik	mekaaninen
hsop	onnistuneesti
crap	ansa
kyek	kakku
nrut	viihdyttää
syes	sir
hjet	seitsemäntoista
hjen	naisellinen
hmom	hunaja
hdec	valitettavasti
lwen	legenda
slot	liesi
frac	kapinallinen
gwan	turvota
mruk	parantaa
swot	suo
zlan	ansaita
hnem	eloisa
hdes	pukeutuminen
prak	saarnata
frin	maisema
hfet	vastustaa
cros	kertosäe
ryon	järkevä
tcos	sato
tsen	jalostus
hwek	susi
nlik	epääminen
klap	matto
dras	halveksia
prop	hedelmällinen
slim	pilli
hgis	juusto
krut	purra
srot	saattaja
bjan	vaeltaa
nwen	laivasto
myas	naamio
kwaf	kehittää
twis	ohjaamo
pcip	lyijykynä
srap	vihannes
sren	näyttely
tlun	housut
hrup	korruptio
nrip	kaappi
srup	keitto
jran	kirurgi
bjat	avustus
gyat	vakooja
hlem	holtiton
srak	abstrakti
kson	aksentti
cwis	torstai
sret	vilpittömästi
hraf	liikenne
hres	arkkitehtuuri
hsuf	hävittäminen
rwak	crack
twon	ornamentti
hfus	elpyminen
hkom	koodi
djat	metsästäjä
nlut	tiedote
hsef	käärme
mris	demokratia
bric	akku
mlam	vaha
zran	jakaminen
cron	jännitys
hzen	uida
traf	kaistale
cwaf	kirjekuori
srip	savuke
mrot	moottori
swon	vapaaehtoinen
ryak	reaktio
pfun	osittain
blac	matkatavarat
mret	ministeriö
hjon	seksuaalinen
kcok	kirves
dram	timantti-
kren	vaihtoehtoinen
tcek	kaiku
hdif	identiteetti
tfas	suurlähettiläs
hfot	muodostuvat
lwas	laiska
hmep	momentanenäkökohta
kfin	koodaus
mwin	kuvitteellinen
hrem	säde
pram	kiipeily
byac	kellari
mren	mieleenpainuva
swen	senaatti
kras	ruumisarkku
hgun	niellä
nlok	langeta
ryic	maatalous-
gwin	swing
srut	niitty
hkes	monimutkainen
hfis	eroaminen
frak	toistuvasti
hnom	salaliitto
hcop	pub
hlec	pippuri
mlot	melodia
zrat	ehdokas
proc	suojelija
flik	kettu
cyet	pahoitteli
hgim	savupiippu
slet	hedge
tcok	tarkkuus
bjit	entinenkuollut
brot	nuppu
bwat	viltti
hdus	sika
gwat	norsunluu
kret	ote
nwet	tarkkailija
jwan	katu
nwis	kynnet
mwic	mehiläinen
bzat	näyttelijä
gyan	hiki
zyit	johtaja
blic	illuusio
pcet	epävarmuus
tsot	taittaa
bwit	raja
tres	korostaa
hkof	kulutus
nyen	notkua
hles	muistuttaa
cyek	säkki
hjis	neula
gjan	ilmiö
prec	käyttäytyä
drot	ohjattu
kcek	käyrä
twic	kana
brak	tynnyri
zwat	tavanomainen
clap	tavanomainennäkökohta
tsec	asiantuntija
bwin	tehdävaikutus
cwet	jotarajoittavat
hbek	leipuri
zlin	oliivi-
mron	pakettiauto
drin	omistaa
psap	paljastaa
gjin	syntymäpäivä
clut	vasara
cwun	tuoksuva
twaf	triviaali
pcot	lemmikki-
krok	kallo
dlik	lainsäätäjä
cwic	onneksi
srun	rypistääotsaansa
crec	tuhoaa
jlan	marginaali
kcip	mestari
blin	miljardi
ryik	kemiallinen
mlas	pulssi
flit	lentäjä
hzet	solmu
cwik	majesteettinen
twet	hame
mwik	viikoittain
tfis	tekninen
tlon	ajoneuvo
cram	mairitteleva
grac	vahvistaa
kraf	varis
trup	ominaisuus
hduk	koukku
cruk	tiikeri
nrap	taloudenhoitaja
crot	valtatie
mlip	miliisi
hfoc	valokuva
nres	eheys
plos	plus
tfam	läpinäkyvä
nlic	yhdeksäntoista
hwok	pätevä
nlen	essee
fyic	tehokkuus
hwuk	ainutlaatuinen
hgok	orgaaninen
flic	teologia
flot	kellua
hboc	velvoittaa
hwoc	noita
syot	studio
cwip	samppanja
hbes	lippu
lwic	avioero
blot	pultti
cwot	vankeus
cwam	suoni
prik	passiivinen
hfum	vaahto
grik	sora
zrin	esiliina
gren	planeetta
hfuc	ylösnousemus
claf	hylly
flas	tuuletin
hjot	trooppinen
hbim	mielivaltainen
krek	elohopea
hbec	hyväntahtoinen
tsaf	itsemurha
pwas	nyppiä
plot	reportteri
kfak	kuluttaa
blak	parveke
hdos	tahra
kwis	klassinen
kcos	moittia
psen	eläke
kres	verbi
hzon	apina
srim	allekirjoitus
glin	haluttomuus
mlut	pahamaineinen
myot	tuodamaahan
fwac	perustaja
troc	soihtu
hgaf	kielioppi
hyop	jahti
ksip	Sukupuuttoonkuollut
sres	retki
hnup	kupoli
hzun	itsepäinen
mric	lihas
gjat	suuruus
hros	hieroa
zrac	raukkamainen
tros	malja
myus	hiiri
dwac	vuoropuhelu
byak	vuohi
htef	räätälöidä
hfek	kukoistaa
dzan	määrätä
nyon	anonyymi
zrit	muodollinenilmoittautua
pcos	urheilu
hjec	sulaa
dlas	poistaa
mras	sateenvarjo
mram	mineraali
cwut	aselepo
hbok	ankka
swun	saippua
dwak	nukke
plif	huvila
slon	ompelu
tfut	onnitella
djac	sovittaayhteen
hjas	tukahduttaa
kric	kani
kwot	kapellimestari
gzan	takuu
clot	pelaaja
ksek	hyönteinen
psam	ryhti
mwut	pöllö
htem	vakinaisesti
clon	viulu
dzin	asukas
rwim	vastaavasti
hyof	suotuisa
dron	lohikäärme
dwit	auditiivinentodistusarvo
sroc	vientiä
hzot	päättyminen
djik	viipyä
kfik	kansi
ryun	säätö
hmes	pormestari
rwac	laitteisto
sruk	sirkus
sros	vähemmistö
bzan	mellakka
kset	orkesteri
bjon	pekoni
hjut	rajoittamaton
tfen	puolustavat
zwac	haitta
dyin	keskustelu
myis	muusikko
mlis	henkisesti
pret	riittämätön
tsek	arkkitehti
hlom	sitruuna
ksos	yskä
crok	päänsärky
flin	hedelmällisyys
mrun	puuseppä
swec	satunnainen
syuk	lusikka
blun	ilmapallo
tcep	liitu-
fric	virvoke
rwik	pystysuora
rwen	ehkäistä
flet	inferentialtodistusarvo
pfac	kustantaja
srek	etikka
tfun	tunneli
pwet	palapeli
gyik	matematiikka
fwot	häivyttää
lwin	tasapainoinen
jwin	maksa
bwik	sublativetapaus
hdup	sukeltaa
hnop	monopoli
bwic	sukellusvene
ryen	riippumatta
hcem	maanjäristys
hbos	laboratorio
nrek	työntekijä
ryim	rytmi
nyic	tulkita
dwas	suurlähetystö
rwok	provosoida
kram	kykenemättömyys
ksim	declarativemieliala
clok	suklaa
pcec	etuoikeutettu
nyis	erakko
tyoc	sattuma
grak	naarmu
zlat	käsine
hjuk	polvistua
trif	maantiede
djit	systemaattinen
pson	voittamaton
mwis	investointi
cwec	sanallinen
hdek	maallinen
blik	haukka
sloc	psykologia
brap	romu
jlat	merirosvo
dros	annos
slam	lohi
pwun	vanukas
gwik	magneettinen
pcop	pumppu
myen	samoin
ksen	happi
mrap	työnjohtaja
tfot	todistus
ksus	rykelmä
trok	retoriikka
tloc	askelma
zyan	airo
nlun	Kirjaudusisään
hlop	teleskooppi
jlin	oikeinkirjoitus
lyut	pilvinen
hsof	aallokko
fyik	viski
klet	suhteellisesti
hwof	paju
hlum	kameli
myet	amatööri
klis	eristäminen
hbaf	elämäkerta
gwac	aasi
hwum	huhu
pwik	näkökulma
pron	ammattilainen
myes	kuukausittain
mwen	haaveilu
kfic	loma
klek	napsauttaa
cwon	soikea
lyak	joustava
kwon	sanakirja
hjam	kinkku
rwon	sateenkaari
crip	täten
zwan	esiintyviä
srok	pääkirjoitus
craf	ruumiillinen
tlok	säiliö
brip	perhonen
tfap	kartoittaa
jwat	twin
pros	käyttö-
psun	enne
clet	kurjuudessa
hbus	bambu
dyas	kauppias
klun	kertymä
jlit	yksimielinen
hdom	painajainen
kron	hiili
hzam	hillo
cyot	kuuntelija
hmem	museo
lwam	aakkoset
fras	hajottaa
psoc	booli
hgum	purukumi
brek	jarru
glit	vakavuus
frun	laho
gris	aggressiivinen
mroc	kitka
bzit	hämähäkki
plut	peruna
glac	ahneus
gzac	moninkertaistaa
prun	kierre
jlet	kalenteri
nyim	nimitys
tlos	biljoona
slut	salaatti
fwit	myöntävämieliala
pyen	sovellukset
nlon	nimellinen
dren	osoittaa
drun	tyytymättömyys
cyok	olankohautus
hfop	jalkapallo
ryac	kumppanuus
gzin	pioneeri
hgip	kaali
tyet	urheilu-
hdof	idiofoni
hwup	korvaamaton
lwek	vipu
syec	senaattori
jyak	majoittaa
mlim	muurahainen
fwic	tehokkaasti
gzit	raskaana
blas	riippuvuus
jrin	jokapäivä
gwak	nilkka
drik	omituisesti
prif	muuttuja
jwit	monimuotoisuus
krip	syrjintä
ryot	awed
nwut	jalkakäytävä
kcif	aktiivisesti
jrak	sammakko
twek	liiallinentapaus
psot	sovitus
pfon	sieni
sluk	orava
nlim	irrealismieliala
ksaf	niukkuus
glak	tulivuori
plen	tasapaino
kfaf	huivi
kyon	hyödyntää
jlik	geologinen
psop	passi
kfis	avointyöpaikka
fyon	affiniteetti
nram	moraaliton
hbuk	keksi
gras	transsi
hyos	levoton
flim	elokuva
plet	tabletti
rwam	atomi
blis	vanilja
zlit	aids
fyut	nirso
crim	pyramidi
hjif	laiton
crif	ujous
lwap	luuttu
tyon	tähtitiede
mrim	sokkelo
drut	kuvaileva
nrim	apuraha
kruc	kilpikonna
kwam	neuvonantaja
jrik	kriketti
dlut	tarkoittaa
pyot	kyyhkynen
dyon	sovittaminen
prap	operaattori
bzin	kunniamerkki
tyek	kolmio
trec	rahastonhoitaja
nron	vety
pyet	kirjoitin
tsok	tukehtua
zyin	krooninen
slek	polkupyörä
jyin	tekniikka
ryas	lähetys
zrak	virkistää
nyas	tanssija
gric	muutto
zlak	rikkoa
tces	tennis
hjun	tuulinen
twen	kutoa
kyet	keräilijä
gwit	selkä
kyot	sointu
fwin	taajuus
tfuc	kangaspuut
dlet	hakemisto
pfik	ajattelija
bjet	talousarvio
trek	strategia
kros	kvartsi
gjit	sakset
gwic	kytkin
frik	teoreettinen
tluc	pyyhe
pruc	partio
glic	jäätikkö
krun	täydellisyys
bjin	ennustus
tlaf	osallistua
tfet	valmistaja
bras	sivu-
dwik	vastaaja
clec	pakokaasu
cres	shakki
tcef	kirsikka
tcom	kompastella
nyot	Kääntäjä
tyok	kuorma-auto
cyip	verraton
grot	sinappi
bris	langaton
nlam	huutokaupata
slif	seula
hgos	ruoste
swoc	epävakaa
jyat	konkurssiin
slum	islam
hjes	väestönlaskenta
dzat	hiipiävarpaisillaan
slun	keskeyttää
nwot	jatkuvuus
gyic	kitara
pfas	puolueellisuus
zyik	sinkki
blen	kiiltävä
hyem	jalava
hnep	ryntäily
nyut	kudottu
ryam	pronominimerkki
clim	mauste
jret	terävyys
tfon	härnätä
jwac	Jaava
hrep	resepti
dyac	toimilupa
myip	metri
rwis	rodullinen
hkem	komeetta
nwon	innovaatio
zwin	kieltää
dyis	keskiaikainen
mrec	varpunen
fyot	alaviite
mlon	mittaus
pfis	ratifiointi
rwot	kiertorata
hfok	säästäväinen
glof	golf
zron	nolla-
hzip	postinumero
hwom	asunnoton
bjic	pureskelua
pcim	täyttää
hjip	siru
bwac	haukotus
mlos	mooli
mrip	keramiikka
bron	alkio
ksoc	vähennys
cyum	hiiva
jyan	ammattikieli
plim	luumu
mwet	hautausmaa
ryet	valmistua
glik	kastelu
plap	kapitalisti
tsif	jousto
gyak	hai
djon	oletusarvo
nwun	täsmällinen
cles	realismi
dris	yhäuseammin
hkef	kahvila
blus	ambulanssi
blap	lompakko
bjak	hurmioitunut
klim	irvistys
gyac	tiedemies
jyit	mielentyyneys
dzit	realistinen
bwak	ulko-
dyot	radio
bwon	papu
fris	epävirallinen
klut	spekuloida
tfek	pihvi
nrok	typpi
zyat	partakone
bram	mutista
ryis	alustava
nlip	analysoida
nros	erottuva
hcof	riisua
tfif	kannustin
kroc	vako
hdum	juutalaisuus
pses	vastaanottaja
plok	täydentää
lyet	linssi
pwek	pegativetapaus
kfas	syöpä
pwen	sotilas
nrun	muistutus
clek	vuotaa
pcif	puolustus
glas	monimutkaisuus
zwit	puhelias
kces	riittävyys
crem	jälleenmyynti
grap	napata
kwip	puuttua
dyut	alennus
crus	hierarkia
gyet	jade
gram	sotkea
kyip	lisko
nyet	tyyny
crop	vesiputous
glon	gallona
mrok	hyttynen
fluc	sujuva
dwic	poikkeama
slec	tutkimusmatkailija
srec	päättyvän
blut	painia
myok	mosaiikki
tlek	pistoke
nruk	tarttuva
nwoc	tästälähtien
bjut	kyykky
hges	raskaus
twoc	ruokakauppa
kyos	kommunistinen
mrek	hämmästyttää
clip	katumus
pwok	prosecutivetapaus
dwot	diktaattori
zyac	huoli
jlic	satelliitti
slop	tohveli
ryip	verrannollinen
psim	lähentää
byet	työtön
cyop	harraste
rwun	kriteeri
blop	polttimo
syok	tukija
klos	kloori
lwot	kloridi
byic	bakteerit
lyik	tahmea
blok	biologinen
jlac	teeskennellä
bret	tavu
krif	eritys
blet	baletti
nruc	virtsa
tsus	valkosipuli
dyak	keskiluokka
tcem	pihdit
cyoc	haastava
trep	mansikka
dlun	saastuminen
hlup	albumi
hbep	baseball
praf	piratismi
pwis	partisiippi
grek	autotalli
kruk	kainalosauva
hfof	fosfori
rwut	rakenteellinen
myam	kuntosali
krec	nosturi
jras	urakoitsija
zrik	ilmoittaa
blam	tanssisali
klip	käsityöläinen
hwef	palkaton
zlac	banaani
gret	generaattori
lwuk	kylkiluu
nyek	nikkeli
blos	bussi
sles	sensuroida
tlif	laatta
kses	makkara
mwot	tomaatti
lyot	auto
tsom	kalium
brut	virtuaali-
djap	algebra
hjok	yleinen
kfen	käsitteet
pcok	optinen
bzut	perääntyä
syek	työttömyys
mruc	toukka
bwas	selain
klif	kalsium
rwet	kauko-ohijännittynyt
srif	historiallinenjännittynyt
hwem	spektri
syom	natrium
tyos	edunvalvoja
jyic	panttivanki
hguk	kurpitsa
dwun	rypistyä
swip	piikki
tlec	rasti
blaf	raiskata
tsem	ateismi
mloc	monitori
gyot	ehdollinen
trop	koetin
rwap	neljännesvuosittain
hjep	sukupuoli
pyim	platina
dlon	kaksois-määrä
pcep	keuhko
twuk	pesu
tyec	tag
syup	Super
trom	johdinauto
nyip	paikallisesti
glis	bensiini
gjik	munuainen
hjos	yksin
hjuc	ryöstää
swek	ylityöllistetty
psek	arsenikki
twok	tilastollinen
tsep	heinäsirkka
slos	sosialistinen
nwim	aisti-todistusarvomieliala
tlop	pöytäliina
trus	kiistanalainen
pwot	talutushihna
djot	sedimentti
nloc	tölväistä
mwon	mandariini
hjek	kuski
crom	tehdäyhteistyötä
myon	keuhkokuume
twec	sijoittaa
ryek	raketti
dlic	osinko
kwet	luistella
bwen	pakkomielle
plon	siirtolapuutarha
syon	huohottaa
djis	digitaalinen
byut	narttu
hyep	silmäluomi
dwon	diagonaalinen
byis	alitajunta
brec	kulmakarva
cyec	aivastus
hwop	watti
clus	hilpeä
kfun	käyttöaste
nwum	hindulaisuus
fyim	pakolainen
cwos	sukkula
tfoc	vihlaisu
pwon	proteiini
sraf	itsetyytyväinen
hbom	oksentaa
gyen	geeni
drim	fuksi
trem	varusteet
tsup	särkeä
slok	sosiologia
kwoc	squash
bwam	äänestäjä
mlok	liikkuvuus
kyen	alueellinen
hmop	liikeylämäkeä
rwek	takautuva
kfup	kuutio
grok	porkkana
drap	saadaansaan
lwis	molekyyli-
ksuc	kirjanpitäjä
tsop	haista
kyok	kurkku
nroc	vimma
jlot	liuotin
psof	fosfaatti
hgif	hurmata
kfim	emäksinen
psos	voimistelu
pfen	varmistus
kcom	ekonomisti
krom	pilkku
tluk	kiemurrella
hyom	jodi
nwuc	liikealamäkeä
gjac	keskenmeno
pcom	palko
dzic	suunnittelija
grun	bragging
dzot	luovuttaja
hzek	mangaani
kfot	näppäimistö
jlas	epäluotettava
lyim	eliitti
jyen	jeni
pcaf	sulkumerkki
rwip	Rugby
blip	raamattu
kyoc	syy-yhteys
lyon	haava
flis	taivutettu
nrif	napostella
kfam	kvantti
swes	villapaita
lwon	evoluutio-
drec	leikkely
gjap	kylpylä
lyec	lineaarinen
tyom	antimoni
pwuk	superessivetapaus
flaf	alpha
myim	immuuni
pcek	kaappaus
bjac	panimo
bzac	lyhentää
bzak	sukka
twes	televisio
dwut	dokumenttielokuva
ksom	maailmankaikkeus
lyis	metsänhoito
lwim	alumiini
ksok	horoskooppi
sruc	nopeuttaa
dlif	delfiini
byik	tappaja
tfec	paperitavara
hjaf	nisäkäs
ryok	protokolla
dwis	dioksidi
jlon	kaksoispiste
brus	byrokratia
gjak	galaksi
lyip	kliininen
ryem	radium
href	ohut
prok	jääkaappi
slep	satyyri
dret	iteraatio
kluk	arkeologinen
dlis	idiosyncrasy
kfip	mahdotonhyväksyä
mlec	hieronta
pfif	määrittely
nrec	aisti-
pfet	esite
hzoc	taustalla
dlam	ihanteellisesti
nlec	antropologia
kluc	maukas
dyet	sedan
tyif	transitiivinen
krus	kyyristyä
nluc	auringonkukka
lyun	ioni
zrot	luovuttaminen
ksif	väärentää
psif	emissio
crup	päällekkäisyys
fret	löytäjä
grut	inverttisokeri
ksec	luokkatoveri
jric	matkareitti
mrop	mikroaaltouuni
srus	syrjäyttää
gyas	kampaaja
floc	kansanperinne
plek	kapillaari
nwop	takapuoli
nrom	ohjain
twos	terrorismi
lwok	iskulause
dwet	ajanmyötä
slem	sublimoida
grip	grilli
gwas	Vau
kwok	koboltti
gwon	kaura
hdop	liikeyläjuoksulle
glam	peräaukko
bwot	nauta
bren	suoli
byot	video-
bjik	boikotoida
kwim	tietokilpailu
cwek	jääkiekko
grif	sissi
hgem	magnesium
hyes	tietoisuus
fram	apteekki
nwos	vaatimaton
ryap	järjestääuudelleen
cwim	luotettavuus
klep	rakkolevä
psec	korvata
djic	maailmanlaajuinen
kfut	ulkonaliikkumiskielto
crep	hampurilainen
frim	lause
gjas	sytyttää
hdef	veloittaa
ryum	uraani
pluk	arvioida
krop	koordinoida
nraf	veronmaksaja
tyes	integroitu
plip	opined
hgom	gamma
hgus	kerroin
cwuc	lämmitin
zret	vähentää
nles	analyytikko
trof	intransitiivinen
hmof	ostoskeskus
hzim	vismutti
dzac	ruokailija
psok	postikortti
blon	lähentyminen
djet	eksyä
ksum	osakas
mrup	mikrobi
clif	helix
cloc	morfologiset
tfes	muonan
gjis	farkut
jren	suuntaus
tlep	tietokanta
kcup	kuponki
glot	Jännite
glut	laskin
srep	kyberavaruudessa
nwes	sijoittaja
ksef	röntgen
bzis	Visa
frut	infrastruktuuri
nyuk	tulikärpänen
dyik	ilmaisin
plec	liitos
brom	bromi
plop	palladium
zlik	pii
flut	voltti
ksop	kosmeettinen
gjun	hoitotuotteita
kfok	hikka
hpof	popcorn
hzuk	eläintarha
nyoc	konnotaatio
jwak	jooga
brim	barium
kles	mestata
mwam	Joo
fwik	ilotulitusraketti
djas	jazz
dyim	audio-
tsum	volframi
drip	tiputtaa
lyaf	elatusapu
prom	ohjelmoija
nrup	panos
hfes	refleksiivinen
rwaf	krysanteemi
dlen	dokumentointi
byas	rokote
fron	heroiini
dluk	katkaista
dyun	määrittää
flap	kansio
kfet	katodi
dlim	ideologia
prek	pysäköinti
syoc	kuva
slus	saavutettavuus
nlos	antikliimaksi
mlen	seleeni
pres	aivokuori
hlof	rikki
nlek	nykyinenmerkityksellisyysmerkki
gwot	lentokenttä
mwip	huijarin
klop	torakka
kwom	kromi
hl6t	litra
nwec	kuitenkin
glip	syklinen
nrop	palkkahallinnon
crum	hormoni
dlep	kehittäjä
frot	lävistää
bwoc	sabotoida
fwis	feministi
djok	konjugaatti
draf	nykyaikaistaa
trum	äärimmäinen
graf	algoritmi
lwes	laser
mlem	millimetri
flen	flex
zlot	anodi
swok	käpertyä
klec	koiraväsynyt
pwim	osa-aikainen
htuf	tonnikala
fyis	jalostamo
lwet	herkkyys
mrem	keskuskone
jwic	nuorentaminen
droc	mielenosoittaja
clem	helium
dzik	kaksikielinen
psem	plasma
hjom	kromosomi
rwuc	järjestysluku
tyus	kokonaisluku
klom	kilometri
hfos	faksi
nwek	genetiikka
jrap	ruuvimeisseli
zwas	alkuruoat
bwok	parsakaali
dwap	sovitin
syem	spam
blek	vektori
tlus	taktiikka
pyif	määrittelemätön
cwoc	kunnossa
mrep	ampeeri
hbem	vitamiini
hxan	ovenvartija
hxut	tukea
hk6m	kadmium
hxin	samanaikaisuutta
txin	titaani
kxin	kilo
klum	paritella
xlis	tiimalasi
hqak	syntaktinen
hxat	luovuus
hxik	ekirja
hxas	työpaikka
bxon	boori
dxin	induktanssi
hxit	helikopteri
tlum	telluuria
txit	takaraja
kxat	hapettua
hvik	kohdista
nluk	analoginen
nyem	senttimetri
hm6t	molybdeeni
hl6m	litium
ht6t	multimedia
xlit	kalori
ryop	robotti
pxas	farmaseutti
hxak	kotitehtävät
lwif	locative
grim	logaritmi
hqat	rukoilijasirkka
qlit	ekologia
xlik	hienoihminen
mlep	sapluuna
hqit	radioaktiivisuus
kxim	kilogramma
hxen	vuokraaja
hxot	syödäliikaa
kyif	kopiokone
fwet	freeware
txet	alaryhmä
hs6n	peräkkäinen
hxet	kuunnellasalaa
xrat	hiustyyli
hqan	takavarikoida
hr6t	iridium
bxat	kaistanleveys
dxet	pöytä-
hxis	räjähdysmäinen
hxok	pääkonttori
hxek	pannavääräänpaikkaan
srem	cerium
hp6t	partitiivi
pxik	partitiivitapaus
kxet	kasetti
pruk	supermarket
hvit	tahdonvoima
xlin	offline
frip	salaus
hvep	ylihintaa
hxon	synkronoida
kxit	maksimoida
hqin	seminaari
tr6n	stereot
ht6n	kiinnike
hvat	tuleva
sl6s	celsius
hn6n	neon
ts6t	todellinenaika
hvin	tehostaa
pxat	lehtikioski
myoc	moduuli
ps6s	pasta
bwek	salkku
dlok	deluxe
fraf	palomuuri
hr6k	artefakti
txat	lounasaika
hqon	oregano
pxun	plutonium
ks6n	työasema
slef	liukuportaat
xrit	hengenpelastaja
hvut	ahtaaliiantäyteen
xrim	yttrium
hx6t	puhettatukevaa
hqum	käyttäjätunnus
hl6n	myyjät
gron	argon
pxan	myynninedistämis-
hvac	astianpesukone
xlan	globalisaatio
txon	aallonpituus
xrik	kierrättää
hxap	reppu
hxac	uudelleenkäynnistää
xyat	maksatulehdus
cwep	palkka
hxos	torus
txif	kirjasin
qlat	kiinteistönvälittäjä
txot	keskisyksy
hxam	milligramma
pxis	pixel
pwif	esikatselu
txam	tantaali
myek	termodynaaminen
hbop	murtautuasisään
hqot	liuenneenaineen
xlic	pyörätuoli
gxit	kansanmurha
hvan	sammuttaapaloa
glim	gallium
pfop	pop-ylös
hzum	zirkonium
xlon	puhelinpalvelu
qlin	epälineaarinen
kxam	skandium
blim	beryllium
kxik	konfiguroida
nr6n	neuroni
hpef	predikatiivinen
hruf	reititin
kxan	kertoma
hxic	ohje
xlip	lentopallo
dyek	debug
hxop	rannekello
qrot	neutroni
nwip	niobia
hs6t	wC
grem	germanium
tles	metalloidi
hp6k	prolativetapaus
qyin	biodiversiteetti
txak	antibiootti
mlun	liikkumattomuus
txan	aktinium
xran	astronautti
dres	purkaa
tr6t	avaruusolento
hk6t	oktetti
hxus	avatalähde
xlat	hullu
mraf	maraton-
ts6n	midkevät
ht6s	autismi
nlif	ionisoi
txut	merkkihenkilö
hm6n	säteilevät
kxis	klipsitaide
xrin	meneillään
xren	suuntaamalla
bxak	kirjanmerkki
pfos	ammattilainenlauseke
hvis	ulosteet
hd6n	nimittäjä
brum	kokoushuone
hqis	shovinisti
hk6n	koota
xyit	siirtääavain
xyin	yksisekunti
hxun	oikeuteen,
hvas	roolit
glok	blogi
hvak	polveileva
pxit	iposoite
hvet	vieressä
xram	saflori
hc6n	ilmeisyyttä
qran	Koraani
zyen	xenon
hqas	vannon-in
bzas	välinpitämätön
hj6n	eiihmisen
hnof	välttelevä
txas	päättäjät
hbum	buddhalaisuus
ts6s	riitely
pxin	ainekset
hr6n	säännöstellä
hxim	puolivälissäkesällä
dxit	keskitalvella
hxaf	kaivaa
nlus	huonekasvi
txap	statusbaari
vrit	haamukirjoittaja
kxak	pelleillä
bxin	ihmiskehon
hqik	sadetakki
hxes	hertsi
hxif	hypnotisoida
xras	tunti-
pl6k	avustavana
dxat	kiirehtiminen
hxip	vasta-aine
vrat	shortsit
hqek	muokkaavat
qrit	vastakkaisuus
pxot	postitoimisto
hxom	romuposti
hqic	arvostelija
lwun	blue-jean
hp6n	kypsyminen
dxan	liittämällä
xrak	näyttelijärooli
dxak	onnettomuus
hven	kontit
mwap	sarjakuva
qlan	värisokea
xros	riisuutuminen
srom	esittelytila
hc6t	chattailuun
qrat	ylösalaisin
hn6t	esto
hqet	verkkosivusto
fres	fundraise
froc	taonta
xlak	hyperlinkki
vlat	puheliaisuus
dvan	poistuessasiitä
gxin	valloittavat
ryes	vastaanottovirkailija
kxot	liittimet
xyan	rajaaminen
vlan	mainostaja
ryom	toriumatomi
hluf	vanhuus
hquk	pistää
lyum	tuliumatomi
tyem	terbiumatomi
hp6m	praseodyymi
txic	kotiinsivu
mros	autoilija
dyam	rodiumatomi
pc6n	oikeudenkäyntimäärä
nyos	postilaatikkoon
pyek	projektori
kxon	krypton
hxuc	pelastamiseen
qrik	centrictapaus
xwin	kokemattomuus
kxic	sammutin
hvot	vuokaavio
dxot	jogurtti
hqut	lokiulos
pxen	osasto-
drok	tavoitelaukaista
flon	kännykkä
txos	keskimmäinenääni
hqok	vinotapaus
xwik	potilastapaus
hx6n	prehodiernal
txik	etusormi
hqen	lähettäjä
mlap	haittaohjelmat
hvun	mielipiteenmuokkausta
hvon	kulua
vran	postimies
pfes	professori
pwip	runoilija
hqam	treenata
gxat	laillisuus
ks6t	syynäoleva
vrin	rekrytoija
kxip	klipsilauta
sr6n	tuomitseva
vlit	arvioiva
tyup	lähiö
mrom	morfeemi
xron	kuulokkeet
gxak	kallis
hrof	troijalainenhevonen
xlas	halvaantunut
dzet	kunnostaa
txac	siirtävää
xrot	käyttämätön
txis	pistematriisi
syif	siyksiköt
xrac	yllättävän
brif	binary-arvo
dlos	modaalinentapaus
txun	määritteet
dvat	pahantuulinen
psom	ensikäden
gjek	muu-jos
nlem	yksikkö-of-massa
qret	jälleenmyyntikauppa
txip	triple-piste
dlek	erikseen
lwut	flow-virta
dxis	dramaattisesti
hs6m	cesium
vlak	junavaunujen
hn6m	nerium
kxap	pahvi
bxan	lähtevät
myem	toukokuu
gxik	siviili-oikeudet
hxoc	ilmavoimat
xrok	työtoveri
kr6t	kuvakaappaus
txok	automaattisesti
hxep	rullalauta
srop	älypuhelin
pxak	capsLukko
hk6k	kansanmusiikki
hl6k	euler's-numero
pyom	poloniumatomi
xyam	talliumatomi
hvic	hyökkääviä
lyok	locativetapaus
xlot	asuntoja
txen	oikaiseminen
kxac	vastahyökkäys
qrak	rikkuri
hbup	uima-allas
txuk	oikosulku
tsef	suippeneva
bxit	verkkoisäntä
ksem	lukeavain
byim	rubidiumatomi
hvam	vanadiiniaatomi
lw6n	lantaani
frum	fluoriatomi
nyom	neodyymi
mlom	multalmäärä
kxas	personoida
xret	teratavu
hs6k	hakumoottori
frus	ruostumatonta
gxan	galaxysukupuoli
vlas	ääntelyä
glet	kaasupedaali
hvim	runtime
bxip	bittikartta
qrin	tähtisukupuoli
bvak	abessiivitapaus
pxon	poissa
dvik	adessiivitapaus
dvek	agentivetapaus
hlef	agenttilaukaista
kwek	ettätapaus
kxen	yhteinensukupuoli
ht6m	lainausmuoto
tsuf	transnumero
hf6n	sakkojen
tc6t	suoraanesine
gvik	ergativetapaus
gxon	pirstoutuminen
ksep	reseptoriin
vyin	elokuvateatteri
pyos	passiivinenääni
hnef	rajallinenverbi
xwit	ensisijainenesine
hqim	genomisenmieliala
jlak	yleistys
vrik	lopullinenhiukkanen
qyan	kuvitteellinen-yksikkö
kxaf	nopeus-of-light
xyic	phishing
qyit	Kriittinenpiste
hvek	evitativetapaus
bvik	subessivetapaus
hzes	riivattutapaus
prus	tietokone-virus
ples	suoritin
pxif	valvoaupseeri
dvak	dännöntapaus
brun	touring
tsi_k	antessivetapaus
tyum	ruteniumatomi
vyak	adverbiaalitapaus
pxim	pääministeri
syum	strontiumatomi
sy6n	epäileväisyys
hy6n	elävöittääsukupuoli
pxac	empaattinenilo
vlin	ajoneuvosukupuoli
qwin	mineraalisukupuoli
hr6s	lähete
tf6n	kasvovesi
xris	käyttäjäliitäntä
hw6n	kiroilua
xlen	sanallinensubstantiivi
pyec	taulukkolaskentaohjelma
vlim	virtuaali-muisti
bres	sanasuoritin
hqip	pilvitietojenkäsittely
vlic	virtuaali-kone
pfam	roskapostittaja
dyap	toinenkieli
txek	nnen-root
dxen	datakaivos-
byip	liiketoimintahenkilö
hs6c	itseluottamus
txim	viittaavista
hb6t	muuttaaoftapahtuma
hdem	verkkotunnuksennimi
dxon	eritapahtuma
lwaf	salamaajaa
sl6t	crastinaljännittynyt
xyik	velttolevy
fyif	refleksiivinenääni
bvin	maailmankaikkeussukupuoli
hm6p	emolevy
tfip	transitiivinenverbi
jlen	sijaintisukupuoli
xrap	raidallinen
tc6n	tutkimussukupuoli
sl6n	taiteellinensukupuoli
xrek	potilaslaukaista
xwan	abstraktisukupuoli
dxif	videoneuvottelu
dyip	epäsuorapuhe
zrek	exocentrictapaus
hvuk	herättäen
xwat	ohiperfektiivinen
hr6m	renium
txaf	laukeaa
hmef	persoonatonverbi
tx6t	tekstitoimittaja
txes	kollektiivinensubstantiivi
bvat	mistreating
bvuk	absolutivetapaus
ry6t	radiaani
vlis	virtuaali-todellisuus
qren	planeettojensukupuoli
gvak	kieliopin-tapaus
bxok	kalju
mrum	tietokoneohjelmoida
ps6t	käyttö-järjestelmä
hfom	foneemi
tlem	lukeavainmuisti
pwam	spyware
kfif	ydinbenefactive
qwit	järkevyys
nlaf	asentaminen
nwok	assosiatiivinentapaus
dzas	dissatisfy
swuk	superlatiivi-tapaus
syos	yhteenveto
kr6n	sähköinennykyinen
dvin	elotonsukupuoli
pxom	propositivemieliala
vris	vastavuoroinenääni
rwos	aerosoli
dr6t	huomionkerääjää
ht6k	tietoliikenne
slaf	sosiaalinenverkottuminen
lyuk	peräkkäinenlauseke
qras	esimiehet
ty6n	terminaali
gwet	piantulevaisuusjännittynyt
hp6s	applicativeääni
tsof	antipassiveääni
ht6p	continuativenäkökohta
hn6f	necessitativemieliala
pfip	passiivinenpartisiippi
glap	toolbar
sy6k	eksistentiaalinenlauseke
qyat	valoisaintensiteetti
hy6t	kieliopin-esine
vyan	Pronouncing
sluf	singulativemäärä
dvit	liiallinenkesto
qyak	yksittäinentoimintaverbi
bzik	fysiikka
xlet	superlatiivi-aste
hqap	esittääpartisiippi
qwat	määräofaine
qyik	yhdistävähiukkanen
sr6t	ylikriittinen-neste
hfem	epentheticmorfeemi
tl6t	kauko-tulevaisuusjännittynyt
mrif	mikrofoni
pcuk	postpositionaltapaus
tfim	satunnainenpääsymuisti
fwim	eti-
ly6t	allocutionsopimus
hvap	vierittääbaari
hfep	frequentativenäkökohta
bvan	jakelupronomini
fyun	kelluva-point-numero
xyas	pyyhkimisen
hvif	verbi-pääte
xyis	ohipassiivinenpartisiippi
tl6n	keskeinenjalostusyksikkö
tfok	locativesuunta-tapaus
qwan	useinpyysikysymykset
