ni	fi&#39;ili
na	nominativeharka
ka	accusativeharka
ta	topicharka
ca	hello
wu	vocativeharka
kcah	m
ti	genitiveharka
ci	siffa
wa	kuma
mi	ni
sa	ka
nyah	mu
ya	shi
ma	manufaharka
yi	dativeharka
li	realisyanayi
tu	deonticyanayi
cu	matukaryanayi
si	epistemicyanayi
yu	instrumentalharka
nu	cikimahallin
pa	mutummahallin
tyah	mkashi
la	dogaramagana
fa	perfectiveal&#39;amari
ki	dasiga
ne	namijijinsi
mwah	comitativeharka
ra	basiga
pwah	benefactiveharka
swih	essiveharka
no	negatoryquantifier
pi	surfacemahallin
da	adpositionalharka
te	locationharka
to	sararimahallin
ga	hanyaryanayin
ri	tambayanayanayi
ba	kumako
ku	mko
so	sourceharka
pwih	ablativeharka
ksah	kusanci
tsah	demonstrative
ko	kashiwutsiya
pyah	amma
wi	duniyaquantifier
ji	matajinsi
pu	mnumber
bi	msiga
co	socialmahallin
me	imperfectiveal&#39;amari
klah	akwai
twah	elativeharka
twih	illativeharka
di	umarninyanayi
tlah	zaɓenaquantifier
kyah	abinda
tcah	tambayakalma
ja	copula
cyah	mutum
clah	wasu
do	lambar
tlih	assertivequantifier
se	lokacimahallin
myah	bokoharka
tyuh	kawai
tcih	hortativeyanayi
tyih	retrospectiveal&#39;amari
lo	volitiveyanayi
cwah	bayan
nlah	alienablemallaka
nlih	inalienablemallaka
cyih	deliberativeyanayi
lwah	perlativeharka
pfih	mal&#39;amari
tsih	nan
ce	karkashinmahallin
pcah	harilayau,
lwih	delativeharka
swah	semelfactiveal&#39;amari
nyih	cigaban
fu	mayardahankali
plah	so
po	paucalnumber
kyih	saboda
ksih	causalharka
gi	sunan
tfah	dacesuna
crih	bayyaneevidential
kceh	m
dwih	desiderativeyanayi
wo	kalma
srah	sai
tweh	terminativeharka
nwih	inessiveharka
pcih	wajibiyanayi
crah	yiimani
ro	jiharmahallin
cwih	fatan
kwih	factiveevidential
fi	samu
psih	optativeyanayi
tseh	myanayi
lweh	allativeharka
nrih	anthropicjinsi
tceh	wannanmaganaalama
re	daban-dabanbatun
croh	tsoro
mrah	fahimta
cyuh	shakka
twuh	dubitativeyanayi
myih	m
lyih	amfani
flah	counterfactualmatukar
we	vialisharka
clih	sanyi
pyih	zamanlafiya
su	fãce
kwah	so
le	tsawon
bo	yiwuwa
mlah	matsala
syah	murmushi
slih	barci
zi	undefined
twoh	quotativeharka
mo	mmutum
kcih	DonAllah
rwih	precativeyanayi
mrih	mRegister
rwah	yiwuwaal&#39;amari
cyeh	mamaki
go	gnomical&#39;amari
tsoh	girmamawa
za	inchoativeal&#39;amari
jwih	jussiveyanayi
mwih	permissiveyanayi
sloh	nasara
prih	masuzamankansu
de	rabaharka
tcoh	zafi
ryah	dariya
mlih	m
ye	possessivealama
ke	commissiveyanayi
creh	m
mweh	completiveal&#39;amari
nrah	dumi
nroh	fushi
bwah	duk
trah	girmankai
mroh	halinkirki
slah	kiwonlafiya
syih	social
pe	cessativeal&#39;amari
krih	m
tfih	intensifier
fe	akarshe
prah	bijire
trih	evidential
nwah	evidentialharka
srih	m
zo	zoicjinsi
nweh	eventiveyanayi
cwoh	wannantaronalama
plih	multiplicativeharka
dwah	daakeso
kcoh	gaji
drah	gamsu
lu	tabbasyanayi
frih	sabaRegister
frah	rauni
mruh	wawa
djih	juyayi
krah	gode
cruh	kunya
fyah	maganaalama
ryih	undefined
kruh	m
tyeh	rubutu
kreh	m
tleh	hesternalsiga
kfah	hadaya
dyih	ƙi
cloh	mjinsi
nloh	jidadin
psah	yankeƙauna
sleh	vegetaljinsi
nruh	m
drih	sha&#39;awa
sroh	gafara
brih	tushe
kluh	rikice
bwih	benedictiveyanayi
klih	m
grih	m
nyeh	himmaharka
nleh	m
dlih	jinkiriwajibi
proh	ruwaitoevidential
mloh	melancholy
du	mufuradi
jrih	haƙuri
freh	referential
kloh	m
kroh	laya
tcuh	babbarsha&#39;awa
kcuh	inductiveyanayi
xa	lãbãrimahallin
nreh	juyayi
pseh	al&#39;amari
ge	wakili
mu	admonitiveyanayi
byah	kishi
pcoh	maƙil
treh	directevidential
yo	myanayi
cwuh	bugu
tloh	&#39;yandasiga
dlah	tabbataccenlabarin
cluh	mummuna
myuh	dara
dyah	distaldemonstrative
rwuh	m
troh	imprecativeyanayi
dzih	rashintunani
swuh	assumptiveyanayi
bzah	wãsã
gwih	wato
dloh	hodiernalsiga
dweh	delimitativeal&#39;amari
kweh	mmutum
truh	zazzabi
tfeh	telical&#39;amari
lyeh	atelical&#39;amari
ru	prohibitiveyanayi
kfih	yaro
cyoh	m
nluh	biyayya
cweh	tarko
nwoh	rai
sruh	burge
ksoh	jima&#39;i
lyah	m
mreh	momentaneal&#39;amari
pceh	undefined
bjih	tsohonmarigayin
pcuh	rashintabbas
xi	sabõdaal&#39;amari
blih	adaure
tsuh	marasmuhimmanci
fwih	majestic
grah	undefined
brah	sabani
cleh	undefined
sreh	mRegister
pfah	m
droh	auditoryevidential
flih	inferentialevidential
sweh	sublativeharka
ksuh	declarativeyanayi
pleh	gata
psoh	undefined
be	fi&#39;ili
mwoh	undefined
kleh	undefined
glah	zari
kseh	myanayi
zrah	Sabani
dyoh	ideophone
syoh	undefined
gwah	exessiveharka
zlih	irrealisyanayi
zrih	kanjinkunya,
byih	karbuwa
ryeh	wakilinsunaalama
fwah	frugal
bjah	undefined
kxah	equanimity
gvih	pegativeharka
pxih	nasara
xrah	undefined
tfoh	undefined
kxih	contrition
ryoh	prosecutiveharka
qyah	DaukanHankali
r6	participle
txah	mdasiga
xrih	tarihisiga
dxah	dualnumber
syuh	super
vweh	undefined
n6	azancishineevidentialyanayi
bweh	kamudawanira&#39;ayi
xlih	maibandariya
txih	undefined
sluh	undefined
txoh	motsiUphill
xe	retrospective
pxah	undefined
vwah	motsidownhill
xyih	Elite
fleh	inflected
psuh	superessiveharka
syeh	undefined
qi	tsallakawa
xruh	cower
zwah	wow
tr6h	motsiupriver
qwah	undefined
xlah	worldwide
tyoh	maratsallakawa
tluh	anticlimax
qa	yanzudacewaralama
kxoh	undefined
rwoh	ordinal
ve	vector
kyoh	undefined
swoh	bidabi
pxeh	partitiveharka
txeh	augmentative
dxih	predicative
pxoh	prolativeharka
pfoh	promagana
blah	blase
fyih	bamutum
xo	actorrawa
pc6h	fitinanumber
greh	centricharka
groh	Manufarjawo
dxoh	tsakiyarmurya
rweh	QFontDatabaseharka
xwah	mharka
xu	prehodiernal
xroh	safita
ks6h	causative
vi	binarydarajar
dleh	modalharka
gjeh	kumaidan
xreh	ma&#39;aikaci
lwoh	locativeharka
ml6h	multalnumber
gjih	galaxyjinsi
qlah	starjinsi
bvih	abessiveharka
dvah	adessiveharka
je	agentiveharka
t6	wakilijawo
kxeh	toharka
gxih	kowajinsi
tc6h	lissafiform
ts6h	transadadi
ryuh	directabu
gveh	ergativeharka
pyoh	mmurya
qe	guntunfi&#39;ili
xwih	primaryabu
myoh	gnomicyanayi
vrih	karshebarbashi
va	evitativeharka
bveh	subessiveharka
dxeh	mallakiharka
dvih	lativeharka
tsa7h	antessiveharka
dyeh	adverbialharka
mleh	raijinsi
pfeh	empatheticfarinciki
xleh	abinhawajinsi
qlih	ma&#39;adinaijinsi
xloh	fi&#39;ilisuna
dreh	yarenabiyu
bvah	kaiamincewa
qrah	canjinataron
fo	daban-dabantaron
sl6h	crastinalsiga
fyoh	turawayanzumurya
bxih	duniyajinsi
jlih	tsallakawafi&#39;ili
kyeh	Localityjinsi
txuh	bincikejinsi
s6	mjinsi
preh	mjawo
sr6h	mjinsi
nyoh	kaikaitaccemagana
zreh	exocentricharka
kfeh	daperfective
jo	mfi&#39;ili
kxuh	gamasuna
bu	absolutiveharka
qrih	planetaryjinsi
kfoh	corebenefactive
kwoh	associativeharka
pluh	superlativeharka
jrah	lantarkiahalinyanzu
glih	matattunjinsi
p6	propositiveyanayi
vrah	najunamurya
lyuh	mkashi
gleh	nandanangabasiga
lyoh	applicativemurya
ps6h	antipassivemurya
tfuh	continutiveal&#39;amari
nr6h	necessitativeyanayi
pr6h	mparticiple
sy6h	rayuwanmagana
qyih	luminoustsanani
gluh	singulativenumber
kwuh	wucekimaduration
xyah	gudamatakifi&#39;ili
vlih	superlativedigiri
djah	baparticiple
m6	adadinabu
ti7	connectivebarbashi
f6	epentheticmorpheme
tli7h	mmsiga
si_	postpositionalharka
l6	allocutiveyarjejeniya
k6	frequentativeal&#39;amari
bzih	rabawakilin
tu7	iyoayanumber
vo	fi&#39;ilisa
ki7	damparticiple
ta_	locativedirectionalharka
