hnit	főnéviigenév
hnak	alanyesetiügy
hkak	tárgyesetügy
htak	témaügy
hpap	apu
hmam	anya
hyat	szülői
hcan	Helló
hwik	vokativuszügy
hsuc	ős
htat	nagyszülő
hcac	éhes
hnik	birtokosügy
hcit	melléknév
hwan	és
hman	nekem
hnan	te
hwam	minket
htit	azt
htac	rendeltetésihelyügy
htik	részeshatározóügy
hyit	REALIShangulat
htim	deontichangulat
hcut	feltételeshangulat
hsit	episztemikushangulat
hyak	hangszeresügy
htan	belsőkontextus
hpan	személykontextus
htin	függetlenkikötés
hyan	függőkikötés
hfap	befejezettvonatkozás
hkat	múltfeszült
hnin	férfiasnem
hmak	comitativeügy
hnat	ajándékfeszült
hpak	benefactiveügy
swik	essiveügy
htut	tagadókvantor
hsan	felületkontextus
hpin	adpositionalügy
hwin	elhelyezkedésügy
hkan	helykontextus
hnac	útügy
hyut	kérdőhangulat
hnam	ésvagy
hkit	kizárólagosvagy
hsuk	forrásügy
hpik	ablativusügy
hcat	közelség
hmat	meggyőző
hkuk	kikötésfarok
hlan	de
hsut	minden
hyin	egyetemeskvantor
hcin	nőiesnem
hpac	többesszámszám
hyik	egy
htic	azok
hkik	ki
tcat	jövőfeszült
hsin	társadalmikontextus
hkac	amikor
hmip	folyamatosvonatkozás
klan	ott
hlak	relatívügy
hlik	illativusügy
htam	irányelvhangulat
hlat	választásikvantor
hkam	mit
hwat	kérdésszó
htap	kapcsolószó
hpat	személy
nyan	férfi
hkas	tudott
tcan	más
hnuc	szám
twit	tolakodókvantor
hsak	időkontextus
htuk	időbeliügy
htun	csak
htum	buzdítóhangulat
hyip	visszatekintővonatkozás
hlit	volitivehangulat
pcic	kell
tyut	kettő
hsat	lát
hkut	tud
hcic	le-
hcap	után
hpam	első
hlac	elidegeníthetőbirtoklás
hkap	soha
hnic	elidegeníthetetlenbirtoklás
tyat	régi
tcit	tanácskozóhangulat
tcin	nap
hlam	jön
hwak	magánhangzó
hkin	megy
lwak	perlativeügy
hpip	haladóvonatkozás
lyan	hosszú
hsac	mondjuk
kyan	hogyan
htas	újra
hsic	itt
hcik	gondol
hcak	alattkontextus
hfan	megtalált
hsun	kéz
hyac	is
nwan	fiatal
tyit	ellen
tlan	Isten
twak	delativeügy
hmin	semmi
hyas	egyszer
hlap	semelfactivevonatkozás
kcac	balra
hyic	fűrész
hcas	ház
hwac	világ
tyin	három
hnun	neo
hcuk	fókusz
pyan	szerelem
hsis	mindig
hyam	éjszaka
hyap	király
hkic	között
hmas	elme
cyit	szív
pluc	paucalszám
kyik	mert
ksak	okozatiügy
tcun	Kész
hnim	név
tsan	megfelelőfőnév
klac	ország
hpun	kérdezte
cyat	láthatóbizonyítékonalapuló
pcac	jobb
hmac	pillanat
hnas	nemtud
hwic	víz
twim	desiderativehangulat
kwan	fény
tlat	szó
tyan	ajtó
hsas	reggel
syat	amíg
twik	terminativeügy
hpit	fehér
pcan	pénz
hyis	szegény
mwan	halál
hfam	forma
nwik	inessivusiügy
kcat	együtt
tsac	gyakran
pyat	barát
psan	fél
hpim	parancsolóhangulat
hyuc	kerek
hfat	küldött
hcis	feleség
kcan	hisz
hsik	nyilvános
htus	államikontextus
hpas	fiú
clat	gyermekek
tyak	ésígy
cwan	remény
syin	kedves
hkuc	magas
tyac	olvas
syit	város
hlic	már
hfit	factivebizonyítékonalapuló
tcac	lány
hcun	hall
ksan	legkevésbé
hyaf	talán
kyat	valóban
tcic	test
hwit	visszatérés
cwat	levegő
hfaf	törvény
hput	Segítség
lyat	levél
ksas	négy
hpic	óhajtóhangulat
hfuk	Tűz
hcam	óra
twat	háború
kyak	számos
tlit	második
pcin	mögött
hmut	Elvesztett
clan	ezer
hfac	család
twan	lélek
hwas	kérdés
syan	igazság
htis	gyártás
tsat	potenciálishangulat
lwik	allativeügy
nyin	antropikusnem
hfak	öt
tcak	azonostantárgyjelző
htuc	különbözőtantárgy
hnap	válasz
hmit	tenger
hcuc	félelem
pcat	megért
syas	feltételek
hcaf	kétség
twut	dubitativehangulat
hkis	fekete
tlak	hoz
hyus	szép
nyit	fajta
htip	tíz
ksis	sztori
hpuk	könyv
hlin	elektronikus
hkun	számla
lyas	kamat
lyit	ír
pwat	ágy
hnis	kor
hnut	alternatívfeltételes
slas	művészet
hwis	VIALISügy
pyak	testvér
lyin	vonal
tyas	táblázat
hyun	folyó
kyac	szem
tfan	hirtelen
kcin	mély
hmuc	cél
cyac	vér
hmap	rózsa
tlin	hideg
hyif	előre
tyam	késő
hnaf	tegyükfel
hkip	közel
myan	enyém
tsin	tudás
hkup	másolat
hsam	férj
hlis	hat
cwit	élő
cyan	béke
myat	emlékezik
tyic	természetes
hfut	esik
swas	szolgáltatás
hsap	kivéve
pcit	szerzőijog
hyim	hadsereg
kyas	ló
plic	jövő
pcak	nyugati
hpis	fizetés
hyuk	piros
hwun	arany
twin	vágy
plan	játék
hpus	hivatal
syun	kormány
kyic	templom
htaf	erő
hlun	hossz
kyin	vállalat
kyis	papír
mlan	valószínűség
hcim	különösen
cyas	viseli
twac	ablak
nyat	szépség
hcus	utóbbi
htup	vám
htif	távolság
pyas	láb
hlas	vad
ksin	zöld
hmaf	baj
myac	mosoly
hsim	alvás
kyit	idézett
kwik	quotativeügy
fwan	látogatás
slan	kövesse
psit	jelenlét
hmic	édes
hmuf	száj
hfin	gazdag
tcam	ellenség
psuk	törött
kcap	hajó
pwan	befogadószemély
hfic	befolyás
tcuc	megjelenik
hkim	titok
pyin	kérem
pwit	precativehangulat
pyit	udvariasnyilvántartás
cwak	gonosz
myak	március
tcas	helyek
hlaf	marad
psat	helyette
nlan	kék
psac	lehetetlen
kcuk	iskola
kcit	házas
kcak	élelmiszer
syis	húsz
tlac	csendes
hcip	leendővonatkozás
kwin	így
tsit	megállt
pyac	nyelv
hsus	hét
hcup	terem
cyap	csoda
tfin	született
fyat	bíróság
hnip	gnómikusvonatkozás
tsak	tisztelet
tlas	érdemes
syuc	fa
plat	fal
cyak	menny
twip	kezdetivonatkozás
mlat	parancs
swit	jussivehangulat
mwas	hónap
hwaf	tökéletes
tyap	tapasztalat
ksac	körülmények
syac	friss
hnuk	herceg
kwak	fedett
tyuk	keleti
pwac	kő
hkif	nemes
nyac	irány
cyis	szék
tyuc	várakozás
tsun	falu
tyik	egyetért
hnum	megengedőhangulat
slak	siker
tsic	megpróbálja
slat	hegy
hmik	zene
hkus	kiáltás
hsip	hét
hpaf	magán
nwas	hírek
tfac	színhely
fyan	kert
cwas	kezdődik
hfik	elosztóügy
lyac	tanul
syik	politikai
clin	Henrik
cyin	fekszik
tsas	öntvény
cyik	hatóság
tlap	padló
cyam	nyár
tcut	vallás
tcap	menekülni
hlut	szerző
pyun	barna
tcuk	fájdalom
swan	tavaszi
hmun	puha
kyun	sarok
nyak	védjegy
tsis	igazságszolgáltatás
psas	gyárt
cyaf	nevetés
hwut	elfelejt
hyup	Európa
hwap	nyolc
psak	elhaladó
kyap	szörnyű
pyic	kívánt
hmim	közepes
hsaf	lehelet
hmis	bölcs
hsum	birtokosjelző
ksat	kellemes
ksit	sír
tsap	sziget
kyam	tábor
tcum	érintés
cyun	szerencse
psic	part
tyun	domain
mwit	commissivehangulat
tlut	fokozat
myit	téli
kfan	magatartás
slac	futás
myin	perc
tyip	vezet
klas	üveg
pfat	tábla
cyic	hiú
swam	ügyek
syam	biztonságos
tsut	orvos
hlip	kiegészítővonatkozás
kcas	sötétség
nyun	meleg
hpuc	ital
tlam	példa
hfun	harag
tsik	ellenére
tsam	közvetlenül
hmup	kalap
klak	kutya
slin	ezüst
swac	szolgáló
kcam	büszkeség
pyik	vonat
myut	erkölcsi
syak	belép
swat	kard
kyuk	támadás
clac	Egészség
tyaf	bekezdés
swic	társadalmi
tfit	visszatérítés
hkaf	hivatalos
pcas	pillantás
nyam	dicsőség
tfat	tizenkét
pcut	elkötelezett
pwin	bor
mwat	íz
fyac	Vas
syap	terjesztheti
myap	kereskedelmi
hyum	segítségével
fwak	bíró
klat	kapitány
twap	megszűnésvonatkozás
kcic	kíváncsi
kwic	külföldi
hnif	erősítő
myun	fontosság
tlic	végül
cyuk	nyak
syut	szabadság
pfan	fél
kyuc	száraz
pcap	félre
tfak	bizonyítékonalapuló
tcik	bizonyítékonalapulóügy
twun	távoli
tyis	Haladás
nyap	keskeny
plit	épület
hpif	oldal
pwic	holding
syic	szomorú
tsip	bűn
syim	beteg
tcis	becsületes
pcun	bank
ksap	elfogad
lyam	folyam
tcaf	gondosan
kwac	fül
hpup	kenyér
kcut	választ
nwam	állat
hsup	zoicnem
nwit	eventivehangulat
tcim	azonoseseményjelző
tlik	multiplikatívügy
kyus	kereszt
hmus	vastag
kfat	merészel
nwat	nő
myic	eső
hpum	felület
swut	szent
clis	július
mwun	divat
hfas	akta
cwac	váll
kwat	kényelem
nwac	bárki
tcip	kívánatos
kfac	fű
hmuk	húz
plin	nyílás
kwun	június
mlik	hal
klin	főváros
pfut	mell
twam	követelés
fyin	költség
nlit	atiéd
mlin	millió
pyut	imádkozik
hluk	fáradt
ksut	megöl
cyut	árnyék
psin	súly
kcis	szürke
pyam	bátor
mwac	elégedett
klam	sokatmondó
ksam	nemzeti
hfip	gyenge
klik	völgy
hkum	spekulatívhangulat
clas	sárga
cyuc	hőség
mlac	maradványok
syip	egyaránt
pwak	doboz
tcif	hegyes
psip	alapelv
ksik	következmény
tsim	évad
flan	tudomány
pcam	látszólag
kcun	furat
ksuk	nagybácsi
mlit	lista
pcik	veszélyes
kwas	augusztus
hluc	népszerű
klit	ismeretlen
flak	ismerős
fyit	ismerősnyilvántartás
lwat	olvasó
plun	gyalogló
twas	kétszer
pcis	pap
fyas	sebesült
nlat	palota
myuk	bolond
pfak	kedvez
tcuf	kilenc
cwap	együttérzés
plac	robbanás
pyap	elhelyezés
lyic	öltözött
hcum	zaj
lwit	irodalom
tsuk	rang
hfup	vihar
kcik	zseb-
nwap	november
tyim	december
psaf	távollét
nlac	népesség
kyaf	köszönet
slis	sorozat
pyaf	madár
mlak	tulajdonos
kwut	kabát
hwuc	kapcsolatok
pyis	gyorsan
twuc	füst
nwak	január
mlic	gép
tlis	fogak
ksun	égő
clam	szégyen
klaf	minőség
clit	gyűrű
fyak	kifejezés
fyam	kifejezésjelző
kwap	négyzet
hwip	vasárnap
psis	költészet
pwut	eleve
kyim	vétel
clic	mezők
pyip	április
kfap	október
psut	tárgyak
kcuc	keserű
nlap	rabszolga
hsok	laza
htet	szöveg
hbat	legrosszabb
hrit	hitel
hzit	jellemzők
hpet	tizenöt
krac	kegyetlen
hduc	por
hrik	gyakorlati
hron	szín
hnus	orr
hric	barátságos
srik	kínálat
hten	tegnap
tlet	hesternalfeszült
slap	nemsikerül
hban	viselet
hdat	vak
fran	légy
hdan	ördög
htec	fokozatosan
hmon	misszió
cran	áldozat
hran	lelkiismeret
hmos	miniszter
nrit	energia
hcet	gyűlölet
hset	központ
hrin	racionálisnem
hcot	élvez
hrip	rövid
htep	imádat
hcif	bőr
hrat	tető
kran	korona
hkon	kastély
tran	kétségbeesés
hmif	mérföld
trin	kör
hgin	börtön
hkop	csésze
hcen	tag
swin	civil
hrac	mindenhol
hris	szokás
hbin	egyre
hmot	hús
hdut	tej
hwen	növényinem
nran	ritka
hbac	unokatestvér
crut	híd
hsoc	Készlet
hsom	só
nris	ártatlan
hbit	elkerül
crin	csodálat
rwin	királynő
hgut	számol
hdas	tánc
hnot	szálloda
hdin	tölt
hton	Rab
hdak	üzlet
hlet	lépcsők
hson	Bocsánat
hgek	homoszexuális
hras	homok
hsep	szeptember
hbic	ROM
hlen	engedély
hcon	kellően
hgit	tanú
kfon	konyha
hbak	elad
tlim	kezelés
hsot	sebesség
kyut	számítógép
hnen	örök
htek	könyvtár
hzan	tartalmazó
hbis	bázis
hbun	zavar
kcus	főz
hgat	sivatag
hwus	csók
hbif	jég
hbot	labda
hrut	érv
hdit	áldáshangulat
hdis	bűnös
hjan	büntetés
plis	rendőrség
hgan	elrejt
hsen	expedíció
nrin	tudatlan
hyen	felhő
frif	február
hdik	betegség
hnek	kezdeményezésügy
hbam	néni
hmen	alázatos
hdip	késleltetettparancsoló
prat	jelentettbizonyítékonalapuló
hdet	éjfél
hjit	ujj
hmoc	valahol
pran	nyomjameg
kcec	vidék
hken	utóbbiidőben
hloc	melankólia
hrak	személyzet
htes	bámulás
rwan	jutalom
hdon	adományoz
htot	homlok
hnet	angyal
hdun	egyedülálló
croc	hiba
hlon	hajnal
hyec	juh
hjin	türelem
hrec	referenciális
mran	kukorica
htos	többség
hcos	intézkedések
hkoc	néha
hlif	nyereség
clak	cukor
hjat	emberiség
tram	keret
hdic	korong
hkok	magányos
srat	művész
crak	báj
hmet	email
hden	döntés
gran	kormányzó
crac	ág
hjac	lelkesedés
hdim	induktívhangulat
hcok	siet
hyet	olaj
pwap	cső
trat	nyomtatás
tcot	szilárdanyag
hdoc	ó
hren	társalgáskontextus
tcon	dél
krin	kabin
plam	riasztás
hnes	ideges
tcen	megfigyelés
hsek	vonatkozás
plik	alkalmazható
slik	selyem
hfen	cent
hgen	ügynök
hnon	unió
crik	pokol
tcet	hiányos
mrat	vegyes
hdam	figyelmeztetéshangulat
hgac	becsvágy
htoc	valahogy
hdac	Tanács
nwin	alkotmány
srit	hangszer
hret	határozottan
nlin	online
hzat	árapály
klic	főiskola
hkek	farok
nric	generáció
hgic	zsúfolt
hgak	macska
trit	közvetlenbizonyítékonalapuló
tyot	szerződés
hnok	tartalom
crit	elhagyatott
slen	tizenegy
srin	ösztön
hpok	törzs
hyot	nyugtalanhangulat
cric	menedék
hruc	durva
cwin	lovaglás
hzak	ráz
dyit	ipar
hpec	szakma
nras	nővér
hcec	tanítás
hbut	cipő
hmec	homályos
twot	tevékenység
crat	szombat
hkot	kapacitás
hnec	napfény
hwuf	özvegy
cren	fészer
nrat	csillag
hget	vendég
hbik	áldja
brin	belső
hpot	elérhető
trac	ellenállás
prac	származik
hcoc	üreges
hpon	tartomány
hwim	civilizáció
dwan	lejtés
cwok	sokk
hdok	vezetés
crun	kincs
hzik	mag
hrot	újmúltfeszült
hket	ébren
hcek	bútor
hrop	kötél
mrac	kaland
byit	ünnep
trak	évi
hzin	déli
sric	szertartás
clik	vadászat
trap	liberális
hrim	kereszténység
hrus	hercegnő
blat	oltár
cyon	apró
hwep	háló
krat	bíboros
tris	lila
kcot	gyűjt
hben	választás
trik	részeg
kfit	emel
tcec	csere
nrik	határozottcikk
grat	császár
dran	adminisztráció
hpen	korábban
cluk	csúnya
nrac	ártalmatlan
ryin	kiképzés
hrun	tekercs
nwic	hüvelyk
slit	lő
gzat	újság
krot	vágás
drit	szakáll
hzis	könny
hdap	tizennyolc
sris	történelmi
mrut	bruttó
nyik	sár
bran	menyasszony
drat	függ
djan	óriás
glat	egyszerűség
hpoc	őszi
pras	fátyol
hgot	összejövetel
tret	színház
tras	összehasonlítás
rwit	vetélytárs
hfon	alakítás
klot	edző
hmum	humor
drac	társalgás
rwas	regény
tset	bosszú
hdot	távolabbimeggyőző
ryut	irigy
hwon	meghívás
byat	megégett
flac	vaku
prot	portré
crek	javasol
htok	összeütközés
htop	átok
prit	átkozódóhangulat
hces	tehetetlen
klup	klub
hnos	árvíz
dwin	közöny
prin	horizont
mrit	feltevésszerűhangulat
tcoc	meredek
hcom	harmónia
grit	mennydörgés
tlot	gyermekkor
hgik	térd
hwes	öntudatlan
hzac	kölcsönös
hsec	szoftver
tson	intézmények
ryit	nyugta
dlin	fegyelem
slip	csúszás
klon	forradalom
hfim	földműves
hpom	emelvény
cyen	diák
hgec	barlang
hroc	hagyomány
srac	benyújtja
ryat	tragédia
kcen	szűz-
hbap	búcsú
krik	kritika
krap	pamut-
fwat	kórház
kcet	bérlés
hgas	gáz
pfin	elkerülhetetlen
dlit	levélnövényen
ryan	fordítás
sran	temetés
mrin	Liszt
hram	romantikus
dlan	dollár
hzas	tréfa
hsos	tizenhat
klen	kolónia
gyin	szárny
hsif	oroszlán
cluc	ravasz
prip	készítmény
hzut	köd
dwat	gyógyszer
krit	korrigál
sras	fészek
hses	tizennégy
brat	ellenvetés
flat	sav
hjic	ugyanis
slic	fegyver
hbuc	használó
tron	narancs
byan	fürdőkád
hrif	primitív
tlip	létrehozni
blan	kosár
kris	titkár
hyon	Addig
tren	Ma
dlat	maifeszült
hzic	méreg
tfic	puska
tlen	tehetség
hlim	éghajlat
dyat	társ
kcon	kinyilatkoztatás
dlac	mosás
krak	gyónás
hbas	ostobaság
hkec	szén
hrek	visszaállítás
hkos	kenu
hwif	helyettes
tric	ideiglenes
hdep	delimitativevonatkozás
mwak	halom
ksot	csont
hnoc	hétfő
nlas	kedd
brac	szerda
frap	szövetségi
pfit	reprezentatív
pcoc	pólus
lyen	vászon
swak	mosogató
pcen	elnök
brit	véres
hwec	ostrom
hwet	gyomor
hlos	emeleten
hbon	változatos
pcon	sárgaréz
hsem	csúcstalálkozó
lwac	olcsó
tsos	verseny
kwen	kizárólagosszemély
trun	leszállás
trut	szobor
hrap	tüzérségi
hgap	letartóztatás
trot	hőmérséklet
grin	szomszédság
hjak	ölelés
hpek	csomag
hlus	szarvas
hwos	hálószoba
tsuc	bokor
pcuc	kirakodás
cris	örökös
clun	tölgy
hpes	kellemetlen
nlet	befejezetlen
hrom	program
pyon	zongora
swet	meggyőzni
dric	láthatatlan
tyen	jólismert
hruk	kegyetlenség
frat	kijelölt
hyoc	kísértés
hlep	telikusvonatkozás
nrot	nemzetközi
nret	erőszakosan
hfif	filozófus
pfic	reprezentáció
hmek	érzékeny
hfec	jólét
myik	halászat
truc	lop
tcop	ajak
rwic	visszavonul
htom	gazdaság
glan	Képtár
pren	párhuzamos
hlek	atelicvonatkozás
nrak	kontinens
truk	kopogás
hjim	tiltóhangulat
rwat	nyakkendő
hcep	sejt
dyan	tojás
jrat	mesterséges
nren	ihlet
ksic	válság
tsoc	kutató
lwan	ebéd
hpos	fenyő
hcuf	nyom
tcus	perel
pset	kiterjesztése
hkep	réz
swis	tengerész
prim	császári
trip	ostor
cras	ing
swap	söprés
syet	vázlat
htof	tolvaj
clen	csatorna
kwit	személyiség
klok	többlet
hrok	reform
hguc	szomjúság
kcim	fenyegető
hpem	tenyér
psik	hangszóró
frit	küszöb
cret	nyomai
mrak	lándzsa
syen	ülés
tcup	nyirkos
hyek	utazó
trim	ón-
plak	panasz
hyok	szög
hgam	tehén
hmok	malom
jrac	térkép
kloc	gallér
gyit	szándékosan
hbip	sör
mlet	bársony
lyap	visszaélés
cwen	nyáj
bwan	unokahúg
tses	tizenhárom
jrit	indokol
nlak	kézirat
sron	harcos
cruc	péntek
broc	kefe
dlot	letöltés
krim	krém
pric	hangmagasság
prut	zsűri
hgon	fagyott
sram	szószerint
pfot	edény
hlot	tervezett
djin	érme
hlok	Ugrás
hpep	alma
hwot	sodrott
dlak	megvitatása
brik	Iratkozzfel
nlis	lemásol
hbet	fogadás
pris	vírus
hjik	vendégszeretet
blit	gyerekes
hjap	palást
tfik	tükrözi
hdaf	elérése
hpop	opera
kcaf	bujkál
kcoc	könyök
hrum	javítás
cyim	gyanús
dyic	nevelési
hgoc	gödör
drak	rendetlenség
plas	taps
byin	kétkomponensű
hzap	apátság
nlot	hűség
mrik	mechanikai
hsop	sikeresen
crap	csapda
kyek	torta
nrut	szórakoztat
syes	úr
hjet	tizenhét
hjen	nőies
hmom	édesem
hdec	sajnálatosmódon
lwen	legenda
slot	tűzhely
frac	lázadó
gwan	dagad
mruk	javul
swot	ingovány
zlan	pénztkeres
hnem	élénk
hdes	öltözködés
prak	prédikál
frin	Látvány
hfet	engedélyezi
cros	énekkar
ryon	racionális
tcos	termés
tsen	feldolgozás
hwek	farkas
nlik	elutasítás
klap	szőnyeg
dras	megvet
prop	termékeny
slim	síp
hgis	sajt
krut	harapás
srot	kíséret
bjan	vándorol
nwen	haditengerészet
myas	maszk
kwaf	fejleszt
twis	taxi
pcip	ceruza
srap	növényi
sren	bemutat
tlun	nadrág
hrup	vesztegetés
nrip	szekrény
srup	leves
jran	sebész
bjat	juttatás
gyat	kém
hlem	meggondolatlan
srak	absztrakt
kson	hangsúly
cwis	csütörtök
sret	Tisztelettel
hraf	forgalom
hres	építészet
hsuf	ártalmatlanítása
rwak	repedés
twon	dísz
hfus	felépülés
hkom	kód
djat	vadász
nlut	hírlevél
hsef	kígyó
mris	demokrácia
bric	akkumulátor
mlam	viasz
zran	megosztás
cron	izgalom
hzen	úszás
traf	szalag
cwaf	boríték
srip	cigaretta
mrot	motor
swon	önkéntes
ryak	reakció
pfun	részben
blac	poggyász
mret	minisztérium
hjon	szexuális
kcok	fejsze
dram	gyémánt
kren	váltakozó
tcek	visszhang
hdif	identitás
tfas	nagykövet
hfot	áll
lwas	lusta
hmep	momentanevonatkozás
kfin	kódolás
mwin	képzeletbeli
hrem	sugár
pram	mászó
byac	pince
mren	emlékezetes
swen	szenátus
kras	koporsó
hgun	nyelés
nlok	elkényeztet
ryic	mezőgazdasági
gwin	hinta
srut	rét
hkes	összetett
hfis	lemondás
frak	többször
hnom	összeesküvés
hcop	kocsma
hlec	bors
mlot	dallam
zrat	jelölt
proc	pártfogó
flik	róka
cyet	megbánta
hgim	kémény
slet	sövény
tcok	pontosság
bjit	előzőelhunyt
brot	bimbó
bwat	takaró
hdus	malac
gwat	elefántcsont
kret	kivonat
nwet	megfigyelő
jwan	sugárút
nwis	körmök
mwic	méh
bzat	színész
gyan	izzad
zyit	végrehajtó
blic	illúzió
pcet	bizonytalanság
tsot	szeres
bwit	határ
tres	feszültség
hkof	fogyasztás
nyen	nyögés
hles	hasonlít
cyek	zsák
hjis	tű
gjan	jelenség
prec	viselkedik
drot	ellenőrzött
kcek	ív
twic	csirke
brak	hordó
zwat	szokásos
clap	szokásosvonatkozás
tsec	szakértő
bwin	hatni
cwet	határos
hbek	pék
zlin	olajbogyó
mron	kisteherautó
drin	szán
psap	tegye
gjin	születésnap
clut	kalapács
cwun	illatos
twaf	jelentéktelen
pcot	házikedvenc
krok	koponya
dlik	törvényhozás
cwic	szerencsére
srun	homlokátráncolja
crec	pusztító
jlan	margó
kcip	bajnok
blin	milliárd
ryik	kémiai
mlas	impulzus
flit	pilóta
hzet	csomó
cwik	fenséges
twet	szoknya
mwik	heti
tfis	műszaki
tlon	jármű
cram	hízelgő
grac	erősítése
kraf	varjú
trup	tulajdonság
hduk	horog
cruk	tigris
nrap	házvezetőnő
crot	országút
mlip	milícia
hfoc	fénykép
nres	sértetlenség
plos	plusz
tfam	átlátszó
nlic	tizenkilenc
hwok	képzett
nlen	esszé
fyic	hatékonyság
hwuk	egyedi
hgok	organikus
flic	teológia
flot	úszó
hboc	kötelez
hwoc	boszorkány
syot	stúdió
cwip	pezsgő
hbes	transzparens
lwic	válás
blot	csavar
cwot	fogság
cwam	ér
prik	passzív
hfum	hab
grik	kavics
zrin	kötény
gren	bolygó
hfuc	feltámadás
claf	polc
flas	ventilátor
hjot	tropikus
hbim	önkényes
krek	higany
hbec	jóindulatú
tsaf	öngyilkosság
pwas	bátorság
plot	riporter
kfak	kiad
blak	erkély
hdos	folt
kwis	klasszikus
kcos	vádol
psen	nyugdíj
kres	ige
hzon	majom
srim	aláírás
glin	idegenkedés
mlut	hírhedt
myot	import
fwac	alapító
troc	fáklya
hgaf	nyelvtan
hyop	jacht
ksip	kihalt
sres	kirándulás
hnup	kupola
hzun	makacs
mric	izom
gjat	nagyság
hros	dörzsölés
zrac	gyáván
tros	pirítós
myus	egér
dwac	párbeszéd
byak	kecske
htef	Szabó
hfek	fejlődik
dzan	ró
nyon	névtelen
zrit	hivatalosnyilvántartás
pcos	sport-
hjec	olvad
dlas	töröl
mras	esernyő
mram	ásványi
cwut	fegyverszünet
hbok	kacsa
swun	szappan
dwak	baba
plif	villa
slon	varrás
tfut	gratulál
djac	összeegyeztetni
hjas	elnyomja
kric	nyúl
kwot	karmester
gzan	garancia
clot	játékos
ksek	rovar
psam	testtartás
mwut	bagoly
htem	tartósan
clon	hegedű
dzin	lakó
rwim	illetőleg
hyof	előnyös
dron	sárkány
dwit	hallásibizonyítékonalapuló
sroc	exportáló
hzot	felmondás
djik	habozik
kfik	fedő
ryun	szabályozás
hmes	polgármester
rwac	hardver
sruk	cirkusz
sros	kisebbség
bzan	lázadás
kset	zenekar
bjon	szalonna
hjut	korlátlan
tfen	védekező
zwac	hátrány
dyin	mérlegelés
myis	zenész
mlis	mentálisan
pret	nemmegfelelő
tsek	építészmérnök
hlom	citrom
ksos	köhögés
crok	fejfájás
flin	termékenység
mrun	ács
swec	véletlen
syuk	kanál
blun	ballon
tcep	kréta
fric	felüdítés
rwik	függőleges
rwen	megelőzése
flet	következtetésibizonyítékonalapuló
pfac	kiadó
srek	ecet
tfun	alagút
pwet	kirakósjáték
gyik	matematika
fwot	áttűnés
lwin	kiegyensúlyozott
jwin	máj
bwik	sublativeügy
hdup	BEMÁRT
hnop	monopólium
bwic	tengeralattjáró
ryen	tekintetnélkül
hcem	földrengés
hbos	laboratórium
nrek	munkás
ryim	ritmus
nyic	értelmez
dwas	nagykövetség
rwok	provokál
kram	képtelenség
ksim	kinyilatkoztatóhangulat
clok	csokoládé
pcec	kiváltságos
nyis	remete
tyoc	véletlenegybeesés
grak	karcolás
zlat	kesztyű
hjuk	térdel
trif	földrajz
djit	szisztematikus
pson	legyőzhetetlen
mwis	beruházás
cwec	szóbeli
hdek	világi
blik	sólyom
sloc	pszichológia
brap	darabka
jlat	kalóz
dros	dózis
slam	lazac
pwun	puding
gwik	mágneses
pcop	szivattyú
myen	hasonlóképpen
ksen	oxigén
mrap	művezető
tfot	bizonyítvány
ksus	fürt
trok	retorika
tloc	felhívott
zyan	evezős
nlun	bejelentkezés
hlop	távcső
jlin	helyesírás
lyut	felhős
hsof	hullámtörés
fyik	whisky
klet	viszonylag
hwof	fűzfa
hlum	teve
myet	amatőr
klis	szigetelés
hbaf	életrajz
gwac	szamár
hwum	szóbeszéd
pwik	távlati
pron	pro
myes	havi
mwen	álmodozás
kfic	vakáció
klek	kettyenés
cwon	ovális
lyak	rugalmas
kwon	szótár
hjam	sonka
rwon	szivárvány
crip	ezennel
zwan	előforduló
srok	szerkesztőségi
craf	tizedes
tlok	tartály
brip	pillangó
tfap	diagram
jwat	iker-
pros	üzemeltetési
psun	ómen
clet	szerencsétlenség
hbus	bambusz
dyas	kereskedő
klun	felhalmozódás
jlit	egyhangú
hdom	lidércnyomás
kron	szén
hzam	lekvár
cyot	hallgató
hmem	múzeum
lwam	ábécé
fras	szétszór
psoc	puncs
hgum	gumi
brek	fék
glit	stabilitás
frun	rothadás
gris	agresszív
mroc	súrlódás
bzit	pók
plut	burgonya
glac	kapzsiság
gzac	szaporodnak
prun	pörgés
jlet	naptár
nyim	jelölés
tlos	billió
slut	saláta
fwit	igenlőhangulat
pyen	alkalmazások
nlon	névleges
dren	igazolni
drun	elégedetlenség
cyok	vállvonás
hfop	futball
ryac	társaság
gzin	úttörő
hgip	Fejeskáposzta
tyet	atlétikai
hdof	idiophone
hwup	felbecsülhetetlen
lwek	fogantyú
syec	szenátor
jyak	elhelyezésére
mlim	hangya
fwic	hatékonyan
gzit	terhes
blas	bizalom
jrin	mindennap
gwak	boka
drik	furcsán
prif	változó
jwit	sokféleség
krip	megkülönböztetés
ryot	tiszteletteljes
nwut	járda
kcif	aktívan
jrak	béka
twek	túlzottügy
psot	bűnhődés
pfon	szivacs
sluk	mókus
nlim	irrealishangulat
ksaf	hiány
glak	vulkán
plen	egyensúlyi
kfaf	sál
kyon	kihasználni
jlik	geológiai
psop	útlevél
kfis	üresedés
fyon	affinitás
nram	erkölcstelen
hbuk	keksz
gras	révület
hyos	nyugtalan
flim	film
plet	tabletta
rwam	atom
blis	vanília
zlit	AIDS
fyut	kényes
crim	piramis
hjif	törvénytelen
crif	félénkség
lwap	lant
tyon	csillagászat
mrim	labirintus
drut	leíró
nrim	ösztöndíj
kruc	teknősbéka
kwam	tanácsadó
jrik	krikett
dlut	jelöli
pyot	galamb
dyon	alkalmazkodás
prap	operátor
bzin	jelvény
tyek	háromszög
trec	kincstárnok
nron	hidrogén
pyet	nyomtató
tsok	fojtás
zyin	krónikus
slek	kerékpár
jyin	mérnöki
ryas	átvitel
zrak	Frissítés
nyas	táncos
gric	elvándorlás
zlak	megsért
tces	tenisz
hjun	szeles
twen	szövés
kyet	gyűjtő
gwit	gerinc
kyot	akkord
fwin	frekvencia
tfuc	szövőszék
dlet	Könyvtár
pfik	gondolkodó
bjet	költségvetés
trek	stratégia
kros	kvarc
gjit	olló
gwic	kapcsoló
frik	elméleti
tluc	törülköző
pruc	járőr
glic	gleccser
krun	teljesség
bjin	jóslás
tlaf	résztvenni
tfet	gyártó
bras	oldalsó
dwik	alperes
clec	kipufogó
cres	sakk
tcef	cseresznye
tcom	botlás
nyot	fordító
tyok	kamion
cyip	kimagasló
grot	mustár
bris	drótnélküli
nlam	árverés
slif	Szita
hgos	rozsda
swoc	bizonytalan
jyat	csődbejutott
slum	iszlám
hjes	népszámlálás
dzat	lábujjhegyenmegy
slun	felfüggesztésére
nwot	folytonosság
gyic	gitár
pfas	előítélet
zyik	cink-
blen	fényes
hyem	szilfa
hnep	tülekedés
nyut	kötött
ryam	névmásjelző
clim	fűszer
jret	élesség
tfon	kötekedik
jwac	Jáva
hrep	recept
dyac	választójog
myip	méter
rwis	faji
hkem	üstökös
nwon	innováció
zwin	tilalom
dyis	középkori
mrec	veréb
fyot	lábjegyzet
mlon	mérés
pfis	megerősítés
rwot	pálya
hfok	takarékos
glof	golf
zron	nulla
hzip	postaiirányítószám
hwom	hajléktalan
bjic	rágás
pcim	elegettesz
hjip	csip
bwac	ásít
mlos	anyajegy
mrip	fazekasság
bron	embrió
ksoc	levonás
cyum	élesztő
jyan	szakmainyelv
plim	szilva
mwet	temető
ryet	érettségizni
glik	öntözés
plap	kapitalista
tsif	rugalmasság
gyak	cápa
djon	alapértelmezett
nwun	pontos
cles	realizmus
dris	egyreinkább
hkef	kávézó
blus	mentőautó
blap	pénztárca
bjak	elragadtatott
klim	fintor
gyac	tudós
jyit	egykedvűség
dzit	valószerű
bwak	szabadtéri
dyot	rádió
bwon	bab
fris	informális
klut	spekulál
tfek	steak
nrok	nitrogén
zyat	borotva
bram	motyog
ryis	bevezető
nlip	elemez
nros	kontrasztos
hcof	Levetkőzik
tfif	ösztönző
kroc	barázdál
hdum	judaizmus
pses	befogadó
plok	kiegészítés
lyet	lencse
pwek	pegativeügy
kfas	rák
pwen	zálog
nrun	emlékeztető
clek	szivárog
pcif	fenntartás
glas	bonyolultság
zwit	beszédes
kces	elégséges
crem	kiskereskedelem
grap	Megragad
kwip	beavatkozni
dyut	kedvezmény
crus	hierarchia
gyet	gebe
gram	vicsorog
kyip	gyík
nyet	párna
crop	vízesés
glon	gallon
mrok	szúnyog
fluc	folyékony
dwic	eltérés
slec	felfedező
srec	lejáró
blut	birkózik
myok	mozaik-
tlek	dugó
nruk	fertőző
nwoc	ezentúl
bjut	guggolás
hges	terhesség
twoc	élelmiszerbolt
kyos	kommunista
mrek	meghökkent
clip	bűnbánat
pwok	ügyésziügy
dwot	diktátor
zyac	szórakozottság
jlic	műhold
slop	papucs
ryip	arányos
psim	hozzávetőleges
byet	munkanélküli
cyop	hobby
rwun	kritérium
blop	izzó
syok	támogató
klos	klór
lwot	klorid
byic	baktériumok
lyik	ragadós
blok	biológiai
jlac	kitalál
bret	byte
krif	kiválasztás
blet	balett
nruc	vizelet
tsus	fokhagyma
dyak	középsőosztály
tcem	fogó
cyoc	kihívástjelentő
trep	eper
dlun	környezetszennyezés
hlup	album
hbep	baseball
praf	kalózkodás
pwis	melléknéviigenév
grek	garázs
kruk	mankó
hfof	foszfor
rwut	szerkezeti
myam	tornaterem
krec	daru
jras	szerződőfél
zrik	értesít
blam	bálterem
klip	kézműves
hwef	Kifizetetlen
zlac	banán
gret	generátor
lwuk	borda
nyek	nikkel
blos	busz
sles	cenzor
tlif	csempe
kses	kolbász
mwot	paradicsom
lyot	kocsi
tsom	kálium
brut	tényleges
djap	algebra
hjok	generikus
kfen	fogalmak
pcok	optikai
bzut	mozgat
syek	munkanélküliség
mruc	hernyó
bwas	böngésző
klif	kalcium
rwet	távolimúltfeszült
srif	történelmifeszült
hwem	színkép
syom	nátrium
tyos	megbízott
jyic	túsz
hguk	tök
dwun	ránc
swip	tüske
tlec	ketyegés
blaf	erőszak
tsem	ateizmus
mloc	monitor
gyot	feltételes
trop	szonda
rwap	negyedévenként
hjep	nem
pyim	platina
dlon	duplaszám
pcep	tüdő
twuk	súroló
tyec	címke
syup	szuper
trom	targonca
nyip	helyileg
glis	benzin
gjik	vese
hjos	felügyeletnélkül
hjuc	zsákmány
swek	túldolgozott
psek	arzén
twok	statisztikai
tsep	szöcske
slos	szocialista
nwim	szenzorosbizonyítékonalapulóhangulat
tlop	asztalterítő
trus	vitatott
pwot	póráz
djot	üledék
nloc	pisze
mwon	mandarin
hjek	zsoké
crom	együttműködik
myon	tüdőgyulladás
twec	elhelyez
ryek	rakéta
dlic	osztalék
kwet	korcsolya
bwen	megszállottság
plon	kiosztás
syon	liheg
djis	digitális
byut	kurva
hyep	szemhéj
dwon	átlós
byis	tudatalatti
brec	szemöldök
cyec	tüsszentés
hwop	watt
clus	vicces
kfun	kihasználtság
nwum	hinduizmus
fyim	menekült
cwos	űrsikló
tfoc	szúr
pwon	fehérje
sraf	selfelégedett
hbom	hányás
gyen	gén
drim	újonc
trem	cicoma
tsup	összetör
slok	szociológia
kwoc	Fallabda
bwam	szavazó
mlok	mobilitás
kyen	regionális
hmop	mozgásfárasztó
rwek	visszatekintő
kfup	kocka
grok	sárgarépa
drap	csapdábaejt
lwis	molekuláris
ksuc	Könyvelő
tsop	bűz
kyok	uborka
nroc	orgia
jlot	oldószer
psof	foszfát
hgif	elbűvöl
kfim	lúgos
psos	gimnasztika
pfen	igazolás
kcom	közgazdász
krom	vessző
tluk	tekergőzés
hyom	jód
nwuc	mozgáslesiklás
gjac	vetélés
pcom	hüvely
dzic	tervező
grun	kérkedés
dzot	donor
hzek	mangán
kfot	billentyűzet
jlas	megbízhatatlan
lyim	elit
jyen	jen
pcaf	zárójel
rwip	rögbi
blip	Biblia
kyoc	okozás
lyon	fekély
flis	ragozott
nrif	rágcsál
kfam	kvantum
swes	pulóver
lwon	evolúciós
drec	boncolás
gjap	gyógyfürdő
lyec	lineáris
tyom	antimon
pwuk	superessivusügy
flaf	alfa
myim	immúnis
pcek	emberrablás
bjac	sörfőzde
bzac	rövidít
bzak	zokni
twes	televízió
dwut	dokumentumfilm
ksom	világegyetem
lyis	erdészet
lwim	alumínium
ksok	horoszkóp
sruc	gyors
dlif	delfin
byik	gyilkos
tfec	irodaszer
hjaf	emlős
ryok	jegyzőkönyv
dwis	dioxid
jlon	kettőspont
brus	bürokrácia
gjak	galaktika
lyip	klinikai
ryem	rádium
href	ritkított
prok	hűtőszekrény
slep	szatír
dret	ismétlés
kluk	régészeti
dlis	egyénikifejezésmód
kfip	elfogadhatatlan
mlec	masszázs
pfif	leírás
nrec	szenzoros
pfet	szórólap
hzoc	hátterében
dlam	ideálisan
nlec	embertan
kluc	ízletes
dyet	szedán
tyif	tranzitív
krus	meglapul
nluc	napraforgó
lyun	ion
zrot	kiadatás
ksif	hamisít
psif	kibocsátás
crup	átfedés
fret	kereső
grut	invert
ksec	osztálytárs
jric	útiterv
mrop	mikrohullámúsütő
srus	elűz
gyas	fodrász
floc	folklór
plek	hajszálcsöves
nwop	fenék
nrom	ellenőr
twos	terrorizmus
lwok	szlogen
dwet	túlóra
slem	szublimátum
grip	rostély
gwas	Azta
kwok	kobalt
gwon	zab
hdop	mozgásfolyón
glam	végbélnyílás
bwot	szarvasmarha
bren	bél
byot	videó-
bjik	bojkott
kwim	kvíz
cwek	jégkorong
grif	gerilla
hgem	magnézium
hyes	tudatosság
fram	gyógyszertár
nwos	igénytelen
ryap	átrendezni
cwim	megbízhatóság
klep	hínár
psec	térít
djic	világszerte
kfut	kijárásitilalom
crep	hamburger
frim	elv
gjas	meggyullad
hdef	terhelési
ryum	uránium
pluk	értékeli
krop	koordináta
nraf	adófizető
tyes	integrált
plip	vélekedett
hgom	gamma
hgus	együttható
cwuc	fűtőkészülék
zret	levon
nles	elemző
trof	tárgyatlan
hmof	sétálóutca
hzim	bizmut
dzac	étkező
psok	képeslap
blon	konvergencia
djet	elkalandozik
ksum	részvényes
mrup	mikroba
clif	csigavonal
cloc	morfológiai
tfes	élelmező
gjis	Farmer
jren	összehangolás
tlep	adatbázis
kcup	kupon
glot	feszültség
glut	számológép
srep	kibertér
nwes	beruházó
ksef	xsugár
bzis	Visa
frut	infrastruktúra
nyuk	szentjánosbogár
dyik	detektor
plec	összefonás
brom	bróm
plop	palládium
zlik	szilícium
flut	volt
ksop	kozmetika
gjun	ápolás
kfok	csuklás
hpof	pattogatottkukorica
hzuk	állatkert
nyoc	másodlagosjelentés
jwak	jóga
brim	bárium
kles	lefejez
mwam	igen
fwik	tüzijáték
djas	dzsessz
dyim	hang-
tsum	volfrám
drip	csöpög
lyaf	feleségtartásidíj
prom	programozó
nrup	bemenet
hfes	visszaható
rwaf	krizantém
dlen	dokumentáció
byas	vakcina
fron	heroin
dluk	szétkapcsol
dyun	diagnosztizál
flap	mappa
kfet	katód-
dlim	ideológia
prek	parkolás
syoc	pillanatkép
slus	megközelíthetőség
nlos	antiklimax
mlen	szelén
pres	kéreg
hlof	kén
nlek	jelenlegifontosságjelző
gwot	repülőtér
mwip	csaló
klop	csótány
kwom	króm
hl6t	liter
nwec	ennekellenére
glip	ciklikus
nrop	bérszámfejtés
crum	hormon
dlep	fejlesztő
frot	átfúr
bwoc	szabotázs
fwis	feminista
djok	konjugált
draf	korszerűsítésére
trum	szélsőséges
graf	algoritmus
lwes	lézer
mlem	milliméter
flen	Flex
zlot	anód
swok	odasimul
klec	kutyafáradt
pwim	részidő
htuf	tonhal
fyis	finomító
lwet	érzékenység
mrem	mainframe
jwic	megfiatalodás
droc	tüntető
clem	hélium
dzik	kétnyelvű
psem	vérplazma
hjom	kromoszóma
rwuc	sorrendi
tyus	egészszám
klom	kilométer
hfos	fax
nwek	genetika
jrap	csavarhúzó
zwas	előétel
bwok	brokkoli
dwap	adapter
syem	levélszemét
blek	vektor
tlus	taktika
pyif	meghatározhatatlan
cwoc	rendben
mrep	amper
hbem	vitamin
hxan	portás
hxut	támogat
hk6m	kadmium
hxin	egyidejűség
txin	titán
kxin	kiló
klum	párosodik
xlis	homokóra
hqak	szintaktikai
hxat	kreativitás
hxik	ekönyv
hxas	munkahely
bxon	bór
dxin	induktivitás
hxit	helikopter
tlum	tellúr
txit	határidő
kxat	oxidálódik
hvik	igazítsa
nluk	analóg
nyem	centiméter
hm6t	molibdén
hl6m	lítium
ht6t	multimédia
xlit	kalória
ryop	robot
pxas	gyógyszerész
hxak	házifeladat
lwif	helyhatározóieset
grim	logaritmus
hqat	mantis
qlit	ökológia
xlik	szofistaérveketfejtki
mlep	sablon
hqit	rádióaktivitás
kxim	kilogramm
hxen	bérlő
hxot	sokateszik
kyif	másológép
fwet	ral
txet	részhalmaza
hs6n	egymásutáni
hxet	ereszalja
xrat	hajvágás
hqan	lefoglal
hr6t	irídium
bxat	sávszélesség
dxet	asztali
hxis	exponenciális
hxok	központja
hxek	elhány
srem	cérium
hp6t	részelő
pxik	részelőügy
kxet	kazetta
pruk	szupermarket
hvit	akaraterő
xlin	nemelérhető
frip	titkosítás
hvep	túlfizet
hxon	szinkronizálni
kxit	maximalizálása
hqin	szeminárium
tr6n	sztereó
ht6n	kapocs
hvat	közelgő
sl6s	Celsius
hn6n	neon
ts6t	igaziidő
hvin	áramvonal
pxat	újságos
myoc	modul
ps6s	tészta
bwek	aktatáska
dlok	luxus
fraf	tűzfal
hr6k	műalkotás
txat	ebédidő
hqon	oregano
pxun	plutónium
ks6n	munkaállomás
slef	mozgólépcső
xrit	testőr
hvut	túlzsúfol
xrim	ittrium
hx6t	fokozódó
hqum	felhasználónév
hl6n	értékesítők
gron	argon
pxan	promóciós
hvac	mosogatógép
xlan	globalizáció
txon	hullámhossz
xrik	újrahasznosítása
hxap	hátizsák
hxac	újrakezd
xyat	májgyulladás
cwep	fizetés-ellenőrzés
hxos	oszlopláb
txif	betűtípussal
qlat	ingatlanügynök
txot	őszközepe
hxam	milligramm
pxis	pixel
pwif	előnézet
txam	tantál
myek	termodinamikai
hbop	szünetbanben
hqot	oldottanyag
xlic	kerekesszék
gxit	fajirtás
hvan	tűzoltás
glim	gallium
pfop	popfel
hzum	cirkónium
xlon	forródrót
qlin	nemlineáris
kxam	szkandium
blim	berillium
kxik	Beállítás
nr6n	neuron
hpef	állító
hruf	router
kxan	faktoriális
hxic	irányelv
xlip	röplabda
dyek	hibakeresés
hxop	karóra
qrot	neutron
nwip	nióbium
hs6t	vécé
grem	germánium
tles	félfém-
hp6k	prolativeügy
qyin	abiológiaisokféleség
txak	antibiotikum
mlun	immobilizáció
txan	aktínium
xran	űrhajós
dres	nyomástcsökkent
tr6t	földönkívüli
hk6t	oktett
hxus	nyisdkiforrás
xlat	rögeszmés
mraf	marathon
ts6n	midtavaszi
ht6s	autizmus
nlif	ionizál
txut	előkelőség
hm6n	kibocsátó
kxis	csipeszművészet
xrin	alatt
xren	átirányítás
bxak	könyvjelző
pfos	prokifejezés
hvis	ürülék
hd6n	névadó
brum	tanácsteremben
hqis	soviniszta
hk6n	összeállít
xyit	váltáskulcsfontosságú
xyin	egymásodik
hxun	fennmaradt
hvas	szerepek
glok	blog
hvak	kígyózó
pxit	iplakcim
hvet	következőnaknek
xram	pórsáfrány
hc6n	nyilvánvalóság
qran	Korán
zyen	xenon
hqas	esküszikbanben
bzas	fásult
hj6n	nememberi
hnof	semmitmondó
txas	döntéshozók
hbum	buddhizmus
ts6s	veszekedés
pxin	összetevők
hr6n	adag
hxim	nyárközepéig
dxit	télközepén
hxaf	kiás
nlus	házinövény
txap	állapotbár
vrit	Szellemíró
kxak	bolondkörül
bxin	emberitest
hqik	esőkabát
hxes	hertz
hxif	hipnotizál
xras	óránkénti
pl6k	asszisztens
dxat	meggondolatlanság
hxip	ellenanyag
vrat	rövidnadrág
hqek	átalakítása
qrit	polaritás
pxot	álláshivatal
hxom	hulladéklevél
hqic	bíráló
lwun	kékjean
hp6n	érés
dxan	csatolva
xrak	színészszerep
dxak	baleset
hven	konténerek
mwap	komikusszalag
qlan	színvak
xros	vetkőzés
srom	bemutatóterem
hc6t	beszélgetni
qrat	fejjelle-
hn6t	gátlás
hqet	hálówebhely
fres	fundraise
froc	kovácsolás
xlak	hyperlink
vlat	pergőbeszéd
dvan	akiszállás
gxin	hódító
ryes	recepciós
kxot	csatlakozók
xyan	elhatárolás
vlan	hirdető
ryom	tóriumatom
hluf	régikor
hquk	injekciót
lyum	túliumatom
tyem	terbiumatom
hp6m	prazeodinium
txic	otthonoldal
mros	autós
dyam	ródiumatom
pc6n	próbaszám
nyos	Bejövő
pyek	vetítő
kxon	kripton
hxuc	megmentésére
qrik	centrikusügy
xwin	tapasztalatlanság
kxic	tűzoltókészülék
hvot	folyamatábra
dxot	joghurt
hqut	logki
pxen	megyei
drok	célravasz
flon	mozgótelefon
txos	középsőhang
hqok	ferdeügy
xwik	betegügy
hx6n	premai
txik	indexujj
hqen	feladó
mlap	rosszindulatú
hvun	meggyőzés
hvon	viseletki
vran	levélhordozó
pfes	Egyetemitanár
pwip	költő
hqam	munkaki
gxat	jogszerűség
ks6t	okozó
vrin	toborzó
kxip	csipesztábla
sr6n	rosszalló
vlit	értékelő
tyup	külváros
mrom	morféma
xron	fejhallgató
gxak	drága
hrof	trójailó
xlas	bénult
dzet	újradekorálására
txac	átadó
xrot	felhasználatlan
txis	pontmátrix
syif	siegységek
xrac	meglepően
brif	kétkomponensűérték
dlos	módbeliügy
txun	attribútumok
dvat	rosszedzett
psom	elsőkéz
gjek	másha
nlem	egységnak,-nektömeg
qret	kiskereskedelembolt
txip	hármaspont
dlek	egyénileg
lwut	folyamjelenlegi
dxis	drámaian
hs6m	cézium
vlak	motorkocsi
hn6m	Nerium
kxap	karton
bxan	induló
myem	májushónapja
gxik	civiljogok
hxoc	levegőerő
xrok	munkatárs
kr6t	screenshot
txok	automatikusan
hxep	gördeszka
srop	okostelefon
pxak	sapkákzár
hk6k	népizene
hl6k	Eulerszám
pyom	polóniumatom
xyam	talliumatom
hvic	inváziós
lyok	helyhatározóiesetügy
xlot	lakások
txen	újrafogalmazása
kxac	ellentámadás
qrak	sztrájkokelfojtásával
hbup	úszásmedence
txuk	rövidáramkör
tsef	kúpos
bxit	hálóházigazda
ksem	olvascsak
byim	rubídiumatom
hvam	vanádiumatom
lw6n	lantán
frum	fluoratom
nyom	neodímium
mlom	multalszám
kxas	megszemélyesít
xret	terabyte
hs6k	keresmotor
frus	korrodáló
gxan	galaktikanem
vlas	vocalizations
glet	gázpedál
hvim	futásidejű
bxip	bitmap
qrin	csillagnem
bvak	abessiveügy
pxon	nemérhetőel
dvik	adessiveügy
dvek	agentiveügy
hlef	ügynökravasz
kwek	naknekügy
kxen	közösnem
ht6m	idézetforma
tsuf	transzszámjegy
hf6n	bírságolás
tc6t	közvetlentárgy
gvik	ergatívokügy
gxon	szilánkosodás
ksep	receptor
vyin	filmszínház
pyos	passzívhang
hnef	végesige
xwit	elsődlegestárgy
hqim	gnómikushangulat
jlak	általánosítás
vrik	végsőrészecske
qyan	képzeletbeliegység
kxaf	sebességnak,-nekfény
xyic	adathalászat
qyit	kritikaipont
hvek	evitativeügy
bvik	subessiveügy
hzes	megszállottügy
prus	számítógépvírus
ples	feldolgozó
pxif	rendőrségtiszt
dvak	halmozottügy
brun	túrázó
tsi_k	antessiveügy
tyum	ruténiumatom
vyak	határozóiügy
pxim	elsőminiszter
syum	stronciumatom
sy6n	gyanakvás
hy6n	élőnem
pxac	empatikusöröm
vlin	járműnem
qwin	ásványinem
hr6s	áttétel
tf6n	toner
xris	használófelület
hw6n	káromkodás
xlen	szóbelifőnév
pyec	táblázatkezelő
vlim	ténylegesemlékezet
bres	szófeldolgozó
hqip	felhőszámítástechnika
vlic	ténylegesgép
pfam	spammer
dyap	másodiknyelv
txek	n-edikgyökér
dxen	adatbányászati
byip	üzletiszemély
hs6c	magabizalom
txim	utalva
hb6t	változásnak,-nekesemény
hdem	domainnév
dxon	különbözőesemény
lwaf	vakuhajtás
sl6t	crastinalfeszült
xyik	floppykorong
fyif	visszahatóhang
bvin	világegyetemnem
hm6p	alaplap
tfip	tranzitívige
jlen	helységnem
xrap	csíkos
tc6n	kutatásnem
sl6n	művészetinem
xrek	betegravasz
xwan	absztraktnem
dxif	videókonferencia
dyip	közvetettbeszéd
zrek	exocentricügy
hvuk	felidézve
xwat	múltbefejezett
hr6m	rénium
txaf	kiváltott
hmef	személytelenige
tx6t	szövegszerkesztő
txes	kollektívfőnév
bvat	mistreating
bvuk	absolutiveügy
ry6t	orsócsontiideg
vlis	ténylegesvalóság
qren	földinem
gvak	nyelvtaniügy
bxok	kopasz
mrum	számítógépprogram
ps6t	üzemeltetésirendszer
hfom	fonéma
tlem	olvascsakemlékezet
pwam	spyware
kfif	magbenefactive
qwit	racionalitás
nlaf	telepítés
nwok	asszociációsügy
dzas	nemelégítki
swuk	felsőfokúügy
syos	összegző
kr6n	elektromosjelenlegi
dvin	élettelennem
pxom	propositivehangulat
vris	kölcsönöshang
rwos	aeroszol
dr6t	Testőr
ht6k	távközlés
slaf	társadalmihálózatépítés
lyuk	egymástkikötés
qras	felettesei
ty6n	terminál
gwet	hamarjövőfeszült
hp6s	alkalmazóhang
tsof	antipassivehang
ht6p	továbbképzésvonatkozás
hn6f	necessitativehangulat
pfip	passzívmelléknéviigenév
glap	eszköztár
sy6k	egzisztenciáliskikötés
qyat	világítóintenzitás
hy6t	nyelvtanitárgy
vyan	kinyilatkoztatás
sluf	singulativeszám
dvit	túlzottidőtartama
qyak	egyetlenakcióige
bzik	fizika
xlet	felsőfokúfokozat
hqap	ajándékmelléknéviigenév
qwat	összegnak,-nekanyag
qyik	összekötőrészecske
sr6t	szuperkritikusfolyadék
hfem	beiktatottmorféma
tl6t	távolijövőfeszült
mrif	mikrofon
pcuk	névutósügy
tfim	véletlenhozzáférésemlékezet
fwim	etídium
ly6t	rövidbuzdítóbeszédmegegyezés
hvap	tekercsbár
hfep	gyakorítóvonatkozás
bvan	elosztónévmás
fyun	úszópontszám
xyas	törlés
hvif	igeelhelyezi
xyis	múltpasszívmelléknéviigenév
tl6n	központifeldolgozásegység
tfok	helyhatározóiesetirány-ügy
qwan	gyakrankérdeztekérdések
