hnit	不定詞
hnak	主格場合
hkak	対格場合
htak	トピック場合
hpap	パパ
hmam	ママ
hyat	親の
hcan	こんにちは
hwik	呼格場合
hsuc	祖先
htat	祖父母
hcac	飢えました
hnik	属格場合
hcit	形容詞
hwan	そして
hman	私に
hnan	君は
hwam	米国
htit	それ
htac	先場合
htik	与格場合
hyit	現実相気分
htim	義務に関する気分
hcut	条件付きの気分
hsit	知識の気分
hyak	インストルメンタル場合
htan	インテリアコンテキスト
hpan	人コンテキスト
htin	独立節
hyan	依存句
hfap	完了形アスペクト
hkat	過去時制
hnin	男性性別
hmak	随格場合
hnat	現在時制
hpak	受益者格場合
swik	様格場合
htut	否定的な量記号
hsan	表面コンテキスト
hpin	adpositional場合
hwin	ロケーション場合
hkan	スペースコンテキスト
hnac	方法場合
hyut	疑問詞気分
hnam	そしてまたは
hkit	排他的または
hsuk	ソース場合
hpik	アブレーション場合
hcat	近接
hmat	例証的な
hkuk	句尾
hlan	だけど
hsut	すべて
hyin	ユニバーサル量記号
hcin	フェミニン性別
hpac	複数数
hyik	1
htic	彼らの
hkik	誰
tcat	未来時制
hsin	ソーシャルコンテキスト
hkac	いつ
hmip	未然アスペクト
klan	そこ
hlak	相対場合
hlik	入格の場合
htam	指令気分
hlat	選択科目量記号
hkam	何
hwat	質問単語
htap	コピュラ
hpat	人
nyan	男性
hkas	可能性
tcan	他の
hnuc	数
twit	断定的な量記号
hsak	時間コンテキスト
htuk	一時的な場合
htun	のみ
htum	勧告的な気分
hyip	回顧展アスペクト
hlit	意志による気分
pcic	しなければなりません
tyut	二
hsat	見る
hkut	知っています
hcic	ダウン
hcap	after
hpam	最初
hlac	譲渡可能な所持
hkap	決して
hnic	譲渡できません所持
tyat	古い
tcit	審議気分
tcin	日
hlam	来ます
hwak	母音
hkin	行きます
lwak	perlative場合
hpip	プログレッシブアスペクト
lyan	長いです
hsac	いう
kyan	どうやって
htas	再び
hsic	ここに
hcik	考えます
hcak	下コンテキスト
hfan	発見
hsun	ハンド
hyac	また
nwan	若い
tyit	に対して
tlan	神
twak	降格場合
hmin	何も
hyas	かつて
hlap	semelfactiveアスペクト
kcac	左
hyic	見た
hcas	家
hwac	世界
tyin	三
hnun	ネオ
hcuk	フォーカス
pyan	愛
hsis	常に
hyam	夜
hyap	キング
hkic	の間に
hmas	マインド
cyit	ハート
pluc	paucal数
kyik	なぜなら
ksak	原因となります場合
tcun	終わりました
hnim	名
tsan	適切な名詞
klac	国
hpun	尋ね
cyat	目に見えます証拠の
pcac	より良い
hmac	瞬間
hnas	できません
hwic	水
twim	願望気分
kwan	光
tlat	単語
tyan	ドア
hsas	朝
syat	まで
twik	終止的な場合
hpit	白
pcan	お金
hyis	貧しいです
mwan	死
hfam	形
nwik	内格場合
kcat	一緒に
tsac	しばしば
pyat	友人
psan	ハーフ
hpim	命令気分
hyuc	円形
hfat	送信
hcis	妻
kcan	信じます
hsik	パブリック
htus	状態コンテキスト
hpas	息子
clat	子供
tyak	このようにして
cwan	希望
syin	親愛な
hkuc	高い
tyac	読む
syit	シティ
hlic	既に
hfit	叙実証拠の
tcac	女の子
hcun	聞く
ksan	最低
hyaf	たぶん
kyat	確かに
tcic	体
hwit	リターン
cwat	空気
hfaf	法律
hput	助けて
lyat	文字
ksas	4つの
hpic	願望法気分
hfuk	火災
hcam	時間
twat	戦争
kyak	いくつかの
tlit	二番
pcin	後ろに
hmut	失われました
clan	千
hfac	家族
twan	魂
hwas	質問
syan	真実
htis	メイキング
tsat	潜在的な気分
lwik	向格場合
nyin	人類の性別
hfak	五
tcak	同じテーママーカー
htuc	異なりますテーマ
hnap	回答
hmit	海
hcuc	恐れ
pcat	わかる
syas	条項
hcaf	疑問に思う
twut	探るような気分
hkis	黒
tlak	持って来ます
hyus	綺麗な
nyit	ソート
htip	十
ksis	ストーリー
hpuk	本
hlin	エレクトロニック
hkun	アカウント
lyas	関心
lyit	書きます
pwat	ベッド
hnis	年齢
hnut	事実に反します条件付きの
slas	アート
hwis	vialis場合
pyak	兄
lyin	ライン
tyas	表
hyun	川
kyac	眼
tfan	突然
kcin	深い
hmuc	目的
cyac	血液
hmap	ローズ
tlin	コー​​ルド
hyif	フォワード
tyam	遅く
hnaf	仮定する
hkip	ほぼ
myan	鉱山
tsin	知識
hkup	コピー
hsam	夫
hlis	6
cwit	生活
cyan	平和
myat	覚えています
tyic	ナチュラル
hfut	秋
swas	サービス
hsap	除きます
pcit	著作権
hyim	軍
kyas	うま
plic	未来
pcak	西
hpis	支払う
hyuk	赤
hwun	ゴールド
twin	欲望
plan	遊びます
hpus	オフィス
syun	政府
kyic	教会
htaf	力
hlun	長さ
kyin	会社
kyis	紙
mlan	確率
hcim	特に
cyas	くま
twac	窓
nyat	美しさ
hcus	後者
htup	義務
htif	距離
pyas	足
hlas	野生
ksin	緑
hmaf	トラブル
myac	笑顔
hsim	睡眠
kyit	引用符で囲まれました
kwik	引用癖のあります場合
fwan	訪問
slan	続きます
psit	プレゼンス
hmic	甘い
hmuf	口
hfin	リッチ
tcam	敵
psuk	壊れた
kcap	船
pwan	包括的な人
hfic	影響
tcuc	現れる
hkim	秘密
pyin	お願いします
pwit	嘆願の気分
pyit	丁寧登録
cwak	悪の
myak	行進
tcas	場所
hlaf	滞在
psat	代わりに
nlan	青
psac	不可能
kcuk	学校
kcit	既婚
kcak	フード
syis	20
tlac	静か
hcip	プロスペクティブアスペクト
kwin	与え
tsit	停止
pyac	言語
hsus	週間
hcup	ホール
cyap	ワンダー
tfin	うまれた
fyat	裁判所
hnip	格言家のアスペクト
tsak	尊敬
tlas	価値
syuc	木
plat	壁
cyak	天国
twip	起動相アスペクト
mlat	コマンド
swit	短形気分
mwas	月
hwaf	パーフェクト
tyap	経験
ksac	状況
syac	新鮮な
hnuk	公爵
kwak	覆われました
tyuk	東
pwac	石
hkif	ノーブル
nyac	方向
cyis	椅子
tyuc	待っています
tsun	村
tyik	同意します
hnum	寛大な気分
slak	成功
tsic	しよう
slat	丘
hmik	音楽
hkus	泣く
hsip	セブン
hpaf	プライベート
nwas	ニュース
tfac	シーン
fyan	庭園
cwas	ベギン
hfik	分配の場合
lyac	学びます
syik	政治的
clin	ヘンリー
cyin	うそ
tsas	キャスト
cyik	権限
tlap	床
cyam	夏
tcut	宗教
tcap	エスケープ
hlut	著者
pyun	褐色
tcuk	痛み
swan	春
hmun	柔らかい
kyun	コー​​ナー
nyak	商標
tsis	正義
psas	作物
cyaf	笑い
hwut	忘れる
hyup	ヨーロッパ
hwap	8
psak	通過
kyap	ひどいです
pyic	必須
hmim	ミディアム
hsaf	息
hmis	賢いです
hsum	所有格マーカー
ksat	楽しいです
ksit	墓
tsap	島
kyam	キャンプ
tcum	タッチ
cyun	幸運
psic	海岸
tyun	ドメイン
mwit	約束型気分
tlut	度
myit	冬
kfan	行動
slac	ランニング
myin	分
tyip	鉛
klas	ガラス
pfat	ボード
cyic	無駄な
swam	業務
syam	安全
tsut	医師
hlip	完了相アスペクト
kcas	闇
nyun	暖かいです
hpuc	ドリンク
tlam	例
hfun	怒り
tsik	にもかかわらず
tsam	直接
hmup	帽子
klak	犬
slin	銀
swac	サーバント
kcam	誇り
pyik	列車
myut	道徳
syak	入る
swat	剣
kyuk	攻撃
clac	健康
tyaf	段落
swic	ソーシャル
tfit	払い戻し
hkaf	公式
pcas	一目
nyam	栄光
tfat	12
pcut	従事して
pwin	ワイン
mwat	味
fyac	鉄
syap	分配します
myap	トレード
hyum	使用して
fwak	裁判官
klat	キャプテン
twap	停止アスペクト
kcic	好奇心の強いです
kwic	外国の
hnif	増圧器
myun	重要性
tlic	最後に
cyuk	ネック
syut	自由
pfan	側面
kyuc	ドライ
pcap	余談
tfak	証拠の
tcik	証拠の場合
twun	遠く
tyis	進捗
nyap	狭い
plit	建物
hpif	ページ
pwic	ホールディング
syic	悲しい
tsip	罪
syim	病気
tcis	正直な
pcun	バンク
ksap	受け入れます
lyam	ストリーム
tcaf	慎重に
kwac	耳
hpup	パン
kcut	選択します
nwam	動物
hsup	安息香性別
nwit	事象語気分
tcim	同じイベントマーカー
tlik	乗法場合
kyus	クロス
hmus	厚いです
kfat	挑戦
nwat	成長します
myic	雨
hpum	表面
swut	聖なる
clis	7月
mwun	ファッション
hfas	ファイル
cwac	ショルダー
kwat	快適さ
nwac	誰でも
tcip	希望
kfac	草
hmuk	ドロー
plin	オープニング
kwun	六月
mlik	魚
klin	資本
pfut	乳
twam	請求
fyin	費用
nlit	あなたのもの
mlin	百万
pyut	祈る
hluk	疲れました
ksut	殺します
cyut	影
psin	重量
kcis	グレー
pyam	勇敢な
mwac	満足
klam	伝えます
ksam	国民
hfip	弱い
klik	谷
hkum	投機的な気分
clas	黄
cyuc	熱
mlac	遺跡
syip	同様に
pwak	ボックス
tcif	尖った
psip	原理
ksik	結果
tsim	シーズン
flan	科学
pcam	明らかに
kcun	ボア
ksuk	叔父
mlit	リスト
pcik	危険な
kwas	8月
hluc	人気のあります
klit	未知の
flak	おなじみの
fyit	おなじみの登録
lwat	リーダー
plun	ウォーキング
twas	2回
pcis	祭司
fyas	負傷者
nlat	宮殿
myuk	だまします
pfak	賛成
tcuf	9
cwap	同情
plac	バースト
pyap	パッティング
lyic	服装
hcum	ノイズ
lwit	文献
tsuk	ランク
hfup	嵐
kcik	ポケット
nwap	11月
tyim	12月
psaf	不在
nlac	人口
kyaf	感謝
slis	シリーズ
pyaf	鳥
mlak	オーナー
kwut	コー​​ト
hwuc	関係
pyis	急速に
twuc	煙
nwak	1月
mlic	機械
tlis	ティース
ksun	燃焼
clam	恥
klaf	品質
clit	リング
fyak	フレーズ
fyam	フレーズマーカー
kwap	平方
hwip	日曜日
psis	詩
pwut	preordained
kyim	購入
clic	フィールド
pyip	4月
kfap	10月
psut	オブジェクト
kcuc	苦い
nlap	スレーブ
hsok	緩いです
htet	テキスト
hbat	最悪
hrit	クレジット
hzit	特徴
hpet	15
krac	残酷な
hduc	ほこり
hrik	実用的
hron	色
hnus	鼻
hric	優しいです
srik	供給
hten	昨日
tlet	hesternal時制
slap	失敗します
hban	着る
hdat	ブラインド
fran	飛ぶ
hdan	悪魔
htec	徐々に
hmon	ミッション
cran	犠牲
hran	良心
hmos	大臣
nrit	エネルギー
hcet	嫌い
hset	センター
hrin	ラショナル性別
hcot	楽しみます
hrip	簡潔な
htep	崇拝
hcif	肌
hrat	ルーフ
kran	クラウン
hkon	城
tran	絶望
hmif	マイル
trin	サークル
hgin	刑務所
hkop	カップ
hcen	メンバー
swin	市民の
hrac	どこにでも
hris	カスタム
hbin	なってきて
hmot	お肉
hdut	ミルク
hwen	植物性の性別
nran	レア
hbac	いとこ
crut	ブリッジ
hsoc	株式
hsom	塩
nris	無邪気な
hbit	避ける
crin	感嘆
rwin	女王
hgut	カウント
hdas	ダンス
hnot	ホテル
hdin	埋めます
hton	囚人
hdak	ショップ
hlet	階段
hson	恩赦
hgek	ゲイ
hras	砂
hsep	9月
hbic	破滅
hlen	ライセンス
hcon	十分に
hgit	証人
kfon	キッチン
hbak	売る
tlim	治療
hsot	速度
kyut	コンピューター
hnen	永遠の
htek	ライブラリ
hzan	含みます
hbis	ベース
hbun	混乱
kcus	クック
hgat	砂漠
hwus	キッス
hbif	氷
hbot	玉
hrut	引数
hdit	祝祷気分
hdis	罪を犯しました
hjan	罰
plis	警察
hgan	隠す
hsen	遠征
nrin	無知な
hyen	雲
frif	2月
hdik	疾患
hnek	イニシアチブ場合
hbam	叔母
hmen	謙虚な
hdip	遅延命令
prat	報告証拠の
hdet	真夜中
hjit	指
hmoc	どこか
pran	押す
kcec	領域
hken	最近
hloc	憂鬱
hrak	スタッフ
htes	視線
rwan	褒賞
hdon	寄付します
htot	額
hnet	天使
hdun	単数
croc	エラー
hlon	夜明け
hyec	羊
hjin	忍耐
hrec	参照の
mran	トウモロコシ
htos	多数
hcos	対策
hkoc	時折
hlif	利益
clak	シュガー
hjat	人類
tram	フレーム
hdic	ディスク
hkok	寂しい
srat	アーティスト
crak	チャーム
hmet	Eメール
hden	決定
gran	知事
crac	ブランチ
hjac	熱意
hdim	帰納気分
hcok	急ぎます
hyet	油
pwap	パイプ
trat	印刷
tcot	固形物
hdoc	ああ
hren	談話コンテキスト
tcon	正午
krin	キャビン
plam	警報
hnes	神経質な
tcen	観察
hsek	アスペクト
plik	適用されます
slik	シルク
hfen	セント
hgen	エージェント
hnon	連合
crik	地獄
tcet	不良品
mrat	ミックス
hdam	訓戒気分
hgac	野心
htoc	何とか
hdac	弁護士
nwin	憲法
srit	楽器
hret	しっかりと
nlin	オンライン
hzat	潮
klic	カレッジ
hkek	尾
nric	世代
hgic	混雑しました
hgak	ネコ
trit	直接証拠の
tyot	条約
hnok	コンテンツ
crit	放棄されました
slen	十一
srin	本能
hpok	部族
hyot	不安気分
cric	シェルター
hruc	無礼な
cwin	ライディング
hzak	振ります
dyit	産業
hpec	職業
nras	ナース
hcec	教え
hbut	靴
hmec	漠然としました
twot	アクティビティ
crat	土曜日
hkot	容量
hnec	日光
hwuf	寡婦
cren	小屋
nrat	星
hget	ゲスト
hbik	祝福します
brin	インナー
hpot	利用できます
trac	抵抗
prac	派生する
hcoc	ホロー
hpon	州
hwim	文明
dwan	ハング
cwok	ショック
hdok	運転
crun	宝
hzik	シード
hrot	最近過去時制
hket	起きている
hcek	家具
hrop	ロープ
mrac	冒険
byit	ごちそう
trak	年次
hzin	南方の
sric	式
clik	狩猟
trap	リベラル
hrim	キリスト教
hrus	王女
blat	祭壇
cyon	小さな
hwep	ウェブ
krat	枢機卿
tris	紫の
kcot	ギャザー
hben	選挙
trik	酔っぱらい
kfit	リフト
tcec	交換
nrik	明確な記事
grat	天皇
dran	管理
hpen	以前に
cluk	醜い
nrac	無害の
ryin	トレーニング
hrun	ロール
nwic	インチ
slit	シュート
gzat	新聞
krot	切断
drit	髭
hzis	涙
hdap	18
sris	歴史的
mrut	キモい
nyik	泥
bran	花嫁
drat	左右される
djan	巨人
glat	単純
hpoc	秋
pras	ベール
hgot	集会
tret	劇場
tras	比較
rwit	ライバル
hfon	形成
klot	コー​​チ
hmum	ユーモア
drac	談話
rwas	小説
tset	復讐
hdot	遠位例証的な
ryut	嫉妬深いです
hwon	招待
byat	焦げ
flac	フラッシュ
prot	肖像画
crek	示唆する
htok	紛争
htop	呪い
prit	のろいを表します気分
hces	無力な
klup	クラブ
hnos	洪水
dwin	無関心
prin	地平線
mrit	仮定の気分
tcoc	急な
hcom	調和
grit	サンダー
tlot	幼年時代
hgik	膝
hwes	無意識
hzac	相互
hsec	ソフトウェア
tson	機関
ryit	領収書
dlin	規律
slip	スリップ
klon	革命
hfim	農家
hpom	プラットフォーム
cyen	学生
hgec	洞窟
hroc	伝統
srac	提出します
ryat	悲劇
kcen	バージン
hbap	お別れ
krik	批判
krap	コットン
fwat	病院
kcet	家賃
hgas	ガス
pfin	避けられません
dlit	葉
ryan	翻訳
sran	葬儀
mrin	粉
hram	ロマンチック
dlan	ドル
hzas	冗談
hsos	16
klen	コロニー
gyin	翼
hsif	ライオン
cluc	狡猾な
prip	準備
hzut	ミスト
dwat	医学
krit	校正します
sras	ネスト
hses	14
brat	異議
flat	酸
hjic	すなわち
slic	武器
hbuc	ユーザー
tron	オレンジ
byan	浴
hrif	プリミティブ
tlip	確立します
blan	バスケット
kris	秘書
hyon	その間に
tren	今日
dlat	現在の時制
hzic	毒
tfic	ライフル
tlen	才能
hlim	気候
dyat	メイト
kcon	啓示
dlac	ウォッシュ
krak	告白
hbas	ナンセンス
hkec	石炭
hrek	リストア
hkos	カヌー
hwif	バイス
tric	一時的
hdep	delimitativeアスペクト
mwak	パイル
ksot	骨
hnoc	月曜
nlas	火曜日
brac	水曜日
frap	連邦政府の
pfit	代表
pcoc	ポール
lyen	リネン
swak	シンク
pcen	大統領
brit	血まみれの
hwec	包囲
hwet	胃
hlos	2階
hbon	多様な
pcon	真鍮
hsem	サミット
lwac	安いです
tsos	コンテスト
kwen	排他的人
trun	着陸
trut	像
hrap	砲兵
hgap	逮捕
trot	温度
grin	ご近所
hjak	擁する
hpek	パック
hlus	鹿
hwos	ベッドルーム
tsuc	ブッシュ
pcuc	放電
cris	相続人
clun	オーク
hpes	不快
nlet	不完全な
hrom	プログラム
pyon	ピアノ
swet	説得します
dric	目に見えません
tyen	よく既知の
hruk	残酷さ
frat	割り当てられました
hyoc	誘惑
hlep	TELICアスペクト
nrot	国際
nret	激しく
hfif	哲学者
pfic	表現
hmek	敏感
hfec	福祉
myik	釣り
truc	スチール
tcop	リップ
rwic	リタイア
htom	経済
glan	ギャラリー
pren	平行
hlek	未完了相のアスペクト
nrak	大陸
truk	ノック
hjim	ひどく高いです気分
rwat	ネクタイ
hcep	細胞
dyan	卵
jrat	人工的な
nren	ひらめき
ksic	危機
tsoc	検索
lwan	ランチ
hpos	松
hcuf	押す
tcus	訴える
pset	延長する
hkep	銅
swis	船乗り
prim	インペリアル
trip	ホイップ
cras	シャツ
swap	スイープ
syet	スケッチ
htof	泥棒
clen	チャネル
kwit	人
klok	過剰
hrok	改革
hguc	渇き
kcim	脅迫的な
hpem	手のひら
psik	スピーカー
frit	しきい値
cret	形跡
mrak	槍
syen	セッション
tcup	湿りました
hyek	旅行者
trim	錫
plak	苦情
hyok	角度
hgam	牛
hmok	ミル
jrac	地図
kloc	カラー
gyit	意図的に
hbip	ビール
mlet	ベルベット
lyap	乱用
cwen	群れ
bwan	姪
tses	13
jrit	正当化します
nlak	原稿
sron	戦士
cruc	金曜日
broc	みがきます
dlot	ダウンロード
krim	クリーム
pric	ピッチ
prut	陪審
hgon	フローズン
sram	文字通り
pfot	ポット
hlot	計画されました
djin	コイン
hlok	跳躍
hpep	林檎
hwot	ねじれました
dlak	話し合います
brik	申し込む
nlis	書き写します
hbet	ベット
pris	ウイルス
hjik	ホスピタリティー
blit	幼稚な
hjap	ローブ
tfik	反映します
hdaf	達成します
hpop	オペラ
kcaf	隠蔽
kcoc	肘
hrum	修復
cyim	疑わしい
dyic	教育の
hgoc	ピット
drak	障害
plas	拍手
byin	バイナリ
hzap	修道院
nlot	忠誠心
mrik	メカニカル
hsop	うまく
crap	トラップ
kyek	ケーキ
nrut	楽しませます
syes	サー
hjet	17
hjen	フェミニン
hmom	蜂蜜
hdec	残念ながら
lwen	伝説
slot	レンジ
frac	反乱
gwan	うねり
mruk	改善します
swot	沼地
zlan	獲得します
hnem	アニメの
hdes	ドレッシング
prak	説教
frin	風景
hfet	反対します
cros	コー​​ラス
ryon	ラショナル
tcos	作物
tsen	処理
hwek	狼
nlik	拒否
klap	カーペット
dras	軽蔑します
prop	肥沃な
slim	ホイッスル
hgis	チーズ
krut	一口
srot	護衛
bjan	さまよいます
nwen	海軍
myas	マスク
kwaf	開発します
twis	タクシー
pcip	鉛筆
srap	野菜
sren	示す
tlun	ズボン
hrup	汚職
nrip	キャビネット
srup	スープ
jran	外科医
bjat	手当
gyat	スパイ
hlem	無謀
srak	抽象
kson	アクセント
cwis	木曜日
sret	心から
hraf	トラフィック
hres	建築
hsuf	廃棄
rwak	亀裂
twon	オーナメント
hfus	回復
hkom	コー​​ド
djat	ハンター
nlut	ニュースレター
hsef	ヘビ
mris	民主主義
bric	電池
mlam	ワックス
zran	シェアリング
cron	スリル
hzen	泳ぐ
traf	ストリップ
cwaf	エンベロープ
srip	シガレット
mrot	モーター
swon	ボランティア
ryak	反応
pfun	部分的に
blac	荷物
mret	省
hjon	性的
kcok	斧
dram	ダイヤモンド
kren	代わりの
tcek	エコー
hdif	身元
tfas	大使
hfot	成ります
lwas	怠惰な
hmep	momentaneアスペクト
kfin	エンコーディング
mwin	虚数
hrem	線
pram	クライミング
byac	セラー
mren	思い出深い
swen	上院
kras	棺
hgun	飲み込む
nlok	ふけます
ryic	農業の
gwin	スイング
srut	牧草地
hkes	複雑な
hfis	辞任
frak	繰り返して
hnom	陰謀
hcop	パブ
hlec	コショウ
mlot	メロディー
zrat	候補者
proc	パトロン
flik	狐
cyet	後悔
hgim	煙突
slet	ヘッジ
tcok	正確さ
bjit	前者故人
brot	芽
bwat	毛布
hdus	豚
gwat	象牙
kret	エキス
nwet	観察者
jwan	大通り
nwis	爪
mwic	蜂
bzat	俳優
gyan	汗
zyit	エグゼクティブ
blic	錯覚
pcet	不確実性
tsot	折り畳みます
bwit	境界
tres	応力
hkof	消費
nyen	うめき声
hles	似ています
cyek	袋
hjis	針
gjan	現象
prec	振る舞います
drot	制御されました
kcek	曲線
twic	チキン
brak	バレル
zwat	常習的な
clap	常習的なアスペクト
tsec	専門家
bwin	印象づけます
cwet	有界の
hbek	パン職人
zlin	オリーブ
mron	バン
drin	ささげます
psap	晒す
gjin	お誕生日
clut	ハンマー
cwun	香り高いです
twaf	ささいな
pcot	ペット
krok	頭蓋骨
dlik	議会
cwic	幸いにも
srun	渋面
crec	破壊
jlan	マージン
kcip	チャンピオン
blin	10億
ryik	化学物質
mlas	パルス
flit	パイロット
hzet	結び目
cwik	雄大な
twet	スカート
mwik	毎週
tfis	テクニカル
tlon	車両
cram	お世辞の
grac	強化する
kraf	カラス
trup	属性
hduk	フック
cruk	虎
nrap	お手伝いさん
crot	高速道路
mlip	民兵
hfoc	写真
nres	整合性
plos	プラス
tfam	トランスペアレント
nlic	19
hwok	資格のあります
nlen	エッセイ
fyic	効率
hwuk	ユニーク
hgok	オーガニック
flic	神学
flot	浮く
hboc	義務付けます
hwoc	魔女
syot	スタジオ
cwip	シャンパン
hbes	バナー
lwic	離婚
blot	ボルト
cwot	監禁
cwam	静脈
prik	受動的
hfum	フォーム
grik	砂利
zrin	エプロン
gren	惑星
hfuc	復活
claf	棚
flas	ファン
hjot	トロピカル
hbim	任意
krek	水銀
hbec	慈善
tsaf	自殺
pwas	摘みます
plot	レポーター
kfak	費やします
blak	バルコニー
hdos	染色
kwis	クラシック
kcos	非難します
psen	年金
kres	動詞
hzon	モンキー
srim	署名
glin	リラクタンス
mlut	悪名高いです
myot	インポート
fwac	創業者
troc	トーチ
hgaf	文法
hyop	ヨット
ksip	絶滅しました
sres	遠足
hnup	ドーム
hzun	頑固な
mric	筋
gjat	大きさ
hros	こする
zrac	臆病な
tros	トースト
myus	マウス
dwac	対話
byak	ヤギ
htef	テーラー
hfek	栄えます
dzan	課す
nyon	匿名の
zrit	フォーマル登録
pcos	スポーツの
hjec	メルト
dlas	削除します
mras	傘
mram	ミネラル
cwut	休戦
hbok	アヒル
swun	石鹸
dwak	人形
plif	別荘
slon	縫い
tfut	祝います
djac	調整します
hjas	抑えます
kric	ウサギ
kwot	導体
gzan	保証
clot	プレーヤー
ksek	昆虫
psam	姿勢
mwut	フクロウ
htem	永久に
clon	バイオリン
dzin	居住者
rwim	それぞれ
hyof	有益
dron	ドラゴン
dwit	聴覚の証拠の
sroc	エクスポート
hzot	終了
djik	リンガー
kfik	蓋
ryun	規制
hmes	市長
rwac	ハードウェア
sruk	サーカス
sros	少数
bzan	暴動
kset	オーケストラ
bjon	ベーコン
hjut	無制限の
tfen	防御の
zwac	不利益
dyin	審議
myis	ミュージシャン
mlis	精神的に
pret	不十分な
tsek	建築家
hlom	レモン
ksos	咳
crok	頭痛
flin	肥沃
mrun	大工
swec	ランダム
syuk	スプーン
blun	バルーン
tcep	チョーク
fric	軽食
rwik	垂直
rwen	予防
flet	推論の証拠の
pfac	出版社
srek	酢
tfun	トンネル
pwet	パズル
gyik	数学
fwot	フェード
lwin	バランスのとれました
jwin	肝
bwik	sublative場合
hdup	浸漬
hnop	独占
bwic	潜水艦
ryen	かかわらず
hcem	地震
hbos	研究室
nrek	ワーカー
ryim	リズム
nyic	解釈します
dwas	大使館
rwok	挑発します
kram	できないこと
ksim	宣言型気分
clok	チョコレート
pcec	特権を持ちます
nyis	隠者
tyoc	一致
grak	スクラッチ
zlat	グローブ
hjuk	ひざまずきます
trif	地理
djit	系統的
pson	無敵
mwis	投資
cwec	口頭の
hdek	世俗的な
blik	タカ
sloc	心理学
brap	スクラップ
jlat	海賊
dros	用量
slam	鮭
pwun	プリン
gwik	磁気
pcop	ポンプ
myen	同様に
ksen	酸素
mrap	フォアマン
tfot	証明書
ksus	クラスタ
trok	レトリック
tloc	ラング
zyan	オール
nlun	ログイン
hlop	望遠鏡
jlin	つづり
lyut	曇りました
hsof	サーフ
fyik	ウィスキー
klet	相対的に
hwof	柳
hlum	キャメル
myet	アマチュア
klis	分離
hbaf	バイオグラフィー
gwac	ロバ
hwum	噂
pwik	視点
pron	プロ
myes	毎月
mwen	空想
kfic	休暇
klek	クリック
cwon	オーバル
lyak	エラスティック
kwon	辞書
hjam	ハム
rwon	虹
crip	これによって
zwan	発生
srok	社説
craf	伍長
tlok	タンク
brip	バタフライ
tfap	チャート
jwat	ツイン
pros	オペレーティング
psun	前兆
clet	悲惨
hbus	竹
dyas	ディーラー
klun	累積
jlit	全会一致
hdom	悪夢
kron	炭素
hzam	ジャム
cyot	リスナー
hmem	博物館
lwam	アルファベット
fras	スキャッター
psoc	パンチ
hgum	ガム
brek	ブレーキ
glit	安定
frun	腐敗
gris	積極的な
mroc	摩擦
bzit	クモ
plut	ポテト
glac	貪欲
gzac	かける
prun	スピン
jlet	カレンダー
nyim	指名
tlos	1兆
slut	サラダ
fwit	肯定的な気分
pyen	アプリケーション
nlon	名目
dren	実証します
drun	不満
cyok	肩をすくめる
hfop	フットボール
ryac	パートナーシップ
gzin	パイオニア
hgip	キャベツ
tyet	アスレチック
hdof	イディオフォン
hwup	計り知れません
lwek	レバー
syec	上院議員
jyak	受け入れます
mlim	蟻
fwic	効果的に
gzit	妊娠しました
blas	依存
jrin	毎日
gwak	足首
drik	妙に
prif	変数
jwit	多様性
krip	差別
ryot	恐れおののきました
nwut	歩道
kcif	積極的に
jrak	カエル
twek	過度の場合
psot	償い
pfon	スポンジ
sluk	リス
nlim	非現実相気分
ksaf	希少性
glak	火山
plen	平衡
kfaf	スカーフ
kyon	エクスプロイト
jlik	地質学的な
psop	パスポート
kfis	欠員
fyon	親和性
nram	不道徳な
hbuk	ビスケット
gras	トランス
hyos	不安
flim	膜
plet	タブレット
rwam	原子
blis	バニラ
zlit	エイズ
fyut	気難しいです
crim	ピラミッド
hjif	非合法
crif	内気
lwap	リュート
tyon	天文学
mrim	迷路
drut	記述的な
nrim	奨学金
kruc	カメ
kwam	顧問
jrik	クリケット
dlut	示します
pyot	鳩
dyon	適応
prap	オペレーター
bzin	バッジ
tyek	三角形
trec	会計
nron	水素
pyet	プリンタ
tsok	チョーク
zyin	慢性的
slek	自転車
jyin	エンジニアリング
ryas	送信
zrak	リフレッシュ
nyas	ダンサー
gric	マイグレーション
zlak	違反します
tces	テニス
hjun	強風
twen	ウィーブ
kyet	コレクタ
gwit	脊椎
kyot	コー​​ド
fwin	周波数
tfuc	織機
dlet	ディレクトリ
pfik	思想家
bjet	予算
trek	戦略
kros	石英
gjit	はさみ
gwic	スイッチ
frik	理論的な
tluc	タオル
pruc	パトロール
glic	氷河
krun	完全
bjin	予測
tlaf	参加します
tfet	メーカー
bras	ラテラル
dwik	被告
clec	排気
cres	チェス
tcef	チェリー
tcom	つまずきます
nyot	翻訳者
tyok	トラック
cyip	凌駕
grot	マスタード
bris	無線
nlam	オークション
slif	ふるい
hgos	さび
swoc	不安定な
jyat	破産
slum	イスラム教
hjes	国勢調査
dzat	つま先
slun	サスペンド
nwot	連続
gyic	ギター
pfas	バイアス
zyik	亜鉛
blen	光沢のあります
hyem	エルム
hnep	スクランブル
nyut	編まれました
ryam	代名詞マーカー
clim	スパイス
jret	切れ味
tfon	からかう
jwac	ジャワ
hrep	レシピ
dyac	フランチャイズ
myip	メーター
rwis	人種的
hkem	彗星
nwon	革新
zwin	禁止
dyis	中世の
mrec	スズメ
fyot	脚注
mlon	測定
pfis	批准
rwot	軌道
hfok	質素な
glof	ゴルフ
zron	ゼロ
hzip	ジップ
hwom	ホームレス
bjic	そしゃく
pcim	満たす
hjip	チップ
bwac	あくび
mlos	モル
mrip	陶器
bron	胚
ksoc	控除
cyum	酵母
jyan	専門用語
plim	梅
mwet	墓地
ryet	卒業
glik	かんがい
plap	資本家
tsif	弾性
gyak	鮫
djon	デフォルト
nwun	時間を守ります
cles	リアリズム
dris	ますます
hkef	カフェ
blus	救急車
blap	財布
bjak	恍惚としました
klim	しかめっ面
gyac	科学者
jyit	平静
dzit	現実的な
bwak	アウトドア
dyot	無線
bwon	豆
fris	非公式
klut	推測します
tfek	ステーキ
nrok	窒素
zyat	かみそり
bram	つぶやき
ryis	入門の
nlip	分析します
nros	対照的な
hcof	ふだん着
tfif	インセンティブ
kroc	畝間
hdum	ユダヤ教
pses	受信者
plok	補体
lyet	レンズ
pwek	pegative場合
kfas	癌
pwen	ポーン
nrun	リマインダー
clek	リーク
pcif	弁明
glas	複雑
zwit	おしゃべりな
kces	十分
crem	小売り
grap	つかむ
kwip	介入します
dyut	ディスカウント
crus	階層
gyet	ヒスイ
gram	うなり声
kyip	トカゲ
nyet	パッド
crop	滝
glon	ガロン
mrok	蚊
fluc	流暢
dwic	偏差
slec	冒険者
srec	期限切れ
blut	格闘
myok	モザイク
tlek	プラグ
nruk	感染
nwoc	今後
bjut	スクワット
hges	妊娠
twoc	食料品
kyos	共産主義者
mrek	びっくりさせます
clip	悔恨
pwok	prosecutive場合
dwot	独裁者
zyac	先入観
jlic	衛星
slop	スリッパ
ryip	比例しました
psim	近似
byet	失業者
cyop	趣味
rwun	基準
blop	バルブ
syok	サポーター
klos	塩素
lwot	塩化
byic	細菌
lyik	スティッキー
blok	生物学的な
jlac	装います
bret	バイト
krif	分泌
blet	バレエ
nruc	尿
tsus	ニンニク
dyak	中間クラス
tcem	トング
cyoc	挑戦
trep	イチゴ
dlun	汚染
hlup	アルバム
hbep	野球
praf	著作権侵害
pwis	分詞
grek	ガレ​​ージ
kruk	松葉杖
hfof	リン
rwut	構造上の
myam	ジム
krec	クレーン
jras	請負業者
zrik	通知します
blam	ボールルーム
klip	職人
hwef	未払い
zlac	バナナ
gret	ジェネレータ
lwuk	リブ
nyek	ニッケル
blos	バス
sles	検閲官
tlif	タイル
kses	ソーセージ
mwot	トマト
lyot	オート
tsom	カリウム
brut	バーチャル
djap	代数
hjok	ジェネリック
kfen	コンセプト
pcok	オプティカル
bzut	動きます
syek	失業
mruc	毛虫
bwas	ブラウザ
klif	カルシウム
rwet	リモート過去時制
srif	歴史的時制
hwem	スペクトラム
syom	ナトリウム
tyos	管財人
jyic	人質
hguk	ヒョウタン
dwun	しわ
swip	スパイク
tlec	ダニ
blaf	レイプ
tsem	無神論
mloc	モニター
gyot	条件付きの
trop	プローブ
rwap	季刊
hjep	性別
pyim	白金
dlon	デュアル数
pcep	肺
twuk	精練
tyec	タグ
syup	スーパー
trom	トロリー
nyip	局所的に
glis	ガソリン
gjik	腎臓
hjos	無人の
hjuc	戦利品
swek	過重労働の
psek	砒素
twok	統計的
tsep	バッタ
slos	社会主義者
nwim	感覚の証拠の気分
tlop	テーブルクロス
trus	物議を醸します
pwot	リーシュ
djot	堆積物
nloc	鼻であしらいます
mwon	マンダリン
hjek	騎手
crom	協力します
myon	肺炎
twec	置きます
ryek	ロケット
dlic	配当
kwet	スケート
bwen	強迫観念
plon	割当
syon	パンツ
djis	デジタル
byut	雌犬
hyep	まぶた
dwon	対角線
byis	潜在意識
brec	眉
cyec	くしゃみ
hwop	ワット
clus	陽気な
kfun	占有
nwum	ヒンドゥー教
fyim	難民
cwos	シャトル
tfoc	ズキズキする痛み
pwon	タンパク質
sraf	自己満足
hbom	嘔吐
gyen	遺伝子
drim	新入生
trem	着用
tsup	打ち砕きます
slok	社会学
kwoc	スカッシュ
bwam	有権者
mlok	モビリティ
kyen	地域の
hmop	モーション上り坂
rwek	回顧展
kfup	キューブ
grok	ニンジン
drap	陥れます
lwis	分子の
ksuc	会計士
tsop	悪臭
kyok	キュウリ
nroc	乱交パーティー
jlot	溶媒
psof	リン酸塩
hgif	魅了する
kfim	アルカリ性
psos	体操
pfen	検証
kcom	エコノミスト
krom	コンマ
tluk	リグル
hyom	ヨウ素
nwuc	モーション下り坂
gjac	流産
pcom	ポッド
dzic	デザイナー
grun	壮語
dzot	ドナー
hzek	マンガン
kfot	キーボード
jlas	信頼できません
lyim	エリート
jyen	円
pcaf	括弧
rwip	ラグビー
blip	聖書
kyoc	因果関係
lyon	潰瘍
flis	屈折しました
nrif	ニブル
kfam	量子
swes	セーター
lwon	進化の
drec	解剖
gjap	スパ
lyec	リニア
tyom	アンチモン
pwuk	superessive場合
flaf	アルファ
myim	免疫の
pcek	誘拐
bjac	醸造所
bzac	縮めます
bzak	靴下
twes	テレビ
dwut	ドキュメンタリー
ksom	宇宙
lyis	林業
lwim	アルミニウム
ksok	ホロスコープ
sruc	早めます
dlif	イルカ
byik	キラー
tfec	文房具
hjaf	哺乳類
ryok	プロトコル
dwis	二酸化物
jlon	結腸
brus	官僚
gjak	銀河
lyip	臨床の
ryem	ラジウム
href	希薄な
prok	冷蔵庫
slep	サテュロス
dret	反復
kluk	考古学的な
dlis	特異体質
kfip	容認できません
mlec	マッサージ
pfif	仕様
nrec	感覚の
pfet	リーフレット
hzoc	根底にあります
dlam	理想的に
nlec	人類学
kluc	おいしい
dyet	セダン
tyif	他動詞
krus	縮こまります
nluc	ヒマワリ
lyun	イオン
zrot	引き渡し
ksif	偽ります
psif	エミッション
crup	重複
fret	ファインダ
grut	反転
ksec	同級生
jric	旅程
mrop	マイクロ波
srus	失脚させます
gyas	美容師
floc	民話
plek	毛細血管
nwop	臀部
nrom	コントローラ
twos	テロ
lwok	スローガン
dwet	時間とともに
slem	昇華させます
grip	グリル
gwas	ワオ
kwok	コバルト
gwon	エンバク
hdop	モーション上流地域
glam	肛門
bwot	ウシ
bren	腸
byot	ビデオ
bjik	ボイコット
kwim	クイズ
cwek	ホッケー
grif	ゲリラ
hgem	マグネシウム
hyes	認知度
fram	薬局
nwos	向上心のありません
ryap	再配置します
cwim	信頼性
klep	昆布
psec	払い戻します
djic	世界的に
kfut	門限
crep	ハンバーガー
frim	定理
gjas	発火します
hdef	借方
ryum	ウラン
pluk	評価します
krop	調整する
nraf	納税者
tyes	統合されました
plip	意見を述べました
hgom	ガンマ
hgus	係数
cwuc	ヒータ
zret	引きます
nles	アナリスト
trof	自動詞
hmof	モール
hzim	ビスマス
dzac	ダイナー
psok	はがき
blon	収束
djet	脱線します
ksum	株主
mrup	微生物
clif	ヘリックス
cloc	形態学的な
tfes	仕出し屋
gjis	ジーンズ
jren	アラインメント
tlep	データベース
kcup	クーポン
glot	電圧
glut	電卓
srep	サイバースペース
nwes	投資家
ksef	X線
bzis	ビザ
frut	インフラ
nyuk	ホタル
dyik	検出器
plec	スプライス
brom	臭素
plop	パラジウム
zlik	シリコン
flut	ボルト
ksop	化粧品
gjun	グルーミング
kfok	しゃっ​​くり
hpof	ポップコーン
hzuk	動物園
nyoc	含蓄
jwak	ヨガ
brim	バリウム
kles	首を切ります
mwam	うん
fwik	花火
djas	ジャズ
dyim	オーディオ
tsum	タングステン
drip	ドリブル
lyaf	扶養手当
prom	プログラマー
nrup	入力
hfes	反射的
rwaf	菊
dlen	ドキュメンテーション
byas	ワクチン
fron	ヘロイン
dluk	切断
dyun	診断します
flap	フォルダ
kfet	陰極
dlim	イデオロギー
prek	パーキング
syoc	スナップショット
slus	接近性
nlos	竜頭蛇尾
mlen	セレン
pres	皮質
hlof	硫黄
nlek	現在関連性マーカー
gwot	空港
mwip	偽者
klop	ゴキブリ
kwom	クロム
hl6t	リットル
nwec	それにもかかわらず
glip	サイクリック
nrop	給与
crum	ホルモン
dlep	開発者
frot	穴を開ける
bwoc	サボタージュ
fwis	フェミニスト
djok	共役
draf	近代化します
trum	過激派
graf	アルゴリズム
lwes	レーザ
mlem	ミリメートル
flen	フレックス
zlot	アノード
swok	寄り添い
klec	疲れた犬
pwim	部時間
htuf	シーチキン
fyis	精製所
lwet	感度
mrem	メインフレーム
jwic	若返り
droc	デモンストレーター
clem	ヘリウム
dzik	バイリンガル
psem	プラズマ
hjom	染色体
rwuc	序数
tyus	整数
klom	キロメートル
hfos	ファックス
nwek	遺伝学
jrap	スクリュードライバー
zwas	前菜
bwok	ブロッコリー
dwap	アダプタ
syem	スパム
blek	ベクター
tlus	戦術
pyif	不特定
cwoc	大丈夫
mrep	アンペア
hbem	ビタミン
hxan	ドアマン
hxut	援助します
hk6m	カドミウム
hxin	同時性
txin	チタン
kxin	キロ
klum	交尾します
xlis	砂時計
hqak	構文上の
hxat	創造性
hxik	電子ブック
hxas	職場
bxon	ボロン
dxin	インダクタンス
hxit	ヘリコプター
tlum	テルル
txit	締め切り
kxat	酸化します
hvik	整列します
nluk	アナログ
nyem	センチメートル
hm6t	モリブデン
hl6m	リチウム
ht6t	マルチメディア
xlit	カロリー
ryop	ロボット
pxas	薬剤師
hxak	宿題
lwif	所格
grim	対数
hqat	カマキリ
qlit	エコロジー
xlik	ソフィスティケート
mlep	テンプレート
hqit	放射能
kxim	キログラム
hxen	賃借人
hxot	食べ過ぎます
kyif	コピー機
fwet	フリーウェア
txet	サブセット
hs6n	シーケンシャル
hxet	盗聴します
xrat	散髪
hqan	差し押えます
hr6t	イリジウム
bxat	帯域幅
dxet	デスクトップ
hxis	指数関数
hxok	本社
hxek	置き忘れます
srem	セリウム
hp6t	部分格
pxik	部分格場合
kxet	カセット
pruk	スーパーマーケット
hvit	意志力
xlin	オフライン
frip	暗号化
hvep	余分に払います
hxon	同期します
kxit	最大化します
hqin	セミナー
tr6n	ステレオ
ht6n	ファスナー
hvat	来たる
sl6s	摂氏
hn6n	ネオン
ts6t	リアル時間
hvin	流線
pxat	ニューススタンド
myoc	モジュール
ps6s	パスタ
bwek	ブリーフケース
dlok	デラックス
fraf	ファイアウォール
hr6k	アーティファクト
txat	ランチタイム
hqon	オレガノ
pxun	プルトニウム
ks6n	ワークステーション
slef	エスカレーター
xrit	ライフガード
hvut	混雑させます
xrim	イットリウム
hx6t	増加的な
hqum	ユーザ名
hl6n	販売員
gron	アルゴン
pxan	昇進の
hvac	食器洗い機
xlan	グローバリゼーション
txon	波長
xrik	リサイクル
hxap	バックパック
hxac	再起動
xyat	肝炎
cwep	給与
hxos	トーラス
txif	活字書体
qlat	不動産業者
txot	仲秋
hxam	ミリグラム
pxis	ピクセル
pwif	プレビュー
txam	タンタル
myek	熱力学的な
hbop	ブレークに
hqot	溶質
xlic	車椅子
gxit	ジェノサイド
hvan	消防
glim	ガリウム
pfop	ポップアップ
hzum	ジルコニウム
xlon	ホットライン
qlin	非線形
kxam	スカンジウム
blim	ベリリウム
kxik	設定します
nr6n	ニューロン
hpef	述語
hruf	ルータ
kxan	階乗
hxic	ガイドライン
xlip	バレーボール
dyek	デバッグ
hxop	腕時計
qrot	中性子
nwip	ニオブ
hs6t	トイレ
grem	ゲルマニウム
tles	半金属
hp6k	叙述補助の場合
qyin	生物学的多様性
txak	抗生物質
mlun	固定化
txan	アクチニウム
xran	宇宙飛行士
dres	解凍します
tr6t	地球外の
hk6t	オクテット
hxus	開いたソース
xlat	希代の
mraf	マラソン
ts6n	ミッド春
ht6s	自閉症
nlif	イオン化します
txut	顕著さ
hm6n	発光
kxis	クリップアート
xrin	受けています
xren	リダイレクト
bxak	ブックマーク
pfos	プロフレーズ
hvis	糞便
hd6n	分母
brum	役員室
hqis	狂信的愛国主義者
hk6n	コンパイル
xyit	シフトキー
xyin	1二番
hxun	自給
hvas	役割
glok	ブログ
hvak	蛇行
pxit	腹腔住所
hvet	次に
xram	ベニバナ
hc6n	自明性
qran	コー​​ラン
zyen	キセノン
hqas	誓うに
bzas	気ままな
hj6n	ノン人間
hnof	曖昧な
txas	メーカー
hbum	仏教
ts6s	口舌
pxin	材料
hr6n	配給
hxim	真夏
dxit	真冬
hxaf	掘り出します
nlus	観葉植物
txap	状態バー
vrit	ゴーストライター
kxak	だまします周りに
bxin	人間体
hqik	レインコート
hxes	ヘルツ
hxif	催眠術をかけます
xras	毎時
pl6k	弁護士補助員
dxat	無分別
hxip	抗体
vrat	ショートパンツ
hqek	再形成
qrit	極性
pxot	役職オフィス
hxom	ジャンク郵便物
hqic	レビュー
lwun	青ジーンズ
hp6n	成熟
dxan	取り付け
xrak	俳優役割
dxak	事故
hven	コンテナ
mwap	漫画ストリップ
qlan	色ブラインド
xros	脱衣
srom	ショールーム
hc6t	おしゃべり
qrat	上側ダウン
hn6t	阻害
hqet	ウェブサイト
fres	資金集め
froc	鍛造
xlak	ハイパーリンク
vlat	筆達者
dvan	下船
gxin	席巻
ryes	受付
kxot	コネクタ
xyan	限界
vlan	広告主
ryom	トリウム原子
hluf	古い年齢
hquk	注射します
lyum	ツリウム原子
tyem	テルビウム原子
hp6m	プラセオジム
txic	ホームページ
mros	運転手
dyam	ロジウム原子
pc6n	トライアル数
nyos	受信トレイ
pyek	プロジェクター
kxon	クリプトン
hxuc	救出
qrik	中心の場合
xwin	未経験
kxic	消火器
hvot	フローチャート
dxot	ヨーグルト
hqut	ログでる
pxen	部門別の
drok	ゴール引き金
flon	モバイル電話
txos	中間音声
hqok	斜めの場合
xwik	患者場合
hx6n	事前に現在の
txik	インデックス指
hqen	差出人
mlap	マルウェア
hvun	勧告
hvon	着るでる
vran	郵便物キャリア
pfes	教授
pwip	詩人
hqam	作業でる
gxat	合法性
ks6t	原因となります
vrin	リクルーター
kxip	クリップボード
sr6n	不賛成の
vlit	評価的な
tyup	郊外
mrom	形態素
xron	ヘッドホン
gxak	高価な
hrof	トロイのうま
xlas	麻痺しました
dzet	改装します
txac	明け渡します
xrot	未使用
txis	ドットマトリックス
syif	シユニット
xrac	驚くほど
brif	バイナリ値
dlos	モーダル場合
txun	属性
dvat	悪い和らげられました
psom	最初ハンド
gjek	ほかにもし
nlem	単位の質量
qret	小売り格納
txip	トリプルポイント
dlek	個別に
lwut	フロー現在
dxis	劇的に
hs6m	セシウム
vlak	鉄道車両
hn6m	キョウチクトウ
kxap	段ボール
bxan	出発
myem	5月
gxik	市民のライツ
hxoc	空気力
xrok	同僚
kr6t	スクリーンショット
txok	自動的に
hxep	スケートボード
srop	スマートフォン
pxak	キャップロック
hk6k	フォーク音楽
hl6k	オイラー数
pyom	ポロニウム原子
xyam	タリウム原子
hvic	侵入
lyok	所格場合
xlot	フラット
txen	修正再表示
kxac	反撃
qrak	スト破り
hbup	水泳プール
txuk	ショート回路
tsef	テーパー
bxit	ウェブホスト
ksem	読むのみ
byim	ルビジウム原子
hvam	バナジウム原子
lw6n	ランタン
frum	フッ素原子
nyom	ネオジム
mlom	multal数
kxas	パーソナライズ
xret	テラバイト
hs6k	サーチエンジン
frus	腐食
gxan	銀河性別
vlas	発声
glet	ガスペダル
hvim	ランタイム
bxip	ビットマップ
qrin	星性別
bvak	欠格場合
pxon	利用できません
dvik	位置格場合
dvek	動作主格場合
hlef	エージェント引き金
kwek	に場合
kxen	一般性別
ht6m	引用形
tsuf	トランス数字
hf6n	清澄
tc6t	直接オブジェクト
gvik	能格場合
gxon	フラグメンテーション
ksep	受容体
vyin	映画劇場
pyos	受動的音声
hnef	有限の動詞
xwit	プライマリーオブジェクト
hqim	格言家の気分
jlak	一般化
vrik	最後の粒子
qyan	虚数単位
kxaf	速度の光
xyic	フィッシング詐欺
qyit	クリティカルポイント
hvek	evitative場合
bvik	subessive場合
hzes	所有して場合
prus	コンピューターウイルス
ples	プロセッサ
pxif	警察役員
dvak	lative場合
brun	ツーリング
tsi_k	antessive場合
tyum	ルテニウム原子
vyak	副詞の場合
pxim	プライム大臣
syum	ストロンチウム原子
sy6n	疑わしさ
hy6n	アニメイト性別
pxac	共感的な喜び
vlin	車両性別
qwin	ミネラル性別
hr6s	紹介
tf6n	トナー
xris	ユーザーインタフェース
hw6n	宣誓
xlen	口頭の名詞
pyec	スプレッドシート
vlim	バーチャルメモリ
bres	単語プロセッサ
hqip	雲コンピューティング
vlic	バーチャル機械
pfam	スパム業者
dyap	二番言語
txek	n番目のルート
dxen	データ鉱業
byip	ビジネス人
hs6c	自己信頼
txim	参照
hb6t	変化するのイベント
hdem	ドメイン名
dxon	異なりますイベント
lwaf	フラッシュドライブ
sl6t	crastinal時制
xyik	フロッピーディスクディスク
fyif	反射的音声
bvin	宇宙性別
hm6p	マザーボード
tfip	他動詞動詞
jlen	地域性別
xrap	ストライプ
tc6n	研究性別
sl6n	芸術的性別
xrek	患者引き金
xwan	抽象性別
dxif	ビデオ会議
dyip	間接的なスピーチ
zrek	外心的な場合
hvuk	喚起
xwat	過去完了形
hr6m	レニウム
txaf	トリガー
hmef	人間味のありません動詞
tx6t	テキスト編集者
txes	集合的な名詞
bvat	虐待
bvuk	絶対格場合
ry6t	ラジアン
vlis	バーチャル現実
qren	惑星の性別
gvak	文法的場合
bxok	はげました
mrum	コンピュータープログラム
ps6t	オペレーティングシステム
hfom	音素
tlem	読むのみメモリ
pwam	スパイウェア
kfif	コア受益者格
qwit	合理性
nlaf	装着
nwok	連想場合
dzas	不満を抱かせます
swuk	最上級場合
syos	要約
kr6n	電気の現在
dvin	生気のない性別
pxom	propositive気分
vris	相互音声
rwos	エアロゾル
dr6t	不正解の選択肢
ht6k	テレコミュニケーション
slaf	ソーシャルネットワーキング
lyuk	相次ぎます句
qras	上司
ty6n	ターミナル
gwet	すぐに未来時制
hp6s	実用的な音声
tsof	antipassive音声
ht6p	継続のアスペクト
hn6f	necessitative気分
pfip	受動的分詞
glap	ツールバー
sy6k	実存主義の句
qyat	明るいです強度
hy6t	文法的オブジェクト
vyan	発音を示します
sluf	singulative数
dvit	過度のデュレーション
qyak	シングルアクション動詞
bzik	物理
xlet	最上級度
hqap	現在分詞
qwat	量の物質
qyik	結合粒子
sr6t	超臨界流体
hfem	epenthetic形態素
tl6t	リモート未来時制
mrif	マイクロフォン
pcuk	助詞場合
tfim	ランダムアクセスメモリ
fwim	エチジウム
ly6t	演説契約
hvap	スクロールバー
hfep	反復相アスペクト
bvan	分配の代名詞
fyun	フローティングポイント数
xyas	消去
hvif	動詞接辞
xyis	過去受動的分詞
tl6n	セントラル処理単位
tfok	所格指向場合
qwan	頻繁に尋ね質問
