さようなら: こんにちは, お別れ, バイス
インクルード: 
の: の間に, 約, その
に: 来ます, 広告, 彼ら
に: の間に
最初人: 
私: 私に
三番人: 
それ: それ, それこれ, 誰, キー
彼の: その, 自分の
彼: それ
とともに: 
ために: 五, 約, 広告
として: 誰, インスタンス
二番人: 
あります: 起こります, スタンド
彼女の: その
に: コー​​ル, 約
に: うま, ここに
によって: 通過, そして, 約
これ: 誰, それこれ, あらゆる, いずれか, それ
持ってる: 入手します, くま
または: 
から: 
この: それ, ティース
彼に: その, 人
彼女: 彼ら, それ
じぶんの: 鉱山, 私に, パスワード
彼らの: その, 彼ら, 誰
そう: このようにして, すぐに, 注文
AN: , 1, そして
それら: 彼ら, 君は, 人
我々: 米国, 私に
でしょう: 考えます, 管理します
意志: 意志力
いいえ: しません
もし: 提供
アップ: 上記の, ボード, でる
に: 1, の間に
どれか: いずれか, すなわち, あらゆる, すべて
きみの: あなたのもの
何: 起こります, 行う
示します気分: 指令気分
おとこ: 人, 夫, 男性
他の: 二番, 異なります, もっと
より: もっと, 約, 最大
私たちの: 春, 米国
一部: 何も
に: 上記の, でる
かもしれません: 可能性
今: 現在, もはや
以下のような: 愛, キープ, 似ています
できる: 可能性, ボックス
するべき: しなければなりません, 送信
した: 行う, 事実
そのような: このようにして
A: 1, 
これら: 彼ら, それ
オーバー: 上記の, もっと, 仕上げ, 最大
ずっと: 非常に, ボリューム, 群集, 急な
after: 次, その後
氏: サー, マスター, シード
良い: 綺麗な, すばらしいです, ニート, より良い
決して: しません
最も: もっと, 主として, 多数, 非常に, 最大, 最悪, 最低
条: しなければなりません
それら: 彼ら, その, 誰
彼自身: 自分の, 自分自身
生活: ライブ, ライフスタイル, 母音
無し: 除きます, 14
作ります: フォージ, 行う
よく: 徹底的に, エステート, 右
談話マーカー: 
スルー: 通過
可能性があります: パワー, たぶん, 可能性
どうやって: 方法
あまりに: 非常に, さらに
再び: その後, バック, もはや
たくさんの: 多数, 群集
人: 人, コミュニティ
同じ: 等しい, 彼ら
思想: イデオロギー, アイディア, 考えます
離れて: 遠く, 左, 長いです
下: ダウン
まだ: もっと
場所: スポット, ポジション, どこ
同時に: 時間, 一時的, 一方
ただ: のみ
また: さらに, もっと
まだ: だけど, もっと
しかし: にもかかわらず, だけど, 一方
に対して: 前, 反対
取得する: 入手します, 取る, 可用性, 発見, 派生, つかみます
これまで: 永遠の, 常に, いつ
オフ: 遠く, でる, 覆われました, 閉鎖, 死にます
面: 表面, 百, 人, 口
別の: 1別の, 最終, 異なります, 二番, もっと
新しい: 小説, 新鮮な, 9, 若い
ネオ: 
夫人: 
置きます: キープ, 与える, 行う, 置きます, 十分な
各: あらゆる
伝えます: いう
マインド: 知的, 考えます
少数: 少し, 何も, 少数
事: 問題, 約
誰に: 誰, それこれ
遠く: 遠く, 非常に
呼ばれます: 考えます, いう
全体: フル, すべて, あらゆる, ラジカル
セット: キープ, コレクション, 一緒に, シリーズ
どちらも: 二番, 二
見つけます: 発見, サーチ, 入手します, 住所, 検出
見ます: 見る, チェック, 一目, 現れる
させます: バス, 与える, 日, 注文, 干渉する, 支払う
勧告的な: 
主: マスター, サー, キング
ホーム: 家
何か: 何も, 偏差, 何とか
瞬間: 時間
お父さん: パパ
間の: の間に, いずれか
女性: フェミニン, 女の子, 妻, 男性
女性たち: 
母: ママ
終わり: 最終, 仕上げ, 最後に
ほとんど: 近く, 約, 近似
小さい: 少し
汝: 君は
できません: しません
欲しいです: しなければなりません
しかしながら: だけど, 一方, 1
かなり: 徹底的に, 非常に, 完全に, 十分な
も: 起こります, しません
その: 誰, それこれ, その
ベスト: より良い, 最低
私自身: 私に, 自分自身, 磁気
まで: さらに, 前
から: その後, 最初, なぜなら
中古: 古い, おなじみの
むしろ: 代わりに, もっと, しません
現在: 現在
もっと少なく: 低いです, ダウン, 最低
以内: インナー, 深い, 屋内で, の間に
迄: さらに, 来ます, 前
大: すばらしいです
種類: クラス, ソート, 優しいです, 楽しいです
一定: 決定, 右, 純正, 何も
彼女自身: 自分自身
年: 年次, 五
ハーフ: 途中で, グラインド, 側
真: 純正, 現実的な, 事実, 右
何でも: 何も, 誰, 行う
手段: 方法, 車両, リソース
状態: 調子, 入る, 国, 政府, ルール
一人で: 寂しい, ソロ, 1, 女の子, 自分自身, のみ
場合: 問題, 秋, インスタンス, 起訴, なぜなら
汝: 君は
高い: 上記の, 床
確か: 保証します, 右, 安全, 厳密に
確かに: 事実
自体: 自分自身, 自分の, さらに, 手動で
沿って: 一緒に, 長いです, 長さ
土地: 国, エステート
リターン: 撤退, バック
残します: 休暇, 放棄されました, 左, 許可
どちら: さらに
法律: 右, 法的, ルール
レイ: キープ, 助けて, 仮定する, ポジション
ポイント: スポット, アクション, のみ, 段落
子: 子供
希望: 希望, 欲望, 要求
話して: いう
従って: このようにして, その結果として
時間: 鐘, 時間
間に: 時間, の間に
いくつかの: もっと, 異なります
ビジネス: トレード, 会社, 作業, 職業
かどうか: マザーボード, 行う
やり方: 方法, ファッション, 進捗
理由: アカウント, なぜなら
一般的な: いつもの, パブリック
後ろに: バック
なります: 来ます
デッド: 死にます, 死, 絶滅しました
地球: 国
男の子: 息子
前後: でる, 次
感じます: 感じ, 実現します, 聞く, 考えます
精神: 魂
質問: 問題, 引数
真実: 事実
接地: 床, 国
本当に: 現実的な, 非常に, 事実
残り: 快適さ, リタイア, 遺跡, 休暇, 残り, もっと
可能: たぶん, 可能性
向かって: あらゆる, 側
人間: 人, 人類
ショート: 低いです, 簡潔な, 狭い, 少し
タウン: シティ
以下: 次, 続きます
必要: 必要, しなければなりません
原因: アカウント, 誘発します, なぜなら
イブニング: 夜, 午後
強い: パワー, 暴力的な, 強化する, 神経質な
できます: 資格のあります, できます, 可能性
レディ: フェミニン, 女の子
テーマ: 規律, テーマ, セマンティック, 問題, 従います
同じテーママーカー: 
わかる: 理解, 実現します, 知っています, 平均, 証明します
周りに: 周囲の, 近く, 約, 眼
頼みます: 祈る, お願いします, 尋ね
武器: 武装を解除します, ハンド
順番: 側, シリーズ, 注文, 1
感覚: 理解, 平均, 感じ, セマンティック
持って来ます: 鉛, 取る
閉じる: 閉鎖, 近く, に閉じる
ホールド: キープ, 結び目, 待つ, 持続する
キャラクター: 動作, マーク, 自然, 役割
視力: シーン, 見る, 一目, プレゼンス, 時間
パーティー: ごちそう, コンマ, 採択, 国
罰金: すばらしいです, 微妙
レディー: 準備します, 既に, つま先
一般: いつもの, パートナー, 相互, パブリック
トーク: ネゴシエーション, スピーチ, ストーリー, 話し合います
書かれました: 書きます, 苦い
年齢: 大人, 古い
ほかに: 最終, 異なります, 1別の, もっと
力: パワー, 課す, 玉
アート: 芸術的, ショー
横切って: クロス, 上記の, 反対, 右
早く: 時期尚早, 開始, プリミティブ, すぐに, オープニング
はずです: しなければなりません
太陽: 
後で: 未来, その後, 次
すべてのもの: あらゆる, すべて
過去: 回顧展, 最終
行為: アクション, 作業
大会: 従います, 発見, 見る
さらに: もっと, 追加の, さらに, より良い
思われる: 現れる, 考えます
超えて: もっと, でる
どちらもありません: 起こります, しません
フォワード: 前, 次
ビュー: 意見を述べました, 一目, 見る, 風景, シーン
音: 音声, 単語, トーン
なし: 何も, しません
クリア: 開いた, トランスペアレント, 明らかに, 光
道路: 高速道路, 方法
遅く: ゆっくり, 最終, ディレイ
娘: 女の子, 王女
リアル: 純正, 事実, ロイヤル, リテラル, 現実的な
ほぼ: 近く, 約
知識: 理解, 情報
向かって: 
悪い: 最悪, 悪の, 貧しいです
生活: ライブ, ライフスタイル
平和: ルーム, 沈黙
北: 回答, 真夜中
ナチュラル: 自然, 風景
かわいいです: 綺麗な, 非常に, 十分な
フェア: 右, 報告する, 十, 中性, 彼ら
サービス: サーブ, お手入れ
以下: ダウン
ヘア: 頭
パス: 通過, 近く, 卒業, クロス, 受けます
喜び: ハッピー, 楽しみ, エクスタシー, 陶酔
歴史: ストーリー, 日付, 歴史的
注意: 覚えています, 表記法
しかし: にもかかわらず, だけど, 一方
フロント: 反対, 前
大きい: すばらしいです, 広いです
確かに: 厳密に, コー​​ス
風: 空気
受け取ります: 入手します, 領収書, 取る, 派生, 受けます
注意: お手入れ, 優先, フォーカス, 観点
力: パワー
多分: たぶん
嬉しいです: ハッピー, 陽気な, 満足, 楽しみ
重要: 必要, 間接的な
あなた自身: 自分の, 自分自身
仲間: パートナー, 友人, 人, 協同組合
意見: 意見を述べました, アイディア
信仰: 信じます, 忠誠心
前: 東, その後, 前, バック
電荷: 費用, 取る
腕: ハンド, 貧しいです, スリーブ, ショルダー
後者: 最終, モダン
オブジェクト: 目的, 何も, セマンティック, 抵抗します
紳士: 男性, サー, マスター
さまざまな: 異なります
特定の: 特に, 専門
漸く: しません, レア
チーフ: マネージャー, 頭, 主要な
チャンス: ポジション, 時, 運, 確率
対処: 計画, 契約, 扱います, 対処
考え: 考えます, アイディア
平野: 開いた, ホロー, いつもの, 素朴な
すぐに: かつて, すぐに, 直接
恐れ: 恐れ, 心配して
シングル: 1, 寂しい
喜び: ハッピー, 興奮, 楽しみ, 陶酔
壊れた: 硫黄, カット
ない限り、: 除きます
キャリー: くま, 着る, 妊娠, 取る
影響: 効果, インフルエンザ
外側: でる, 除きます
外観: 現れる, デモンストレーター, シーン
なんでも: いずれか, 行う
滞在: 座ります, 待つ, スタンド, キープ
期間: 段階, 時間, 長いです
シスター: 兄, ナース
戦い: 戦争
前者: 古い, エレクトロニック
若者: 若い
単に: のみ, 寂しい
リーチ: 来ます, 範囲
システム: 注文, 階層, 組織, システム
ディナー: 夜, ランチ, ごちそう
静か: 穏やかな, 沈黙, 寂しい
その後: 未来, その後, 次
歩く: ウォーキング, 行きます, 床
プロパティ: エステート, 条項
ワンダー: 奇跡, 奇妙な, 驚き
フィギュア: デジタル, 統計, 数, 画像
一般に: いつもの
古代: 古い, 古い昔ながら, 古代, プリミティブ
尊敬: 観点, 名誉, 危険, 約
三番: 三, 火曜日
シンプル: 単純, いつもの
残ります: スタンド, キープ
社会: ソーシャル, コミュニティ, 会社
戦い: けんか, 戦争
結果: 効果, フルーツ
コマンド: 注文, 決定づけます
予想: 期待, 希望, 不適切な, 推測
ほんの: のみ, 湖
横: 近く, 次, 側
サイレント: 穏やかな, 沈黙
パーフェクト: 完全に, すばらしいです
通り: 方法, 色, 距離
書き込み: 書きます, 文字
完全に: 完全に, 徹底的に, フル, 積極的に
木材: 木製, 木, スティック
早く: すぐに, 急速に
通知: 見る, 広告, コミュニケーション, 警告
鮮やか: シャープ, 光, 光沢のあります
ボート: 船, 浮く, ヨット
ノーブル: すばらしいです
幾分: 何とか, 何も
突然: 突然
値: 価値
原因: なぜなら, 右
読書: 読む
同意します: 契約, 不承認
ライン: ライン
ピース: チップ, 部, ストレッチ
元: 古い
会話: ネゴシエーション, スピーチ, コー​​ル
適切な: フィット, 最適な, 右
機会: 時, ポジション
コスト: 費用, 支払う, 価値
かなりの: すばらしいです, 間接的な, 印象的な, 十分な
上: 最適な, 上記の, サミット
結婚: 既婚
ステップ: アクション, 段階, ラング, 足
ベギン: 開始, 持続する
あたり: あらゆる
個人: 人, 個別に, 原子
難しいです: ハード, ヘビー
ビット: 部, 少し, ビート
権限: 管轄, パワー
病気で: 病気, 悪の
元の: 純正, リテラル, ルート
幸福: ハッピー, 運, エクスタシー, 楽しみ, 陶酔
提供します: 提供, 与える, 保証します
調査: 学びます, スタジオ
個人的な: プライベート, 個別に, 自分の
時計: チェック, モニター, 見る
喜んで: 満足, ハッピー, 楽しみ
ホット: 暖かいです, 火災, 夏
努力: 試します, 歪み
準備: 準備します, 既に
試み: 試します, クイズ, 刺します
速いです: すぐに, 急速に
下に: ダウン
世紀: 百
意図されました: 意図します, フォーカス, 目的, 準備します
まっすぐ: 直接, ライブ, 正直な
恐らく: 簡単に, 確率, たぶん
正義: 右, 定義
単に: のみ
信頼: 信じます, 忠誠心, 頼ります
通路: 部, 通過, ストレッチ
閉まっている: 閉鎖, に閉じる, 覆われました, パック
われわれ自身: 自分自身
ドレス: ローブ, 服装, リッチ
必須: 必要
ミディアム: 平均
所持: 許可, つかみます
通常: いつもの, 傾向があります
一定: 安定しました, キープ, 決定
軍: 軍
上昇: クライミング, ボード, 成長します
50: 
会議: セッション, アセンブリ, 訪問
キャンプ: キャンプ, フィールド
国家: 国, 国民, レース
存在: プレゼンス
応答: 回答, 払い戻し, 注釈
空: 雰囲気, 天国
幸運: 運, 調子, エステート
ドメイン: フィールド, 範囲
状況: ポジション, 調子, 状況
度: 等しい
中間: 平均, センター, の間に
冬: コー​​ルド, 未来
許可します: 許可
淡いです: 黄, 色, かすかな, パステル, 光
行動: 動作, アクション
ランニング: レース, ラン, 足
宗教的な: 宗教
移動: 移動します, 引数, アクション
やめる: ブレーク, スタンド
もっと悪いです: 最悪, 悪の
口頭の: いう, スピーチ
無駄な: フリー, 空の
損失: 不利益, 失われました, リーク
提供: 提供, 与える, 症状, サーブ, 特権
コンプリート: フル
アクセス: 訪問, 可用性
闇: ダーク
情熱: 感じ
物理的: 物理, 体
例: インスタンス
質問: 引数, 尋ね
開始: 開始
にもかかわらず: にもかかわらず, 最悪, 怒り
深刻: 墓, すばらしいです, 慢性的
銀: お金, 金曜日
十分: 十分な, コー​​​​ヒー
メイン: 頭, マスター, キー, インナー, 主要な
素晴らしい: 奇妙な, 暴力的な, すばらしいです, エレガント, ニート
関連しました: 観点
パス: 方法, コー​​ス
意味: セマンティック, 平均, 重要性
たくさん: 質量, 非常に, 飲み込む
シート: 椅子, 包囲, 本社
ゲーム: ギャンブル, 遊びます
ステートメント: 表現, 報告する, 広告
グレース: お願いします
夢: 悪夢, 睡眠
岩: スカート, 石
特別: 特に, プライベート, 専門, 専門家
移動: モビリティ, 移動します, 母音, 運動
費用: 費用, 支払う
シェア: 部, 杭, 役割, 分配します
期待します: 期待, 待つ, 希望
栄光: 名声, 名誉
スペース: ポジション, ホール, フィールド, 宇宙飛行士
一般: いつもの, 乳製品
考えます: 考えます, 扱います, 観点
大いに: 非常に, 主として, 慢性的
利点: 利益, 目的
役員: 公式
レート: 名誉, コー​​ス
服: ふだん着, 千, 服装
符号: 表記法, ジェスチャー, マーク, スポット
ネイティブ: 自然, 純正, 居住者
差: 異なります, 分化, 区別
ワーキング: 従業員, 作業, 行う, 日
結婚します: 既婚, 入手します
完成しました: 仕上げ, フル
エクステント: バウンド, ボリューム, 範囲, 規模
好奇心の強いです: 面白い, 奇妙な
ほかに: 代わりに, 除きます
方法: 方法, レシピ, かつて, ファッション
優れた: より良い, すばらしいです, エレガント, 非常に
信頼: 信じます
正確に: 特に, フル, 完全に, 徹底的に, 厳密に
ビル: 原稿, アカウント
広大な: 広いです, すばらしいです
ファンシー: 概念の, 綺麗な, 虚数, ニート
クイック: すぐに, 急速に
はい: うん, このようにして, インスタンス
自由: フリー, 独立
余談: 分離しました, 横向きに, 側
ピュア: 新鮮な, 昇華させます
について: 上記の, 約
失う: 置き忘れます, 失われました
証拠の: 証拠
同様の: 似ています, 等しい, なぜ, 彼ら
全く: 徹底的に, 完全に, すべて
ページ: 側, ヤード, ガラス
特に: 特に
山: 丘, 酸
誇りに思う: 誇り
明らかに: 開いた, トランスペアレント, 明らかに, シャープ
価格: 名誉, 価値
30: 13
シャット: 閉鎖, に閉じる, パック, 死にます
運命: 運, 義務
判定: 文, ルール, 裁判官, 管轄, 危機
受け入れます: 許容可能な, 承認します, 取る
種: ソート, 性別, 縦
シーク: サーチ
最高: 最悪, 最低
さもないと: もっと
名誉: 名誉
耳: 許可
ボトム: ダウン, 床, 低いです
援助: エイズ, 助けて, サポート, 扱います
同じイベントマーカー: 
完全に: フル, 完全に, 徹底的に, 十分な
喜び: ハッピー, 不快, 楽しみ, 陶酔
量: ボリューム, 群集, 数, 羊
税金: 家賃, ライン, 納税者, 三
ストレンジャー: ゲスト, 奇妙な, 外国の, 未知の
挑戦: 勇気
生き物: 生体, 生物学的な, 動物
偽: うそ, 違う
背の高いです: 長いです, 床, 長さ
ゲート: ドア
自由に: 独立, フリー, リベラル, 独立して, 緩いです
ブロー: ショック, ストローク, ショット
海岸: ビーチ, 海岸
日々: 日, 日記, 毎日
驚きました: 驚き
分布: 分配します
富: お金, エステート, コピー
自由: フリー, 独立
前進: 進捗, 前
穏やか: 柔らかい, 甘い, 微妙, 男性
確実に: コー​​ス
確保します: 安全, 入手します, 守ります, 保証します
占領下: つかみます, 従事して
ドロー: ドラッグ, 面白い, 削除します
ステージ: アクション, 段階, 調子, シーン
部分: 部
舌: 言語, 串
怒って: 怒り
キャリッジ: 輸送, 列車, トロリー
天気: 空気, 時間
雪: 氷, 眼
必要: 重要性, 必要
練習: 運動, アクション, カスタム
請求: 要求, 起訴, 告白
王子: 公爵, キング
グループ: コングロマリット, 群れ, コレクション, バンド, ボード, グループ
ずっと: どこにでも, ラジカル
同情: 同情, ごめんなさい
加えます: 広げます, 追加の, 増加する, 改善します
リーディング: 鉛, 間接的な, マスター, 人気のあります, 主要な
重量: ヘビー
グレー: 褐色, 灰
勇敢な: 勇気
薄いです: 希薄, 狭い, 微妙
多数の: 群集
頻繁に: しばしば, 繰り返されます, ハッピー
有名な: 人気のあります, よく既知の, 母音, 舞い上がります
強力な: パワー, 神経質な
生きています: ライブ
弱い: かすかな, 貧しいです, 非常に
神: 推測, 神
材料: ハードウェア, セマンティック, 問題, 文献
率直な: 正直な
熱: 夏, 暖かいです
ガード: 守ります, キープ, お手入れ
同様に: バランス, 等しい
当然: 自然
顕著: 奇妙な, すばらしいです, エレガント, 印象的な
月: 月
わずかな: 少し, 簡単に, 光, ささいな
スタイル: 光
尖った: 半球, シャープ, 角度
原理: 理論, 開始
即時の: すぐに, 直接
喜んで: 既に, つま先, マイル, 準備します
結果: 間接的な, 効果, フルーツ, その結果として
入札: 柔らかい, 契約, レース
興味がある: 意図します, 関心
四半期: 足
高度な: 上記の, テクニカル, モダン
アクティブ: 作業, アクション, 効果的な
承知して: 意図的に, 知っています, 知覚
危険な: 危険, サイバー犯罪
神聖: 聖なる
王国: ロイヤル
全体: すべて, フル, ラジカル
すてきな: 綺麗な, 楽しいです
習慣: 動作, 方法, カスタム
リーダー: 歌手, 読む
直接: 直接, 最初ハンド, ライブ
実際に: 現実的な, 事実
アプローチ: 戦術, ファッション, 機構
聴覚: 聞く
スロー: キャスト, ショット
知恵: 知的
真に: 現実的な, 完全に
数字: 数
悲しみ: うつ病, ごめんなさい
ドライブ: 運転, 車両, コー​​ラス, 遠征, 奨励します, 鉛, ラン
障害: 非難, 違う, 障害
事件: 問題, 日
接触: コミュニケーション, タッチ, 紹介します
駅: スタンド, センター, シーズン
電子: 
えっ？: 
聴く: 聞く, リスナー
傷つけます: 損傷, 痛み, 負傷者
表現します: 表現, 説明します, 例証的な
賛成: 側, 積極的に, 酒
高さ: 長さ, 腎臓
サイズ: 次元の, 大きさ, フル, ボリューム, 規模
エッジ: フリンジ, ボード
仕事: アクション, 作業, 義務
苦しみます: 悲惨, ごめんなさい
ノイズ: うるさい, とどろき, 迷惑, 音声
遠いです: 前, より良い, 次
容器: 楽器, 船, 勇気, ポット
愛情: 愛
苦しみ: 拷問, 悲惨, 苦い, トラブル, ごめんなさい
肉: お肉, 体
助言: ボード, 弁護士
壮大な: すばらしいです
役職: 役職オフィス, 送信, ポジション, はがき
ランク: クラス, 情報
想像します: 虚数, 考えます, アイディア
到着: 来ます
想像力: 虚数, 反射, アイディア
大声で: 主張します, すばらしいです, うるさい, ハード
美しい: 綺麗な
非凡な: 奇妙な, 異常な
朝ごはん: 朝, ランチ
人口: 群集
救済: エイズ, 快適さ, グリフ, ファブリック, 助けて
オーナー: マスター, 雇用者
印象: 効果, 感じ, 印象づけます, 印刷, マーク, シール
満足: 満足, 陶酔
関係: 観点
形状: 次元の, 形
誕生: うまれた
コンテンツ: 従います, 満足, 埋めます
考慮: アイディア, 観点, 考えます
レギュラー: 安定しました, 繰り返されます, いつもの, 乳製品
忙しい: 従事して
品質: 質量, 定性
ベイ: ベリー, 膣, のみ
発見する: 発見, サーチ, 開示します
内部: インナー, 深い, 屋内で
土壌: 泥, 床, ソロ, 国, 陶器
完全に: 完全に, 徹底的に, フル
メッセージ: 情報, ニュース
フレーズ: 表現, 文, 単語
言及: 男性
平方: 四角, ボックス
ペア: 右, パートナー, 添付の, ツイン
タイトル: 頭
日曜日: 週間
怒って: だまします
絶対に: 厳密に, 徹底的に, 完全に
スロー: ゆっくり, 穏やかな, 鈍いです
慈悲: 同情
含む: 含めて, 成ります
悲しみ: うつ病, 憂鬱な, 痛み, 悲惨, ごめんなさい
兵士: 軍, ポーン
前: 東, 最終, 前
説明: 説明します, 情報
祈り: 要求, 祈る
信仰: 信じます, 忠誠心
定数: 繰り返されます, 安定しました
最後の: 最終, 最後に, 決定的
ライド: ライディング, ボード, 運転, 自転車
ポリシー: 政治的, 機構, 戦略
お絵かき: 画像, 計画
死にかけています: 死, 死にます
デマンド: 要求
アッパー: 上記の
和: そして, ヨガ, 数
モーション: モビリティ, 移動します, 母音, 運動, 速度
支援: サポート, 助けて
40: 
親切に: お願いします, 優しいです
尊厳: 名誉
キャッチ: 逮捕, 取る
間で: の間に
現在: 現在, ストリーム
たぶん: 確率, たぶん, 可能性
スレーブ: 奴隷制, サーバント, はまって
別: 分離しました, 異なります, ソロ, 個別に, 専門
テロ: 恐れ, テロリスト
コントロール: 制御されました, チェック, 管理します, マスター
当社: 会社, 組織
優れました: より良い, エリート
スピリチュアル: 精神的に, 道徳, 知的
証明: 証明します, 証拠
プロセス: 扱います, 進捗, 方法, 処理
関係: コミュニケーション, 報告する, 観点
心配している: お手入れ, 心配して, 観点
深く: 深い
歌う: 読む, 誰, song
エントランス: ドア, 領収書, しきい値
認めます: 感謝, 与える
供給: 幅, 提供, リソース
クリーン: 新鮮な, ニート, 無邪気な
有用: 必要, 効果的な, できます
繊細な: 微妙, 気難しいです, エレガント, 柔らかい, フェミニン
選択: 選択します, 選挙, チェック, オプション
巨大: すばらしいです, ヘビー
できません: しません, 失敗します
カバー: 蓋, コー​​ト, 毛布, 覆われました
ダブル: ツイン, 2回, かける
勝利: 成功, 利益, ビート
ダース: 12
絶えず: しばしば, 繰り返されます, 常に, 連続, 安定しました, 持続する
レベル: 調子, 表面, 規模
リリース: 放電, 出版, フリー
ラフ: 最悪, 悪い和らげられました, 無礼な
先に: 上記の, 前, 次
接続: バウンド, 添付の, 共役
利得: 入手します, 利益
添加: 追加の, 補体
室: ルーム, ホール, カメラ, キャビン
徐々に: ゆっくり
知り合い: おなじみの, プライマー, 身元
間違い: 違う
ベース: 財団, 条項
車: 列車, 車両, お茶
誰も: 誰でも, 何も
密接に: 慎重に
エネルギー: パワー
裸: 開いた, バー, 恥, ホロー, はげました, 空の, のみ
部分的に: 途中で, 部
色: 色
安全性: 安全, 救い, お手入れ
説明: 情報, 定義
眠って: 睡眠
注意深いです: 慎重に
楽しみます: 楽しみ, ハッピー
ドロップ: 浸漬, 秋, リーク
ブリリアント: 光沢のあります, すばらしいです, 賢いです
物語: ストーリー
グレー: 褐色, 灰
高度に: 非常に
励起されました: 興奮, イライラしている
絶望: 欲求不満, かすかな
楽: 快適さ, 促進します, 低いです
合計: キモい, すべて, 撤退
親切: 美徳
サークル: サーキュレーション, アパート, 円形, ホイール
鈍い: ボア, 低いです
極端な: 最大, 極性の, 非常に, ラジカル, 慢性的
意図: 意図します, 目的
期間: 条項, 締め切り, 単語
適用します: つかいます, アプリケーション, 取る
労働: 作業, 従業員
インテリジェンス: 知的
ストライク: 攻撃, 印象的な, ビート
かなり: 徹底的に, 十分な, 非常に
イベント: 時, ショー
優しく: 柔らかい, ゆっくり
接続: アタッチメント, コー​​ル
保護: 守ります, シェルター, お手入れ, セーブ
意識: 起きている, 意図的に, 感じ
版: 費用, 印刷, 許可, ボード
フライト: 鳥, 飛ぶ, 舞い上がります, 空気, 翼
明らか: トランスペアレント, 証拠, 明らかに
カップル: ツイン, 二
多様: ソート, 異なります
離れて: 分離しました, 遠く, 除きます, 独立して, 二
ひどいです: ひどいです, 悪の
皆: すべて, 誰でも, あらゆる
労働: 作業, 従業員
恋人: 親愛な
スーツ: フィット, マッチング, 起訴
歌います: song
熱心な: 欲望, 心配して, 準備します, キモい
必要とします: 要求, 主張します, 必要
たびに: いつ
ミルク: 乳製品, 乳
成功しました: 成功
ビジョン: 風景, フォーカス
レイズ: 改善します, 広げます, リフト, 増加する
開発: 進捗, 進化の
クール: コー​​ルド, 綺麗な
トライアル: 試します
海外で: 外国の, 亡命
献身的な: 忠誠心, 忠実な
文学の: 文献, リテラル
ライター: 著者, ライター
株式: スティック, 役割, アクション
タイプ: 書きます, 押す
たくさん: リッチ, 冗長性, 十分な, 傾向があります
避ける: 防ぐ, 注文
賛成: 側, 積極的に, 酒
メンタル: 知的, 精神的に, インナー
姿勢: 一目, スタンド, ジェスチャー, 段落
感嘆: 賞賛
不安: 心配して, 恐れ, 先入観
教える: 知っています, 学びます, 教育
カウント: パーティション, 頼ります, アカウント, 集計
好奇心: 心配して
目に見えます: 現れる, 知っています
ガイド: マニュアル, 証拠, 運転, 鉛
実際: 現実的な, 純正, 事実, ロイヤル
悲惨な: 悲しい, 残念な, 悲惨
害: 悪の, 損傷, 一口
ショップ: 書店, 購入, 小売店
恩赦: 許します, ごめんなさい
頼みます: 祈る
滅多: 時々, レア
記録: 録音, ディスク, セーブ
脂肪: 油, 厚いです, 州
平らな: アパート, 曖昧な, 計画
出発: 出口, 行きます
贈り物: 褒賞, 訪問
技能: できます
寺院: 家
ライセンス: 許可, 特許
同意: 承認します, 陶酔, 許可
十分に: フル, 十分な, コー​​​​ヒー
創傷: 損傷, 負傷者, 潰瘍
笑い: 笑い
大胆な: 勇気
証人: 証拠
愚かな: だまします
誰でも: 誰でも, 誰
自己: プライベート, 自分自身, 自分の
極めて: 非常に
治療: 扱います, お手入れ
喉: ネック, 舞い上がります
患者: 病気, 忍耐
成長: 増加する, 進捗, 成長します
量: 質量, 群集, 用量, 数, 大きさ
結論: 撤退, 解決, コレクション, 仕上げ
厳しい: 墓, ヘビー, 厳密に, 暴力的な, 慢性的, キモい
言い訳: 許します, 他動詞, ごめんなさい
原点: 自然, 不定詞, ルート
聴衆: 受動的, パブリック
限られました: 狭い
残り: 遺跡, 残り
ベース: 財団, 言語
勝つ: 成功, ビート
メイド: 女の子, サーバント, バージン
そっと: 柔らかい, ゆっくり, 穏やかな
現実: 事実
輝かしいです: エレガント, 聖なる
同様に: さらに
サイト: シーン, ウェブサイト, スポット
帆: 船, ベール
驚きました: 恐れ
不幸: 残念な, ハッピー, 悲しい
格納: ストレージ, セーブ
リマーク: 意見を述べました, 観点, 注釈, うま
ポーズ: ブレーク
貴重な: 価値
従って: このようにして
工場: クライミング, 木, ミル, 植生
絶対の: フル, リテラル, 完全に, ラジカル
容易に: 簡単に, すぐに
激しい: シャープ, 暴力的な, ハード, 残酷な, 野生
激怒: 怒り
発見: 発見, サーチ, オープニング, 革新
関連しました: 観点
罰: 文
少し: 少し, 簡単に
神秘的な: 秘密, 漠然としました, 目に見えません, 奇妙な
シェード: 影, トーン, ニュアンス
殺人: 殺します
感情: 感じ
破壊: 破滅, 破壊する
ホラー: 恐れ
地元: 局所的に, インナー, スポット
無知な: 無知, だまします
寛大な: リベラル, リッチ
範囲: 距離, シリーズ, 範囲
ホスト: 軍, ゲスト, 群集
ぬれました: 雨, 湿りました
神秘: 秘密
所有します: 自分の, くま, 相続人
意識: 合理性, 感じ, 良心, 式
以前は: 前
費やす: 費用
製造: 作物
ソース: 噴水, リソース, 不定詞
デッキ: ブリッジ, 蓋, グループ
叔母: 叔父
治世: キング, 印税, ルール
コンプライアンス: 続きます, 適応, 高調波, 従います
彼女の物: その
花: 関心, 泥, 栄えます
達成: フル
感謝: 感謝
哲学: 訪問
属する: 含めて, 観点
快適: 徹底的に, 楽しいです
市場: 購入, 市長
キャップ: 帽子, 蓋
どこか: どこでも, どこにでも
喜んで: ハッピー, 楽しみ
家庭: 家族, 家, 経済, 仮定する
艦隊: 船, 海軍, 浮く
赤ちゃん: 子供, 人形
領域: フィールド
: 
正確な: 純正, 粉, フル, フィット, リテラル
画像: 画像, ショー
疑い: 疑問に思う, 疑わしい
ごみ: 抵抗します, 不承認, 廃棄物
スタッフ: クルー, スティック, 従業員
責任: 義務, 非難
視線: 一目, 見る, 見詰める
恥ずかしい: 恥
お食事: フード, 食べる, 粉, ランチ
状態: ポジション, 調子
示す: 入る, ショー, 考えます, 示唆する
詩: 詩, song
発生します: 現れる, 起こります
航海: 遠征, 旅行者
出席する: 参加します
与えます: できます, 購入, 与える, くま
寄付します: 貢献します, 与える
ジョブ: 作業, 日
進みます: 持続する, 増加する, 進捗, ウォーキング, 次
後悔: ごめんなさい, 嘆きます
リスク: 危険
急速な: すぐに, 急速に
異なります: 異なります, 分離しました, 個別に, 対照的な
正しく: 徹底的に, 足, 右
単数: ユナイテッド, 単位, 異常な
エラー: 違う
評判: 賞賛, 名声
アピール: 面白い, コー​​ル
強く: 非常に
欠如: カット, 不在, 部族
暴力: 暴力的な, 拷問
レンダー: 行う, 紹介します, 与える
キャリア: 職業, 作業, ライフスタイル
設計: 計画
商業の: トレード
提案: 示唆する, 文
全くの: フォージ, フル
スペア: 追加の, 置き換える
国内の: 市民の, インナー, 居住者, 国民, サーバント
ファーム: 農業の, 形, フィールド
参照: 参照の, メモリ, 見積もり
存在します: プレゼンス, スタンド, そこ
: 
問題: 条項, トラブル, テーマ, 問題
提供: 提供, 与える
火炎: 火災, 花火
時折: 時々, 繰り返されます
飛行: 飛ぶ
布: ファブリック, 千
第4: 4つの, 水曜日, ルーム
利益: 利益, 目的
: 
章: ドア, 部, 頭, シーズン, 資本, 約
ホール: ボア, ピット, ホール, ホロー
リーズナブル: 賢いです, ラショナル, 十分な
シュガー: 方法
置換: 置き換える, 代わりに, 手当, 交換
ため息: 息
推力: 主張します, 支払う, スクイーズ
フレーム: 規模, 法的, ショット
反対: 抵抗します, 抵抗, 不承認, 反対
物質: セマンティック, 問題, 核
Eメール: 送信, エレクトロニック
分割: パーティション, 部, 解剖
詩: 詩, 段落
決定: 解決, 決定
確からしいです: たぶん, 確率
痛いです: 苦い, 痛み
永遠に: 常に, 永遠の
海洋: 海
リア: バック
リーダー: 頭, マネージャー, 導体, マニュアル
熱心な: 意図します, 心配して, シャープ
熱意: 陶酔, エクスタシー, 興奮
見かけ上: 例証的な, ラショナル, 開示します
急ぎます: すぐに, カーフ
スキーム: 計画, ストライプ, チャート
無用な: 廃棄物
それにもかかわらず: だけど, 一方
スムーズ: 柔らかい, 微妙
固体: 例証的な, 設立, ハード, キューブ
必ずしも: しなければなりません, 必要
ビルド: 建物, 製剤, 一般化します, 準備します
未遂: 試します, 刺します
同等の: 等しい
最近: 最近, モダン, 最終
旅行: 訪問, 観光, 旅行者
正午: 午後, 南
位置して: 秋, ポジション
発表: 広告, コミュニケーション
やめます: 防ぐ, 閉鎖
状況: 調子, エンベロープ, 状況
テント: キャビン, シーン
頻繁な: 繰り返されます, しばしば
警報: 鐘, 怖がらせます
声を出して: 音声, うるさい
独立しました: 独立, 緩いです, 独立して, その
本質的な: 必要, オーガニック
観察: 観察する
恒久的な: 安定しました, 永遠の
感謝: 感謝
保存します: ストレージ, 入手します, 守ります, キープ, セーブ
アスペクト: 側
ナイフ: 剣
恐怖: 恐れ
賢いです: 賢いです, 狡猾な
: 
地区: ライブ, クラス, 州
失敗: 失敗します, 違う, 倒産
セント: あたりセント, 百, パーセンテージ
感情: 感じ
エージェント: 平均
絶望的な: かすかな
連合: アライアンス, ユナイテッド
付与: 承認します, 与える
真剣に: 心から, ヘビー, 重力, 群集
ヒット: かける, 成功
巨大な: すばらしいです, ヘビー
: 
信念: 文
好む: オプション, ハッピー, 優先
熱: 火災, インフルエンザ
インパルス: ひらめき, パルス, 感じ
私たちのもの: 春, 米国
誤りました: 違う, 乱用, 不適切な
理想的: より良い, 異常な
ラッシュ: 群集, ストローク
否定します: 忘れる
正しい: 右, 忠実な, 最適な
実行します: ショー, 行う, 管理します, 持続する
: 
概念: 概念の, アイディア, 感じ
討論: 話し合います, 引数
しっかりと: 設立
帝国: ロイヤル
ペン: 鉛筆, 頭
許可: 許可
維持します: キープ, 守ります, 管理します
混雑しました: スクイーズ, 群集, 密度
制限: バウンド
恐ろしい: ひどいです
ポート: ドア
経験豊かな: 経験, 専門家, 受けます
反対: 反対, 不承認, 対照的な, 抵抗します
条約: メモ, 契約, 任意
コンテンツ: 成ります, 埋めます
モード: 方法
発生する: 起こります, 来ます
探求: サーチ
実質的に: 実用的, 近似
トレース: マーク, 不承認, メモリ
特性: 専門, 動作, 定性, 美徳, 症状
陽気な: ハッピー, 陽気な, 醜い
配置: 注文, 配置, 契約
西部の: 西
圧力: 印刷, スクイーズ
政治: 政治的
科学的: 科学, 科学者
振ります: 
: インダストリアル, 工業化します, 
値する: 賞賛, 資格のあります, 価値, 無罪
インタビュー: 訪問, インタビュアー
地域: フィールド
セックス: 性的, 6, 性別
創造: 生体, 製剤, 設立, 作物
トレイル: マーク, 選挙, 方法, 尾
見通し: 希望, 確率, 風景, シーン, うまくいけば
従う: 従います, 続きます
操作: ドリフト, アクション, 外科医, 操作, マニュアル
北方: 回答
深遠: 深い
一致: マッチング, ギャンブル, レース
鎖: シリーズ, ネックレス
ユニフォーム: ローブ, 服装
債務: 非難, 宗教, 義務, クレジット
教え: 教育
ベンチャー: 冒険, 投資, 会社
実行: 従います, アクション, 実装します
気分: 感じ, ユーモア, 配置
気付きます: 見る, 実現します, 重荷, 理解, つかみます, スパイ, 知覚
宣言する: 説明します
バージョン: コピー, 翻訳
奇数: 奇妙な
感謝します: 感謝
無限: 永遠の, 不定詞
他の場所: どこでも
セキュリティ: 安全, お手入れ
賢明な: 賢いです, ラショナル, 影響を受けやすいです, 最適な
コテージ: 小屋, キャビン
容量: できます, 能力
落ち着きます: 座ります
関連します: 従事して, 参加します, 成ります
協議会: ボード
検査: チェック, 選択します, 試します
鋼: 鉄
テスト: チェック, 試します
慈善: 愛, ボランティア
素子: 要素
小屋: 注ぐ, キャスト, 小屋
誰か: 誰, 人, 誰でも
入射: 事故, 憲法
行: ライン, シリーズ, 政府, 注文
貧困: 貧しいです
激しいです: 暴力的な, キモい
利用できます: 提供, 可用性, 効果的な
修正します: 改善します, 安定しました, 見詰める
珍しいです: 異常な, いつもの, 奇妙な
派生する: 入手します, デリバティブ, 派生, 誘発します
さびれました: 放棄されました, 砂漠, 寂しい
確立: 製剤, 設立
投票: マッチング, 選択します, 音声
耐える: くま, サポーター, 最終, 抵抗します
成功します: 成功, うまく
脚: 足, 骨, ブリッジ
入札: 要求
インテリア: インナー
軽く: 簡単に, 光, 少し
表示: ショー, 症状, シーン, 証拠, デモンストレーター
閉じ込められました: のみ
目的: 目的, フォーカス
クリティカル: 必要, 決定的, 墓
標準: 安定しました
バッグ: ポケット, 袋, バスケット
繰り返す: バック, 繰り返されます
トラック: モニター, song, 方法, 続きます, トラック
取り除きます: 削除します, 無罪, セーブ
レジデンス: シェルター, 配置
: 
楽しいです: 面白い, ハッピー, 陽気な, エンターテインメント, 楽しいです
企業: 会社, 組織
守る: 守ります, 傾向があります, ラン
重く: 墓, ヘビー
スタッフ: 品, 問題
セクション: 部, パーティション, 解剖, 記事
決済: 契約, シェルター
プレート: ディスク
克服します: 対処, ビート
敷地: 財団, 条項
大理石: 石
最近過去時制: 
能力: できます, 才能, 能力
波: 潮, 漠然としました, 波長
フォーク: 人気のあります, フォーク, 民話
可能性: 確率, 可能性
バター: 油
憎しみ: 軽蔑, 嫌い
追求: 起訴, サーチ
引く: ドラッグ, 削除します
信号: ジェスチャー, マーク, パスワード
安全に: 安全
燃やす: 焦げ, 煙
説明します: 説明します
レッスン: 教育, コー​​ス
カード: 段ボール, 地図, 簡潔な, 紙
応用: つかいます, ソフトウェア, 要求, アプリケーション
インテリジェント: 知的, 賢いです
郡: ボイコット, 地域の, シティ, 州, ミリタリー
フォーマット: 形, キャスト, 順列
フロー: ストリーム, ドリフト
60: 16
損傷: 破滅, 損傷
さらに: 追加の, さらに, もっと
コマース: トレード
南方の: 南
アウター: でる
平均: 平均, あらゆる
裸: 恥
明らか: トランスペアレント, 明らかに, 開いた
懸念: お手入れ, 心配して, 関心, 先入観
マジック: チャーム
キャンペーン: 遠征, 運動
ささやきます: つぶやき, 息
一般に: いつもの, しばしば, パブリック
ハント: 狩猟, 魅了する
先生: 著者
弁護士: 弁護士
オペレーション: アクティビティ, ラン
詳細: スプレッド, 仕様
まもなく: すぐに, 簡潔な
祝福: 祝福します
小さな: 少し
鋭く: 速度, シャープ, 非常に
胸: 乳
深さ: 深い, ルーム
パフォーマンス: ショー, 生産性, デモンストレーター
繁栄: 栄えます, 成功, 福祉
概念: 妊娠, 概念の, 逮捕, 感じ
店員: 販売員, 従業員, 公式
決めます: 決定, 決定的
被害者: 狩猟, 犠牲
動機: ひらめき, 意図します, モーター, 目的, テーマ, 酒
明確な: 決定
傾向: 動作, マイル, 配置, ドリフト
リモート: 遠く
フラグ: バナー, 知っています
管理: ルール, 管理します
まれに: レア
以前に: 前
無害の: 安全
トレーニング: 教育
ひどく: 違う, 非常に, 悪の
フィード: 食べる, フード
セントラル: センター, 核, 連邦政府の
コントラスト: 対照的な, 抵抗します, 分化, 区別
構造: 建物, 構造上の, 組織, 組成, 建築, ファブリック
支払い: 支払う
ペース: 速度
問い合わせ: 要求, サーチ, 評価
ロール: 遊びます
どこ: どこ, どこでも
負っています: 罪を犯しました, 義務, 与える
ハンドル: 管理します, 操作
旅行: 訪問, 遠征
シュート: ショット, 亡命, 取る
幸運な: 運
新聞: 日記, 紙, コー​​ラン
雇用: 失業者, 先入観, 作業
切断: カット
決定します: 決定, 決定的, 課す
手数料: ボード
一方、: 一方
交差点: 交差点, クロス, 通過
にぎやか: ライブ
風: 空気
相対: いとこ
それによって: このようにして
提供: 紹介します, 提供, 福祉, 配置, 期待
に対する: 約, 観点
選ぶ: 選択します, 取る
台無しになりました: 破壊する
届けます: 与える, 紹介します, 送信
予期しません: 驚き, 突然
机: 表, オフィス
LANE: ライン, バンド
表します: 代表, インスタンス, いう
立派な: 名誉
花嫁: 王女
責任: 義務, 非難
がっかりした: 野心, 欲求不満
適切な: フィット, マッチング, 右
左右される: バウンド, 頼ります
巨人: すばらしいです, モンスター
把握: 理解, スクイーズ, 実現します, つかみます, シルク
到着します: 来ます, 起こります
秋: 秋
ありません: 不在
暗がり: ダーク
容疑者: 推測, 疑問に思う, 疑わしい
決定: 決定, 報告する, 定義, 解決, 意図します
基本: 財団, 条項, サポート
調べます: 観察する, チェック
賞: 褒賞, プレミアム
購入: 購入
誰か: 人, 誰でも
敗北: ビート, ネックレス, 失敗します, 欲求不満, 謙虚な
犯罪者: 犯罪
愚かな: だまします
想起: 覚えています, 撤退
職業: 職業, 積極的な
談話: モダン, スピーチ, 説教
支援する: 助けて, サポート, 協力
販売: オークション, 売る, ディスカウント
招待: コー​​ル
物語: ストーリー
劣ります: ダウン
認めます: 実現します, 診断, 検出, 知覚
肖像画: 画像
作ります: フォージ, 一般化します, 準備します
紛争: 例外
失望: 欲求不満, 野心, 竜頭蛇尾
建設: 建物, 建築, 組成
熱心: 陶酔, 興奮
責任: 義務
ポジティブ: 積極的に, プロ, 羊
治す: 扱います, お手入れ, 改善します
含めます: 含めて, 入る, 成ります
満たす: 満足, 従います, ふけます, デコード
苦しみ: 苦い, 痛み
愚か: 無知, だまします
粒: トウモロコシ
正確に: フル, 徹底的に, 厳密に
引き受けます: 仮定する, 観点
見積もり: 推測, 見積もり
ルート: 方法, ルート
ビジター: 旅行者, ゲスト, 観察者
ノン: しません, 非合法, 雨
ワイヤー: ライン
ほとんど: 特に, 主として
無意識: かすかな
外部: でる, 外国の
宇宙: 宇宙, 世界
クロック: 鐘
命令: レシピ, 方向, マニュアル, 決定づけます, 教育
痛いです: 潰瘍, 病気, 痛み, 非常に
有効にします: できます
導入: 紹介します, 提供, プライマー, インポート, 役割
条件節: 
荒野: 砂漠
混乱しました: 神経質な, 欲求不満, 混乱, ジレンマ
結婚式: 既婚
: 
代わって: 代表, 側, 部, 代わりに
数えます: 信じます, 頼ります, アカウント
不確か: 不確実性, 不安定な, 漠然としました
エンゲージメント: 従事して, 指名
汚れた: キモい
プラットフォーム: 財団
メッセンジャー: 大使, 天使
医師: 医師
編成: 組織
カバーします: 覆われました, ルーフ
: 
誠実: 正直な, 現実的な, 心から, 優しいです, うん, 純正
感覚: 感じ, 興奮
提出します: , 送信
特定: 特に, プライベート, 専門家
堅いです: ハード
同行します: 従います, 続きます
スコア: マーク
飢え: 飢えました, 貪欲
お気に入り: お気に入り
税関: 伝統, インチ, 義務
感銘を受けて: 感じ, 印象づけます
餌食: 狩猟, 戦利品, 犠牲
ミュージカル: 音楽, ミュージシャン, 高調波
満足のいきます: 疾患
ばかげました: 無知, 陽気な
シート: 紙, 葉, リーフレット
不名誉: 恥, 侮辱的な
もともと: 主として
賃金: 支払う
広範囲: 広いです, 深い
余暇: エンターテインメント, 空の, リタイア, リラックス
顎: 髭, 扱います
グロー: 光, 放射線, フラッシュ
嫉妬: 嫉妬深いです
敵: 不親切な, 敵
鉄道: 鉄道, 列車
ポンド: 本
東の: 東
市民: 市民の
特徴: 特徴
対応: コミュニケーション
リザーブ: 本
妙に: 奇妙な
提案します: 示唆する
樹皮: 皮質, 肌
受付: ようこそ, 領収書, 採択
楽しいです: 楽しいです, 不快, 陽気な
ウェイク: 起きている
研究: サーチ
君主: 天皇, キング
衣類: ファブリック, 服装
病気: 疾患, 病気
日光: 光, 日光
冗談: 笑い
コメント: 説明します, 注釈
金属: 鉄, ミネラル
溶液: 解決, 回答
エンティティ: 楽器, 単位, プレゼンス, 組織, 会社
出発する: 脱線します, 亀裂, 行きます, さまよいます
ひどく: 苦い
穏やかな: 穏やかな
驚いて: 心配して, 怖がらせます
: 
文化: 文化的な, 文明
トリック: 微妙, だまします, 操作, 狡猾な, 化粧
カラム: 純正
ファイナンシャル: お金
準備: 準備します, メーカー
冗談で: 気の利いた言葉, ユーモア
シェル: 皮質, 肌
: 
ネスト: ライブ
想像します: 妊娠, 考えます, 妊娠しました
任命: 指名, 約束する
フェッチ: 取る, 入手します, 派生, 戦術
キャンドル: 光, ランプ
犯罪: 侮辱的な, 攻撃, 犯罪, 質量
混合: ミックス
モデル: インスタンス
欠陥: 非難, しわ, 身体障害
ヒント: 弁護士, ジェスチャー
異議: 抵抗
クラフト: 微妙, 名
ネグレクト: 放棄されました, 省略, ボイコット, 無関心
データ: 情報
武器: 武装を解除します, 銃
ピンク: ローズ
祖父: 祖先, 祖父母
疎遠形の: 
所得: 収入, インポート, 産出
活発な: 暴力的な
ライトニング: エレクトロニック, ボルト, フラッシュ
スポーツ: 運動
パウダー: 粉, ほこり, ドライ
ペインティング: 画像
シャウト: うるさい, とどろき, 泣く
不注意な: 無謀, 無関心
戸口: ドア
便利: 実用的, 簡単に, フィット
郵便物: 役職オフィス, 文字, マッチング
ペイント: 色
降伏: 伝統
確立します: 紹介します, 設立
マイルド: 柔らかい, 選挙区, 希薄
速やかに: かつて
部門: 部
値する: 価値, 資格のあります
やめます: 放棄されました, 亀裂, キャスト, 閉鎖, でる, 辞任
保証: 保証します, 寄託, 頼ります, 約束する
鏡: ガラス
プロット: 計画, ストーリー
上向きに: もっと
悲しそうに: 悲しい, 罪
控えめな: いつもの, 謙虚な
皿: 裁判所, フード, 食べる
ストロー: 草
ネット: ウェブ
せっかち: 忍耐
暖かさ: 暖かいです
落ち着きのありません: 心配して, 不安定な, ブレーク
: 
実験: パイロット, 経験, 試します
途方もない: ひどいです, すばらしいです, 非常に
改善: 改革, 修復, 進捗, 改善します
紛争: けんか, 引数
命題: 文, 計画, 示唆する
多分: たぶん, 可能性
ライフル: 銃
シールド: 守ります
採用します: 採択, 家賃, つかいます, 義務
気候: 雰囲気
異なり、: 異なります, 反対
回復します: セーブ, 大丈夫, バック
メイト: 串, パートナー, 友人
アレンジ: 注文, 法律を制定します, 管理します
委員会: ボード
老人: 古い, 大人
幽霊: 魂
区別する: 分化, 特徴づけます, 区別, 対照的な, 分離しました, 開示します
認識: 実現します, 告白, 身元, 知覚
粘土: 泥, モル, 陶器
トランク: 部族, 荷物, ブート, すばらしいです
管理: 管理します
リストア: バック
抗議: 抵抗します, 行進, 不承認, 抵抗
パイル: ダンプ, 杭, 群集
適度な: 平均, いつもの
スペル: チャーム, つづり, 注文
エリア: フィールド, 地域の, 表面
フォーマル: 公式, 非公式
編集者: 著者, 出版社, 秘書
認める: 告白, 感謝
救済策: 医学, 改善します, 扱います
追求します: ふけます, モニター, 続きます
ポール: ごめんなさい, 極性の, へそ, スティック
バイタル: 必要, 決定的, キー, 致命的な
大統領: 頭, 会長
区: 翼, 地域の, 部
ミズ: 
歓声: ハート, 奨励します, 楽しみ
血まみれの: 血液
正当化: ラショナル, 右, 正当化します
感心します: 賞賛
公然と: 明らかに, 開いた, オープニング
: 
変形: 変化する, 適応
劇的: とどろき, ドラマ, 例証的な, 劇的に
2階: 上記の
多様な: 異なります
降下: 自然
羨望: 嫉妬深いです
負荷: 歪み, 妊娠, バー, 部族, 重荷, 開いた
装います: 装います, ドラマ
内部: インナー
カーテン: ベール
健康: 健康
曖昧な: 漠然としました, 曖昧な
第5: 五
センター: センター
安いです: 低いです
コンテスト: レース
変更します: 変換, 変化する, 置き換える
垣間見ます: 一目
契約する: メモ, 注文, 結び目, 契約
節約: セーブ, ストレージ, 経済
文字列: ロープ, シリーズ
組み合わせ: ミックス, コレクション, コー​​ル
温度: 暖かいです, 水銀
厳格な: 厳密に, シャープ, ハード
プロ: 職業, プロ
負傷しました: 負傷者, 損傷
ご近所: 周囲の, ライブ
喫煙: 煙, シガレット
医療の: 医師
知らせます: 情報
目立ちます: 人気のあります, 思い出深い, 間接的な, キー, よく既知の
機関: 会社, 組織
擁する: 寄り添い, 歪み
苦悩: 苦い, 悲惨, 痛み, 拷問, ごめんなさい
明らかに: 開いた, 明らかに, トランスペアレント
キャプチャー: 魅了する, 逮捕, 取る
: 
十分な: 十分な, 広いです, 群集
ベッドルーム: ルーム
純粋に: のみ, 徹底的に
ジョイント: 一緒に, パートナー, ミックス, コー​​ル, 相互, ユナイテッド
参照します: 参照の, 見る
識別する: 身元, 実現します, 検出
ベンチ: バンク
レスキュー: セーブ, 救い
リミット: バウンド, 縮めます
期待: 期待, うまくいけば, 希望
: 
プログラム: 計画, 議題
発明: 発明します, 革新, サーチ
: 財布, 
電気の: エレクトロニック
間隔: 一時的, ブレーク
追跡: 狩猟
占める: 取る, つかみます
ガウン: コー​​ト, 服装, ローブ
ロック: 城
最低: 最悪, 最低
: ためらいます, リラクタンス, 疑問に思う, 
提案: 示唆する, 文, 計画
幸せに: ハッピー
続きます: 次, その後, 続きます
不安な: 不安定な, 不快, 心配して
輝き: フラッシュ, 日光, 研磨
機械: メカニカル, 機械, 機構
魅力的: 面白い, 磁気, 望ましい
製品: 品, 作物
経済の: 経済, 簡潔な
病気: 疾患, 病気, ボトル
エンジン: モーター, 機械
彼らのもの: 彼ら
レザー: 肌
スロープ: マイル, 浸漬, 曲がりました
心配: 心配して, 先入観, お手入れ
激しく: ハード
: 
指定の: 決定, 名目
木材: 木製, スティック, 木
計算します: アカウント
殺害: 殺します
おかしいです: 奇妙な, 陽気な
侮辱: 侮辱的な, 軽蔑, 恥
表現: 表現, メモ
できません: できます
食事をします: 食べる, フード, ランチ
敏感: 影響を受けやすいです, キー
食欲: 欲望, 貪欲
礼儀: 丁寧, 名誉
球: フィールド, 玉, 地域の, 円形
敬語: 名誉
罪: 罪を犯しました, 犯罪, 非難, 罪
おいしい: おいしい, 味
幼児: 玉
小麦: 民話, トウモロコシ, 褐色, ミル
ユーモア: ユーモア
出会い: 対処, 日付
トワイライト: 夜明け
パーク: 庭園
支配します: 管理します, ルール, マスター, 覆われました
形成: 教育, フォージ, 製剤, 組成, 設立, 作物
ギャラリー: コレクション
リーン: マイル, 鉛
大陸: コンチネンタル, ボリューム
ノック: ためらいます, ビート, クリック
ユニティ: ユナイテッド, 単位, 連帯
主要な: パイオニア, キー, 親, すばらしいです, 主要な, インナー
予備: オープニング
細胞: 核, 細胞電話, 膣, キャビン
境界: バウンド, フリンジ
呼吸します: 息
免除します: フリー, 無罪, 許します, 例外
裕福な: リッチ
誰も: すべて, 誰でも
豊富な: リッチ, 非常に
画家: アーティスト
眼鏡: ガラス
射撃: ショット, 狩猟
ワゴン: 列車, トロリー, アパート
貸します: 与える, クレジット, 見積もり
着手します: 開始, 行う
聖職者: 祭司
マウント: インストール, 増加する, 丘, 酸
アレイ: コレクション, シリーズ, 注文, 順列, 整列します, ああ
マガジン: 押す, 毎月
: 
厳しいです: ハード, 厳密に, 無礼な
押す: スクイーズ, 奨励します, 押す
タイト: 狭い, 厳密に, ハード
: 
放棄します: 放棄されました
主に: 特に, 主として
忠実な: 忠誠心, 正直な, 忠実な, 管財人
適しました: 優しいです, フィット, マッチング, 最適な
助言します: 弁護士
ウエスト: ロマンチック
安定しました: 安定しました, 設立, 決定
コミット: 約束する, 行う, しわ, 罪
影響を及ぼす: 効果, 印象づけます
意義: 重要性
農民: 農家
かなり: 非常に, 間接的な, 十分な
延長する: スプレッド, 広げます, ストレッチ
個人的に: 個別に, プライベート, 自分の, 人
道徳: 道徳
反乱: 反乱, 革命
糸: ライン
船乗り: 塩
応答: 反応, 回答
インペリアル: ロイヤル
ブランク: 空の, ホロー, 白
マイナー: 二次, 少し, 鉱夫
: 
バーゲン: トレード, 時, 契約
疲労: 疲れました, 歪み
嫌い: 軽蔑, 嫌い, リラクタンス
ノーマル: いつもの
スケッチ: アウトライン, 計画, ショー
とにかく: 既に
ドライバ: 運転手, 運転, 導体, パイロット
保持します: キープ
宣言: 広告
人: 人
過剰: 追加の, 冗長性
分離: クラス, 距離, 分離しました
嫌悪感: 軽蔑
成し遂げます: 実現します, 入手します, 対処, フル
正しく: 等しい
暴徒: 群集, 質量
不要: 廃棄物, しなければなりません
毛皮: 肌, コー​​ト
賛辞: 家賃
和らげます: 無罪, 許します, 促進します, 置き換える, リラックス
立法: 法律を制定します, ルール, 議会
プロジェクト: 計画
対応します: 似ています, マッチング, 観点
妖精: 天使, 別荘
結論を下します: 結び目, コレクション
幸運な: 運, ハッピー
ラップ: 膝, 円形, 採択
リッジ: サミット
台無し: 戦利品, 破滅, ソフィスティケート
責任: 簡単に, 傾向があります, 影響を受けやすいです
思いやりのある: 心配して, 賢いです
好調: 優しいです, 楽しいです, フレックス, 望ましい, 最適な, 承認します
錫: バンク
依存: はまって, 添付の, 従業員, 頼ります
令状: 保証します, 正当化します, メモ
苦情: 文句を言います, 白
コンベンション: メモ, 契約, サミット
角度: コー​​ナー, ポリゴン, 角度, 広いです
広く: 非常に, 主として, 広いです
牛: 牛
偏見: 嫌い, バイアス, ファイバ, 結び目
驚くべき: 奇妙な, びっくりさせます, 驚き, 印象的な
適切な: マッチング, フィット, 右
自信を持ちます: 勇気, 安全, 信じます, 純正, コー​​ス
器官: 楽器, メンバー, 体
選択: 選択します, 指名, オプション, 選挙
畏敬の念: 恐れ
: 
比較します: 比較
関連します: フック, コミュニケーション, 観点, いう
推定する: 信じます, 推測, 仮定する, 観点
行方不明: 絶滅しました, 失われました
ファッショナブル: ファッション, モダン, エレガント
ディスターブ: 神経質な, 積極的な, 干渉する, バリア
協会: 観点, 組織
姪: 甥, 孫娘
身体: 体
学部: カレッジ, 階乗
セーリング: 船, ベール
スマート: 賢いです
ささいな: リング, ささいな, 少し
注意: 警告, お手入れ
戦士: ヒーロー
液体: 水
概念: 概念の, 感じ
特別に: 特に
ジャンプ: 飛ぶ, ダンス, ヒール, バウンス
不本意: 意図します, 準備します
余分な: 追加の
ピッチ: 舗装, トーン, しません
厄介な: 奇妙な
感謝する: 感謝
陪審: 裁判官
生き延びる: ライブ
文字通り: リテラル
簡単に: 簡潔な, 簡単に
男: 人
ペニー: コイン
採用: 採択, 承認します, 仮定する, 取る
定期的に: しばしば, 安定しました, 繰り返されます
調査: サーチ
憲法上の: 憲法
最新: 最終, 新鮮な
瞳: 学生
全く: 完全に, 徹底的に, フル, 積極的に
ねじれました: 曲がりました
: 
異なる: 異なります, 分離しました, 区別, 個別に
災​​害: 破滅, 反転
ベット: 杭, 調子, 花火
定期的な: 与える
生: ライブ, キモい, 緑, 結び目, はげました
ログ: 入る, 録音, ログイン
ホスピタリティー: エンターテインメント
カート: 列車, 車両, トロリー
: 
従事する: 添付の, つかいます, 家賃, キープ, 成ります, 従事して
群れ: 群れ, クルー, 群集
: 
収集します: ギャザー, コンパイル, コレクション
パン: ポット, パン
暴行: 攻撃
欺く: だまします, うそ
喪: ごめんなさい
: 
承認: 承認します, 採択, 拍手, 許可
撤退します: 削除します, ドラッグ, 面白い, リタイア, 撤退, バック
曲: song, 調和
思いやり: 同情
裏切る: 売る
変装: 隠す
転写: コピー, デリバティブ
資料: ファイル, マニュアル
隣人: 周囲の, 近く
罰します: 文
ブロック: 防ぐ, ボリューム, バリア, 黒
義務: 義務
低下: 秋, 浸漬
野心的な: 野心
休日: 休暇, ごちそう
鷲: タカ, ネクタイ
立派な: 名誉
重要: 必要, 間接的な, 印象的な
機能: 特徴
密集: 厚いです
フィクション: 小説, 虚数, ストーリー
推奨します: 示唆する, 紹介します
70: 
教育の: 教育
上向きに: もっと
ホーン: トウモロコシ
基金: ボックス, 資本, 線
ロッジ: 小屋, ファイル, キャビン, 別荘
コスチューム: カスタム
運賃: 家賃, 行きます, 地図
リマインド: 覚えています, 似ています
枕: 川
どこにも: スポット, どこでも
: 
死体: 体
エッセンス: 核, 要素, ペット
標高: 急な
レルム: フィールド, 世界, 範囲
階段: 階段, 規模
アコード: メモ, マッチング, 契約, フィット, 任意
レース: レース, パルス
学者: 学生, 科学者
ルーラー: 公爵, 知事
クレイジー: だまします
楽しませます: ようこそ, エンターテインメント
挨拶: ようこそ
巨大な: モンスター, ひどいです
かろうじて: のみ
施設: 装置, 促進します, 快適さ
奪います: スチール, 戦利品, 奪います
はしご: 階段, 導体, 規模, 学校
エンディング: 仕上げ, 最終
: 
分割: パーティション, 分配します, 解剖
トレッド: ウォーキング, ラング
防衛: お手入れ, 守ります
信じられません: 奇妙な, エレガント
アーチ: 弓
選民: 選挙, 選択します
シャイ: 内気, 恥
プライム: 主要な
80人: 
残念ながら: 残念な
霧: ミスト
着色されました: 色
相談します: 尋ね
警告します: 警告, 誘発します
浅い: 深い, 財団, 低いです
奨励: 奨励します, 快適さ, ひらめき
不規則な: いつもの
プロモーション: 進捗, 広告
忠実に: 忠誠心, 忠実な, 心から
: 
移転: 翻訳, 輸送
基本: 財団, インフラ
バンドル: パック, ファイバ
悲劇的な: ひどいです
レビュー: 批判
ひどく: ひどいです, 非常に
料理: クック, キッチン
反乱: 反乱, 革命
難破船: 破壊する, 事故, 破滅
納得させます: 説得します, 保証します
図: インスタンス, 画像
神経: 静脈, 勇気, 神経質な
確かめます: 知っています, 保証します, 決定, チェック
誓約: 保証します, 約束する, 人質, 寄託, ポーン, 誓う
獲得します: サーブ
その後: その後, 次
選択します: 選択します
解釈: 翻訳, 説明します
チャレンジ: コー​​ル
禁じます: 防ぐ, 阻害
入場: 領収書, 採択, 告白, しきい値
プール: 水泳プール, ピット, ブリッジ
会議: セッション, アセンブリ
平等: 類推, バランス, 等価
新たに: 最近, 小説
周囲: 風景, 周囲の, 雰囲気
侵入: 攻撃, ログイン
パターン: インスタンス, かつて, 形, 格子
明らかにする: 開示します, 反映します, 開いた
解決します: 解決, 緩いです
説教: 説教
祖母: 祖父母
ウール: コットン
伝える: コミュニケーション, 付き合います, ネゴシエーション
: 
基本的に: 条項, 主として, 平均
反対します: 抵抗します
検体: インスタンス
作物: 収穫, カット, 作物
正確: 粉, リテラル
リゾート: 取る, シェルター, ブレーク
拒否: 廃棄物
ボンド: キー, 寄託, コピュラ, 奴隷制
交感神経: 同情
給料: 支払う
連続的な: 持続する, 安定しました
エキサイト: 誘発します, 駆り立てます, かき混ぜます, 起きている
乱暴に: 野生, 暴力的な
悲しみ: うつ病, 悲劇, ごめんなさい
連合国の: ユナイテッド
天井: 毛布, ルーフ
: 証明書, 
ゴール: フォーカス, 目的
現金: お金
空いています: 開いた, フリー, 空の, 緩いです, 漠然としました, ゼロ
軽蔑します: 軽蔑
芝生: 草, 牧草地
七面鳥: 
隣人: 周囲の, 近く
究極: 最終, 最大, 最後に
提出: 送信
エントリ: 入る, 録音
: 
徹底しました: 深い, 徹底的に, フル
エキサイティング: 面白い
受賞: 成功, ビート
保守的な: オーソドックス, 知事
熱狂的な: 心配して, 興奮
階下: ダウン
招待: 注文
沸騰: クック, 潰瘍, 稚魚
美しく: 美しさ, 綺麗な, 楽しいです, ニート
明日: 昨日
: 
居心地の悪いです: 心配して, 不快
港: シェルター
装置: 装置, 機構
アサート: 主張します, つかみます
発話: 表現, うま
レール: 鉄道, 列車
作物: 収穫, 作物
不完全: フル, 身体障害, 不完全性
: 
取得します: 入手します, 購入
攻撃: 攻撃, 侮辱的な, 積極的な
冷たく: コー​​ルド
講義: スピーチ, コー​​ス, 説教
それによって: どこ
知覚: 感じ, 一目, 曲がりました, 知覚, 理解
開発します: 手の込んだ, 進化します
関数: 式, 作業, アクティビティ
弾丸: ショット, 鉛, 玉
: 
バインド: バウンド, ロープ
同じ: 等しい
かなりの: 例証的な, すばらしいです, 間接的な, 印象的な, 十分な
バルク: 質量, 大きさ, ボリューム, 腫瘍, 群集
長引きます: 長いです, リンガー, 縦
イライラして: イライラしている, 不快, 怒り
動揺: 神経質な, 悲しい
: タクシー, 
束: コピュラ, クルー, バンド
示す: 症状, ショー
干し草: 草
ディベート: 引数
静止: 沈黙, 穏やかな
部分的: 例外, 部
牛肉: お肉
繰り返しの: 時間, 繰り返されます
: 
団結させます: 連帯, マージ, 調整します, 参加します, メルト
刃: 葉, 剣
工場: ミル
logophoric: 
出席: 参加, 可用性, プレゼンス
ジャーナル: 押す, 日記
正直なところ: 心から, 忠誠心, 正直な
正当な: 法的, 正当化します
木曜日: そこ
リーグ: アライアンス
: 
トラフィック: サーキュレーション, 輸送, 母音
四肢: メンバー, 翼
: 
スチュワード: マネージャー, サーバント
素晴らしいです: エレガント
進化: 改革, 進化の, 進化します
逆: 上側ダウン, 反対
調査: チェック, サーチ
アミューズ: エンターテインメント
コンテンポラリー: モダン, 同期します, 一時的
スキャンダル: 汚職
意図的な: 意図的に
シンボル: 表記法, ジェスチャー, 地図, マーク
回復: 救い
洗浄: ウォッシュ, ランドリー
: 
正確な: 粉, フィット, リテラル
発生: 起こります, 時, プレゼンス, 憲法
軸: ショルダー, 木
: 
幹: ドライ, 部族, ルート
株式会社: 会社, 組織
好み: 特権, 選択します, バイアス, オプション, 優先
衝動: 誘発します, 欲望, 奨励します, 尋ね
減らします: 低いです
除去: 距離, 安全
アサーション: 引数, 広告
アクセス可能な: 訪問, 発見
コメディー: ユーモア
流す: 色, 興奮
コー​​ド: ヤード, エンコード, パスワード
十分な: 十分な, コー​​​​ヒー
スプリット: 分配します
: 
歴史家: 歴史的
強度: 密度, 歪み, 大きさ
民主主義: 共和国, 民主的な
信条: 告白, 宗教, 方法
アトラクション: チャーム, 重力
コンサート: 祭り, 式
下向きの: ダウン
分析: 解決, 分析します
プロンプト: すぐに, 要求
: 
強調: アクセント, 主張します, 重要性
ブロンズ: 銅, 褐色
衣服: ローブ
自責の念: 悲しい
: 
排他的: 独占, プライベート, 14, 専門
ポーター: 着る
ダッシュ: ライン, ダッシュボード
ストリップ: バンド, バー, ふだん着
最終的に: 最後に
チーム: クルー
誰でも: 誰, いずれか, 誰でも
高価な: 親愛な
本部: 本社, センター
急性: シャープ, 慢性的
恥ずかしい: 神経質な, 恥, 置き忘れます
子孫: 子供
ネットワーク: ウェブ
飛行機: 鳥, 表面, 機械, 舞い上がります
部分的に: 部
誇らしげに: 誇り
テラス: バルコニー, ルーフ
グリップ: トラップ, 拳, スクイーズ, 出口, シルク
謙虚: 単純
爆発: バースト
省: オフィス
直径: 記事
部隊: 軍
しっかり: 厳密に
ペナルティ: 文
代わりの: オプション, 交換
拘束: 忍耐
画面: ベール
泥: 湿りました, 泥, ほこり
時代: シーズン, 古代, 長いです, 連帯
繁殖: かける, レース, 肥沃
干渉: 干渉する, 迷惑, 障害
成ります: 成ります, 含めて, 傾向があります
受け入れ: 許容可能な, 採択, 領収書
エンジニア: メカニカル, 記事
停止: 足, 逮捕, 閉鎖, 防ぐ
代替案: オプション, 置き換える
切手: シール
コンパクト: 簡潔な, 縮めます
姿を消す: 絶滅しました, 目に見えません, 失われました
カウンタ: ディスク, 不承認, 反対, ライバル
金星: 金曜日
引き付けます: 面白い, 印象づけます, 魅了する
驚くべき: 驚き, 印象的な
コンペ: ライバル
結晶: ガラス
シャワー: 浴, 雨
: 
大規模な: ヘビー
セラー: ルーム
哲学的: 哲学者
デバイス: 装置, 戦術, 楽器
グレア: 一目, シャープ
最終的には: 最後に
許し: 許します
ひどく: 非常に, ひどいです
熟考: 反映します, 反射, 計画
製造: 作物, メーカー
楽に: 楽しいです
展示会: 報告する
クエスト: サーチ
拡張: スプレッド, 腎臓
構成します: 成ります, 組成
論争: 物議を醸します, 引数
: 
おおよそ: いつもの, 近似
オーバーヘッド: 上記の
: 
陰謀: カット
抑えます: 阻害, 防ぐ
保存: セーブ, お手入れ, キープ
パブ: バー, 宿
流域: 谷, 水泳プール, シンク
メロディー: トーン
: 
雇う: 家賃
心配して: 心配して, 神経質な, お手入れ
高齢者: 古い年齢, 古い
大学: カレッジ
: 
修正します: 置き換える
: 
用心深いです: 慎重に
財団: 財団
前の: 東, 前, 古い
複雑な: 複雑な, ハード, 手の込んだ
謝罪: ごめんなさい, 林檎
怖がって: 恐れ
代替: オプション, 手当, 置き換える
使用法: つかいます
復元: 修復
ヘッジ: フェンス
プライマリー: マスター, 財団, 惑星
ビーム: 線
ツアー: 訪問, 遠征
誇張されました: 塩, 異常な
有能な: できます, 資格のあります
農業: 農業の
緊急: すぐに, 沈殿させます, 必要
正確さ: 純度
アラート: 警告, 起きている, マーク
形: 形
オーブン: レンジ
丸みを帯びました: 円形, 丸め
従来型の: いつもの, オーソドックス
弁護します: 正当化します
コー​​ド: ロープ
古典的な: クラシック, 音楽
並んで: 平行, 次, 一緒に
エキス: 見積もり, ジュース
パイント: ビール
チューブ: パイプ
大通り: 時
象: 象牙
埋め込む: 葬儀
効率的な: 効果的な, 効果
ミックス: ミックス, かき混ぜます
擾乱: 障害, 迷惑, 干渉する
エグゼクティブ: マネージャー
10番目の: 十
比較の: 比較
午前: 朝, 光沢のあります
ケージ: 城
: 品, バー, 
刑務所: 刑務所
巧妙: 狡猾な, できます
悲鳴: 泣く
妥協: 契約, 調和
弾薬: ショット
アシスタント: サポーター, 助けて
杖: スティック
折り畳みます: 従事して
境界: バウンド, フリンジ
プロセス: アプリケーション, 処理
主張します: 話し合います, けんか, 主張します
論理: 引数, ラショナル, 合理性
パニック: 恐れ
応力: 歪み, うつ病
消費: つかいます, 食べる
サスティーン: サポート, 入手します
クラッシュ: 事故, 秋
欠けています: カット, 部族
段階的な: ゆっくり
クラッシュ: 破壊する, 重力, スクイーズ, 愛
現象: 問題, 症状
実行します: 従います, ラン, 実現します, アクション, 実装します
挨拶します: 健康, ようこそ, 祝福します
君主制: ロイヤル
振る舞います: ライブ, 扱います
曲線: 弓
利便性: 簡単に, 快適さ
子羊: 羊
論理的: ラショナル
ダイエット: フード, 用量
司法の: 裁判所, 法的
一貫性のあります: バランスのとれました, 安定しました, 整列します
不信: 疑問に思う, 忠誠心
フェザー: 春
: いつもの, 
自主的な: ボランティア
: 
ジャケット: コー​​ト, セーター
水泳: 泳ぐ
印象的: 面白い, 印象的な, 効果的な
下に: ダウン
地方の: 農村, 州, 地域の
: 
: 
補償: 手当, 褒賞
推測: 推測
ウェイター: サーバント
推進します: 促進します, 奨励します, 広告
ささげます: 意図します
敵意: 抵抗します
障害: バリア, 障害, トラブル
: 
プランテーション: エステート, 保育園
フォスター: 促進します, 宗教, ペット
晒す: アウトライン, 開示します, 開いた
パッチ: スポット, アタッチメント
中断: ブレーク, 迷惑, バリア
: 
親指: インチ, 無知
革命的: 革命, ラジカル
: 
: 
繰り返し: ヘビー, 繰り返されます
素晴らしいです: 奇妙な, びっくりさせます
先端: 半球, サミット, 弁護士
キック: フットボール, ショット
脅威: 脅迫的な
ジャングル: 森林, 野生
典型的な: いつもの
: 
燃料: 油
静かな: 穏やかな
先: 目的, 床, 配置
ピン: 秘密, 針
火星: 行進
仲間: パートナー, 平行, 添付の, 友人, 協同組合
悪質な: 不道徳な, 悪の
バンケット: ごちそう
詳しいです: 手の込んだ, 深い, ヒンジ
クローゼット: キャビネット
立法の: 法律を制定します, 議会
マージン: フィールド, フリンジ
チャンピオン: ヒーロー, チャンピオンシップ
メンテナンス: キープ
: 
異なって: 区別, 個別に, 異なります
逃げます: ラン, エスケープ
句: ストリーム, 段落, 記事, ボリューム
: 
化合物: デリバティブ, 複雑な
関係: コミュニケーション, 報告する, 観点
代理店: 組織, 会社, オフィス
笑顔: 笑顔, しかめっ面
異常に: 異常な, 非常に
: 
デモンストレーション: ショー, 行進, デモンストレーター
毎週: 週間
かりて: クレジット, 見積もり, 祈る
腫れ: うねり
トピック: テーマ, 問題, ストーリー
: 
強化する: , 強化する
: 
一生: ライフスタイル, コー​​ル
評決: ルール
属性: 美徳
浸透します: クロス, スプレッド
識別: 身元, 定義, 検出
: 
: 
写真: 画像, ショット
味方: 友人, 優しいです, ユナイテッド, 要素
溝: 溝, ピット
道: 方法, ストレッチ, 引数, 棺
リボン: バンド, 映画
プラス: もっと
香水: 香り, 香り高いです
面倒: トラブル, 干渉する, 迷惑
エッセイ: 記事, 報告する
: 
ライダー: ライディング
孤独: 寂しい, 沈黙
手首: ハンド, パルス
細かく: 柔らかい, 微妙, 最後に
リー: 
効率: 能力, 産出, できます
非難します: 文, 嘆きます, 罪を犯しました, 非難
顎: 扱います
ユニーク: ユナイテッド
必然的に: 避けられません
ドラム: ダンス, 空の
制裁: 承認します
ビン: ボックス, バスケット
: 
デュレーション: 一時的, 時間, 長さ
量ります: 測定
修道院: 修道院
パブリッシュ: 出版, 分配します, 開示します
洞察: 理解
絶対に: 厳密に, コー​​ス
: 
シフト: 変化する, 通過
今晩: 夜
因子: 従業員, 係数, 要素
混乱: 積極的な, 障害, 混乱
練習: 運動, アクション
聖域: 祭壇
: いつもの, 一時的, ランダム, 
歴史的: 歴史的
うんざりしました: ボア, イライラしている
シュリンク: ギャザー
支出: 費用, つかいます
心強いです: ハート
外交的: 狡猾な
暴露: 表現, 報告する, 効果, 光, 反応
原油: キモい, 緑, 結び目
超えます: レイプ, クロス, 最大
インスパイア: 奨励します, ひらめき
チケット: バナー, 地図
後方: バック, 辞任
靴: 靴, ブート
詐欺: 錯覚, 操作
爆発: バースト
暖炉: 煙突, 兄, 火災, レンジ
ジャー: ガラス, ボトル, ポット
ソース: ドレッシング
腐りました: 怠惰な, 不道徳な
動作: 動作
最近: 昨日, 現在, 最近, モダン
: 
ローン: クレジット, 見積もり
不当な: ラショナル, ナンセンス, 不合理, 無謀
欲望: 野心, 欲望
毎年: 年次
: 
流体: 水
キッド: 子供
非常識な: だまします
打倒: 注ぐ, 最後に
成果: 成功, エクスプロイト
仮定: 仮定する, 概念の, 採択, 曲がりました, ディスカウント
ユーモラス: ユーモア, 陽気な
退職: リタイア, 辞任
発音する: アクセント
: 
: 
議会: 議会, 上院
クリープ: クライミング
緊急: 心配して, 危機
小包: パック, 部
引き出し: ボックス, 階段, ドラッグ
貢献: 貢献します, 杭, 協力
リンク: リンカ, アタッチメント, コピュラ
摘みます: 勇気, ベリー, 強要します
印刷: 出版, 印刷, シール, 押す
提唱者: 正当化します, 被告, 弁護士
環境: 雰囲気, 風景, 周囲の
確認します: 証明します, 保証します, 承認します, 強化する
熟練しました: できます, 資格のあります
アナウンス: 開示します, 出版
辞職します: 辞任
拒否する: 抵抗します, 不承認
タフ: ハード, 残酷な, 天使
断片: チップ, スクラップ, ストレッチ, パーティション, 指数
瞑想: お手入れ, 反映します
染色: スポット
埋葬: 葬儀
仮説: 仮定する
仮定の気分: 投機的な気分, 仮定の気分, 条件付きの気分
トランザクション: アクティビティ, トレード, コミュニケーション
激怒: レイプ, 怒り, 軽蔑, 恥
変わります: 変数, 異なります, 置き換える
弁護士: 代表, 弁護士
怒らせます: 侮辱的な, 罪を犯しました, 不承認, 擦り傷
パケット: パック, ポケット
ランチ: ランチ
非難します: 非難
オッズ: 確率
パイ: ケーキ
年金: 構文, リタイア
動詞: 単語
正確に: 右, 厳密に, 徹底的に
: 冒険, 危機, 危険, 
: 
情事: キャスト, スクラップ
マリン: 海軍, 海
: 
電気: エレクトロニック, ストリーム, バイオグラフィー
エイリアン: 外国の, ゲスト, 地球外の
割れた: バースト, 亀裂
押し下げられました: 悲しい, うつ病, 憂鬱な
アイロニー: 悲惨
厚く: 厚いです
合理的に: ラショナル
ケーブル: ホロー, フレックス
説明します: 説明します, インスタンス
悪名高いです: よく既知の
傷つけます: 損傷
正しく: 右, 大丈夫
牧草地: 牧草地
: 
ワーム: マスク, 深い, 昆虫
推定: 推測
編集: 処理
洋服: 組織, 装置, ローブ, 文献
不運: 残念な
第8: 8
リラックスしました: 快適さ, リラックス, 穏やかな, 安定しました
隣接: 近く, 周囲の
: 
側面: 特徴
上級: 親
家庭教師: コー​​チ, 不承認
強盗: 戦利品, スチール, エクスプロイト
トレーディング: トレード
: 
塊: 結び目, 質量
偶発: 事故, ランダム, 一時的, 驚き, 意図的に
施設: 家, スポット, 建物
配信: 紹介します, 玉
: 
湾曲しました: 曲がりました, フレックス
生産的な: 作物
バリエーション: 区別, 分化, 変化する
膨張しました: うねり
耕す: 成長します
変化: 変化する, 異なります, 区別
相手: ライバル, 不承認, 敵
孫: 孫娘, 甥
ネイル: 爪, ボルト
慈悲: 福祉, 美徳
精度: 純度
表示: 症状, マーク, ジェスチャー
: 
削減: カット, スクイーズ, 赤
パット: ポット
対話: ネゴシエーション, コミュニケーション
腹: 胃, へそ, 船
勤勉: 試します
うんざりします: 嫌い
構成します: 書きます, フォージ, 一般化します
: 
: 
矛盾: 物議を醸します, 抵抗します
: 
旅客: 旅行者
刺します: 刺します, 苦い, 一口
同時に: 一緒に, その間
エピソード: 間接的な, 部
達成します: 実現します, 派生, 入手します, 成ります
しつこいです: 持続する
飢えます: 飢えました
相談: ネゴシエーション, 弁護士
ヤギ: 羊, 塩素
: 
サワー: 酸
下線: 主張します
パレード: 行進
ヘルメット: 帽子
宣言する: 出版
宿泊施設: ホテル, 適応
スプレー: 医学, コミュニケーション, エアロゾル
正式に: 公式, 非公式
: 
不穏な: 神経質な, 干渉する, 心配して, 迷惑
グレード: ブリッジ, クラス, 係数
スツール: 椅子
正当化: 正当化します
外国人: 外国の, ゲスト
削除します: 削除します
交通: 輸送
理解: 理解
planning: 計画
奇妙な: 奇妙な
ディレクター: マネージャー, 頭
一時的な: 一時的, 時間
うまく: 綺麗な, 楽しいです, うまく, ニート
施行します: 従います, 課す, 警察, 実装します
スケルトン: 骨, 建物
包括的な: 広いです, 深い, フル, 周囲の
脅かす: 脅迫的な
プログレッシブ: 進捗, ラジカル
リソース: リソース
閉じ込めます: つかみます, 縮めます, 狭い, バウンド
祝います: 賞賛
保険: 安全
任命します: 眼, 選択します
割り込み: 抵抗します, カット, 干渉する, 切断します, ブレーク
抑えます: 虐げます, 防ぐ
: 
層: クラス
手掛かり: 証拠, キー
歯: ティース
成熟しました: 大人, 賢いです
依存: はまって, 頼ります, 信じます
保証: 保証します, 寄託
手順: 機構, アクション, ファッション, 処理
勧告: 示唆する
ギャップ: ブレーク, オープニング, 区別, 距離
: 
暗示します: 平均, 示唆する
アタッチ: 添付の, スプライス
姿勢: ジェスチャー, インジケータ, ポジション, スタンド
フクロウ: 鳥
スイート: 翼, コレクション, アパート
宝石: 宝, 栄えます, 寄託
: 
第二に: 二番
: 
: 
感情の: 感じ, 影響を受けやすいです
コンクリート: 例証的な
コンバイン: アライアンス, マージ, 一緒に
それぞれ: 区別
ピーク: サミット
通貨: お金, コイン, 交換
目的: 目的, フォーカス
追悼: メモリ, 警告
: 
: 
別々に: 分離しました, 異なります, 個別に, 寂しい, 独立して
トレイ: ディスク
水平の: バランス, 平行
喉が渇きました: 渇き
チャーター: 憲法, 紙, 家賃
項目: 品, 記事, 音声, ソート, ポジション, ネック
: 
計算: アカウント, 国勢調査, 余弦, 集計
拡張: スプレッド, 広げます
ねじれ: ボルト
伝統的な: 伝統, オーソドックス
巻き込みます: 含めて, 成ります
ルーチン: いつもの, 機構
解決する: プラウ, 緩いです, デコード
誘惑します: からかう, 誘発します, 誘惑
不成功: 失敗します, うまく
政治家: 政治的
: 
規制: ルール
違反: 損傷
ジャンクション: 交差点, 結び目
ボス: マネージャー, 雇用者, 頭
ピア: 宿題, 公爵
結果: うまく, 効果
ストランド: ビーチ, バンド
: 
瀬戸際: フリンジ, リップ, 海岸
商品: トレード, 品, 商人
よそよそしいです: 分離しました, 遠く
取得: 入手します, 可用性
亡命: 病院, シェルター, 亡命
確認します: 証明します, 承認します, 保証します
: 庭園, 
スケジュール: 表, 配置
地方自治体の: シティ, 詩
暴動: かき混ぜます
ベテラン: 人気のあります
: 
証言します: 証明します, 証拠
母性: 妊娠しました, ママ
彫刻: 像
: 
味: 味, 香り
ブランド: マニュアル, マーク
: 
荷物: 荷物
ごみ: ナンセンス, スクラップ, ダンプ, 廃棄物, 最悪
ツール: 楽器
混沌: 障害, 混乱
時制: 神経質な, 時間, 長いです
: 
めんどり: チキン
控えめな: 賢いです, 微妙
悼みます: 泣く, 嘆きます, ごめんなさい
方言: アクセント, 研磨
エレメンタリー: 財団
運賃: 荷物, バー, 品
ワイプ: スイープ, 削除します
拒否: 負
地下: 秘密, 地質学的な
: 
接続詞: 連続, リンカ, 一緒に
中間体: チェック
式: レシピ, 押す, 式
カンニング: だまします, 操作, うそ
不十分な: 残念な, 不適切な
出没します: ためらいます, 怖がらせます, 現れる
登録: リスト, 録音, 入る
不定: 漠然としました
余剰: 追加の, 冗長性
震える: 震える
組織: 組織, ウェブ, ファブリック, ウィーブ, バナナ
ドラフト: アウトライン, 概念の
おもちゃ: 人形, 遊びます
階段: 階段, ラング, 規模
遷移: 感染, 変化する, 通過, 変換
ボタン: キー
頭痛: 頭
テナント: 居住者
不親切: 不親切な, 無礼な, 残酷な
プログラム: 計画, 議題
製造業: インダストリアル, ミル, 作物, メーカー, マニュアル
ゾーン: フィールド, 地域の, バンド, カラー
第9: 9, 三
アルコール: ワイン
癒します: 改善します, 扱います
: 
90: 
: 
: 
舵を取る: 鉛, 管理します, 嵐, 共役, 船
影響力のあります: 効果的な
囲む: カラー, 包囲
溺れ死にます: シンク
滑り台: スリップ
雌豚: クライミング, パン, 豚
支配的な: すばらしいです
リーダーシップ: 鉛, 階層, マニュアル, 地図
祝う: 説得します
チョーク: 準備します, チョーク
大騒ぎ: 興奮, 混乱
副: 代表, バイス
自動車: モーター, 車両
: 
改正: 改革, 修復
垂直: スタンド, 縦
不十分: 十分な
くそー: 乱用
推論: 推測, 撤退, コレクション
推論の気分: 帰納気分
広告: 広告
盗難: スチール
自発: 本能, 任意, ランダム
ユーティリティ: 組織, つかいます, 楽器, 促進します
接続します: フック, スプライス, マージ, 参加します, 持続する
下向き: ダウン
介入: 干渉する
復活: 復活させます
: 
インターネット: トレード
物理的に: 物理, 体
ドット: スポット, キモい
ショッキング: ショック
荒々しく: 無礼な
インデックス: 指数, リスト, インジケータ
肝: ヘビー
送信します: 送信, 分配します
: 
上へ: 上記の, でる
チャット: ネゴシエーション, ゴシップ
アンバー: 黄
トン: トーン
垂直: 急な
スムーズに: 徹底的に
テンション: 歪み, 興奮
鯨: 選挙
有毒: 毒
: 
租界: 特権, ディスカウント
ワーカー: 従業員
傾斜: 浸漬, 共役
トイレ: キャビネット
仏: 火災
犯罪: 侮辱的な, 攻撃, 犯罪
恨み: 嫌い, 復讐
不屈の精神: 忍耐, 勇気
予想します: 希望, 期待
リズム: ビート
ラット: マウス
ニット: ウィーブ, 編まれました, 結び目
対応します: 従います, マッチング, フィット, 回答, 観点
拘留します: 防ぐ, つかみます, 逮捕, キープ
解釈します: 説明します
サロン: ホール
操作します: 操作, 作業, ラン, アクション, 管理します
ドレイン: ガター, ラン, チャネル
賃金: 支払う
不快な: 嫌い, 悪の, 不快, 最悪, 醜い
墓地: 葬儀, 墓
石膏: 仕上げ
タップ: パイプ, タッチ
退けます: 袋, 不承認, 冗長性, 許します
挑発します: 興奮, イライラしている, 憂鬱な
装飾: 装飾的な, 仕上げ
つま先: つま先, 足, 指
できないこと: 身体障害, 弱点
最も遠いです: 遠く
定義します: 手の込んだ
制限されました: バウンド, バリア
食器棚: キャビネット, 棚
刺激: レシピ, イライラしている, ひらめき
ラック: 棚, 拷問
監督: 導体
プレゼン: 紹介します, ショー, 症状, デモンストレーター
ゴム: 玉, エラスティック
除外する: 奪います, に閉じる
チョコレート: 褐色
特権を持ちます: 特権
一致: 残念な
スクラッチ: 擦り傷, 開始
スクリュー: ボルト
探ります: 観察する, エクスプロイト
保証します: 保証します
シリンダー: ディスク
概要: アウトライン, 抽象
ありそうもありません: 確率
群れ: 群れ, 息子
系統的: 機構
事実上: 近く, 実用的
クライアント: カスタム, ゲスト
カタログ: リスト, 表, チャート
: 
口頭の: 侮辱的な, リテラル, 直接
化学: 化学物質
: 
世俗的な: 中性
焼く: パン, クック
ピアス: 刺します, ボア, 穴を開ける
スナッチ: 涙, つかみます, 誘拐
打ち上げ: キャスト
調節します: ルール
農業: 農業の
留めます: 逮捕, 大丈夫
女優: 俳優
劇場: 劇場, ホール
ドラッグ: 医学, ドラッグ, 約
不利な: 最悪, 不利益, 負, 不親切な
キャンディ: 甘い
ペースト: キープ, ネックレス
囚人: トラップ, 罪を犯しました, 囚人
調査します: 観察する, チェック, 評価
パッケージ: パック, コレクション
スナップ: ポップ, クリック, 画像, 潮, すぐに
タイヤ: リング
目立ちます: 印象的な, 一目
コア: 財団, 核
前任者: 祖先, 古い
同様に: なぜ
ダム: ほこり
滑りやすいです: スリップ
変換: 変化する, 変換
: 
ロケーション: ポジション, スポット
クラスタ: コングロマリット, 質量, バンド
引用: 見積もり
親権: お手入れ
もっともらしいです: 許容可能な
トス: キャスト
濃度: コレクション, フォーカス, 整合性
ハンディ: 実用的
餌: 味, プライマー
さまざまな: 異なります, モザイク, 対照的な
スライス: チップ, ディスク
: 
ドリル: ボア, 掘る, 運動
答えます: 反応, 払い戻し, 回答
: 
死亡: 死
雑草: 草, シガレット
相対的に: ボリューム
数学の: 数学, アスリート
道徳的に: 道徳
あえぎ: 息
レーシング: レース
出口: 出口, でる
分離: 分離しました
いつか: 時々
苦難: 苦い, 悲惨, トラブル, 迷惑, ごめんなさい
噂: ゴシップ, 音声, 名声
無視します: 無関心
ジュニア: 若い
心理的な: 心理学, 精神的に
編み物: ウィーブ, 編まれました, ウェブ
間接的な: 直接, 間接的な
先例: インスタンス
通路: 線, ホール, 通過
反します: 反対
買い戻します: セーブ
経路: 方法, 横断歩道, 桟橋
ギヤ: 装置, ティース, リブ, ラン
お祝い: ごちそう, 式, 祭り
出版: 出版, 分配します, 出版社
顧客: ゲスト, 買い手
ラグ: カーペット, 床, 毛布
: 
見通し: 一目, 風景, 視点
美的: 美しさ, チャーム
消費します: つかいます
憤慨します: 嫌い, 抵抗, 怒り
ポーズ: 誘発します, スタンド
満足: 満足
理解できません: 漠然としました
断固たる: エレガント
要因: 要素
: 
正午: 午後, 南
ユリ: 読む, 蓮
名詞: 名, 単語
折り畳み式の: 曲がりました
役立ちます: 助けて
続きます: 主張します, 持続する, 最終, 続きます
受け継ぎます: 相続人
速度: 速度, 沈殿させます
同僚: 協同組合, パートナー, 兄
欠乏: カット, 省略, 低いです, 部族
確保: 保証します
不公平な: 右, 不適切な
サブ: 置き換える
バケツ: バレル, スプーン
団体: 組織
ディーラー: 小売店, 販売員, 商人
主に: 特に
儀式: 式, 崇拝
大腿: ハム, 足
: 
累積: コレクション
検査官: 観察者
ワードローブ: キャビネット, ローブ
テクスチャー: 組織, ウィーブ, 建築
調整: 調整します
荒れ狂います: 暴力的な
知りません: 実現します
: ポット, 
初期: オープニング, 開始, 最初, プリミティブ
最小: 最低
補正: 改革, 修復
一口: パン, 一口
見落とします: 忘れる, 無関心
全会一致: ユナイテッド
炭素: 石炭
: 
さわやかな: シャープ
単語: 辞書, 単語
散歩: さまよいます, ウォーキング
: 
フィットネス: 運動, 調子
国籍: ナショナリズム, 国民
味: 味, 香り
: 
重要でありません: 必要, ささいな, 無関係の
アルファベット: アルファベットの, 母音, 音節
スキャッター: スプレッド
パンチ: 拳, ビート
: 
ストライド: 進捗
周: ボリューム
軸: ショルダー, 印刷, ヒンジ
: のり, 
満足させます: 疾患, 満足
信頼性のある: 忠実な
気持ち悪いです: 嫌い, 醜い
倫理的な: 道徳, 丁寧
崩壊: 秋
クッション: 川
混乱させる: 破壊する, びっくりさせます, 失敗します
神話: ストーリー, 伝説
所有: エステート
恐怖: 怖がらせます, ひどいです, 恐れ
ブレーキ: ブレーク
ナット: 豆, シード
拡大します: うねり, 増加する
太陽: 日光
襲撃: 攻撃
嘴: リップ, 単位, 鼻
リース: リーシュ, 家賃
: 
比: バランスのとれました, 比較, 規模, 報告する, 類推
櫛: みがきます, ショルダー
翻訳します: 翻訳
レクリエーション: エンターテインメント
サンプル: インスタンス, 試します
複数: 質量
イニシアチブ: 計画, 試します
ゼリー: ジャム
: 
アナーキー: 障害, 混乱
リビジョン: 改革, 繰り返されます
プロフィール: アウトライン, ファイル
ファイナンス: お金
: 繰り返されます, パトロール, 
基本: 財団, インフラ
払いのけます: ダンプ, 遠く, 失脚させます
電気: エレクトロニック
ハーブ: 草
栄えます: 栄えます, 成功
類似: 類推, 似ています, 連帯
: 
プライバシー: プライベート
アリーナ: フィールド
スピン: スパイラル, 遊びます
旅行者: 旅行者
: 
: 
粒子: 原子, シード
生来の: 純正, 柔らかい, うまれた
住民: 居住者, ライブ
カレンダー: 日記
フルート: ホイッスル
再生: 肥沃
スパン: 長さ
サラダ: パワー
屋根裏: バルコニー
: 
染料: 色
実証します: 証明します
算術: アカウント
: 
倫理: 道徳
正式に: 公式
困らせます: 干渉する, からかう, 駆り立てます, ボア
グライド: スリップ
トレイト: 専門, ストレッチ, 美徳
作曲家: ミュージシャン
パートナーシップ: 協力, アライアンス, 貢献します
継続: 持続する, 連続
シーケンス: シリーズ, 注文
アスレチック: アスリート, 運動
酩酊: 酔っぱらい, ドリンク
割り当てます: 決定的, 取る
タックル: つかみます, 対処, 装置, インターセプト
縁石: 阻害, 舗装
: 
広告: 広告, 名声
モーゲージ: 人質, クレジット, ポーン
寛容: 忍耐, くま
抑制する: 防ぐ, 虐げます
配偶者: 妻, 夫, パートナー
有効な: 効果的な, 資格のあります, 大丈夫
バルブ: バン, バルブ, 蓋
: 
バグ: 昆虫
構築します: 建物, 製剤, 段階, 成ります, 組成
コウモリ: スティック, クラブ
矛盾しました: 無関係の, 対照的な, 物議を醸します, ライバル
自動: 直接, 自動的に
明確な: 開いた, トランスペアレント, 現実的な
効果的に: 効果的な, 効果
依存: はまって, 頼ります
検査します: 観察する, チェック
足首: ヒール
分類: ソート
妙に: 奇妙な
ホール: 輸送, ドラッグ, 戦利品, ホール
厄介な: 恥
使用禁止: 身体障害, 受動的
傲慢な: 誇り
カール: 縮れた, リング
宝石: 石, 栄えます, ダイヤモンド, 寄託
記念日: お誕生日
ラップ: パック
多様性: 区別
威信: クレジット, 名声
過失: 省略, 軽蔑, 無謀
差別: 分化, 例外
ターゲット: 目的
ストール: スタンド
: 舗装, 
投資: 投資, 購入
クルーズ: 船
ラリー: 連帯, アセンブリ
噂: ゴシップ, 音声, 名声
積極的に: 完全に, 積極的に
チェック: チェック
出てきます: 現れる
: 嵐, 
: 
区画: パーティション, アパート, キャビン, ルーム
具体的に: 特に
フレームワーク: 規模
迷惑な: 気難しいです, 狭い, 干渉する
バング: ポップ, バースト, ショット
: 
集計: キモい, 集計, 砂利
分数: 部, 杭, 噴水
違法: 非合法, 野生, 不適切な
ディゾルブ: 溶媒, 放棄されました
火山: 丘
平衡: バランス
: 
: 観光, 
: 
探査: サーチ
: 
定常: 安定しました, 書きます
タマネギ: 弓, バルブ
親和性: 類推, 連帯
不正直: 忠実な, 正直な
補足: ウィジェット, 追加の
衝突: ショック, 干渉する
アームチェア: 椅子, ソファー
パン生地: 粉, 質量, 酵母, ケーキ
乗り出します: 参加します, 開始
トランス: エクスタシー
拒絶: 廃棄物
分散: けんか, 分化, 変化する, 区別
吸収: 肌, エクスプロイト
: 
: 
: 
: 
集合的な: 質量, 一緒に
タイムリーな: 時間, 首を切ります
侵入します: 攻撃
解任: 袋, 冗長性
かなり: 主として, 十分な
実験的: パイロット
膜: 映画, テレビ, 画像
: 
タブレット: ボード
宣伝: 広告, 名声
緩和: リラックス, エンターテインメント
拡大します: 広げます, スプレッド, 解凍します
タンブル: つまずきます, 秋, 浸漬
化石: 油, 考古学的な, オーガニック
制約: バリア
力学: メカニカル, エンジニアリング, 力学, 疫学
: 
ゼスト: スパイス, 経験, 味, 肌
サイクル: サーキュレーション, 自転車, ホイール, 与える
昼寝: 睡眠, うなずき
ハムレット: 郊外, 村
足: 足
ブーム: 栄えます, バウンス, バースト
再現します: コピー, 産出
会議: アセンブリ
ワークショップ: スタジオ
減少: カット, 秋, 低いです
ほうき: 雨
: 
発音: アクセント
判定: 文, ルール, 裁判官, 管轄, 危機
集中: フォーカス
アンドゥ: 開示します, バック
フェリー: ヨット, 船
パネル: ダッシュボード, ボード
簡単な: 直接, 簡単に, トランスペアレント, ライブ
: 
: 
高度: 長さ
顧問: 拷問
: 
示します: ショー, 平均
輸出する: ガラス
犯人: 彗星, 罪を犯しました
パー: 等しい, バランス, 段落, 名目, 評価
廃止します: 削除します
調整します: 適応, 最適な, フィット, 調整します, 正当化します
メンバーシップ: メンバー
ゲージ: 測定, 規模, 大きさ, インジケータ
耐えます: 許します, くま
: シミュレーション, 
ヒップ: 臀部, ロマンチック
付着します: 続きます, 参加します, スティック, キープ, 従います
刺激します: イライラしている
不安: 障害, 心配して
貞操: 純度
収縮: 内気
ジャーナリスト: レポーター
解説: ワクチン, 定義, 注釈
送信: 感染, 送信
: 
謝ります: 林檎
: 
: 
投票: マッチング, 音声, バレエ
なめます: 私に
潜在的な: できます
適格: 資格のあります, 右, フィット
ループ: サーキュレーション, ヒンジ, リング
労働者: 従業員
起訴します: 起訴, 非難
ライセンス: 許可, 特許
放棄する: 放電
自我: 自分自身, 息
ジェット: 鳥, ストリーム
違反します: カット
: 
生存: ライフスタイル, 母音
フリーズ: フローズン
現職: 設立
無関心: 無関心
: 
整理します: 組織, 準備します, 法律を制定します, 管理します, 組成
恐らく: たぶん
: 
: 
コー​​ド: 斜辺, 契約
出血: 血液
: 甘い, プリン, 
: 弓, 
検出: 発見, サーチ, 開示します, 検出
スマッシュ: 破壊する, ブレーク
周波数: サーキュレーション, ためらいます
ステッチ: 縫い, 汗
ディレクトリ: 証拠
チョップ: 一口, カット, ステーキ
加熱: 暖かいです, 夏
クーデター: 革命, ショット, ストローク, 反乱, 決定的
: 
思いやりのあります: 同情
思想家: 知的
予算: バランス
シビック: 市民の
ポータル: ドア
: 
インサート: 入る, 増加する, 紹介します
黙想します: 反映します, 考えます
はさみ: ドラッグ
フレキシブル: フレックス, エラスティック
スラブ: ボード, レンジ
資格: 資格のあります, 才能
スイッチ: 変換, キー, 置き換える
理論的な: 理論
タオル: ファブリック
10年: 十, 結び目
複数: 異なります, もっと
: 
包帯: ドレッシング, バー
きちんとしました: ニート
ハック: タカ
拍手: 拍手
空虚: 空の, 玉
骨髄: 油, 脳, パンプキン
吸収します: エクスプロイト, 吸います, 削除します
予測: 期待, 推測
教育します: 教育, 列車
問い合わせ: 要求, サーチ, 評価
支配: ルール
親の: 親
参加します: 参加します, 従事して, 参加, 部
: 
エレベーター: リフト
メーカー: メーカー
ラテラル: 側, 追加の
延期します: ディレイ, 煙
嫌悪: 軽蔑, 嫌い
通行料金: 犠牲
メタファー: インスタンス, 輸送
広範: スプレッド, 広いです
: 
ちっぽけな: 少し
: 
パーセント: あたりセント, パーセンテージ
爆弾: ポンプ
決定的に: 深い
予約: つかみます
縫う: 縫い
化学者: 化学物質
ラウンジ: ブレーク, ホール, 椅子
: 
開始: 開始, 攻撃
: 
ダイビング: 浸漬
: 
非難します: 文, 非難
膜: ベール
サスペンド: 防ぐ
平手打ち: ビート
求愛: ヤード
商品: 品
: 
相互: 交換, 相互, 反転
剃ります: 砲兵
処方: 医学, レシピ, コピー, ルール
利用します: エクスプロイト, つかいます
耐久性のあります: 長いです
系統: おなじみの
: 
亜鉛: シンク
有限の: 最後に
: 期待, 候補者, 
スクランブル: 歪めます, ストローク, レース
アカデミック: 教育, 学生
タイヤ: リング
消費者: つかいます, ユーザー
有効: 価値, クレジット
約: 近似, 約
顕微鏡: 望遠鏡
民間人: 市民の
ストラップ: リーシュ, ロープ, ホイップ
シンボリック: ジェスチャー, 身元, マーク
適応する: 適応, 対処, 書き写します, 最適な, 置き換える
可能性: 確率, 可能性
主観的: 精神的に, 虚数
代名詞: 良心
誤って: 違う, 乱用
: 
思いとどまらせます: 野心, 憂鬱な
ステープル: クリップ, 主要な
新人: ゲスト, 参加します
無限大: 不定詞, 数学
グラフィック: チャート, グラフィカル
イチジク: 画像
ニッチ: キー
失望させます: 失敗します, 欲求不満
キャリア: ベクター, オペレーター
: 
投影: 計画, ショー, 反映します
解放: 放電, 救い, 無罪, 独立
振動: 共振, 震える, 発振
: 
フランチャイズ: 特権
つじつまの合いません: ナンセンス, 無関係の, 残念な, 不適切な
回転: サーキュレーション, 革命
生理的な: 心理学
メーター: 測定
制限: バウンド, バリア
カテゴリー: コミュニティ, クラス
人種的: レース, 人種差別, 歪み
置換: 代わりに, 置き換える, オプション
直面します: 対処
禁止: バリア
ロビー: 誘発します, ホール
投げます: キャスト, 縮れた, スクラップ, ダンプ
補います: 化粧, 置き換える, 褒賞
スクロール: 本, 縮れた
メカニック: メカニカル, 職人
侵略: 攻撃, 積極的な, レイプ
ちょっと: こんにちは, ようこそ
測定: 測定
競争します: ライバル
軌道: クラス
: 
: 
アカデミー: カレッジ
: 
初心者: 新鮮な
離婚しました: 離婚
貯水池: タンク
ショッピング: 購入
: 
暗黙: フル
戦略的: 戦略
型: 形, 印刷, キャスト, キノコ, 母音, テンプレート
リハーサル: 運動
満たす: フル
主張: 主張します
: 
先行します: 前
ミッド: 中世の, の間に
: 
: 
ツーリスト: 旅行者, 観光
飲料: ドリンク
心に留めます: 忘れる
明確に述べます: 説明します, 表現, 例証的な
トレラント: 忍耐
修正します: 変化する, 置き換える, スプライス, 改革, 修復
胚: 核
ダイアグラム: チャート, 地図
控除: 探偵, 例外
演繹的な気分: 帰納気分
圧倒する: 虐げます, 洪水
モバイル: 移動します, 電話, モビリティ, 変数
持ち上げます: リフト
さらに: さらに
逆説: 悲劇
拍手を送ります: 拍手
誇張する: 塩
ブロンド: 黄, ゴールデン
合図: マーク, パスワード, スティック
ランナー: ホール
交渉します: ネゴシエーション, 話し合います
政権: ルール
公差: くま, 忍耐
十字軍: 遠征
流行: 悲劇, 翻訳
技術: テクニカル, 戦術, エンジニアリング
ターミナル: 最後に, ターミナル
出力: 費用, 撤退, 出版, 出口, 生産性
HTML: 
検索します: スポット, 検出
デフォルト: 省略
コンテキスト: 風景, シーン
リクルート: 候補者
ゴミ: 最悪, 廃棄物
: 会計, ボックス, 
: 
連合: アライアンス, ユナイテッド
: 
欠陥: 非難, 違う, 身体障害, 不利益
: 
認めます: 感謝
放送: 出版, 送信
ダイヤル: 選択します, リング, ギャザー
流行: 人気のあります, サーキュレーション, スプレッド
ますます: すべて, 主として
変換: 変化する, 変換
凧: ドラゴン
曖昧な: 漠然としました, 物議を醸します, 曖昧な
カフェ: コー​​​​ヒー, バー
賞: 褒賞, プレミアム, 与える, 奨学金
同程度の: 比較
ラベル: スタジオ, マーク
賛成の: 承認します
親族関係: 類推, 社会主義者
は虫類: ヘビ
アウトドア: でる, 開いた
無線: ラジウム, 無線
政治的に: 政治的
引用します: 見積もり
残基: 遺跡
: 
テープ: カセット, バンド, 氷, 映画
当たり障りのありません: 柔らかい, 甘い
: 
オーラル: リップ, 口, 気の利いた言葉
不一致: けんか
推測します: 推測
: 
追い出します: 失脚させます, 放電, 削除します
: 
スキップ: ダンス, 左
マグカップ: カップ, しかめっ面, 口
免除: ディスカウント, 例外, 冗長性
ポータブル: モビリティ, 少し, 細胞電話
ラッピング: パック
ブリリアンス: 才能, 美しさ
フィン: バレエ, 翼
移民: マイグレーション
: 
: 
: 
手術: 外科医
宣伝: 
正弦: 14
蓄積します: 保証金, ギャザー
うんち: パイプ
含意: 撤退, 効果
インセンティブ: 奨励します, イライラしている
: 
有害な: サイバー犯罪, 不親切な
田舎: 風景, 農村, 郊外, フィールド, 村, 国
分解する: 破壊する
: 
土着: 自然, 純正, 居住者
スタック: ダンプ, 煙突
講師: スピーカー
: 
ディスク: ディスク, ディスケット
資格を得ます: 資格のあります
傾向: 方向, 曲がりました, 配置, ドリフト, 傾向があります
誘導: ひらめき, 誘発します
企業の: 会社
小売り: スリーブ
不安定な: 不安定な, 非永続性
互換性のあります: 平行, フィット, 最適な, マッチング
電話: 電話, コー​​ル
: 
真空: 空の, ポンプ
: 
つかむ: 刺します, 取る, つかみます
けいれん: 地震, バースト, ヒステリー
: 
退屈な: ボア
ポートフォリオ: コレクション, 財布
隙間: 亀裂
合併症: 複雑
介入します: 干渉する
: 
代理人: 代表
: 
意志: 意志力, 欲望
予測します: 期待, 推測
楽観: 希望, 信じます, うまくいけば
皮: 肌, 皮質
彫ります: 一口
: 
ホバー: 浮く, 舞い上がります, ためらいます
セクタ: フィールド, 地域の, 部
姓: 名, 彼ら, 城
機関: 会社, 組織
緊急: 心配して, 興奮
乗算: かける
楽しい: 楽しいです, 醜い
: 
滝: 噴水
つまらないです: 憂鬱な, 欲求不満
抑止します: 防ぐ, 怖がらせます, 阻害
否定: 負
勝者: 成功, チャンピオンシップ
複合: ミックス, ユナイテッド
拒否: 不承認, 阻害
影響: 効果, ショック
ファイバ: ファイバ
一口: 口, 飲み込む, 一口
ビジュアル: オプティカル, シーン
爪: 爪
: ケーキ, 酵母, 
: 
原告: 俳優, 原稿, 起訴
欺きます: 歪めます, びっくりさせます, だまします
禁止する: 阻害, 防ぐ, バリア
パフォーマー: 俳優, アーティスト, プレーヤー
: 
トーナメント: レース, チャンピオンシップ
格闘: 戦争
要件: 要求, 調子
マイナス: 最低
: 
だらしありません: 無謀
感染: 感染
: 
強調する: 主張します
パンツ: ズボン
混乱させる: パズル, びっくりさせます
ささげます: ボランティア, 意図します
外科的な: 外科医
誠実: 事実
: 
数字: 整数, 指
: 
100分の1: 百
近所の: 近く, すぐに, 小売店
星座: 銀河, アライアンス, 惑星
通常は: いつもの, しばしば, 傾向があります
紛らわしいです: 物議を醸します, パズル, 混乱, ジレンマ
比例しました: バランス, 規模
子音: レシピ
同意しません: 不承認
フォント: フォージ
: 
刺激します: 怒り, 干渉する, からかう, イライラしている
傑出した: より良い, 印象的な, 例外
開始: 開始
降水量: 沈殿させます, 雨
怖がらせます: 怖がらせます
趣味: エンターテインメント
文法的: 文法
数の: 数, デジタル, 統計的に
基準: 規模
予報: 推測, 期待
不承認: 不承認
エキゾチック: 外国の, 奇妙な
高めます: 改善します, 広げます, 増加する, 解凍します
融合: マージ, メルト, コー​​ル, ミックス
世論調査: 選挙
才能のあります: 才能, できます
解凍: メルト
スティッキー: 必要
成分: 組成, 要素, パーティション
カーネル: 核
正します: ストレッチ, 直接
飾る: 装飾的な
明示的: 明らかに
大統領の: 総裁
一致します: マッチング, フィット
祝い: 賞賛
: 
スキャン: スイープ
エンタイトル: 右
賭け: 調子, 花火, ギャンブル
技術的に: テクニカル, エンジニアリング
経過: 通過, 残り
経済: 経済
実証的: 経験
支配します: マスター
広告を出します: 広告
: ライブラリ, 
拡散: サーキュレーション, 分配します, スプレッド, 出版
グレイズ: 擦り傷, 名目
アジャイル: おしゃべりな
キット: 装置, ボックス
開業医: 医師, コー​​チ
ソーク: 吸います, 浸漬, 誘発します
競合他社: ライバル
保全: 守ります, セーブ, お手入れ, キープ
スライム: 泥, 舗装, ドリブル
反射: 反射
挑戦: ハード
都市: シティ
困らせます: トラブル
: 
汚染: 汚染します, 汚職
化学品: 化学物質
スニッフ: 息
ママ: ママ
松葉杖: サポート
登録: 録音, 入る
水溶性の: メルト
恐ろしいです: ひどいです, 脅迫的な
スペシャリスト: 専門家, 専門
憧れます: 欲望, お茶
バスルーム: 浴
ギャンブル: ギャンブル, 遊びます, 冒険, 杭
積分: 必要, 統合されました
取り除きます: 削除します, 殺します
付録: アタッチメント, 追加の, 手当
: 
職員: 従業員, クルー
: 
循環します: 分配します, 改善します, スプレッド
: 
: 
: 
: 
包括的な: ユナイテッド
: 
売り手: 販売員, 小売店, 売る
悩まします: 神経質な, 干渉する
: 
: 
爆発します: バースト
流出: リーク, 注ぐ
無料で: フリー
成分: 要素
赤字: 開いた, 部族
動揺: 神経質な, 不快, 悲しい, 障害
ハウジング: 家
: 
写真の: 段階, 画像, カメラマン
公理: 証明します
: 
害虫: 昆虫
ピル: 玉
メディア: 押す
残骸: 破滅
コーパス: 体
メニュー: リスト
骨折: 亀裂, 骨
パイ: シリコン
: 
フォーラム: ボア, 裁判所
: 
勢い: 速度, パルス
傾斜: リュート, 曲がりました, 斜辺, 浸漬
タイル: れんが, ボックス
ハッカー: 海賊
本棚: ライブラリ, 書店
計算: アカウント, 余弦, 集計
プロデューサー: メーカー
金銭的な: お金, 交換
描きます: 紹介します, 反映します
インフレーション: うねり
マージナル: フリンジ, ささいな
ファンタジー: 虚数
: 
: クック, 
: 
弱体化させます: 破壊する
ソケット: 撤退, 出口
コヒーレント: 厳密に
: 
基本的に: 条項, インフラ, 財団
検索します: 救い, 派生, バック, 検出
意図的な: 意図的に, 学びます
バーチャル: 純正
生存者: 家族
フラックス: 川, ストリーム
: いつもの, 
競争力のあります: ライバル
歯科医: 医師
動きます: 移動します
生物学: 生物学的な
: 
アルコール性の: 酔っぱらい, ワイン
: 
区別する: 分化, 対照的な
好戦的な: ラジカル, テロリスト
決定的な: 必要, 決定的, 重要性
割り当て: 作業, 運動, 義務
クォータ: 特権
発掘: ピット, 掘る, 溝
カルシウム: フットボール
記念します: 説得します
歴史的に: 歴史的
リモート過去時制: 
核の: 核, 分子の
対: 反対, 前, 敵, スタンド
こんにちは: こんにちは, ようこそ, 救い
排除: 削除します, 省略
落ち着きました: リラックス, 快適さ
: 
: 
効果: 効果的な, 効果, できます, 可用性
: 
脆弱な: 影響を受けやすいです
ストライプ: ストライプ, ライン, バンド, 映画
透明: トランスペアレント
ファサード: マスク
: 
プロトタイプ: インスタンス
オフセット: 対処, 偏差
屋: その後, ああ, うん, 君は, 誰
: 
制限します: 防ぐ, 縮めます
ダニ: マーク, 移動します
歩行者: ウォーキング, 人
バット: タンク
主張します: 非難, 主張します
: 
制御されていません: 任意
ヌル: ゼロ, 空の
条件付きの: 添付の
技術: テクニカル
マーケティング: トレード
プローブ: 評価, 衛星
: 
経済的に: 経済
管理者: マネージャー, 管財人
: 新鮮な, 
描きます: 紹介します, 長いです
孫: 孫娘, 甥
デュアル: 二, ツイン
: 
合成: インストール, コレクション
奇妙な: 奇妙な
: 
応募者: 候補者
言語学の: 言語
タグ: マーク
: 
: 
: 
隆起: リフト, 進捗
: 
驚異的な: ソロ, スーパー, エレガント, 異常な
評価: 評価, 推測
動的: パワー, 力学
修正します: チェック
壊す: パーティション, 秋, 解決
疲れます: 疲れました
キャンパス: カレッジ, 学校
: 
論文: 論文
統計的: 統計, 統計的に
策定します: 準備します, 製剤
サンドイッチ: パン
pluractional: 
刺激: 促進します, 興奮, イライラしている, ひらめき
検閲: 検閲官
装備します: 補体, 準備します
ノミネート: 指名, 示唆する
方程式: 方程式, 表現
セグメント: 部, ストレッチ
キャンセル: スクラップ, 欲求不満, 放棄されました
メーター: 測定
感覚の証拠の気分: 
: 
押し下げます: 虐げます
ミスター: サー, マスター
再構成します: 修復
アトミック: 原子, 分子の
洗練されました: 複雑な, モダン
発します: 放電
けいれん: 肩をすくめる
不適切: 無関係の, 残念な, 不適切な
堆積物: 沈殿させます
鼻であしらいます: 軽蔑, 非難
バリアント: 異なります, オプション
特定します: 参照の, 決定的
批判します: 批判, 訪問
: 
退屈: 迷惑, 悲惨
協力します: 協力, 協同組合
海外の: 外国の
分析します: 分析します
: 
降雨: 雨
航空機: 鳥, 舞い上がります
スパイシー: シャープ
: 
柔軟性: 弾性
: 
ロケット: ミサイル
副詞: エンベロープ
: 
不安定: 不安定な, 非永続性
剥奪: 奪います, 不利益, 一口
生成します: 作物, フォージ, 準備します
近似値: 近似, 推測
: 
士気: 起きている, 道徳, 精神的に
楽観的: 希望, 信じます
分類します: ソート, 分配します
カリキュラム: コー​​ス, 議題
屋外: でる
反応します: 反応, 行う
スクリプト: 原稿, ライン, 聖書
恐喝: 強要します
: 
ボーナス: 褒賞, プレミアム, 追加の
ポインタ: 針
資産: エステート, プレゼンス, 資本, リソース
: 
変動性: 異なります, 変化する
デルタ: 
: 
あいまいさ: 漠然としました, 物議を醸します, 不確実性, 迷路
トランス: 
中性: 中性, 動物
ハンディキャップ: 身体障害, 不利益, バリア
写真撮影: 画像
不足: カット, 不在, 部族
変位: 置き換える
: 
: 
菌: 細菌, キノコ, 傘
言葉遣い: 製剤, テキスト, 単語
シャトル: 輸送
: 
リファイン: 改革, 昇華させます
外交官: 大使
開始します: 紹介します, 開始
: 
打ち砕きます: ブレーク
: 
: 
吸い込みます: 息
組み込みます: 成ります, ふけます
スカッシュ: パンプキン
有権者: 選挙区
フェデレーション: 連邦政府の, ユナイテッド
漁師: クモ
アンロード: 放電
生息地: シェルター
呼び起こします: かき混ぜます, 誘発します
さようなら: お別れ
取り壊します: 破壊する, 破滅
: 
ハッシュ: 話し合います
馬蹄: うま
ねじれ: 偏差, さまよいます, 歪めます
: 
スラム: ビート
関連しました: フィット, 観点
機能的な: 実用的, 作業
: 
変位させます: 失脚させます, 置き換える
自治: 独立
キュウリ: オプション
学部: 財団, 学生
グラフ: チャート, 地図
魅了する: 魅了する, からかう
可愛い: 綺麗な, 甘い
腹部: 胃
: 
: 
リテラシー: 教育, 能力
: サーバント, 
合成: 人工的な
トレーナー: コー​​チ
節約します: ストレージ, セーブ, 守ります
ごみ: スクラップ, ダンプ, 廃棄物, 最悪
: 
写真: 画像, ショット
教科書: マニュアル, 本
: 
固めます: 強化する, マージ
拘束します: 強要します
エコノミスト: 経済
リグル: しかめっ面
ヨウ素: ミネラル
感染させます: 感染, 汚染します
流産: 中絶, 低いです
デザイナー: 決定
まず: 最初, プライマー
分泌します: 分泌, 隠す
UNIX: 
マンガン: ミネラル
ほうれん草: 親
インテンシブ: 暴力的な, 神経質な
説得力のあります: 例証的な
アプリ: アプリケーション, プログラマー
デビュー: 最初, 開始
第1000: 千
屋内: インナー, 深い, 屋内で, 覆われました
取り消す: ドラッグ, 奪います
: 
振幅: 大きさ, スプレッド
: 
次元: 方向, 次元の, 次, 規模
聖書: 聖書
量子: 採択, 部
ポスター: バナー
加速します: 沈殿させます, 速度
激化します: 強化する, 増圧器, 慢性的
一般的に: いつもの, しばしば, 特に
コミットメント: 約束する
キュー: 尾, 注文, 現在
ブラケット: クリップ, 肘, フック, サポーター, サポート, 括弧
: 
: 
逆数: 上側ダウン, 反転, 従事して
蒸発します: メルト, あくび
航空: 雰囲気, 空気, 飛ぶ, 翼
相関: バランスのとれました, 比較, コミュニケーション
計算: 性別
エスニック: 国民, 歪み
リニア: 素朴な
圧縮します: ジップ, ジャム
スラッシュ: カット
浸食: 涙
トリッキー: 狡猾な, 手の込んだ, 複雑な, ハード, 天使
特性評価: 特徴づけます
接辞: スプライス, 平行, 誘発します
分子: 分子の
コンフィギュレーション: 配置, 構造上の, アセンブリ, 組成
インタラクション: ネゴシエーション, 重複, コミュニケーション, 相互
定量的な: ボリューム
内観: 回顧展
オリエント: 東
精子: シード
醸造所: ミル
簡略化する: 促進します
支持します: サポート, 承認します
: 
信頼性: 忠誠心, 信頼性, クレジット
: 
転覆: 破滅
隔離します: 分離しました
偏向: ドリフト, 偏差, バイアス
注入: 針, ワクチン
強要します: 強要します
サンダル: 靴
チャンク: チップ, 段落, ストレッチ
テレビ: テレビ
穀物: 豆
コンテナ: 楽器, タンク, ポット
: 
移動します: マイグレーション, さまよいます, 移動します, 行きます
用語: 条項
コンポーネント: 特徴, 要素, パーティション
有権者: 選挙区
陰茎: 性別
消します: 削除します, 破壊する
介在します: 調整します
資本主義: 資本家
林業: 森林
スキー: スケート
クリアランス: ギャンブル, 許可
: 
: 
選択的な: 選択します, 選挙
静的: 安定しました
収束します: マージ, フォーカス
グローバル: 国際, 世界, 変数
イジェクト: 失脚させます, 排気
: 
死傷者: 事故, 犠牲
OK: 等しい, 非常に
現実的: 実用的, 現実的な, 従事して
審判: ルール, 裁判官
インクルージョン: 録音, 成ります
受益者: ユーザー, 利益
差動: 異なります
息を吐き出します: 息
流域: 水
フィクスチャー: 適応, 装置, 品
: 
インストール: インストール, 設立
伝統的に: 伝統
教室: クラス
: 装置, 
潜在的に: 能力
プロトコル: 契約
結石: アカウント
結腸: スポット
グラム: 暖かいです, 草
ガソリン: ガソリン, パトロール
: 
思春期の: 若い
10進数: 少数
こねます: スクイーズ, トラブル
補完的な: 補体
飛行機: 鳥, 舞い上がります
およそ: 約, 近似
スポンサー: 寄託
懐中電灯: フラッシュ
スーツケース: ボックス, 荷物
スワップ: 交換
: 
任意: カスタム, 任意, オプション
反復: 繰り返されます
マトリックス: 胃
描写: ショルダー, 画像
プレ: 東, 前, 牧草地, 既に, 辞書
広告: 広告
容認できません: 不適切な
: 
気絶させます: びっくりさせます, ショック
入射: 浸漬
倒れます: 注ぐ, ハート
感覚の: 感じ
コンセンサス: 契約
監督します: 管理します, モニター, 警察, ハング
根底にあります: サブテンド, 財団
: 
移植: 交換
アルミニウム: アルミニウム
: 
: 失業, 
変動: 発振
シミュレート: シミュレーション, 装います, 書き写します
: 
複雑にします: 複雑な
メンター: コー​​チ
: その後, 
スロット: オープニング, 出口
分析的な: 分析します
操作します: 操作, かき混ぜます, うそ
: 
ベジタリアン: 野菜
ノルム: 仕様, ルール
シラミ: ティース
地下鉄: トンネル
呼吸器の: 息
突然変異: 変化する, 変換
下着: リネン
モデム: 
加速度: 促進します
区別する: 分化, 区別, 対照的な
偽ります: フォージ, 歪めます
季節の: シーズン
: 
エミッション: 排気, 放射線
村人: 農村
コマ: コンマ
: 
反転: 反転, 反対
: 
: 
: 
: 
スーパーバイザー: 観察者, マニュアル, スーパー
: 
監査: チェック
: 
: 
ハイキング: 舞い上がります, さまよいます, リフト, ウォーキング, 増加する
: 職人, 
軌跡: スポット, ポジション
再生: うまれた, 生まれ変わり
不況: うつ病, 経済
: 
略奪: 戦利品
モチーフ: テーマ
スローガン: パスワード
統合: 協力, マージ
: 
マゼンタ: 紫の
最小限に抑えます: 最低, 狭い, 低いです
: 
居住の: シェルター, 居住者
数字: デジタル, 数, 整数
塩辛いです: 塩
: 
CD: 
理論家: 理論
水族館: 魚
: 
牽引力: ドラッグ, 主張します
パラシュート: 傘
重要なことには: 必要, 特に
全体: すべて, キモい
悪化します: 歪めます
mirative: 
ダイナミクス: 力学, 速度, 疫学
性的関心: 性的, 性別
主に: 主として
: 
フリップ: 反対
: 
腸: 腸
: 
考古学: 考古学的な
ピーナッツ: 豆
同格: 手当, 順列
クッカー: レンジ, キッチン, ポット
ズボン: ズボン
基準: インジケータ
: 
幾何学的な: 幾何学
概要: アウトライン, 簡潔な
認知度: 理解, 知覚
: 
チンパンジー: モンキー
: 
: リーフレット, マニュアル, 
遺伝子の: 形態学的な, 遺伝学, 遺伝子
参加者: 参加します, 役割, 分詞
: 
レパートリー: 才能, コレクション, ソフトウェア
: 
: 
: 
回転させます: サーキュレーション, 遊びます
: 
レイアウト: 組織, 計画, 配置, 順列, 構文
同性愛: ゲイ
: 
バウチャー: プラグ, 領収書
: 
シナリオ: 風景, 状況
定理: 文, 理論
ブースト: 増加する
: 
: 
評価します: 評価, 検出, 推測
認知: 診断, 精神的に
調整する: 座標
明らかにする: 手の込んだ, 説明します
毒性: 毒
ストレス: 主張します
スランプ: うつ病, 危機, 浸漬
応じます: サーブ, 提供, 保証します, フル
サファリ: 
代数の: 代数
耐性: 慢性的, 抵抗, 免疫の
スナック: トースト
シネマ: 映画, 映画劇場
: 
蛇口: パイプ, ミル
マーカー: マーク
: 
周辺: 周囲の, 地域の, フリンジ
断定的な: 決定, 述語, 決定的, 頑固な
ノード: 結び目
見出し: ライン
肥満しました: 厚いです
引きます: 削除します, 奪います, 引き算
アナリスト: 外科医
自動詞: 必要
モール: スーパーマーケット, 品
: 
収束: 変化する
株主: パートナー, 杭
まとめます: 縮めます
性器: 肥沃
ヘリックス: スパイラル, カタツムリ, 縮れた
: 
クッキー: ビスケット, ケーキ
ベータ: 
膨らませます: うねり
エレクトロニクス: エレクトロニック
リライト: 書き写します
ラボ: 研究室
職業の: 職業, 作業, コミュニケーション
: 
勾配: マイル, 浸漬
: 
カラフル: 色
カバレッジ: 覆われました, ワクチン, お手入れ, 毛布, ルーフ, 観点, ボリューム
関与: 参加します, 参加
: 
サイバースペース: 雲
: 
: 
: 
オリエンテーション: 方向, 傾向があります, ポジション
パーズ: 分析します
商: 能力, 用量
作ります: 作物
サーマル: 油
ステレオタイプ: 例外
環境の: 風景, エコロジー, 周囲の
テク: テクニカル
シグマ: 
残余: 遺跡, 冗長性
分離: 分離しました
大型トラック: トラック
: 
: 
スタジアム: フィールド
: 
コーディネーション: 座標
細菌の: 細菌
: 
実装: 実装します
適応: 最適な, 適応, プロ
生物学者: 科学者
: 
インタフェース: コミュニケーション
パラジウム: 保証します
: 装飾的な, 化粧, 
暗記します: メモリ, セーブ, 覚えています, 実現します
コンサルタント: 弁護士
診断: 診断, 症状
: 
: 
: 
: 
: 
含蓄: セマンティック, 定義
: 
シラバス: 抽象
: 
: 
伝導: ライン, 誘拐, 輸送, サーキュレーション, 反転
100万分の1: 百万
治療: 扱います
ナショナリスト: 国民
バリウム: バー
主流: いつもの, キー
意味のあります: 平均, 間接的な, セマンティック
問題のあります: トラブル
: 
: 
オーディオ: 音声
: 
: 
: 
: 
代謝: 大使
グリッド: ウェブ, ボックス
: 
空間的な: 雰囲気, 次元の, 個別に
専門にします: 専門家, 専門
: 
: 
週末: 土曜日
試験: 卒業, クイズ, 試します
個別の: 分離しました, ソロ
抑制する: 阻害, 防ぐ, インターセプト
ドキュメンテーション: マニュアル
オートバイ: モーター
マントラ: 
マルチ: もっと, 非常に
学期: セッション
蒸し暑いです: 湿りました, 暖かいです
形態: 形態学的な, 科学, 形
: 
診断します: 診断, 実現します
スキャナ: ブラウザ
グラフィック: チャート, グラフィカル
冠状: 疾患, ハート
アーカイブ: ファイル
シータ: 
対決: 比較, 摩擦
貨物船: トラック
最適: 最適な, すばらしいです, クラシック, 最低
基本的に: 条項, 主として
サイクリング: サーキュレーション, 自転車
動機: ひらめき, イライラしている
硫黄: 硫黄
オペレーショナル: 操作, アクション, 再起動, ラン
軌道: 方法
関連性: 重要性, コミュニケーション
現在関連性マーカー: 
自転車: 自転車, ホイール
指令: 例証的な, 参照の
航空会社: 鳥, 空気, 組織, 舞い上がります
: 
リットル: リットル
バスケットボール: バスケット
: 
統一します: マージ, 調整します
それにもかかわらず: その後, 一方
スタンス: スタンド, ポジション, 段落, ドリフト, 役割
最小限の: 最低, 低いです
サイクリック: サーキュレーション
基板: 分子の, 表面
: 
: 
: 
水中: いずれか
: 
不備のあります: 不適切な
専門知識: 経験, 専門
: 
: マーク, 
アイコン: 地図, マーク
ORD: 
電子: エレクトロニック
インタラクティブ: 重複, 相互
最初に: 最初
サボタージュ: 破壊する
相互に作用します: ネゴシエーション, コミュニケーション, 付き合います
数学: 数学
胎児の: 核
近代化します: モダン
過激派: ラジカル, テロリスト
連想: バイス
小便: 尿
: 
: 
はい: 非常に, 大丈夫
: トーン, 
: 
スワイプ: スチール
目的にかないます: 意図的に
セミ: 途中で, 売る, グラインド, 幅
頭字語: 簡潔な
頭文字: 
: 
序数: 交差点
ニューラル: 神経質な
抗: 抵抗します, 抵抗, ライバル, 反対
: 
統合します: 同期します, 参加します, ラジカル
近位: 近く
: 
: 
栄養素: ミネラル
不明瞭な: 漠然としました, トランスペアレント
: 
外傷: ショック, 損傷, 潰瘍
: 
: 
交換: 交換
: 
評価します: 評価, 推測
マナ: 精神的に
過去形: 
縦座標: 座標
スキュー: 歪めます
: 
クローン: コピー
: 一時的, 
: 
実行可能な: 利益
: 
: 
バックアップ: 海岸
: 
爆撃機: 積極的な
: 
複製: コピー, 回答
: 
ラムダ: 
反応性: 反応
: 
ガールフレンド: パートナー, 女の子
時刻表: 時間, 配置
構文上の: 構文
: 
: 
安定させます: 安定しました, 安定
反体制派: ライバル
反応: 反応, 示唆する
: 
共感: 同情, 理解
: 
ボロン: ピット
アンケート: クイズ
酸化します: コー​​ル
ミリメートル: ミリメートル
更新: 改革
: 
分子: 分子の
セットアップ: 準備します, 設立
: 
精神科の: 知的, 精神的に
: 郊外, 
症候群: 疾患, 症状
: 
パラダイム: 概念の, インスタンス
: 
: 
: 
: 
アミノ: 
アオリスト: 
活性化します: 行う, アクション
マイクロ: 微妙, マイクロフォン
: 
無作為に: ランダム, に場合
: 
仲間外れ: 分離しました, ボイコット
: 
予測可能な: 推測
統計値: 統計
サブセット: 部
方法論: 方法, 戦術, かつて
芸術作品: 作業, 芸術的
ピザ: 
シーケンシャル: 注文
言語学: 科学
差し押えます: つかみます
: 
産業化: 工業化します, インダストリアル
キロメートル: キロメートル
多国籍: 国際
プランナー: ストライプ, 計画
ダイアログ: コミュニケーション
指数関数: 指数
シェアウェア: 
: 段ボール, ボックス, 
合同の: 優しいです
アップロード: ダウンロード
研究者: 科学者
割り当てます: 分配します, 解剖, 持続する
: マニュアル, ストライプ, 計画, コピー, 
ISH: 
係数: 係数
: 
: 
サッカー: フットボール
資格: 右
残り物: 遺跡, 残り, ギャザー
: 
パラメーター: 要素
マクロ: すばらしいです, キモい
二次方程式: お茶
持続可能な: 安定しました, バランスのとれました
可換の: 交換
最大化します: 最大
: 
経験の: 経験
: 
: 
: 
: 
URL: 
: 
インサイダー: インナー, メンバー
トン: トーン
: 
: 
: 
暗号学: 暗号化
モジュール: 単位, ボリューム
酵素: 酵母
エピファニー: 祭り
パスタ: 質量
: 
剽窃します: スチール
: 
寮: シェルター
: 
ティーンエイジャー: 若い
やる気にさせます: ひらめき
ハイライト: マーク
否定します: 破壊する, 奪います, 負
彼氏: パートナー, 友人
原子炉: 反応
: 
行動の: 動作
不遜: 誇り
: 
: 
WWW: 
: 
感謝君は: 感謝
: 
首謀者: 脳, 魂, マスター
: 
生態学的な: エコロジー
移民: 難民, コロニアル
ノートパソコン: 遠く, 細胞電話, ノート
大学院生: はがき
埋め込みます: 浸漬, ふけます
コピー: コピー, 画像
再帰: 階層
: 文字, 
: 
恐怖症: 恐れ
: 
活動家: アクション
: 
トンシャツ: シャツ
セラピスト: 医師, 扱います
: 
顔文字: ハッピー
: 海, 
: 
: 
大物: キング, 群れ
覚醒: 興奮, キモい
同期します: 同期します, シンク
活字書体: 聖書, 音節
酸性の: 酸
: 
: 
化学療法: 化学物質
語彙の: 辞書, 単語
法として: 
: 
ブレークに: ブレーク
: 
: 
: 方法, 舗装, 横断歩道, 
XML: 
クラシファイア: ソート
捕食者: ハンター
: 
前衛番人: パイオニア
議長: 頭, 会長
: 
資料: リーフレット
カリスマ的な: チャーム
決定: 決定
: 
スカンジウム: テルル
設定します: 管理します, 組成
ガイドライン: マニュアル
仮説として取り上げます: 仮定する
: 
デバッグ: ふるい
冷蔵庫: 冷蔵庫
リブート: 再起動
: 
ブロードバンド: 帯域幅
: 
ひらめき: ひらめき, アイディア
: 
複製します: コピー, フォージ
: 
ウェブマスター: 
不安: 恐れ, 心配して
停戦: 休戦
暗号化します: 暗号化
ファームウェア: 
失言: 省略, 違う, スリップ
兄弟姉妹: 兄
: 
スポークスパーソン: スピーカー, 代表
: クリップ, 
: 
: チェック, 
希代の: 異常な
ハイジャック: 誘拐, プラウ
非金属: 半金属
: 
イッテルビウム: 
: 
ラドン: 
批評: 批判
: 
ベルト: バンド, バー
面白そうな: ハッピー, 陽気な, オプション
: 
: 
venitive: 
mudita: 
mindstream: 
クレジットカード: クレジット
ボーリウム: 
びっくりしました: びっくりさせます
exclamative: 
激励の: 
デポート: 失脚させます
副動詞: 
クワーティ: 
: 
ウィン: 
: 
観光を: サーキュレーション, ボア
感染します: 感染
: 
yaor: 
後方: バック
廊下: ホール
コネクタ: コピュラ, プラグ, アタッチメント
マイトネリウム: 
午後: 午後, 夜
フェミニン: フェミニン
: 
: チェック, 
シーボーギウム: 
: 
ローレンシウム: 
意志あります: 
: 
無知な: 無知, だまします
: 
README: 
相互に関連付けます: フック
再帰: 
モデレータ: 進行役, マネージャー
: 
ホットドッグ: ソーセージ
善: 美徳
usitative: 
回帰: 撤退
バスタブ: 浴
割合: バランスのとれました, 杭, 部, ストレッチ
微分積分学の前学習: 
輪廻: 
ハイパーリンク: ハイパーテキスト
ウィキ: 
直示: 
会報: リーフレット, 情報
訴訟: 起訴, けんか, 裁判所
ブレークダウン: パーティション, 分化, 解決
真実を告げます: 
ホルミウム: 
簡単に: 簡単に
: 
素晴らしいです: びっくりさせます, 印象的な
報いる: 支払う
組紐: ウィーブ, 編まれました
憂慮すべき: ひどいです, 心配して
感情を表します: 
割り当て: 配当, 手当
従いましたに: 二番, バック
支配: 効果, パワー
ポッドキャスト: 
次に: 次
各他の: 1別の, 相互
andative: 
単位の質量: 
カタログ: リスト, 表, チャート
識別できます: 身元
出現: 現れる
さようなら: お別れ
: 
賃借: 家賃
から場合: に場合
等: ギター
patientive: 
譲歩: 柔らかい
: 
分配の: 分配します
考古学: 考古学的な
: 
ドブニウム: 
: 
余談から: 除きます
: 
: 
: 
エクサバイト: 
: 
フェルミウム: 
: 
テルビウム原子: ロジウム原子
注射します: 紹介します
キャンバス: ファブリック, ウェブ
ビットマップ: 
たぶん: 明らかに, たぶん, 仮定する
ジスプロシウム: 
: 
アボガドロ: 
オートバイ: モーター
: 
ツリウム原子: ロジウム原子
代わりにの: 代わりに
引退しました: リタイア
ガドリニウム: 
作戦: 戦略
自動詞: 必要
DVD: 
ロブ: 
半径: 線
教授: マスター
確率論的な: ランダム
ゆるく: 緩いです, フリー, 独立して, 状況
: 
コンピューティング: コンピューター, 電卓
: 
安く: 低いです, 購入
面白い: 面白い, 陽気な, 醜い
最適化: 適応
官僚的な: 官僚, 公式
自動詞: 必要
: 
リーマン: 
トリウム原子: ロジウム原子
不賛成の: 不承認
驚くほど: 驚き
コー​​ディング: 暗号化, 色
配給: 用量
: 
家主: 雇用者
離れてから: 除きます
: 
友情: 優しいです
除草剤: 毒
アフィン: 
: 
分隊: バンド
頬: 遊びます
: 
: 
: 
面白いです: 面白い, エンターテインメント, 陽気な
: 
: 
スクリーンショット: ショー
: 
闘争: 戦争
: 
オーソライズ: 承認します, 公式
: 
反対の: 抵抗します, 反対, 反転, 対照的な
ノーベリウム: 
捜査官: 科学者, 探偵
: 
建設的: 製剤
外側の: でる, 除きます
: 
: 受容体, 
: 日光, 
減衰: 解決
テーマ場合: トピック場合
: 
: 
インデックス指: インジケータ
: 
: 
男性: 男性
ファセット: 方向, 側
拡張: 範囲
地主: 天使
フランシウム: 
時: スポット, 時, 詩
にスプリット: 分配します
逆正接関数: 
: 
評論家: 検閲官
オンワード: 最初, 次, 持続する
ウェブサイト: ウェブサイト
: 
武装しました: 武装を解除します
子孫: おなじみの, 孫娘, 世代
ディスクリプタ: 説明します
モバイル電話: 細胞電話
作りますアップ: 化粧
importe: 
: 
虐待: 違う, 虐げます, スチール
: 
verbalizer: 
: 
: 
スペースマーカー: 
除きます: 除きます, 含めて
状態マーカー: 
: 
社会的に: ソーシャル
キュリウム: 
区切り: 分離しました
: 
標準化します: 仕様
引用終わり: 見積もり
後援: 奨学金, お手入れ
戦場: 戦争
制度の: 構造上の
フッ素原子: ロジウム原子
監査人: 会計士, 感謝
腫瘍: 腫瘍
野生動物: 自然, 野生
設立: 設立
: 
: 
中古に: カスタム
実質上: 主として, 十分な
通信の: コミュニケーション, おしゃべりな
フィボナッチ: 
ルビジウム原子: ロジウム原子
作業でる: 運動, 作業, 手の込んだ
フーリエ: 肥沃な
教育を受けました: 教育, 丁寧
アインスタイニウム: 
: 
持ってるに: しなければなりません, 義務
進行: 進捗, 進化の
携帯電話: 細胞電話
に場合: に場合
: 
とてつもなく: 非常に, スーパー
近似の: 近似
ロジスティック: 荷物
エントラント: 分詞
帰属: 
ユーロピウム: 
トポス: 
: インク, 
逆使役形: 
: 
: 
関係詞節標識: 
: 
適用されました: 実用的, 取る
加えます: 改善します
情熱的な: トロピカル
問題: トラブル, 問題
タリウム原子: ロジウム原子
ゴールドバッハ: 
バナジウム原子: ロジウム原子
困惑: 恥, トラブル
フェルマ: 
ポロニウム原子: ロジウム原子
: 
補助的な: 補体, 追加の
パッケージング: パック, 舗装
能力: できます, 管轄, 資格のあります, 能力
組み合わせ論: 組み合わせの
ビア: 通過, 上記の
ダンシング: 遊びます, ダンス
興味深いことに: 面白い, 楽しいです, 問題
発達上の: 進化の, 進捗
接周辞: 
困難: トラブル, 不利益
: 
: 
サプライヤー: 疑問に思う
ディストリビューション: 分配します
: 
日焼け: 褐色
シャーデンフロイデ: 
潜んでいます: キャッシュ
: 
: 
: 
: 
代わりに: 代わりに
ご近所: 周囲の, ライブ
ラザホージウム: 
量マーカー: 
シアン: 青
因数分解: 
ソーシャルマーカー: 
中性性別: 男性性別
遺伝的に: 遺伝子, 遺伝学
: 
プロフレーズ: プロ文
速度の光: 
一般化: 一般化します
: 進行役, ドナー, 
ストロンチウム原子: ロジウム原子
プロセッサ: 処理
ベンド: 曲がりました, フレックス, しゃがみます
補文: 
事業者: ビジネス人, 商人
: 
: 
ソプラノ: 幼稚な
信じられないほど: スーパー, 非常に
バークリウム: 
: 
相対場合: 相対場合
: 
ルテニウム原子: ロジウム原子
呼吸: 免疫の, 息
はずですに: しなければなりません
ランダム化します: ランダム
すなわち: すなわち
執行: 実装します
対立します: 抵抗します, 反対, 不承認, 抵抗, 被告
厄介な: 心配して, お手入れ
: 
名詞化: 
世界ワイドウェブ: 
目的場合: 先場合
: 
防衛: お手入れ, 守ります
ポアソン: 毒
: 
展開します: 分配します, ふけます
分母: あらゆる
accompanier: 
: 
翻訳します: 翻訳
輪郭: アウトライン, 形
キャプチャ: 
いいえ1: 何も
: 
旅: 訪問, 遠征
三つの部分から成ります: 
: 
ミス: カット, しません
掘り出します: 掘る
: 
ブロガー: ブログ
: 
咳嗽: 咳
: 
変数: 変数, 確率
広く: 幅, 広いです, 広げます
卵白: タンパク質
: 
ひどく高いです気分: ひどく高いです気分
キーワード: 主要な
2項の: バイナリ
: 
変化するのイベント: 
: 
間接的なオブジェクト: 直接オブジェクト
所有格場合: 属格場合, 所有格場合
減衰: 
结果: 
: 
ハッシウム: 
: 
流血: 血液
退却: 脱線します, 撤退, リタイア, 辞任
: 
その後: 未来, その後, 最近, 次
定理: 法的
仮定法の気分: 条件付きの気分, 願望法気分
紹介: 紹介します
退職者: リタイア
: 
: 
: エレクトロニック, 
: 
徒党: コングロマリット, クリック
読むのみメモリ: 
: 
氷クリーム: 氷, クリーム
: 
エンターテイナー: エンターテインメント, アーティスト
職業の: 専門, 職業
新しく: 新鮮な, 最近, ルート
登ります: クライミング
: 
エルビウム: 
宣誓: 誓う, 虚辞
: 
ゲーデルの: 
: 
: 
設定: 構造上の
: センチメートル, 
: 
すべて右: 等しい, 非常に
すぐに未来時制: 
: 
対照的な: 対照的な, 対処
同一指示: 
: 
前置詞の場合: 主格場合
: 
ドメイン名システム: 
シングルアクション動詞: 
ランタン: テルル
: 
量の物質: 
: 
リモート未来時制: 
: 
枚挙: 
: 
自慢: 散財
ワイド: 広げます, 広いです, 幅, コー​​ナー
ランダムアクセスメモリ: 
: 
フローティングポイント数: 
多重線形: 
: 
過去受動的分詞: 
セントラル処理単位: 
所格指向場合: 
頻繁に尋ね質問: 
