ni	Infinitive
na	nominativecilik
ka	akusatifcilik
ta	topikcilik
ca	hello
wu	vocativecilik
kcah	luwe
ti	genitifcilik
ci	kata
wa	lan
mi	kula
sa	sampeyan
nyah	us
ya	iku
ma	panggonancilik
yi	datifcilik
li	nyataswasanaati
tu	deonticswasanaati
cu	saratipunswasanaati
si	epistemicswasanaati
yu	instrumentalcilik
nu	interiorcontext
pa	wongcontext
tyah	angger-anggersawijining
la	gumantungangger-angger
fa	perfectiveaspek
ki	kepungkurtegang
ne	lananggender
mwah	comitativecilik
ra	saikitegang
pwah	benefactivecilik
swih	essivecilik
no	negatoryquantifier
pi	lumahingcontext
da	adpositionalcilik
te	lokasicilik
to	papancontext
ga	caracilik
ri	interrogativeswasanaati
ba	lanutawa
ku	eksklusifutawa
so	sumbercilik
pwih	gameluenganakocilik
ksah	jarak
tsah	demonstrative
ko	angger-anggerbuntut
pyah	nanging
wi	universalquantifier
ji	feminingender
pu	jamaknomer
bi	mangsategang
co	sosialcontext
me	imperfectiveaspek
klah	ana
twah	relatifcilik
twih	illativecilik
di	arahanswasanaati
tlah	pilihanquantifier
kyah	opo
tcah	pitakonantembung
ja	copula
cyah	wong
clah	liyane
do	nomer
tlih	tegasquantifier
se	wektucontext
myah	Temporalcilik
tyuh	mung
tcih	hortativeswasanaati
tyih	retrospektifaspek
lo	volitiveswasanaati
cwah	sawise
nlah	alienablemilik
nlih	inalienablemilik
cyih	deliberativeswasanaati
lwah	perlativecilik
pfih	majuaspek
tsih	kene
ce	ingcontext
pcah	uga
lwih	delativecilik
swah	semelfactiveaspek
nyih	neo
fu	fokus
plah	tresna
po	paucalnomer
kyih	amarga
ksih	nyebabakecilik
gi	jeneng
tfah	suwenetembung
crih	katonevidential
kceh	luwih
dwih	desiderativeswasanaati
wo	tembung
srah	nganti
tweh	terminativecilik
nwih	inessivecilik
pcih	utomoswasanaati
crah	pracaya
ro	negaracontext
cwih	Mugi
kwih	factiveevidential
fi	bali
psih	optativeswasanaati
tseh	potensialswasanaati
lweh	allativecilik
nrih	anthropicgender
tceh	padhatundhukpanandha
re	bedatundhuk
croh	wedi
mrah	ngerti
cyuh	mangu
twuh	dubitativeswasanaati
myih	ayu
lyih	kapentingan
flah	counterfactualsaratipun
we	vialiscilik
clih	kadhemen
pyih	tentrem
su	kajaba
kwah	kepinginan
le	dawa
bo	kemungkinan
mlah	alangan
syah	eseman
slih	turu
zi	dipetik
twoh	quotativecilik
mo	klebuwong
kcih	please
rwih	precativeswasanaati
mrih	sopanndhaftar
rwah	calonaspek
cyeh	wonder
go	gnomicaspek
tsoh	bab
za	inchoativeaspek
jwih	jussiveswasanaati
mwih	permissiveswasanaati
sloh	sukses
prih	pribadi
de	distributifcilik
tcoh	pain
ryah	ngguyu
mlih	wicaksana
ye	possessivepanandha
ke	commissiveswasanaati
creh	muspra
mweh	completiveaspek
nrah	anget
nroh	nesu
bwah	éwadéné
trah	bangga
mroh	moral
slah	kesehatan
syih	sosial
pe	mandhekaspek
krih	curious
tfih	Intensifier
fe	pungkasanipun
prah	aside
trih	evidential
nwah	evidentialcilik
srih	sad
zo	zoicgender
nweh	eventiveswasanaati
cwoh	padhaacarapanandha
plih	multiplicativecilik
dwah	dikarepake
kcoh	kesel
drah	wareg
lu	Spekulasiswasanaati
frih	menowondhaftar
frah	tatu
mruh	bodho
djih	simpati
krah	matur
cruh	kawirangan
fyah	tembungpanandha
ryih	preordained
kruh	pait
tyeh	teks
kreh	kejem
tleh	hesternaltegang
kfah	kurban
dyih	sengit
cloh	nyotogender
nloh	seneng
psah	nglokro
sleh	vegetalgender
nruh	resik
drih	admiration
sroh	pardon
brih	basa
kluh	kebingungan
bwih	benedictionswasanaati
klih	guilty
grih	bodho
nyeh	inisiatifcilik
nleh	asor
dlih	telatutomo
proh	kacaritaevidential
mloh	melankolis
du	tunggal
jrih	sabar
freh	referential
kloh	sepi
kroh	Pesona
tcuh	semangat
kcuh	induktifswasanaati
xa	wacanacontext
nreh	gemeter
pseh	aspek
ge	agen
mu	pepélingswasanaati
byah	ambisi
pcoh	crowded
treh	langsungevidential
yo	apprehensiveswasanaati
cwuh	kejut
tloh	anyarkepungkurtegang
dlah	pestiartikel
cluh	nyenengake
myuh	humor
dyah	pisahadohdemonstrative
rwuh	cemburu
troh	imprecatoryswasanaati
dzih	indifference
swuh	assumptiveswasanaati
bzah	jest
gwih	yaiku
dloh	hodiernaltegang
dweh	delimitativeaspek
kweh	eksklusifwong
truh	suhu
tfeh	telicaspek
lyeh	atelicaspek
ru	prohibitiveswasanaati
kfih	childish
cyoh	curiga
nluh	kasetyan
cweh	trap
nwoh	animasi
sruh	thrill
ksoh	seksual
lyah	puguh
mreh	momentaneaspek
pceh	getun
bjih	mantanalmarhum
pcuh	kahanansingdurungmesthi
xi	habitualaspek
blih	diwatesi
tsuh	orapatipenting
fwih	nggumunake
grah	flattering
brah	kasepakatan
cleh	benevolent
sreh	formalndhaftar
pfah	onogunane
droh	parungonevidential
flih	inferentialevidential
sweh	sublativecilik
ksuh	declarativeswasanaati
pleh	kangndarbenihakistimewa
psoh	invincible
be	langsung
mwoh	reverie
kleh	wretchedness
glah	kien
kseh	akurswasanaati
zrah	dissatisfaction
dyoh	idiophone
syoh	Awed
gwah	gedhebangetcilik
zlih	irrealisswasanaati
zrih	shyness
byih	adaptasi
ryeh	netralpanandha
fwah	frugal
bjah	Chrisyesenengbanget
kxah	equanimity
gvih	pegativecilik
pxih	vindication
xrah	expiring
tfoh	mrikiartiné
kxih	contrition
ryoh	prosecutivecilik
qyah	preoccupation
r6	participle
txah	remotkepungkurtegang
xrih	sajarahtegang
dxah	dualnomer
syuh	super
vweh	overworked
n6	sensorievidentialswasanaati
bweh	obsesi
xlih	gumbyang
txih	twinge
sluh	potowareg
txoh	gerakanuphill
xe	retrospektif
pxah	entrap
vwah	gerakandownhill
xyih	elit
fleh	inflected
psuh	superessivecilik
syeh	satyr
qi	transitive
xruh	cower
zwah	wow
tr6h	gerakanupriver
qwah	unambitious
xlah	worldwide
tyoh	intransitive
tluh	anticlimax
qa	saikirelevansipanandha
kxoh	asukesel
rwoh	ordinal
ve	vektor
kyoh	kilo
swoh	urut-urutan
pxeh	partitivecilik
txeh	augmentative
dxih	predicative
pxoh	prolativecilik
pfoh	protembung
blah	ingkahananjati,
fyih	nonmanungsa
xo	aktorperan
pc6h	nyobanomer
greh	sentriscilik
groh	goalpemicu
dxoh	tengahswara
rweh	obliquecilik
xwah	sabarcilik
xu	wishodiernal
xroh	nyandhangmetu
ks6h	causative
vi	binarNilai
dleh	pengandaiancilik
gjeh	liyayen
xreh	coworker
lwoh	gamelurikcilik
ml6h	multalnomer
gjih	galaxygender
qlah	stargender
bvih	abessivecilik
dvah	adessivecilik
je	agentivecilik
t6	agenpemicu
kxeh	kanggocilik
gxih	umumgender
tc6h	panggilanwangun
ts6h	transangka
ryuh	langsungobyek
gveh	ergativecilik
pyoh	pasifswara
qe	watestembung
xwih	utamiobyek
myoh	gnomicswasanaati
vrih	pungkasanpartikel
va	evitativecilik
bveh	subessivecilik
dxeh	duwenicilik
dvih	lativecilik
tsa7h	antessivecilik
dyeh	adverbialcilik
mleh	animategender
pfeh	empathetickabungahan
xleh	kendaraangender
qlih	Mineralgender
xloh	langsungtembung
dreh	kapindhobasa
bvah	potokapercayan
qrah	owah-owahansakaacara
fo	bedaacara
sl6h	crastinaltegang
fyoh	tanggapanswara
bxih	Semestagender
jlih	transitivetembung
kyeh	lokalitasgender
txuh	risetgender
s6	senigender
preh	sabarpemicu
sr6h	abstrakgender
nyoh	langsungwicara
zreh	exocentriccilik
kfeh	kepungkurperfective
jo	mligitembung
kxuh	bebarengantembung
bu	absolutivecilik
qrih	planetgender
kfoh	intibenefactive
kwoh	associativecilik
pluh	superlativecilik
jrah	listriksaiki
glih	inanimategender
p6	propositiveswasanaati
vrah	ngetokakeswara
lyuh	suksesangger-angger
gleh	rauhmangsategang
lyoh	applicativeswara
ps6h	antipassiveswara
tfuh	continuativeaspek
nr6h	necessitativeswasanaati
pr6h	pasifparticiple
sy6h	eksistensialangger-angger
qyih	padhangkakiyatan
gluh	singulativenomer
kwuh	gedhebangetdadi
xyah	singletumindaktembung
vlih	superlativedegree
djah	saikiparticiple
m6	jumlahsakainti
ti7	panyambungpartikel
f6	epentheticci-
tli7h	remotmangsategang
si_	postpositionalcilik
l6	allocutionagreement
k6	frequentativeaspek
bzih	distributifnetral
tu7	ngambangtitiknomer
vo	tembungmuwuhi
ki7	kepungkurpasifparticiple
ta_	gamelurikpituduhcilik
