Infinitive: უსასრულო, infinity, წარმოშობის, წყარო
სახელობითიშემთხვევაში: prepositionalშემთხვევაში
accusativeშემთხვევაში: 
თემისშემთხვევაში: სათაურიშემთხვევაში
მშობელი: მშობელთა, მთავარი, უფროსი, ისპანახი
მამა: მამა
დედა: დედა, დედა, დედათა
მიესალმები: ნახვამდის, hi, hey
წინაპარი: წინამორბედი, ბაბუა
ბებია: ბაბუა, ბებია
მშიერი: შიმშილი, შიმშილით
ნათესაობითშემთხვევაში: კუთვნილებითიშემთხვევაში
ზედსართავისახელი: 
და: თანხა, მიერ, 
მე: თავს, მე, ჩემი, ჩვენ, lick
თქვენ: მათ, შენ, შენ, ya
ჩვენ: ჩვენ, ჩვენი, ჩვენია
ის: მან, რომ, იგი, ამ, ამ, რომელიც
დანიშნულებისშემთხვევაში: ობიექტურიშემთხვევაში
dativeშემთხვევაში: 
რეალურგანწყობა: 
deonticგანწყობა: 
პირობითიგანწყობა: კონიუნქტივისგანწყობა, ჰიპოთეტურიგანწყობა
ეპისტემურიგანწყობა: 
ინსტრუმენტულიშემთხვევაში: 
შინაგანსაქმეთაკონტექსტში: 
პირიკონტექსტში: 
დამოკიდებულიპუნქტი: 
სრულყოფილიასპექტი: 
ბოლოდაძაბული: 
მამაკაცურიგენდერული: neuterგენდერული
comitativeშემთხვევაში: 
იმყოფებადაძაბული: 
benefactiveშემთხვევაში: 
essiveშემთხვევაში: 
არა: არ, არასამთავრობო, ძლივს, ვერ, მოედანზე, არასოდეს, არც, არცერთი, საკმაოდ, არც, არშეუძლია, miss
მისი: მათი, მისი, მისი, მას, იმ, hers, საქართველოს, რომლის, დამოუკიდებელი
ზედაპირზეკონტექსტში: 
adpositionalშემთხვევაში: 
ადგილმდებარეობაშემთხვევაში: 
სივრცეშიკონტექსტში: 
გზაშემთხვევაში: 
კითხვითიგანწყობა: 
დაან: 
ექსკლუზიურიან: 
წყაროშემთხვევაში: 
ablativeშემთხვევაში: 
საჩვენებელი: მყარი, მნიშვნელოვანი, კონკრეტული, დამაჯერებელი, დირექტივა, დრამატული, გამოხატოს, აშკარა, მივიტანოთ
მაგრამ: ჯერ, თუმცა, მიუხედავადიმისა,რომ, მიუხედავადიმისა,რომ, მიუხედავადამისა,
ყველა: ყველას, ყველას, სულ, მთელი, საერთო, მთელი, ყველაფერი, ნებისმიერი, უფრო, საერთოდ
ქალისგენდერული: 
ისინი: მათ, იგი, იმ, მათი, მათი, გვარი, ამ, იგივე, სამართლიანი, მსგავსი, უნდა
მრავლობითინომერი: 
ერთ-ერთი: მარტოხელა, , შევიდა, მარტო, , თავისმხრივ,, თუმცა
რომელიც: ვინმეს, ვინც, რომელიც, რომლის, როგორც, ვის, არაფერი, ვინმეს, რომ, მათი, იმ, მღერიან, ya
მომავალიდაძაბული: 
სოციალურიკონტექსტში: 
როდესაც: როდესაც, ოდესმე
imperfectiveასპექტი: 
იქ: არსებობს, ხუთშაბათი
მეტი: მეტი, ყველაზე, დამატებითი, მიღმა, ზევით, ზემოთ, მრავალ, მეტი, საკმაოდ, ასევე, უფრომეტიც, პლუს, ჯერკიდევ, ჯერ, სხვა, რამდენიმე, სხვადასხვა, სხვა, წინააღმდეგშემთხვევაში,, სხვა, დანარჩენი
გარეთ: გარეთ, გარე, გარე, გარეთ, გარეთ, off, გარეთ, მიღმა, up, საფუძველზე, გადატანა, მეოთხე, დატოვა, გასასვლელი
ნათესავიშემთხვევაში: ნათესავიშემთხვევაში
illativeშემთხვევაში: 
ამის: გააკეთოს, ასრულებს, წამოწყებას, გაწევა, გააქტიურება, გააკეთა, ჩაიდინოს, ბოლო, რა, რეაგირება, არაფერი, თუარა, რამნიშვნელობააქვს, სამუშაო
დირექტივაგანწყობა: მიუთითებსგანწყობა
კითხვასიტყვა: 
copula: კონექტორი, bond, bunch, ბმული
პირი: კაცი, ხალხი, ინდივიდუალური, ვინმეს, ვინმე, ბიჭი, ადამიანის, სახე, პიროვნება, მას, მათ, პირადად, საცალფეხო, თანამემამულე
მამრობითი: მამაკაცური, ვთქვათ,, ჯენტლმენი, კაცი, ნაზი, ქალი
შეეძლო: შეუძლია, შეიძლება, შესაძლოა, შეიძლება, შესაძლებლობა, ალბათობა, შეუძლია, შესაძლებელია, შეუძლია
ნომერი: თანხა, თანხა, ფიგურა, ციფრული, ციფრების, რაოდენობა, ნომრები
ძალიან: დიდად, ძალიან, საშინლად, ბევრი, ძალიან, საშინლად, ფართოდ, მაღალი, ნამდვილად, ცუდად, დიდი, მნიშვნელოვნად, ბევრი, მრავალ, enormously, ყველაზე, საკმაოდ, საკმაოდ, შორს, საკმაოდ, კარგი, კარგი, კარგი, ექსტრემალური, sore, abundant, უჩვეულოდ, წარმოუდგენლად, შესანიშნავი, სუსტი, კატეგორიულად, მკვეთრად
დრო: ხოლო, მომენტი, დროს, დროული, ხანგრძლივობა, დროებითი, დაძაბული, გრაფიკის, ვადა, ამინდი, იმეორებს, საათი, მხედველობა
დროკონტექსტში: 
დროებითიშემთხვევაში: 
შესახებ: დაკავშირებით, დაკავშირებით, თითქმის, დაახლოებით, საქართველოს, მიერ, მეტი, გარშემო, ამისთვის, წლის, თითქმის, დაახლოებით, რამ, მიმართ, თავი, ნარკოტიკების
ლიტერატურული: ფაქტიურად, რეალური, ორიგინალური, აბსოლუტური, სიტყვიერი, ლიტერატურული, ზუსტი, ზუსტი, ზუსტი
მხოლოდ: უბრალოდ, მხოლოდ, უბრალოდ, წერტილი, მხოლოდ, წმინდა, შემოიფარგლება, ძლივს, bay, მარტო, შიშველი
პატარა: პატარა, პატარა, მცირე, ოდნავ, ცოტა, მცირე, წვრილმანი, კნინობითი, პორტატული, რამდენიმე, მსუბუქად, მოკლე
მაშინ: ერთხელ, ya, მასშემდეგ,რაც, წინ, სედანი, შემდეგ, შემდეგ, მიუხედავადამისა,, ამისშემდეგ, მომდევნო, შემდგომში, შემდეგ
hortativeგანწყობა: 
რეტროსპექტივაასპექტი: 
შესანიშნავი: დიდი, დიდი, კეთილშობილური, სერიოზული, დიდი, ხმამაღალი, უზარმაზარი, giant, დიდი, დომინანტური, კარგი, ჯარიმა, მნიშვნელოვანი, დიდი, მნიშვნელოვანი, მშვენიერი, შესანიშნავი, ოპტიმალური, grand, მთავარი, სრულყოფილი, აღსანიშნავია, ბრწყინვალე, მაგისტრალური, მაკრო
volitiveგანწყობა: 
ადრე: ადრე, წინასწარ, წინ, წინუძღვის, სანამ, წლამდე, წინა, ადრე, წინააღმდეგ, წინააღმდეგ, წინ, წინასწარ, უფრო, წინ, წინა, ადრე
უნდა: უნდა, აუცილებლად, ზედმეტი, უნდა, უნდა, უნდა, უნდა-to, მინდა, უნდა
ორი: ორმაგი, ორივე, გარდა, რამდენიმე
ვხედავ: გამოიყურება, კალენდარი, მხედველობა, ცნობა, აღიქვამს, დაათვალიერეს, მზერა, ეხება, შეხვდება
ვიცი,: დადგენა, იცის, ასწავლიან, დროშა, ჩანს, მესმის,
ქვემოთ: ქვევით, ქვემოთ, ქვეშ, ქვემოთ, ქვეშ, ქვეშ, ნაკლებია,, ბოლოში, inferior, დაბლა
პირველი: დებიუტი, საწყისი, მასშემდეგ,რაც, წლიდან, პირველრიგში, თავდაპირველად
საკუთარი: თავი, თავს, ფლობს, პირადად, მისი, თავად, თვითმმართველობის, პირადი
გადაეცემაბურთისფლობადაფიქსირდა: 
განუყოფელიბურთისფლობადაფიქსირდა: 
ძველი: მეორადი, ძველი, ასაკის, მოხუცები, ყოფილი, ყოფილი, ასაკი, ადრე, წინამორბედი
სათათბიროგანწყობა: 
დღეს: ყოველდღიური, მიადევნე, სამუშაო, ურთიერთობა, სამუშაო
სადაც: იქ,სადაც, რომლისდროსაც, ადგილი
მოდის: უნდა, წლამდე, მიღწევა, ჩამოსვლის, ჩამოვა, გახდეს, მოხდეს
გზა: მეთოდი, მეთოდოლოგია, walkway, საშუალება, გზა, მარშრუტი, გზების, გზა, ბილიკი, წესით, გზა, ქუჩის, შაქარი, სიმღერა, ტრაექტორია, ჩვევა, როგორ, პროცესი, რეჟიმი, creed
მუშაობა: სამუშაო, დავალება, აქტიური, ამოცანა, შრომის, შრომის, კარიერა, ფუნქცია, მუშაობას, ფუნქციური, ბიზნესი, აქტის, ვარჯიში, დასაქმების, საოკუპაციო, სამუშაო, ნამუშევრები
ხმოვანთა: ცნობილი, ცხოვრება, გადარჩენის, მოძრაობა, მოძრაობის, საგზაო, ანბანი, mold
წასვლა: ფეხით, მგზავრობის, გამგზავრება, გამგზავრების, მიგრაცია
perlativeშემთხვევაში: 
პროგრესულიასპექტი: 
ხანგრძლივი: გახანგრძლივება, გრძელვადიანი, tall, გასწვრივ, ვადა, ეპოქაში, დაძაბული, მოშორებით, წარმოაჩინოს
ამბობენ: სალაპარაკო, ვუთხრა, საუბარი, წარმოადგენს, დაკავშირებული, ე.წ.
კი: ასევე, ან, სანამ, წლამდე, უფრომეტიც, ძალიან, ანალოგიურად, დამატებითი, გარდაამისა,, თავად
უკან: უკან, უკანა, უკან, უკან, დაბრუნების, აღდგენა, გაუქმება, ერთხელ, განმეორებითი, წინ, მიხედვით, გაიყვანოს, აღდგენა, ვიღებ
აქ: at
ვფიქრობ,: ფიქრი, ეგონა,, განიხილოს, წარმოიდგინეთ,, დაორსულდა, meditate, გვინდა, ე.წ., გონება, გრძნობს, როგორცჩანს,, მიუთითებს, განხილვის
ყოველ: ყველაფერი, თითოეულ, ნებისმიერი, რომელიც, მიმართ, პოსტი, ყველას, მნიშვნელი, მთელი, საშუალო
ბოლო: ბოლოს, უკანასკნელი, საბოლოო, საბოლოო, სხვა, სხვა, უახლესი, ბოლო, დამთავრებული, ბოლო, სიმტკიცის, არსებობს, წინა, ბოლოს
ქვეშკონტექსტში: 
მიიღოს: საკურორტო, დასაკავებლად, მოიტანონ, მიღება, ხელშიჩაგდება, მისაღებად, მიიღოს, აირჩიოთ, დაჭერა, ხელში, დააკისროს, მიიღოს, მოუტანს, განახორციელოს, სროლა, ვრცელდება, მივანიჭოთ, გამოყენებითი
ი: მოვძებნოთ, აღმოჩენა, აღმოჩენა, გამოვლენის, ხელმისაწვდომი, მისაღებად, შეხვდება
ხელი: arm, მაჯის, იარაღის
ახალგაზრდა: ახალგაზრდული, junior, მოზარდი, მოზარდი, ახალი
მისცეს: სარგებლის, გთავაზობთ, შეთავაზება, უზრუნველყოფს, სიტყვით, გაწევა, ახერხებს, ბოლო, დავეხმაროთ, მიადევნე, გასცეს, ჯილდო, პერიოდული, ციკლი, ვაღიაროთ, ვალში
ღმერთი: ღვთაებრივი
delativeშემთხვევაში: 
არაფერი: რაღაც, ობიექტი, არავინ, არაფერი, არცერთი, არავინ, ზოგიერთი, რამდენიმე, გარკვეული, გარკვეულწილად
მარჯვენა: წყვილი, სწორი, ზუსტად, სამართლიანი, სამართალი, გამართლებული, უსამართლო, უფლება, უფლების, კანონი, სწორად, ნამდვილი, გარკვეული, დარწმუნებულივარ,, ანიჭებს, კარგად, მთელს, გამო, სათანადო, სწორად, შესაფერისი, შესაბამისი
ერთხელ: სასწრაფოდ, სასწრაფოდ, მეთოდი, ნიმუში, მეთოდოლოგია
semelfactiveასპექტი: 
მარცხენა: მოშორებით, დატოვოს, გაფართოებული
ნაწილი: განყოფილებაში, ნაწილობრივ, ნაწილი, ნაწილობრივ, ამანათი, ფრაქცია, სეგმენტი, წილი, ცოტა, ცალი, გადასასვლელი, subset, თავი, დეპარტამენტის, ეპიზოდი, ნაწილობრივი, სამმართველოს, პალატაში, სექტორი, წილი, სახელით, მონაწილეობა, კვანტური
სახლი: მთავარი, შენობაში, ტაძარი, საცხოვრებელი, საყოფაცხოვრებო
მსოფლიოში: სფეროში, გლობალური, სამყარო
უფროსი: სათაური, მთავარი, მთავარი, თავი, ლიდერი, პრეზიდენტი, თავმჯდომარე, რეჟისორი, ქურდი, კალამი, თავისტკივილი, თმა
სამი: მესამე, მეცხრე, საგადასახადო
აქცენტი: განკუთვნილი, მიზანი, მიზანი, ობიექტური, კონცენტრირება, ყურადღება, კონცენტრაცია, გადავიდეს, ხედვა
მიყვარს: სითბო, საქველმოქმედო, მოსწონს, crush
ყოველთვის: სამუდამოდ, მუდმივად, ოდესმე
ღამის: საღამოს, ვახშამი, საათზე, დღეს
მეფე: იზეიმოს, lord, მონარქი, ბიზნესმენ, პრინცი
შორის: შორის, შორის, საქართველოს, ამ, შევიდა, ფარგლებში, შუა, შუა, დროს
გული: გულშემატკივრობენ, წამახალისებელი, გადაყენება, კორონარული
paucalნომერი: 
იმიტომ,რომ: გამო, მასშემდეგ,რაც, შემთხვევაში, მიზეზი, მიზეზი
მიზეზობრივიშემთხვევაში: 
სახელი: გვარი, არსებითისახელი, craft
სათანადოარსებითისახელი: 
ქვეყანა: ერი, მიწის, დედამიწა, სახელმწიფო, ადგილზე, ნიადაგის, პარტიის, სოფლის
სთხოვა: ვთხოვთ, კონსულტაციები, მოვუწოდებ, კითხვები
ჩანსმტკიცებულების: 
უკეთესი: უმაღლესი, საუკეთესო, შესანიშნავი, იდეალური, გამოჩენილი, დამატებითი, უფრო, კარგი
მხარე: გვერდითი, ემხრობა, ემხრობა, სახელით, თავისმხრივ,, გვერდი, ასპექტი, ნახევარი, საქმის, მიმართ, გარდა, გარდა
რათქმაუნდა,: სასწავლოგეგმა, გაკვეთილი, ლექცია, რათქმაუნდა,, აუცილებლად, ნამდვილად, კურსი, გზა, დარწმუნებული
საკმარისი: საკმარისი, საკმარისად, ადეკვატური, საკმაო, საკმაოდ, უამრავი, არასაკმარისი, საკმაოდ, საკმაოდ, მნიშვნელოვანი, მნიშვნელოვნად, მნიშვნელოვანი, მნიშვნელოვნად, არსებითად, გონივრული, ბოლო, სრულად
მალე: ცოტახნის, სწრაფი, სწრაფი, სწრაფად, სწრაფი, დაუყოვნებლივ, სწრაფი, ჩქარობს, სასწრაფო, ასერომ, სასწრაფოდ, ადვილად, მიმდებარე, დასაწყისში, ვადამდელი
სრული: სრულად, საკმარისად, აბსოლუტური, სრული, არასრულყოფილი, მთელი, ზუსტად, ზუსტი, სრული, ზუსტად, საფუძვლიანი, მთელი, ყოვლისმომცველი, ზომა, მთლიანად, სრულიად, სრულიად, მზა, შესრულებულია, ზემოაღნიშნულიდან, ფარული, შეასრულოს, cater
ოთახი: პალატა, მეოთხე, საძინებელი, მშვიდობა, ნაწილების, მარანი, სიღრმე
წყლის: თხევადი, სითხის, წყალგამყოფი
desiderativeგანწყობა: 
მსუბუქი: დიზელის, ნათელი, სანთელი, მცირე, სტილი, მსუბუქად, ღია, ნათელი, დღისით, ექსპოზიცია
სიტყვა: ლექსიკური, ხმის, ლექსიკა, ფრაზა, ზმნა, არსებითისახელი, ფორმულირება, ვადა
კარი: კარიბჭე, კარი, შესასვლელი, თავი, პორტი, ვერსია
გამოყენების: გამოიყენოს, გამოყენება, მოხმარების, ხარჯების, სამომხმარებლო, ჩაერთონ, პროგრამა, სასარგებლო, ვრცელდება, დასაქმება, მოიხმარენ
დილით: საათზე, საუზმე
terminativeშემთხვევაში: 
ძალა: ძალა, ენერგიის, შეიძლება, ძლიერი, ძალა, ძლიერი, დინამიური, სალათი, დომინირება, უფლებამოსილება
თავი: საკუთართავს, თავს, თავი, თავს, თავად, თავად, თვითმმართველობის, ego, მარტო
ხმა: ხმის, ხმამაღლა, საარჩევნო, აუდიო, ხმისმიცემა, საქონელი, ჭორები, ჭორები, ხმაური
თეთრი: ცარიელი, საჩივარი
ფული: სიმდიდრე, ვერცხლის, ფინანსური, cash, ვალუტა, ფინანსთა, ფულადი
შემდეგი: გარდა, ერთად, გვერდით, შემდეგ, შემდეგ, განზომილება, წლიდან, მომდევნო, შემდეგ, ამისშემდეგ, შემდგომში, შემდეგ, მეოთხე, წინ, უფრო, წინ, გაგრძელება
ცუდი: arm, სიღარიბის, ცუდი, სუსტი
სიკვდილი: სიკვდილიანობის, კვდება, მკვდარი
ფორმა: ფორმა, mold, ფორმატი, კონტური, ნიმუში, ფერმა, shaped, მორფოლოგია
inessiveშემთხვევაში: 
ერთად: ერთდროულად, გასწვრივ, ერთობლივი, კოლექტიური, კომპლექტი, ერთად, ერთობლიობაში, გაერთიანდება
საკითხზე: შემთხვევაში, ურთიერთობა, რამ, მოვლენაა, პრობლემა, მასალა, ნივთიერება, სათაური, პრობლემა, კითხვა, პერსონალის, თემის, საინტერესოა
ხშირად: ხშირად, მუდმივად, რეგულარულად, ხშირი, საყოველთაოდ, ჩვეულებრივ, როგორცწესი,
მეგობარს: მოკავშირე, მეგობრის, თანამემამულე, mate, ასოცირებული
იმისათვის,: სისტემაში, მოწყობა, მოწყობა, ხელშეკრულების, მასივი, ბრძანება, თავისმხრივ,, რიგი, მდგომ, თანმიმდევრობა, რიგითი, მოიწვიოს, ასერომ, მიადევნე, თავიდანაცილებისმიზნით,, სიტყვიერად
აუცილებელიაგანწყობა: 
რაუნდი: მომრგვალებული, წრე, lap, სფეროში
შენარჩუნება: გამართავს, შენარჩუნება, ქმნის, ბოლო, კომპლექტი, პასტა, შეინარჩუნებს, დაცვის, ჩაერთონ, მოსწონს, შენარჩუნებას, კონსერვაციის, შეინარჩუნოს, დაკავება, ვიცავთ, დარჩენა, რჩება, ფიქსირებული, ტექნიკური
ცოლი: მეუღლე, ქალი
მჯერა,: ნდობის, მიაჩნიათ, ვარაუდობენ,, რწმენა, რწმენა, ნდობის, დარწმუნებული, ოპტიმიზმი, ოპტიმისტური, დამოკიდებულება
ახლოს: გაივლის, გარდა, თითქმის, გარშემო, ახლოს, თითქმის, მიმდებარე, პრაქტიკულად, მიმდებარე, პროქსიმალური, მეზობელი, მეზობელი
საჯარო: ზოგადი, აუდიტორია, საერთო, საყოველთაოდ
სახელმწიფოკონტექსტში: 
შვილი: Swarm, ბიჭი
ასი: მეასედ, სახე, cent, საუკუნის
ბავშვები: ბავშვი, შთამომავლობა, ბავშვი, ბავშვი
შესაბამისად,: ამით, ასერომ, აქედანგამომდინარე,, ასეთი, დიახ, ამიტომ
იმედიმაქვს,: მინდა, პერსპექტივა, მოსალოდნელია,, ოპტიმიზმი, ოპტიმისტური, მოსალოდნელი, ველით, მოლოდინი
ზემოთ: up, მეტი, ფილმი, მაღალი, დაბრუნება, მოწინავე, ზედა, მთელს, დაკავშირებით, მეშვეობით, საფუძველზე, ოვერჰედის, გადატანა, წინ
ძვირფასო: შეყვარებული, ძვირადღირებული
წაკითხული: კითხვა, მღერიან, lily, მკითხველს
ქალაქი: ქალაქი, მუნიციპალური, ქვეყანა, ურბანული
უკვე: მზად, მოამზადა, მზადარის, მაინც, წინასწარ
ისფაქტი,: სიმართლე, რეალობა, ჭეშმარიტება, ნამდვილი, რეალური, ფაქტობრივი, მართლაც, ნამდვილად, რეალურად, გააკეთა
factiveმტკიცებულების: 
გოგონა: maid, ქალიშვილი, ქალი, lady, მეგობარი, მარტო
გესმის: მოვუსმინოთ, მოსმენა, გრძნობს
მინიმუმ: მინიმალური, მინიმალური, მინიმუმამდე, მინუს, ნაკლებია,, უმდაბლესი, ყველაზე, საუკეთესო, უმაღლესი, ოპტიმალური
ალბათ: ალბათ, შეიძლება, სავარაუდოდ,, შეიძლება, შესაძლოა, შესაძლებელია, სავარაუდოდ,, სავარაუდოა,, სავარაუდოდ,
ღია: ნათელი, ჩვეულებრივი, აშკარად, შიშველი, აშკარად, ვაკანტური, გამოკვეთილ, აშკარაა,, გარეთ, დეფიციტი, ღიად, გამოვლენა, დატვირთვის, გამოვლენა
სხეულის: ხორცი, სხეულის, ფიზიკური, ფიზიკური, corpus, ორგანოს, გვამი
საჰაერო: ქარი, breeze, საავიაციო, ამინდი, ავიაკომპანია, ფრენა
ბუნება: ბუნებრივი, შექმნილი, ბუნებრივია,, წარმოშობის, წარმოშობის, ძირძველი, ველური, ხასიათი
დაეხმაროს: დახმარება, სასარგებლო, დახმარება, დახმარება, თანაშემწე, ქმნის, რელიეფის
წერილი: ფოსტა, ბლანკის, წერა
ოთხ: მეოთხე
optativeგანწყობა: კონიუნქტივისგანწყობა
ცეცხლი: ცხელი, flame, ცხელება, ბუხრით, buddha
უფასო: თავისუფლების, თავისუფლების, თავისუფლდება, უფასო, უშედეგოდ, თავისუფლად, ვაკანტური, თავისუფლად, გათავისუფლება
ომის: ბრძოლა, ბრძოლა, ბრძოლა, ბრძოლისველზე, ჭიდაობა
მეორე: სხვა, ორივე, მიხედვით, სხვა, მეორეც
ერთიანი: სინგულარული, ერთიანობის, ინკლუზიური, კავშირი, მოკავშირე, მოკავშირე, უნიკალური, ერთსულოვანი, ერთობლივი, კომპოზიტური, კოალიცია, ფედერაცია
დარეკეთ: გამოწვევა, იჟანგება.მისი, მიმართვა, წლის, კავშირი, მოედანზე, ერთობლივი, fusion, მოწვევა, სიცოცხლისგანმავლობაში, საუბარი, ტელეფონი
რატომ: მსგავსი, ასეთივე
დაკარგული: დაკარგვა, დაკარგავს, დაკარგული, გაქრება
ათასი: მეათასე, ტანსაცმელი, ქსოვილი
ოჯახის: საყოფაცხოვრებო, გადარჩენილი
სული: სული, ghost, მოაზროვნე
ზრუნვა: დაინტერესებული, შეშფოთება, ყურადღება, მედიტაცია, მომსახურება, სპონსორობის, დაცვის, უსაფრთხოების, დაცვის, უსაფრთხოების, თავდაცვის, შენარჩუნებას, კონსერვაციის, დაფარვის, თავდაცვის, სიფრთხილით, სამკურნალო, მკურნალობა, პატიმრობაში, ფიქრი, აწუხებს, შემაშფოთებელია
ნიშნავს: გულისხმობს, აზრი, რაციმასნიშნავს,, მნიშვნელოვანი, აღნიშნავს, შუა, აგენტი, საშუალო, საშუალო, საშუალო, არსებითად, მესმის,
სხვადასხვა: მკაფიო, განსხვავდება, სხვადასხვა, მრავალფეროვანი, სხვადასხვა, განსხვავება, ცალკე, ვარიაცია, ცალ-ცალკე, ცვალებადობა, დიფერენციალური, განსხვავებით, variant, იცვლება, სხვადასხვა, სხვა, სხვა, სხვა, რამდენიმე, სხვაგვარად, სხვადასხვა
პოტენციურიგანწყობა: 
allativeშემთხვევაში: 
anthropicგენდერული: 
ხუთ: მეხუთე, წელი, ამისთვის
ცხოვრება: ცხოვრება, გადარჩება, მოიქცევა, ცხოვრების, ბუდე, რაიონში, სამეზობლოში, სამეზობლოში, ცოცხალი, ცოცხალი, ნედლეული, სწორი, პირდაპირი, მკვიდრი, პირდაპირი
სხვადასხვასათაური: 
პასუხი: ჩრდილოეთით, პასუხი, პასუხი, გადაწყვეტა, შეესაბამება, რეაგირება, ჩრდილოეთ, რეპლიკაცია
ზღვის: ocean, საზღვაო, ზღვისპროდუქტები
შიში: dread, ეშინია, ტერორი, awe, ეშინია, პანიკა, შფოთვა, angst, საშინელებათა, საფრთხესთან, შეშინებული, phobia
მძიმე: რთული, ძლიერი, რთული, მკაცრი, ხმამაღალი, ძალადობრივად, სასტიკი, მკაცრი, მკაცრი, რთული, სახიფათო, მყარი, მჭიდრო
ვადები: ვადა, ტერმინოლოგია, პრობლემა, დაფუძნებული, საფუძველი, საფუძველზე, არსებითად, ფუნდამენტურად, ძირითადად, ქონება
ეჭვი: ეჭვი, უნდობლობა, ყოყმანის, ეჭვმიტანილი, მიმწოდებელი
dubitativeგანწყობა: 
შავი: ბლოკი
ლამაზი: კარგი, ლამაზი, lovely, ლამაზად, ლამაზად, საკმაოდ, ლამაზი, მაგარი, მიმზიდველი
ბნელი: წყვდიადში, სიბნელე
სახის: კლასიფიკაცია, დაალაგეთ, კლასიფიკატორი, კეთილი, სახეობების, სხვადასხვა, საქონელი
ათი: ათიწლისგანმავლობაში, მეათე, სამართლიანი
შოუ: ჩვენება, ასრულებს, შესრულების, დემონსტრაცია, პრეზენტაცია, მიუთითებს, აღნიშნავს, ღონისძიება, პროექტირება, გამოფენა, ხელოვნება, სურათი, ესკიზის, screenshot
ისტორია: მითი, ისტორია, თხრობითი, მხატვრულილიტერატურა, მიწისნაკვეთი, ზღაპარი, განხილვა, თემის
წიგნი: გადახვევა, სარეზერვო, pound, სახელმძღვანელო
ელექტრონული: ელექტრონიკა, ელექტრონული, lightning, ელექტრო, ელექტროენერგიის, ელექტრო, ელექტრიკოსი, ელ, ყოფილი
ანგარიშის: მიზეზი, მიზეზი, გამოთვლა, გამოთვლები, სტატიის, კანონპროექტი, გაანგარიშება, იმედი, მიაჩნიათ, არითმეტიკული
ჩანაწერები: marker, კვალი, ბილიკი, ანგარიში, logo, შედეგი, tick, tag, ნიშანი, სიგნალი, მითითებით, cue, ბრენდი, ხასიათი, ეტიკეტების, შთაბეჭდილება, სიმბოლური, alert, სიმბოლო, ხატი
ინტერესი: ყვავილების, დაინტერესებული, შეშფოთება
დაწერა: დაკომპლექტებას, წერა, ტიპი, წერილობითი, სტაციონარული
საწოლი: 
აუცილებელია: აუცილებელია, მნიშვნელოვანი, სასარგებლო, კრიტიკული, სასიცოცხლო, მნიშვნელოვანი, უმნიშვნელო, განუყოფელი, გადამწყვეტი, მთავარია, უნდა, აუცილებლად, გარდაუვალ, გარდაუვალ, გარდაუვალ, სასწრაფო, წებოვანი, აუცილებლობა, საჭირო, მოითხოვს
იდეა: ეგონა,, განხილვის, აზრი, ცნება, გონებრივიიერიში, ფიქრი, წარმოიდგინეთ,, ფანტაზია
vialisშემთხვევაში: 
ძმა: ძმა, დის, ბუხრით, კოლეგა
ზოგჯერ: იშვიათად, ზოგჯერ, ოდესმე
ონლაინ: მავთულები, თემა, რიგი, lane, ჩატარების, dash, ზოლიანი, საგადასახადო, script, ხაზები, სათაურით
მაგიდა: სამაგიდო, გრაფიკი, კატალოგი, კატალოგი
მდინარე: ბალიში, ბალიში, flux
თვალის: დანიშნოს, გარშემო, snow
ინფორმაცია: გაგზავნა, ახსნა, აღწერა, ბიულეტენი, ცოდნა, მონაცემები, წოდება, აცნობოს
მოულოდნელად: მოულოდნელი, მოულოდნელი
უცნაური: უცნაურად, გასაკვირი, უცნაური, უცნაური, საინტერესოა, მშვენიერი, აღსანიშნავია, საგანგებო, წარმოუდგენელი, საოცარი, უცნაური, სასაცილო, უცხო, ეგზოტიკური, უხერხულ, უჩვეულო, უცნაური, საიდუმლო, საინტერესო
ღრმა: ღრმად, სიღრმე, ფართო, ზედაპირული, საფუძვლიანი, დეტალური, ყოვლისმომცველი, კრიტიკულად, ღრმა, ფარგლებში, დაწვრილებით, შიდა, worm
ცვლილება: მოდიფიკაცია, ვარიაცია, ტრანსფორმაციის, გარდაქმნის, მუტაციას, ცვლა, შეცვალოს, ცვლილებებისშეტანის, გარდამავალი, დაახლოების, ვარიაციები, ეწინააღმდეგება, ცვალებადობა
შეგრძნება: გრძნობს, სენსაცია, აღქმა, შთაბეჭდილება, გრძნობები, განწყობა, დიდიშთაბეჭდილებამოახდინა, ემოციური, სენსორული, განწყობა, აზრი, ვნება, შეგნებული, ცნობიერების, იმპულსი, ცნება, კონცეფცია, კონცეფცია
მიზნით: ობიექტი, მიზანი, ობიექტური, მიზანი, დანიშნულების, მიზანი, განკუთვნილი, მოტივი, სამიზნე, უპირატესობა, სარგებელი
ბედნიერი: მხიარულ, amused, სიამოვნებით, მოხარულივარ,, სიხარული, ბედნიერება, აღფრთოვანებული, აღფრთოვანებული, გართობა, სიხარულით, იღბლიანი, კმაყოფილი, emoticon, ხშირად, სარგებლობენ, ურჩევნია, უბედური
სისხლის: bleed, სისხლიანი, სისხლისღვრა
გაიზარდა: ვარდისფერი
სამხრეთ: სამხრეთ, შუადღისას, შუადღემდე
ცივი: ზამთრის, მაგარი, ცივად
პოზიცია: ადგილმდებარეობა, სიტუაცია, სტატუსი, შანსი, შესაძლებლობა, ფართი, პოზიცია, პოზა, ადგილი, პოსტი, საქონელი, ორიენტაცია, ქმნის, მდებარეობს, locus
დავდგეთ: სადგური, ვერტიკალური, დამოკიდებულება, პოზიცია, შეჩერება, პოზა, უქმნის, ჩერდება, იყოს, დარჩენა, რჩება, არსებობს, წინააღმდეგ
ვარაუდობენ,: ვარაუდი, ჰიპოთეზა, ვივარაუდოთ,, მიღება, ვარაუდობენ,, Hypothesize, ქმნის, საყოფაცხოვრებო, სავარაუდოდ,
აფეთქდა: ჩემი
cut: ნაკლებობა, აკლია, შემცირება, დეფიციტი, შემცირდება, დეფიციტი, miss, ჭრის, შეუშალოს, chop, სლეში, მოსავლის, გატეხილი, არღვევს, შეთქმულების
ასლი: აღვადგინოთ, რეპლიკაცია, იმეორებს, საუკეთესო, ასლი, კლონი, მობილური, prescription, გეგმა, სიმდიდრე
ქმარი: კაცი, მეუღლე
ექვსი: sex
დაბალი: ნაკლებია,, მოკლე, იაფი, იაფად, miscarriage, მინიმალური, ბოლოში, ზედაპირული, მოსაწყენი, დეფიციტი, განმუხტვის, ამცირებს, შემცირდება, მინიმუმამდე
მახსოვს: შენიშვნა, გაწვევას, შეგახსენებთ,, გვემახსოვრება
ეფექტი: გავლენა, იმოქმედებს, შთაბეჭდილება, გავლენა, დომინირება, ეფექტური, ეფექტურად, ეფექტურობა, შედეგი, შედეგი, ექსპოზიცია, შედეგი, გავლენა
დაეცემა: შემოდგომაზე, შემთხვევაში, მდებარეობს, crash, სარეცხის, ავარია, დაშლის, ვარდნა, შემცირება, შემცირდება
გარდა: თუ, გარეთ, გარდაამისა,, ცალკე, გარეთ, გარდა, გარდა, გარდა, გარეშე
საავტორო: 
არმია: ჯარი, სამხედრო, მასპინძელი, ჯარისკაცი
პერსპექტივაში: გაქცევა, სანიაღვრე, გაშვებული, შეასრულოს, მუშაობას, დისკზე, gear, ოპერაციები, ოპერატიული, დავიცვათ
ცხენი: ნალის, at, შენიშვნა, ამბობს
მომავალი: შემდეგ, ამისშემდეგ, შემდეგ, ზამთრის
west: დასავლეთ
გადახდა: ხელფასის, სახელფასო, ხელფასი, thrust, გადახდის, აუნაზღაუროს, საფასური, ღირებულება, მიადევნე
წითელი: შემცირება
ოქროს: 
სურვილი: სურდა, დიდისურვილი, მადას, მინდა, yearn, მოვუწოდებ, ვნების
თამაში: ცეკვა, აზარტული, თამაში, cheek, სათამაშო, roll, დატრიალება, როტაცია
master: lord, პირველადი, მთავარი, პროფესორი, დომინირებს, არეგულირებს, ბატონი, ჯენტლმენი, წამყვანი, mister, მფლობელი, მოაზროვნე, კონტროლის
ოფისი: სააგენტო, სამაგიდო, სამინისტროს
მთავრობის: სახელმწიფო, რიგი
ეკლესია: 
სიგრძე: სიმაღლე, სიმაღლეზე, span, გასწვრივ, ხანგრძლივობა, tall
კომპანია: ფირმა, კორპორაცია, საზოგადოება, ბიზნესი, კორპორატიული, პირი, დაწესებულების, სააგენტო, ინსტიტუტი, საწარმოს, საწარმო
ქაღალდი: ფურცელი, ანკეტა, წესდება, გაზეთი
ალბათობა: შესაძლებლობა, ალბათობა, სავარაუდოდ,, შესაძლოა, ნაკლებადსავარაუდოა,, პერსპექტივა, შანსი, სავარაუდოა,, ცვლადები, შანსები
განსაკუთრებით: სპეციალური, სპეციალურად, კონკრეტულად, განსაკუთრებით, კერძოდ,, ზუსტად, ძირითადად, ძირითადად, პირველრიგში,, კონკრეტული, მთავარია, როგორცწესი,
დათვი: განახორციელოს, სიმტკიცის, დიდსულოვნებისა, ტოლერანტობის, აქვს, ფლობს, ახერხებს, მოითმენს
window: 
შეთანხმება: ოქმი, დასახლებაში, კომპრომისი, კონსენსუსი, ხელშეკრულება, ვეთანხმები, გარიგება, შეთანხმება, სატენდერო, აკორდი, ხელშეკრულების, კონვენციის, მოწყობა, გარიგების
სილამაზის: ლამაზად, ბრწყინვალების, ესთეტიკური
მოვალეობა: პასუხისმგებლობის, პასუხისმგებლობა, ვალდებულება, პასუხისმგებელი, საბაჟო, ამოცანა, დავალება, ვალის, ვალში, უნდა, დასაქმება, ბედი
გაუგზავნე: გადაცემა, წარდგენის, პოსტი, სამაუწყებლო, ელ, გადაცემა, უნდა, სიტყვით, წარუდგინოს
მანძილი: მოხსნა, დიაპაზონი, გამოყოფა, ქუჩის, უფსკრული
დუმილი: სიჩუმეში, მშვიდი, ჩუმად, მარტოობა, მშვიდობა
ფეხით: ფეხი, შეჩერდა, ბარძაყის, toe, კვარტალში, paw, გაშვებული, სწორად, ნაბიჯი
ველური: wildly, უკანონო, სასტიკი, ველური, jungle
იღუპება: მკვდარი, კვდება, off, დახურეს
გადარჩენა: გადარჩენის, შენარჩუნებას, აღდგენა, შენარჩუნებას, კონსერვაციის, გვემახსოვრება, მაღაზია, გამოისყიდოს, სამაშველო, ჩანაწერი, დაცვის, შეინარჩუნოს, rid
მწვანე: ნედლეული, ნედლი
პრობლემები: გადაიტვირთოთ, პრობლემა, პრობლემა, გაჭირვება, სირთულის, knead, დაავადებული, პრობლემური, დაბრკოლება, გართულებების, არეულობის
ღიმილი: grin
არასწორი: შეცდომა, შეცდომა, ცდება, ცუდად, არასათანადომოპყრობის, ყალბი, ბრალია, მარცხი, ხარვეზის, არასწორად, gaffe
ძილის: ეძინა, ოცნება, nap
quotativeშემთხვევაში: 
იწყება: დაიწყოს, დაწყება, წამოწყებას, ნულიდან, დაწყების, დასაწყისში, საწყისი, ინიცირება, დებიუტი, პრინციპი, მოლოდინით, ინიცირება
აქცია: ამოცანა, წერტილი, ნაბიჯი, ეტაპი, აქტის, პროცედურა, აქტიური, ოპერაცია, ოპერატიული, გააქტიურება, აქტივისტი, ნაბიჯი, პრაქტიკა, პრაქტიკა, მუშაობას, საფონდო, შესრულების, შეასრულოს, ქცევის
ვიზიტი: ხელმისაწვდომობა, ინტერვიუ, ხელმისაწვდომი, მოგზაურობა, მოგზაურობა, მოგზაურობა, ტური, ფილოსოფია, აკრიტიკებენ, შეხვედრის, საჩუქარი
დაიცვას: შესაბამისად, ვიცავთ, შემდეგ, განაგრძოს, სიმღერა, თანმხლებ, დაემორჩილოს, მომდევნო, არსებობს
ცდილობენ: მცდელობა, სცადა, ძალისხმევა, ინიციატივა, ექსპერიმენტი, ტესტი, ნიმუში, შრომისმოყვარეობა, სასამართლო, გამოკვლევა, გამოცდა
ყოფნა: არსებობა, არსებობს, პირი, აქტივი, კლების, მხედველობა, დასწრება
მძიმე: განმეორება, მძიმედ, რთული, მძიმე, წონა, სერიოზულად, უზარმაზარი, ღვიძლის, დიდი, მასიური
ტკბილი: დესერტი, candy, ნაზი, BLAND, მიმზიდველი
პირი: ზეპირი, mug, sip, სახე
მდიდარი: უამრავი, abundant, მდიდარი, dress, გულუხვი
მტერი: მტრული, მოწინააღმდეგე, წინააღმდეგ
გემი: ნავი, sail, ფლოტი, მცურავი, გემის, საკრუიზო, საბორნე, მუცლის, იზიარებს
მდგომარეობა: ფსონი, ვაჭრობა, სახელმწიფო, სიტუაცია, გარემოება,, სტატუსი, ბედი, ეტაპი, დონე, ფიტნეს, მოთხოვნა
მათშორის: შეიცავდეს, მოიცავს, ჩართვა, ეკუთვნის, შედგება, გარდა
ინკლუზიურიპირი: 
როგორცჩანს,: გამოჩენა, წარმოიქმნება, წარმოშობა, გაჩენის, ჩანს, როგორცჩანს,, გამოიყურება, ასვენებს
საიდუმლო: საიდუმლო, საიდუმლო, pin, მიწისქვეშა
გთხოვთ: kindly, ვთხოვთ, მადლი
precativeგანწყობა: 
თავაზიანირეგისტრაცია: 
ბოროტი: ზიანი, nasty, მანკიერი, ცუდი, ცუდად, საშინელი, ავად, უარესი
მარტი: აღლუმი, საპროტესტო, დემონსტრაცია, mars
ნელ-ნელა: თანდათან, ნელი, ნაზად, რბილად, ბოლოს, თანდათანობით
ნაცვლად: იმისმაგივრად, საკმაოდ, გარდაამისა,, ჩანაცვლება, ცვლილება, ალტერნატიულად, სახელით
ლურჯი: ცისფერი
შეუძლებელია: 
სკოლა: campus, ასვლა
შემთხვევა: შესაძლებლობა, ღონისძიება, კლების, შანსი, avenue, გარიგების, საათზე
ქორწილი: ქორწინება, ცოლად, ქორწილი
საკვები: კვება, დიეტა, კერძი, feed, dine
ოცი: 
ადვილად: სავარაუდოდ,, ადვილად, პასუხისმგებელი, ადვილი, ფონდის, მცირე, ოდნავ, მსუბუქად, მოსახერხებელი, პირდაპირი, მოკლედ
პერსპექტიულიასპექტი: 
ენა: ენობრივი, ენა, ბაზა
გამოხატვის: გამოხატოს, განცხადება, ფრაზა, მივიტანოთ, ექსპოზიცია, ამბობს, განტოლება, წარმომადგენლობა
კვირის: კვირა, ყოველკვირეული
დარბაზში: თეატრი, hallway, ფართი, პალატა, სალონი, lounge, aisle, runner, ლობის, ხვრელი, haul
საფრთხე: საშიში, რისკის, საფრთხის, მიმართ
ყოველთვის: ზოგადად, ზოგადი, საერთო, რუტინული, ზოგადი, როგორცწესი,, ჩვეულებრივი, უჩვეულო, საყოველთაოდ, მოკრძალებული, ნორმალური, არარეგულარული, ჩვეულებრივი, ტიპიური, შემთხვევით, ჩვეულებრივ, როგორცწესი,, საშუალო, რეგულარული, მუდმივი, ჩვეულებრივი, უხეშად, მარტივი, საშუალო
დაიბადა: დაბადების, აღორძინება, თანდაყოლილი
სასამართლო: სასამართლო, კერძი, ფორუმი, სამართალწარმოება
gnomicასპექტი: 
ღირს: იმსახურებს, მნიშვნელობა, მნიშვნელოვანი, მოქმედების, დამსახურებაა, ღირებულება, ფასი
ხე: ქარხანა, ხის, shaft, ხე-ტყის
კედლის: 
სამოთხეში: sky
inchoativeასპექტი: 
jussiveგანწყობა: 
ტონი: მოედანზე, melody, ტონა, ტონა, ჩრდილში, tuna, ხმის
დაკავშირებით: მიმართ, ვივარაუდოთ,, ვარაუდობენ,, ყურადღება, განხილვის, განიხილოს, ურთიერთობა, ასოციაცია, ურთიერთობა, შენიშვნა, დაფარვის, ურთიერთობა, დაკავშირებული, დაკავშირებული, დაკავშირებული, დაინტერესებული, ეკუთვნის, დაკავშირებით, შესაბამისი, შეესაბამება, შესაბამისი
თვის: მთვარე
გამოცდილება: ემპირიული, ექსპერიმენტული, გამოცდილი, ექსპერტიზა, zest, ექსპერიმენტი
გარემოებები: სცენარი, გარემოება,, სიტუაცია, თავისუფლად
ახალი: ახლად, სუფთა, სუფთა, სუფთა, ახალი, ახალბედა, უახლესი
duke: მმართველი, პრინცი, თანხმობა
დაფარული: დაფარვის, დაფარვის, off, დახურულია, შიდა, საფარის, არეგულირებს
შეკრული: იმდენად,რამდენადაც, შეზღუდვა, ლიმიტი, სასაზღვრო, შეზღუდვა, შეზღუდული, დაკავშირებული, დამოკიდებული, bind, საზღვრის, შეუზღუდოს
აღმოსავლეთ: აღმოსავლეთ, წინ, წინა, ადრე, წინასწარ, orient
ქვის: მარმარილოს, როკ, gem
მიმართულებით: ორიენტაცია, განზომილება, ტენდენცია, საქმის, ინსტრუქცია
სკამი: სავარძელი, სავარძელში, სკამზე, lounge
მხარდაჭერა: შენარჩუნებისა, ადასტურებს, დახმარება, დახმარება, bracket, დახმარება, საფუძველზე, ყავარჯენი
თარიღი: ისტორია, ნაცნობობა
სოფელ: ჰამლეტ, სოფლის
სფეროში: სფეროში, სფეროში, რეგიონში, ტერიტორიაზე, ტერიტორიაზე, ზონა, სექტორი, domain, არენაზე, სტადიონზე, ფართი, ზღვარი, სოფლის, ბანაკში, ფერმა
დაველოდოთ: ველით, გამართავს, დარჩენა
ნებართვა: მისცემს, ყურის, ნებართვა, კლირენსი, დატოვოს, ლიცენზიის, ლიცენზიის, თანხმობის, გამოცემა, ბურთისფლობადაფიქსირდა, დამტკიცების
permissiveგანწყობა: 
წარმატება: წარმატებული, წარმატების, კეთილდღეობა, მიღწევა, გამარჯვება, გამარჯვება, მოხვდა, გამარჯვებული, გამარჯვებული, განვითარებისათვის
hill: მთის, mount, ვულკანის
მუსიკა: მუსიკალური, კლასიკური
დისტალურისაჩვენებელი: 
დღისმეორენახევარში: საათზე, შუადღისას, შუადღემდე, საღამოს
ტირილი: mourn, shout, კივილი
პატივი: პატივი, მიმართ, ღირსება, საპატივცემულო, საპატიო, გადმოიცეს, გაცნობითიხასიათის, დიდება, კურსი, ფასი
შვიდი: 
კერძო: პირადი, თვითმმართველობის, პირადად, სპეციალური, კონფიდენციალურობის, კონკრეტული, ექსკლუზიური
იჯდეს: დარჩენა, მოაგვაროს
ახალიამბები: გაგზავნა
სცენა: საიტი, მხედველობა, კონტექსტში, ჩვენება, ვიზუალური, ეტაპი, კალენდარი, პერსპექტივა, კარავი, გამოჩენა
ბაღში: მებაღე, park
რასის: რასობრივი, racing, გაშვებული, კონკურსი, ტურნირი, სატენდერო, ჯიშის, მატჩი, ერი, scramble, მაქმანი
გამანაწილებელშემთხვევაში: 
ვისწავლოთ: სასწავლო, ასწავლიან, განზრახ
პოლიტიკური: პოლიტიკა, პოლიტიკური, პოლიტიკოსი, პოლიტიკა
გამოსვლა: ლექცია, განხილვა, საუბარი, დისკურსი, სალაპარაკო
ტყუილი: ყალბი, მოტყუება, მოტყუებას, მანიპულირება
მიცემული: hurl, იმისათვის,რომ, Fling, toss, ფორმატი, mold, დაწყებას, დაიღვარა, დატოვა
ჭამა: კვება, feed, კერძი, dine, მოხმარების
სართული: rug, ადგილზე, ბოლოში, ნიადაგის, ფეხით, მაღალი, tall, დანიშნულების
ზაფხულში: სითბო, ცხელი, გათბობა
რელიგია: რელიგიური, ვალის, creed, foster
სურათი: პორტრეტი, ფერწერა, სურათი, ფოტოსურათი, ფოტო, ფოტოგრაფია, ფოტო, ასლი, ნახაზი, ვადამდელი, ფილმი, ილუსტრაცია, პორტრეტი, ლეღვის, ფიგურა
გაქცევის: გაქცევა
ავტორი: მწერალი, მასწავლებელი, რედაქტორი
brown: ნაცრისფერი, ნაცრისფერი, suntan, ბრინჯაოს, შოკოლადი, ხორბლის
განისაზღვრება: განსაზღვრა, გადაწყვიტოს, განსაზღვრავს, გარკვეული, აგრესიული, დიზაინერი, მითითებული, დადგენა, სტაბილური, გარკვეული, გადაწყვეტილება, განმსაზღვრელი, ფიქსირებული
ტკივილი: დააზარალებს, ტანჯვას, მტკივნეული, მწუხარება, sore, აგონიაშია
გაზაფხულზე: ბუმბული, ჩვენი, ჩვენია
რბილი: დამთმობი, გლუვი, წვრილად, სატენდერო, ნაზად, რბილად, ნაზი, BLAND, მსუბუქი, დელიკატური, თანდაყოლილი
კუთხეში: კუთხე, ფართო
: , , , , , , , , , , , , , , , , , , , , , , , , , , , , , , , , , , , , , , , , , , , , , , , , , , , , , , , , , , , , , , , , , , , , , , , , , , , , , , , , , , , , , , , , , , , , , , , , , , , , , , , , , , , , , , , , , , , , , , , , , , , , , , , , , , , , , , , , , , , , , , , , , , , , , , , , , , , , , , , , , , , , , , , , , , , , , , , , , , , , , , , , , , , , , , , , , , , , , , , , , , , , , , , , , , , , , , , , , , , , , , , , , , , , , , , , , , , , , , , , , , , , , , , , , , , , , , , , , , , , , , , , , , , , , , , , , , , , , , , , , , , , , , , , , , , , , , , , , , , , , , , , , , , , , , , , , , , , , , , , , , , , , , , , , , , , , , , , , , , , , , , , , , , , , , , , , , , , , , , , , , , , , , , , , , , , , , , , , , , , , , , , , , , , , , , , , , , , , , , , , , , , , , , , , , , , , , , , , , , , , , , , , , , , , , , , , , , , , , , , , , , , , , , , , , , , , , , , , , , , , , , , , , , , , , , , , , , , , , , , , , , , , , , , წარუდგინოს, გაძლიერება, შემოწმება, raincoat, extinguisher, მიმღები, მზისგანდამცავი, წამყვანის, პროექტორი, skateboard, ელექტრიკოსი, ჰიგიენური, სანტიმეტრი, purse, ყოყმანის, დადასტურება, ტაქსი, სატვირთო, მუდმივი, შემთხვევით, საფრთხის, მკერავი, ვიოლინო, მებაღე, კარპენტერი, ვაზა, რეზინის, პერიოდული, ტროტუარი, ქარიშხალი, scarf, პიკნიკი, vanilla, სამკერდე, დესერტი, arc, პერსპექტიული, საწყობი, მოლარე, pad, საკონდიტრო, ბიბლიოთეკარი, გიმნაზია, crane, მზარეული, ზოგადი, სუფთა, მიმტანად, მრჩეველი, საკანცელარიო, მასაჟი, საცხობი, სედანი, მიკროტალღური, სანტექნიკოსი, გრილი, საფონდოსაბროკერო, ბროშურა, ჰამბურგერი, გამაცხელებელი, კოსმეტიკური, მწვადი, popcorn, რეფლექსურ, logo, tuna, appetizer, ტაიმერი, ფარმაცევტი, სამგზავრო, მუყაოს, გეგმა, ქეისი, ექსკალატორიდან, მაშველს, ბლანკის, ჭურჭლისსარეცხიმანქანა, backpack, ზღვისპროდუქტები, ინვალიდისეტლი, walkway, ფრენბურთის, კონდინციონერი, სტეპლერის, sauna, შეამოწმე, ტონერი, მრეწველობა, shake
აწარმოოს: წარმოება, გენერირება, პროდუქტიული, დაამზადოს, წარმოება, წარმოების, მოსავლის, კულტურების, პროდუქტი, შექმნა, ფორმირება
სიცილი: ხუმრობით, სიცილი
დაგავიწყდეთ: შევჩერდეთ, უარყოფს, მავიწყდება
europe: 
რვა: მერვე
მიღება: მიერ, მეშვეობით, გაივლის, მეშვეობით, გასული, გადასასვლელი, გადაკვეთა, ცვლა, გარდამავალი, aisle
საშინელი: საშინელი, საშინელი, საშინლად, საშიში, დიდი, ტრაგიკული, საგანგაშო, საფრთხესთან, ამაზრზენი, საშინლად
გულისთვის: მოტივი, ემხრობა, ემხრობა
სუნთქვა: რესპირატორული, სუნთქვა, სუნთქვის, ამოისუნთქეთ, ego, ამოსუნთქვა, შვებით, whisper, inhale, sniff
ბრძენი: გონივრული, საღადმოაზროვნე, ფრთხილი, გააზრებული, ჭკვიანი, ჭკვიანი, ინტელექტუალური, mature, ბრწყინვალე
კუთვნილებითიmarker: 
სასიამოვნო: სასიამოვნო, სასიამოვნო, ხელსაყრელი, კომფორტული, კომფორტულად, საინტერესოა, ლამაზი, ლამაზად, კეთილი, ლამაზად, გართობა
შესანიშნავად: მთლიანად, სრულად, სრულიად, სრულიად, აქტიურად, სრულყოფილი, ნამდვილად, საერთოდ, საკმაოდ, ზუსტად, სრულიად, აბსოლუტური
მეხსიერება: გვემახსოვრება, ცნობისთვის, მემორიალი, კვალი
მძიმე: სერიოზული, მძიმე, მძიმედ, სასაფლაოზე, კრიტიკული
თანამედროვე: თანამედროვე, დახვეწილი, მოდერნიზაცია, მოდური, ბოლო, დისკურსი, უკანასკნელი, მოწინავე, დღეს
ადგილზე: წერტილი, dot, საათზე, ადგილმდებარეობა, stain, patch, ადგილი, არსად, შენობაში, locus, საიტი, ადგილობრივი, განთავსდება, ნიშანი, მსხვილინაწლავის
შესვენების: ჩამტვრევა, brake, საკურორტო, lounge, შეწყდეს, ინტერვალი, უფსკრული, smash, შეარყიოს, შეჩერება, პაუზის, შეუშალოს, დაუღალავი
კუნძული: 
შეეხოთ: კონტაქტი, სტეპის
თანაბარი: ექვივალენტი, იგივე, მსგავსი, სამართლიანად, კარგი, კარგი, თანაბრად, ხარისხი, par, იდენტური
ნაპირი: სარეზერვო, ზღვარზე, სანაპირო
დაპირება: ჩაიდინოს, ვალდებულება, დაპირება, დანიშვნის, გარანტია
commissiveგანწყობა: 
გეგმა: სქემა, გარიგება, პროგრამა, პროგრამა, ინიციატივა, planner, გეგმა, წინადადება, პროექტის, მიწისნაკვეთი, ესკიზის, პროექტირება, განლაგება, ბინა, ნახაზი, დიზაინი, წინადადება, დაგეგმვა, დაფიქრების
სიურპრიზი: გასაოცარი, მოულოდნელი, შემთხვევითი, გასაკვირი, საინტერესოა, გასაკვირი, მიკვირს,
წუთი: 
გასროლა: სროლა, სროლა, ტყვია, საბრძოლომასალა, ფოტოსურათი, ფოტო, დარტყმა, bang, გადატრიალების, იმისათვის,რომ, ჩარჩო, kick
გამოიწვიოს: ხელმძღვანელობა, წამყვანი, იზიარებს, ტყვია, დისკზე, უხელმძღვანელებს, მოუტანს, მჭლე
მინა: სარკე, ბროლის, jar, სათვალეები, გვერდი, ექსპორტი
ფორუმში: slab, საბჭოს, up, მოიმატებს, ride, ჯგუფი, კომიტეტის, პანელი, რჩევა, ზღვარზე, კომისიის, ტაბლეტი, გამოცემა
მაგალითად: მაგალითად, ილუსტრაცია, მოდელი, ნიმუში, მეტაფორა, პროტოტიპი, როგორც, წარმოადგენს, ნიმუში, შემთხვევაში, პრეცედენტი, ნიმუში, პარადიგმა, ასახავს, დიახ
უსაფრთხო: უზრუნველყოს, უსაფრთხოების, უსაფრთხოების, უსაფრთხოდ, დარწმუნებული, დაზღვევა, დარწმუნებულივარ,, უვნებელია, მოხსნა
ექიმი: ექიმი, თერაპევტის, პრაქტიკოსი, სამედიცინო, სტომატოლოგი
კლასი: კეთილი, ორბიტაზე, საკლასო, კლასის, გამოყოფა, ფენის, გარეშე, წოდება, რაიონში
completiveასპექტი: 
განმეორებითი: ხშირად, რეგულარული, მუდმივი, მუდმივად, ზოგჯერ, ხშირი, რეგულარულად, პერიოდული, განმეორება, განმეორებითი, იმეორებს, რევიზია, iteration
სამხედრო: ქვეყანა
თბილი: ცხელი, სითბო, სითბო, ტემპერატურა, გათბობა, გრამი, muggy
სასმელი: სასმელი, ლოთობა
აღშფოთება: გაბრაზებული, გაბრაზება, აღშფოთება, გაღიზიანება, მიუხედავად, უკმაყოფილონიარიან, აღიზიანებთ
პირდაპირ: სწორი, პირდაპირი, არაპირდაპირი, ავტომატური, პირდაპირი, დაუყოვნებლივ, straighten, სასწრაფოდ, სიტყვიერი
ქუდი: cap, ჩაფხუტი
ძაღლი: 
მსახური: steward, waiter, მიმტანად, maid, მონა, შიდა
სიამაყე: ამპარტავანი, ამაყი, ამაყად, ამპარტავნება
გულშემატკივარი: პიკის, ხალხმრავალ, mob, თანხა, რაოდენობა, მოსახლეობა, მასპინძელი, pile, ბევრი, ბევრი, მრავალი, სერიოზულად, საკმაო, ნაყარი, ნახირი
მატარებელი: ვაგონი, მანქანის, უნივერსალი, კალათა, რკინიგზის, სარკინიგზო, განათლება
მორალური: მორალი, მორალურად, ეთიკური, ეთიკის, მორალი, სულიერი
greek: 
შეესაბამება: სარჩელი, შესაფერისი, შეეფერება, თავსებადი, სათანადო, მოსახერხებელი, შესაბამისი, შეესაბამება, უფლება, შესაბამისი, შეთანხმება, შეცვალოს, ზუსტი, ზუსტი, ემთხვევა
შესვლის: შესვლა, შესვლის, სახელმწიფო, მიუთითებს, ჩადეთ, მოიცავს, რეგისტრაცია, რეგისტრაციის
წესი: ადმინისტრაცია, მბრძანებლობა, რეჟიმი, გადაწყვეტილება, განაჩენი, გადაწყვეტილება, მსაჯი, არეგულირებს, კანონი, კანონმდებლობა, ნორმა, სახელმწიფო, არეგულირებს, იზეიმოს, რეგულირება, prescription
ხმალი: დანა, დანა
თავდასხმა: შეჭრა, დაესხას, აგრესია, დანაშაული,, თავდასხმის, დანაშაული, strike, დაწყების, შეურაცხმყოფელი, დარბევა
ჯანმრთელობის: ჯანსაღი, მივესალმო
პუნქტის: ლექსი, პუნქტი, ბლოკი, წერტილი, დამოკიდებულება, პოზიცია, par
სოციალური: საზოგადოება, სოციალურად
დაბრუნების: პასუხი, რეაგირება
ბოდიში: ვნანობ, ბოძზე, შეწყალების, საბაბი, ბოდიშისმოხდა, სამწუხაროა,, მწუხარება, განიცდიან, დაავადებული, მწუხარება, ტანჯვას, გლოვა, მწუხარებას, mourn, გაჭირვება
გამბედაობა: pluck, თამამი, დარწმუნებული, ნერვის, სიძლიერე, გაბედავს, მამაცი, გემის
ოფიციალური: ფორმალური, ოფიციალურად, ოფიციალურად, ოფიცერი, კლერკი, ბიუროკრატიული, უფლებას
იმპირობით,: გთავაზობთ, შეთავაზება, უზრუნველყოფს, შესავალი, ხელმისაწვდომია, მიწოდება, დებულება, cater, იმშემთხვევაში,თუ
მოთხოვნა: ლოცვა, მოთხოვნა, სარჩელი, მოითხოვს, მოთხოვნა, გამოძიება, გამოძიება, სწრაფი, წინადადების, პროგრამა, მინდა
ერთიშეხედვით: glimpse, კალენდარი, დამოკიდებულება, აღქმა, მსოფლმხედველობა, მხედველობა, გამოიყურება, შესამჩნევი, მზერა, glare
მიზეზი: დეტალურად, ვრცელდება, გაფართოება, გაფართოება, გაფართოება, გავრცელებული, გავრცელების, გავრცელების, scatter, შეაღწიონ, amplitude, ტირაჟირება
პირიქით: წინა, განსხვავებით, პირიქით, დაპირისპირებული, წინააღმდეგ, მთელს, counter, განსხვავებით, ეწინააღმდეგება, ინვერტული, flip, წინააღმდეგ, ოპოზიციის, ანტი, დავამარცხებთ
თორმეტი: ათეული
დაკავებული: ჩართულობის, დაკავებული, ჩართული, მონაწილეობა, ოკუპირებული, ჩაერთონ, ჩამოყაროს, პრაგმატული, შებრუნებული
ღვინო: ალკოჰოლის, ალკოჰოლური
გემო: არომატი, არომატი, გემრიელი, სატყუარას, zest
რკინის: ფოლადის, რკინის
გავრცელება: გადაცემა, განათავსოს, აქვეყნებს, გამომცემლობა, გავრცელების, ტირაჟირება, განაწილების, გამოყოფს, წილი, გათიშე, გაყოფილი, გაყოფა, დაალაგეთ, გამანაწილებელ, დისტრიბუციის
სავაჭრო: სავაჭრო, ბიზნესი, commerce, ნაკეთობების, ინტერნეტ, გარიგების, გარიგების, მარკეტინგი, კომერციული
მოსამართლე: გადაწყვეტილება, გადაწყვეტილება, მსაჯი, ჟიურის
შეშფოთებულია: სასწრაფო, გადაუდებელ, დაინტერესებული, შეაშფოთა, აწუხებს, შფოთვა, შეშფოთება, ფიქრი, გააზრებული, არასასიამოვნო, შემაშფოთებელია, ეშინია, დიდი, შემაშფოთებელი, საგანგაშო, ენთუზიაზმი, დიდისურვილი, დაუღალავი, მძიმე, ცნობისმოყვარეობა, არეულობა, angst
კაპიტანი: 
შეწყვეტისასპექტი: 
უცხოური: საზღვარგარეთ, უცხო, უცხოელი, ეგზოტიკური, უცხო, გარე, საზღვარგარეთ
გამაძლიერებელი: გააძლიეროს
მნიშვნელობა: აუცილებლობა, შესაბამისობის, რაციმასნიშნავს,, მნიშვნელობა, გადამწყვეტი, ყურადღება
საბოლოოდ: საბოლოოჯამში,, საბოლოოდ, სასრული, საბოლოო, საბოლოო, ტერმინალში, წვრილად, ბოლოს, დამხობის
დაამტკიცოს: მტკიცებულება, ადასტურებენ, დაადასტუროს, დემონსტრირება, ჩვენებისმიცემაზე, მესმის,, აქსიომა
თავიდანასაცილებლად: შეწყვეტის, ნუქნას, დაკავება, ჩაახშოს, შეზღუდოს, ზღუდავენ, ბლოკი, შეკავებას, შეკავება, აიკრძალოს, თავიდანაცილებისმიზნით,, ჩახშობა, შეაჩეროს, შეჩერდა
კისრის: ყელის, საქონელი
საინტერესო: გართობა, სახალისო, გასართობი, საინტერესოა, მიმზიდველი, მოზიდვა, შთამბეჭდავი, მიაპყროს, მიმართვა, გაიყვანოს, საინტერესო, საინტერესო
იურიდიული: სასამართლო, კანონი, ლეგიტიმური, ჩარჩო, თეორემები
მშრალი: ღეროვანი, ფხვნილი
ემსახურება: მომსახურება, მოსაპოვებლად, cater, შეთავაზება
მტკიცებულება: მტკიცებულების, მტკიცებულება, უხელმძღვანელებს, ნახავ, კატალოგი, ჩვენება, მოწმე, აშკარაა,, ჩვენებისმიცემაზე
მტკიცებულებისშემთხვევაში: 
შორეულ: მოშორებით, შორს, off, გარდა, ლეპტოპი, დისტანციური, უგულო, შორეული, დარბევა
პროგრესი: stride, პროგრესიით, განვითარების, პროგრესული, განვითარების, წინასწარ, გაგრძელება, გაუმჯობესება, uplift, ზრდის, ხელშეწყობა, წესით, პროცესი
ვიწრო: წვრილი, მჭიდრო, მოკლე, შეუზღუდოს, შემაშფოთებელი, მინიმუმამდე, შეზღუდული
შენობა: აშენება, სტრუქტურა, მშენებლობა, მშენებლობა, შენობაში, ჩონჩხი
ძიება: მოვძებნოთ, აღმოჩენა, აღმოჩენა, quest, გამოვლენის, ეძებს, შეეცდება, კვლევა, გამოკითხვა, დევნა, გამოძიება, გამოძიება, გამოძიება, exploration, გამოგონება
სამწუხარო: დეპრესიაში, სამწუხაროდ, უმწეო, შემაშფოთებელია, ნაწყენი, remorse, უბედური
ცოდვა: დანაშაული, სამწუხაროდ, ჩაიდინოს
ავადმყოფი: ავად, sore, ავადმყოფობის, პაციენტი, ავადმყოფობა
პატიოსანი: გულწრფელი, ერთგული, პატიოსნად, frank, სწორი, არაკეთილსინდისიერი
საბანკო: bench, ქილა
ტყე: jungle, სატყეო
გაზომვა: წვრილი, საზომი, წონა, მეტრი, მეტრი
ნაკადი: შემოვა, პუნქტი, მიმდინარე, ელექტროენერგიის, flux, jet
ყურადღებით: მჭიდროდ, ფრთხილად, ფრთხილი
პური: bake, sow, sandwich, ლუკმა, პან
დამატებითი: დამატებითი, სათადარიგო, უფრომეტიც, ჭარბი, ჭარბი, დამატებითი, გარდაამისა,, დამატებითი, რჩეულებში, დანართი, ჩანართი, გვერდითი, პრემია
აირჩიეთ: არჩევანი, შერჩევა, აირჩიეთ, შერჩევითი, აირჩიოთ, ახლადარჩეულმა, აკრიფეთ, ხმისმიცემა, გამოკვლევა, უპირატესობა, დანიშნოს
ცხოველთა: არსება, neuter
zoicგენდერული: 
Eventiveსისტემისგანწყობა: 
multiplicativeშემთხვევაში: 
მიიღოს: მოგების, შეიძინოს, შეძენის, მიიღოს, მისაღებად, მოვძებნოთ, უზრუნველყოს, შეინარჩუნოს, შენარჩუნებისა, გამომდინარეობს, მოიტანონ, აქვს, ზემოაღნიშნულიდან, მისაღწევად, ცოლად
გადაკვეთა: მთელს, გადაკვეთა, გაივლის, უნდააღემატებოდეს, შეაღწიონ
სქელი: სიმსუქნე, thickly, ხშირი, fat
იზრდება: ამუშავებენ, მოიმატებს, ზრდის
წვიმა: სველი, ნალექის, შხაპი, ნალექების, არასამთავრობო, ცოცხი
მშვიდად: 
ზედაპირზე: სახე, დონე, თვითმფრინავი, ტერიტორიაზე, სუბსტრატს
წმინდა: წმინდა, დიდებული
ივლისი: 
მოდის: მოდური, წესით, მეთოდი, მიდგომა, პროცედურა
ანგარიში: განსაზღვრა, განცხადება, თანაფარდობა, ურთიერთობა, ურთიერთობა, სამართლიანი, გამოფენა, ესსე, ექსპოზიცია
ფაილი: დოკუმენტი, lodge, ნახვა, არქივი
მხრის: shaft, ღერძი, პორტრეტი, სავარცხელი, arm
სამეფო: იმპერიული, მონარქია, სამეფო, იმპერია, რეალური, ფაქტობრივი
სიმღერა: სრულყოფილი, სიმღერა, სიმღერა, პოემა, მღერიან
კომფორტი: განმუხტვის, სიმშვიდეს, დასასვენებლად, წახალისება, ფონდის, დანარჩენი, რელიეფის, დაწესებულებაში
არავის: ვინმეს, ვინმეს, ვინმე, არავინ, ყველას, ყველას, ვინც
ბალახის: თივა, weed, ბალახს, გაზონის, გრამი, ჩალის
გახსნის: წინასწარი, საწყისი, აღმოჩენა, უფსკრული, slot, ღიად, დასაწყისში
ივნისი: 
თევზი: აკვარიუმი
დედაქალაქში: თავი, ფონდი, აქტივი
მკერდის: გულმკერდის, რძე
განათლება: განათლება, გაკვეთილი, საგანმანათლებლო, წიგნიერების, ფორმირება, სასწავლო, განათლებული, სასწავლო, ინსტრუქცია, ასწავლიან, სწავლების
ბასრი: ნათელი, სასტიკი, მკაცრი, მკვეთრად, ცხარე, აღნიშნა, მწვავე, დიდი, crisp, აშკარად, glare
ხარჯზე: საფასური, ხარჯების, ღირებულება, გამოცემა, გამომავალი, დააკისროს, დახარჯვა
შენია: თქვენი
მილიონი: მემილიონე
ლოცულობენ: ვთხოვთ, ლოცვა, beg, სესხის
დაიღალა: დაღლილობის, დამღლელი
კლავს: მკვლელობა, მკვლელობა, აღმოფხვრას
ჩრდილი: ჩრდილში
მასობრივი: ხარისხი, კოლექტიური, რაოდენობა, ნაყარი, მრავლობითი, ბევრი, ერთიანად, კასეტური, mob, დანაშაული,, ცომი, მაკარონი
შეიქმნა: ინსტალაცია, მყარი, მტკიცედ, სტაბილური, შექმნა, დაამყაროს, მოქმედი, ნაპოვნია, დადგენა, ფორმირება, აწყობა
კმაყოფილი: კმაყოფილი, კმაყოფილება, კმაყოფილება, მოხარულივარ,, დაკმაყოფილება, დამაკმაყოფილებელი, შინაარსი
შეამოწმეთ: შეამოწმეთ, გამოიყურება, დაათვალიერეს, შემოწმება, არჩევანი, შეამოწმოს, შეამოწმოს, გამოკვლევა, ტესტი, აუდიტის, შეამოწმე, შუალედური, გამოკითხვა, გამოიძიოს, დადგენა, გადასინჯვა, კონტროლის
ძალით: სიკეთე, სიკეთე, კეთილგანწყობა, დამახასიათებელი, ატრიბუტი, trait
ოქროს: blonde
ეროვნული: ერი, მოქალაქეობა, ეთნიკური, შიდა, ნაციონალისტური
ძირითადი: პრემიერ-, სიტყვით, მთავარი, მთავარი, მთავარი, წამყვანი, staple
ხეობაში: აუზის
ვხვდები,: დასკვნა, ეჭვმიტანილი, ვარაუდობენ,, ხარჯთაღრიცხვა, შეფასების, პროგნოზი, პროგნოზირება, პროგნოზი, სპეკულირება, ღვთაებრივი, ვარაუდი, მოსალოდნელი, შეფასების, შეაფასოს, შეაფასოს, დაახლოების, პროგნოზირებადი
სპეკულაციაგანწყობა: ჰიპოთეტურიგანწყობა
ყვითელი: ღია, amber, blonde
ნაშთები: ნარჩენების, ნარჩენი, დარჩენილი, ნარჩენების, დანარჩენი
bent: curved, bend, ტენდენცია, გრეხილი, ფერდობზე, ირიბი, დასაკეცი, აღქმა, ვარაუდი
ყუთი: ჩემოდანი, უჯრა, ფონდი, ნაკრები, შეუძლია, მუყაოს, ბინ, მოლარე, კვ, კრამიტი, ქსელის
სეზონი: სეზონური, თავი, სადგური, ეპოქაში
მეცნიერება: სამეცნიერო, მორფოლოგია, ენათმეცნიერების
როგორცჩანს,: აშკარად, ნათელი, აშკარაა,, ღიად, მკაფიოდ, სავარაუდოდ,, აშკარად, აშკარაა,
ჭაბურღილის: ხვრელი, საბურღი, მოსაწყენი, მოსაწყენი, pierce, ვაწყენინო, ფორუმი, შეწუხებული, დასათვალიერებლად
ბიძა: დეიდა
სია: ინდექსი, კატალოგი, კატალოგი, მენიუ, რეგისტრაცია
აგვისტო: 
მშვიდი: მშვიდი, მშვიდი, მშვიდობიანი, ჩუმად, ნელი, სიმშვიდეს, სიჩუმეში, რბილად
პოპულარული: გავრცელების, ცნობილი, ცნობილი, ხალხური, წამყვანი, ვეტერანი
უცნობი: უცხო
ნაცნობი: გაცნობა, lineage, შთამომავალი, მეორადი
ნაცნობირეგისტრაცია: 
ფეხით: ფეხით, tread, გაგრძელება, ლაშქრობა, გასეირნება, საცალფეხო
ორჯერ: ორმაგი
ინტელექტუალური: გონება, დაზვერვის, ფსიქიკური, ინტელექტუალური, ფსიქიატრიული, მოაზროვნე, სიბრძნე, სულიერი
მღვდელი: სასულიეროპირები
დაიჭრა: დაშავდა, ჭრილობა, დააზარალებს
სასახლე: 
სცემეს: დამარცხება, punch, slap, დაარტყა, slam, რიტმს, გადავლახოთ, strike, ცოტა, გამარჯვება, გამარჯვება, გამარჯვებული
სულელი: silly, შეასრულა, მოტყუება, მოტყუებას, სულელური, სულელური, შეშლილი, გიჟები, insane, შეცდომაშიშეყვანას, ignorant, ignorant
ცხრა: მეცხრე, ახალი
თანაგრძნობა: თანაგრძნობა, თანაგრძნობა, სამწუხაროა,, წყალობა, საძაგელი, თანამგრძნობი
პაკეტური: აფეთქების, აფეთქება, აფეთქდეს, დაბზარული, boom, convulsion, bang
ჩაცმული: dress, gown, უნიფორმა, ტანსაცმელი, ტანსაცმელი
ლიტერატურა: ლიტერატურული, მასალა, outfit
კოლექცია: კონცენტრაცია, დაგროვების, კომპლექტი, ჯგუფი, მოედანზე, მასივი, გალერეა, suite, პაკეტი, პორტფელი, სინთეზი, რეპერტუარი, დასკვნა, დავასკვნათ,, დასკვნა, შეგროვება
ცარიელი: ცარიელი, ვაკანტური, ბარაბანი, დასვენების, null, სიცარიელე, ვაკუუმი, უშედეგოდ, შიშველი
ქარიშხალი: ქარიშხალი, იზიარებს
ჯიბეში: ჩანთა, პაკეტი
სასჯელი: გადაწყვეტილება, გადაწყვეტილება, წინადადება, თეორემა, წინადადება, წინადადება, სასჯელი, რწმენა, ფრაზა, ვგმობთ, დენონსირება, საჯარიმო, დასჯა
ნოემბერი: 
დეკემბერი: 
მოხდება: მოხდეს, კლების, იყოს, წარმოიქმნება, რა, არც, არც, ჩამოვა
არარსებობის: არარსებობს, ნაკლებობა, დეფიციტი
მადლობა: მადლობაგადაუხადა, მადლობელი, მადლობა, მადლობა, ვაღიაროთ, აღიარებს, აღიარებენ, ვაფასებთ, აუდიტორის
სერია: ჯაჭვი, string, მასივი, თანმიმდევრობა, კომპლექტი, თავისმხრივ,, დიაპაზონი, რიგი
მისამართი: მოვძებნოთ
ფრინველის: ფრენა, თვითმფრინავი, jet, თვითმფრინავი, თვითმფრინავი, ავიაკომპანია, owl
ქურთუკი: gown, საფარის, ქურთუკი, ბეწვის
მომზადება: მზად, მოამზადა, ორგანიზება, მომზადება, ფორმულირება, განკუთვნილი, მზადარის, დიდისურვილი, არსურს, ცარცი, აღჭურვა, გენერირება, აწყობა, აშენება, შექმნა
სწრაფად: სწრაფად, სწრაფი, სწრაფი, სწრაფი
მოწევა: მოწევა, დამწვრობის, გადადება
იანვარი: 
მანქანა: მანქანა, ძრავის, თვითმფრინავი
მოძრავი: ნაბიჯი, მობილური, ბიუჯეტის, მოძრაობა, მოძრაობის, მიგრაცია, tick
კბილი: კბილი, gear, ამ, louse
სირცხვილი: რი, მრცხვენია, მორცხვი, გაჭირვებული, უხერხულ, არეულობის, შიშველი, შიშველი, შეურაცხყოფად, აღშფოთება
ტვინის: მოაზროვნე, ტვინის
ბეჭედი: წვრილმანი, აკრიფეთ, curl, loop, საბურავი, საბურავი
ფრაზაmarker: 
გაგება: მესმის,, გაგების, აზრი, შემოტევით, თანაგრძნობა, ცოდნა, აღიქვამს, რისთვისაც, აღქმა, ცნობიერების
ხილი: შედეგი, შედეგი
ჩაი: yearn, მანქანის, კვადრატული
აგიხსნით: ახსნა, ასახავს, გამოხატოს, მივიტანოთ, განაცხადოს, განმარტავს, ინტერპრეტაცია, კომენტარისდამატება, ინტერპრეტაცია, აღწერს, აღმწერი
მისასალმებელი: მისალოცი, მიღება, გასართობად, hey, hi, მივესალმო
პოეზია: პოემა, ლექსი, მუნიციპალური, საათზე
ყიდვა: შესყიდვა, შეიძინოს, ახერხებს, ბაზარზე, მაღაზია, იაფად, ინვესტირებას, სავაჭრო
ერთგული: არაკეთილსინდისიერი, ერთგული, ერთგულად, ერთგული, სწორი, საიმედო
შფოთვა: სტიმულირების, აღფრთოვანებული, აურზაური, დაძაბულობა, პროვოცირებას, სიხარული, arousal, flush, ენთუზიაზმი, ენთუზიაზმი, ენთუზიაზმი, გადაუდებელ, სენსაცია
აპრილი: 
ოქტომბერი: 
მწარე: გაჭირვება, აგონიაშია, ტანჯვას, მწარედ, დაავადებული, მტკივნეული, sting, წერილობითი
ფხვიერი: დამოუკიდებელი, თავისუფლად, გადავწყვიტოთ, გადაჭრა, ვაკანტური, თავისუფლად
ტექსტი: ფორმულირება
ცუდი: ცუდი, უარესი, უხეში, უარყოფითი, nasty, მიუხედავად, ყველაზე, უმაღლესი, უმდაბლესი, ნაგვის, trash, ნაგვის
საკრედიტო: იპოთეკური, საკრედიტობარათი, ვალის, სარგებლის, სესხის, სესხის, პრესტიჟი, მოქმედების, სანდოობის
მახასიათებლები: კომპონენტები, ფუნქციები, ასპექტები, ფუნქცია
შეუძლია: მისცემს, კომპეტენტური, შეუძლია, მოცულობა, უნარი, ქმედუუნარო, პოტენციური, ახერხებს, გამოცდილი, ნიჭიერი, უნარი, ეფექტურობა, კომპეტენციის, ნიჭიერი, ეფექტურობის, სასარგებლო
თხუთმეტი: 
სასტიკი: სასტიკი, მკაცრი, ბოროტებად
შეუერთდება: მონაწილეობა, დაესწრება, ჩართული, მოლოდინით, ვიცავთ, მონაწილე, ჩართვა, გაერთიანდეს, დაკავშირება, ახალბედა, ინტეგრაცია
დანაშაული: დანაშაული, დანაშაული,, დანაშაული, სისხლის
მტვერი: კაშხალი, ფხვნილი, dirt
პრაქტიკული: ფუნქციური, პრაგმატული, პრაქტიკულად, მოსახერხებელი, პრაქტიკულად, მოსახერხებელი, გამოყენებითი
ფერი: ფერი, ხატავს, საღებავი, ღია, ფერადი, ფერადი, flush, ქუჩის, კოდირების
განადგურება: wreck, ძირსუთხრის, საბოტაჟი, დეგრადაცია, დანგრევა, crush, smash, დანგრეული, ანგრევენ, წაშლას, უარყოფს, განადგურება
მომატება: გაგრძელება, აძლიერებს, mount, დააყენებს, რჩეულებში, ჩადეთ, ზრდის, გასადიდებლად, ლაშქრობა, ემსახურებოდეს
ცხვირი: beak
მეგობრული: შეეფერება, ხელსაყრელი, შესაბამისები, kindly, გულწრფელი, მოკავშირე, მეგობრობისათვის, კეთილი
გუშინ: ხვალ, დღეს
hesternalდაძაბული: 
ვერ: მარცხი, წარუმატებელი, დამარცხება, ვერ, ანგრევენ, სხვაობა
გაგრძელდება: გაგრძელება, უწყვეტი, მუდმივი, გაგრძელება, მუდმივად, არსებობს, გამოყოფს, გამართავს, წლიდან, დაკავშირება, დაიწყოს, ასრულებს
ამოიღონ: rid, გაიყვანოს, აღმოფხვრას, აღმოფხვრა, wipe, წაშლას, წაშლა, გაუქმება, სხვაობა, მიაპყროს, გაიყვანოს, განდევნა, აღიქვას
აცვიათ: განახორციელოს, porter
ბრმა: 
ფრენა: მფრინავი, ნახტომი, ფრენა, საავიაციო
დიდება: აღფრთოვანებული, აღფრთოვანებულივარ, რეპუტაცია, დამსახურებაა, გილოცავთ, მილოცვა
მისია: 
მსხვერპლს: მსხვერპლი, მტაცებელი, მსხვერპლი, ზარი
სწავლება: ვარჯიში, დავალება, პრაქტიკა, პრაქტიკა, სპორტი, ფიტნეს, რეპეტიცია, საბურღი, მოძრაობა, მოძრაობის, კამპანია, სპორტული
სინდისის: ნაცვალსახელი, ცნობიერების
თეორია: პრინციპი, თეორეტიკოსი, თეორემა, თეორიული
მინისტრი: 
სიძულვილი: nasty, ამაზრზენი, სიძულვილი, dislike, შეუზღუდავად, grudge, უკმაყოფილონიარიან, ზიზღით, ეზიზღება
ტბა: მხოლოდ
ცენტრი: ცენტრალური, ცენტრი, სადგური, შტაბი, შუა
faint: უგონო, სასოწარკვეთა, სასოწარკვეთილი, სუსტი, ღია
რაციონალურიგენდერული: 
მოკლე: მოკლედ, აკრონიმი, მოკლე, ცოტახნის, ანკეტა, კომპაქტური, მიმოხილვა, ეკონომიკური
თაყვანისცემა: რიტუალი
საქონელი: პროდუქტი, სატვირთო, საქონელი, ნაკეთობების, სასაქონლო, პერსონალის, სატვირთო, mall, საშუალებები
კანი: ტყავი, შთანთქმის, ქერქი, shell, კანი, ბეწვის, zest
სახურავი: ტერასა, ჭერი, დაფარვის, დაფარვის
გვირგვინი: 
ციხე: გალიაში, დაიბლოკოს, გვარი
ტახტზე: 
მიმაგრებული: ჩაერთონ, პირობითი, ანიჭებენ, დაკავშირებული, დამოკიდებული, ასოცირებული, წყვილი
mile: ტენდენცია, ფერდობზე, მჭლე, გრადიენტი, მზადარის
ციხეში: ციხეში
საფუძვლიანად: კარგად, კომფორტული, სწორად, შეუფერხებლად, საფუძვლიანი, საკმაოდ, მთლიანად, საერთოდ, სრულიად, საკმაოდ, სრულიად, სრულად, სრულიად, წმინდა, ზუსტად, ზუსტად, ზუსტად
თასი: mug
წევრი: ორგანოს, წევრობის, კიდურის, შიდა
სამოქალაქო: შიდა, მოქალაქე, სამოქალაქო, სამოქალაქო
ყველგან: მთელი, სადღაც
შეესაბამება: შესრულების, შეასრულოს, აღასრულოს, შეესაბამება, თანმხლებ, შეხვდება, დაემორჩილოს, შინაარსი, დაკმაყოფილება, ვიცავთ, სათაური, შესაბამისად
ხოლო: ხოლო, მიუხედავადიმისა,რომ, თუმცა, მიუხედავადიმისა,რომ, მიუხედავადამისა,, მაშინ,როდესაც, მიუხედავადამისა,
მოცულობა: ბევრი, იმდენად,რამდენადაც, თანხა, შედარებით, რაოდენობრივი, ბლოკი, მოდული, ნაყარი, გარშემოწერილობა, დაფარვის, ზომა, კონტინენტზე, პუნქტი
საბაჟო: კლიენტს, სურვილისამებრ, კოსტუმი, პრაქტიკა, ჩვევა, ხოლმე
bow: arch, arc, ხახვი, მრუდი
ხორცი: ხორცი, ძროხის
მცენარეულიგენდერული: 
იშვიათი: იშვიათად, ძლივს, იშვიათად
დეიდაშვილი: ნათესავი
ხიდი: კლასის, deck, ფეხი, აუზი
დაცვა: დაცვის, კონსერვაციის, დაცვის, იცავს, დავიცვათ, შეინარჩუნოს, შენარჩუნება, შენარჩუნებას, უზრუნველყოს, თავდაცვის, თავდაცვის
მარილი: გაზვიადებულია, გადაჭარბებული, მარილიანი, მეზღვაური
innocent: სუფთა
დედოფალი: 
ცეკვა: ბარაბანი, ცეკვა, ნახტომი, გაფართოებული
სასტუმრო: განსახლების
შეავსოთ: შინაარსი, შინაარსი
პატიმარი: მსჯავრდებული
კიბეები: კიბე, stair, ასვლა, უჯრა
gay: ჰომოსექსუალი
ქვიშის: 
ძალადობრივი: ძალადობა, სასტიკი, მღელვარე, მშვენიერი, მძიმე, ძლიერი, ინტენსიური, აქტიური, wildly, ინტენსიური
სექტემბერი: 
ჩაშლის: განადგურება, დივერსიის, დაზიანება, გააფუჭებს, კატასტროფა, wreckage, wreck, დანგრევა
მსხვილფეხარქოსანიპირუტყვი: ძროხა
ტექნიკა: აპარატურა, მოწყობილობა, საკანცელარიო, ნაკრები, gear, outfit, დაძლევის, დაწესებულებაში, საშუალებები
აღიქმება: აღქმა, იცის, აღიქვამს, აღიარებს, აღიარება, ცნობიერების
ყველგან: სადღაც, იქ,სადაც, არსად, სხვაგან
სამზარეულო: სამზარეულო, გაზქურის
გაყიდვა: იყიდება, ნახევრად, გამყიდველი, ღალატი
სიჩქარე: სიჩქარე, ევროპისსაბჭოსსაპარლამენტოასამბლეის, იმპულსი, მკვეთრად, დინამიკა, მოძრაობის, დააჩქაროს
კომპიუტერული: კომპიუტერული
მარადიული: ოდესმე, სამუდამოდ, უსასრულო, მუდმივი
ბიბლიოთეკა: ბიბლიოთეკარი, bookcase
დაბნეულობა: სასადილო, ქაოსი, აურზაური, გაუგებარია, დაბნეული, ანარქია
სტატია: ესსე, საქონელი, განყოფილებაში, პუნქტი, დიამეტრი, ინჟინერი
მზარეული: მზარეული, სამზარეულო, bake, boil
band: ქამარი, ლენტი, ფირზე, რაზმის, ჯგუფი, ზოლები, ზოლიანი, ზონა, მიმართულება, bunch, კასეტური, lane
უდაბნო: უდაბნოში, მიტოვებული
კოცნა: 
ice: ნაყინი, ფირზე, snow
ბურთი: რეზინის, სფეროში, ტყვია, ძალა, ჩვილი, აბი, სიცარიელე, მიწოდება
ჯოხი: საფონდო, cane, ვიცავთ, ხის, ხე-ტყის, წინ, cue, თანამშრომლები, ბოძზე
არგუმენტი: ლოგიკა, ნაბიჯი, დაპირისპირება, დისკუსია, დებატები, დავა, გზების, მტკიცება, კითხვა, კითხვები
დაიცვან: შეამოწმოს, შეამოწმოს, შეისწავლონ, გამოიძიოს, დაკვირვება
კურთხევადგანწყობა: 
ნათელი: გამოჩენილი, განსაცვიფრებელი, strike, მნიშვნელოვანი, მნიშვნელოვანი, მნიშვნელოვანი, შესამჩნევი, შთამბეჭდავი, გასაკვირი, გასაოცარი, აღსანიშნავია
დამნაშავე: დანაშაული, ვალში, შეურაცხყოფა, დამნაშავე, მსჯავრდებული, ვგმობთ
gun: თოფი, იარაღი
პოლიციის: აღასრულოს, ზედამხედველობა
დამალვა: საიდუმლო, შენიღბვას
ექსპედიცია: კამპანია, დისკზე, მოგზაურობა, მოგზაურობა, მოგზაურობა, ტური, crusade
cloud: კიბერსივრცეში
ნარჩენების: აზრიარაქვს, ზედმეტი, უარი, უარი, უარის, ნაგვის, ნაგვის, trash
თებერვალი: 
დაავადება: ავადმყოფობის, ავადმყოფობა, კორონარული, დამაკმაყოფილებელი, დამაკმაყოფილებელი, სინდრომი
ინიციატივაშემთხვევაში: 
უნივერსალური: 
ქონების: კარგად, პლანტაცია, აქტივი, მიწის, ქონება, საკუთრების, ბედი, სიმდიდრე
თავმდაბალი: დამარცხება, მოკრძალებული
დაგვიანებით: გადადება, ბოლოს
გადაიდოაუცილებელია: 
ცნობითმტკიცებულების: 
სამწუხაროა,: სამწუხაროდ,, უიღბლო, დამთხვევა, უბედური, უმწეო, არაადეკვატური, incongruous, შეუსაბამო
შუაღამისას: ჩრდილოეთით
გმირი: მეომარი, ჩემპიონი
finger: toe, ციფრი
პრეს-: მედია, ჟურნალი, ჟურნალი, ბეჭდვა, ტიპი, ფორმულა, ბიძგი
ჯილდო: პრიზი, საჩუქარი, ჯილდო, პრემია, კომპენსაციის, აუნაზღაუროს
ბრალი: ბრალია, ნაკლი, ხარვეზის, ვალის, დანაშაული, snub, სისხლისსამართლებრივიდევნის, პასუხისმგებლობის, პასუხისმგებლობა, ადანაშაულებენ, ამბობენ,, ვგმობთ, დენონსირება
სიღარიბეს: გაჭირვება, დაავადებული, ტანჯვას, უმწეო, უსაქმურობის, განიცდიან, მწუხარება, ირონია
შუბლის: 
რეკლამა: რეკლამა, სარეკლამო, რეკლამა, რეკლამა, განცხადება, საჯაროობის, ცნობა, დეკლარაცია, უნდა, ამისთვის, განცხადება, მტკიცება, ხელშეწყობა, ხელიშეუწყოს
angel: მიწისმესაკუთრე, ლურჯი, მკაცრი, სახიფათო, მომხმარებლები
დიდება: დიდება, რეპუტაცია, ჭორები, ჭორები, სარეკლამო, საჯაროობის, პრესტიჟი
სინგულარულინომერი: 
გამთენიისას: twilight
აპატიებს: საბაბი, შეწყალების, მოითმენს, თავისუფლდება, გაათავისუფლოს, გადააყენოს, პატიება
ცხვარი: ცხვრის, თხა, თანხა, დადებითი
გაფართოება: გადავწყვიტოთ, გადაწყვეტა, გადაწყვეტილება, დასკვნა, ანალიზი, ავარია, შესვენებისქვემოთ, განსაზღვრა, decay
მოთმინება: სიძლიერე, დიდსულოვნებისა, პაციენტი, მოუთმენელი, ტოლერანტული, ტოლერანტობის, თავშეკავება
რეფერენტული: ცნობისთვის, ეხება, დააკონკრეტა, დირექტივა
სიმინდის: ხორბლის, horn, მარცვლეულის
გასაღები: bond, ღილაკს, შეცვლა, მთავარი, სასიცოცხლო, ცნობილი, მგრძნობიარე, მთავარი, ნიშა, საშუალო, ნახავ, რომ
უმრავლესობა: ბევრი, ყველაზე
იგნორირება: ignorant, სასაცილო, სულელური, ignorant, thumb
სისუსტე: უუნარობა
მოგება: უპირატესობა, მოგების, სარგებელი, ეფექტური, გამარჯვება, ბენეფიციარი
bell: სიგნალიზაცია, საათი, საათი
ატმოსფერო: გარემოს, sky, საავიაციო, სივრცითი, კლიმატის, შემოგარენში
კაცობრიობის: ადამიანის
დისკზე: დისკი, slice, counter, ცილინდრიანი, დისკო, ჩანაწერი, უჯრა
lonely: მარტო, მარტოობა, ცალ-ცალკე, მარტოხელა, მხოლოდ, მშვიდი, მიტოვებული
მხატვარი: შემსრულებელი, მხატვარი, მუშაკი
ხიბლი: ქარიზმატული, მოზიდვას, magic, სიტყვიერად, ესთეტიკური
მონობის: მონა, bond
გამგებელი: კონსერვატიული, მმართველი
ფილიალი: 
განწყობას: მოწყობა, კონფიგურაცია, ტენდენცია, ტენდენცია, დებულება, განლაგება, განწყობა, გრაფიკი, გრაფიკის, საცხოვრებელი, დანიშნულების
გისურვებთ: ბედი, ბედი, იღბლიანი, ბედნიერება, შანსი, გაგვიმართლა
მომდინარეობს: მისაღებად, მიიღოს, გამომდინარეობს, მოიტანონ, მისაღწევად, ვიღებ
ინდუქციურიგანწყობა: ახსნითიგანწყობა, ჰიპოთეტურიგანწყობა
საზოგადოების: საზოგადოება, გარეშე, ხალხი
ნავთობის: fat, საწვავის, წიაღისეული, ტვინის, თერმული, კარაქი
მილის: მილის, სტეპის, faucet, poop
ბეჭდვითი: გამოცემა, ზეწოლა, ბეჭდვა, ღერძი, mold, შთაბეჭდილება
oh: ya, მასივი
დისკურსიკონტექსტში: 
წოდებითიშემთხვევაში: 
სალონში: კოტეჯი, კარავი, lodge, პალატა, მობილური, ნაწილების
ნერვული: დაძაბული, დაბნეული, შეუშალოს, ნაწყენი, გაჭირვებული, შემაშფოთებელი, ავიწროვებენ, შემაშფოთებელია, ნერვული, აწუხებს, ნერვის, ძლიერი, ძლიერი, ინტენსიური
განსხვავება: შესაბამისად, სხვაგვარად, ვარიაციები, მრავალფეროვნება, განსხვავდება, გარჩევა, უფსკრული, დიფერენცირება, განსხვავება, განსხვავებით, ვარიაცია, ეწინააღმდეგება
ტვირთი: აღიქვამს, დატვირთვის
აბრეშუმის: შემოტევით, ძალაუფლება
აბუჩად: სძულთ, სიძულვილი, dislike, სიძულვილი, ეზიზღება, snub, შეურაცხყოფად, აღშფოთება, გულგრილობა
ჯოჯოხეთი: 
გამოყოფილი: ცალკე, გარდა, გარდა, მკაფიო, განსხვავდება, ცალ-ცალკე, უგულო, დისკრეტული, იზოლაცია, განდევნილები, delimited, გამოყოფა, გარჩევა, იზოლირება, გათიშვის
შერეული: ნარევი, მოედანზე, კომპოზიტური, ავურიოთ, ერთობლივი, fusion
ხის: ხის, ხე-ტყის
მკურნალობა: მკურნალობა, თერაპია, სამკურნალო, პროცესი, განიხილოს, თერაპევტის, საშუალება, გარიგება, მოშუშებისა, მოიქცევა, დახმარება, chin, ყბის
გაფრთხილება: სიფრთხილით, გავაფრთხილო, alert, მემორიალი, ცნობა
მითითებაგანწყობა: 
ამბიცია: იმედგაცრუებული, იმედი, ვნების, დაუკარგავს, ამბიციური
სარგებელი: ეფექტურობის, აღვადგინოთ, შემოსავალი
რატომღაც: გარკვეულწილად, რაღაც
რჩევა: კონსულტანტი, მინიშნება, ვურჩევ, კონსულტაცია, რჩევა, წვერი, ადვოკატი, ადვოკატი, ადვოკატი
კონსტიტუცია: წესდება, საკონსტიტუციო, ინციდენტი, კლების
ინსტრუმენტი: ინსტრუმენტი, გემის, პირი, ორგანოს, კონტეინერი, სასარგებლო, მოწყობილობა
დგას: სტაბილური, სტაბილიზაციას, რეგულარული, რეგულარულად, ფიქსირებული, მუდმივი, მუდმივად, უწყვეტი, მდგრადი, სტანდარტული, სტატიკური, დაფიქსირება, თანმიმდევრული, მუდმივი, სტაციონარული, სიმშვიდეს
ელემენტები: ფაქტორები, ელემენტი, კომპონენტი, ნივთიერება, კომპონენტები, არსი, მოკავშირე, ფაქტორი, პარამეტრი
უწყვეტიასპექტი: 
ონლაინ: 
tide: ტალღა, ვადამდელი
კოლეჯი: ფაკულტეტი, აკადემიის, campus, უნივერსიტეტის
კუდი: მდგომ, ბილიკი
თაობის: შთამომავალი
კატა: 
პირდაპირიმტკიცებულების: 
მიტოვებული: უყურადღებობა, დატოვოს, მიტოვებული, დატოვა, უარითქვას, დაითხოვოს, გაუქმება
თერთმეტი: 
ინსტიქტი: სპონტანური
ტომის: მაგისტრალური, ღეროვანი, დატვირთვის, ნაკლებობა, აკლია, დეფიციტი, დეფიციტი, დეფიციტი
apprehensiveგანწყობა: 
თავშესაფარი: საკურორტო, საცხოვრებელი, დასახლებაში, ჰაბიტატის, საცხოვრებელი, დაცვის, საცხოვრებელი, თავშესაფარი, harbor
უხეში: უხეშად, უხეში, ბოროტებად, მკაცრი
riding: ride, მხედარი
პროფესია: საოკუპაციო, კარიერა, საოკუპაციო, პროფესიული, პროფესიული, ბიზნესი
ნათურა: სანთელი
ყავა: კაფე, საკმარისი, საკმარისად, ადეკვატური
მედდა: დის
გარწმუნებთ: გარანტია, ორდერი, დაპირება, გარანტია, დააზღვევს, უზრუნველყოს, დადგენა, ადასტურებენ, გთავაზობთ, cater, დარწმუნებულივარ,, დაარწმუნოს, დაადასტუროს, უზრუნველყოს, პალადიუმი
ფეხსაცმელი: ფეხსაცმლის, sandal
ეკიპაჟის: თანამშრომლები, ნახირი, გუნდი, bunch, პერსონალის
ეზოში: კოდი, გვერდი, courtship
ბუნდოვანი: გაურკვევლობა, ბუნდოვანი, ორაზროვანი, გაურკვეველია, საიდუმლო, გაურკვეველი, განუსაზღვრელი, ტალღა, ვაკანტური, გაუგებარია
ბინა: ბინა, წრე, ნაწილების, suite, უნივერსალი
საქმიანობის: გარიგების, ფუნქცია, ოპერაციები
შაბათი: შაბათ-კვირას
მფლობელი: 
sunshine: მზის, მზისგანდამცავი, shine, დღისით
ქვრივი: 
ურთიერთობა: კონტაქტი, მიმოწერა, კომუნიკაციური, ურთიერთობა, ურთიერთქმედება, ურთიერთქმედება, ურთიერთობა, დაკავშირებული, ურთიერთობა, კორელაცია, შესაბამისობის, ცნობა, განცხადება, გარიგების, spray, საოკუპაციო, დიალოგი, ინტერფეისი, დიალოგი
ასახვა: დაფიქრების, reflex, ფანტაზია
ორგანიზაცია: ქსოვილის, ორგანიზაცია, ორგანიზება, outfit, კორპორაცია, სასარგებლო, სააგენტო, პირი, სისტემაში, სტრუქტურა, ტექსტურა, განლაგება, დაწესებულების, ინსტიტუტი, ასოციაცია, ფირმა, საწარმო, ავიაკომპანია, ორგანიზებული
ვარსკვლავი: 
სტუმარი: უცხო, სტუმარი, უცხო, უცხოელი, ახალბედა, კლიენტს, მომხმარებელს, მასპინძელი
ბარი: შიშველი, pub, დატვირთვის, სატვირთო, სატვირთო, კაფე, ბარიუმის, ზოლები, bandage, ქამარი
ბოთლი: jar, ავადმყოფობა
დალოცოს: კურთხევა, მივესალმო
აჟიოტაჟი: მანიპულირება, ავურიოთ, რეზონანსი, ბუნტის, excite
ჩხუბი: ეწინააღმდეგება, დავა, ბრძოლა, სამართალწარმოება, ამტკიცებენ,, უთანხმოება
შიდა: ფარგლებში, დაწვრილებით, შინაგანსაქმეთა, შიდა, ადგილობრივი, შიდა, შიდა, ფსიქიკური, შიდა, მთავარი, მთავარი
წინააღმდეგობის: ოპოზიციის, დაპირისპირებული, საპროტესტო, მდგრადი, ანტი, უკმაყოფილონიარიან, პროტესტი
ღრუ: ჩვეულებრივი, შიშველი, ცარიელი, საკაბელო, ხვრელი
პროვინცია: პროვინციის, რაიონში, ქვეყანა, fat
ცივილიზაციის: კულტურა
hang: ზედამხედველობა
შოკი: დარტყმა, ტრავმა, შოკისმომგვრელი, შეტაკება, გავლენა, საოცარი
გამონაკლისი: ნაწილობრივი, დისკრიმინაციის, სტერეოტიპი, გათავისუფლება, კონფლიქტის, გამოჩენილი, თავისუფლდება, გამოქვითვა
დაძაბულობა: სტრესი, დაძაბულობა, დატვირთვის, დაღლილობის, ძალისხმევა, ინტენსივობის, იკისროს, რასობრივი, ეთნიკური
მართვის: დისკზე, მძღოლი, უხელმძღვანელებს, ride
ფიცს: გინება, დაპირება
საგანძური: ძვირფასიქვა
თესლი: სპერმის, თხილის, ნაწილაკების, ბატონი
კოშკი: 
საყვარელი: საყვარელი
ცოტახნისწინ: ბოლო, ახლად, ახლად, დღეს, შემდეგ
მეძინა: შეგნებული, მორალი, ვიღვიძებ, alert, excite
ავეჯი: 
თოკზე: კაბელი, string, strap, bind
სათავგადასავლო: საწარმოს, საფრთხის, აზარტული
ჰონორარის: იზეიმოს
დღესასწაული: პარტიის, დღესასწაული, საბანკეტო, დღესასწაული, ვახშამი
წლიური: წელი, ყოველწლიურად
მასშტაბის: ჩარჩო, ფარგლებში, წვრილი, თანაფარდობა, ასვლა, კიბე, stair, ზომა, კრიტერიუმი, განზომილება, დონე, იმდენად,რამდენადაც, პროპორციული
შესაბამისად,: შედეგი, ამიტომ
ფონდი: ბაზა, საფუძველზე, დაფუძნებული, ძირითადი, პირველადი, დაწყებითი, ძირითადი, ძირითადი, ზედაპირული, ბაკალავრიატის, საფუძველი, პლატფორმა, ფონდები, ფუნდამენტურად, უდევს
ცერემონია: რიტუალი, ფუნქცია, დღესასწაული, კონცერტი, ფორმულა, ცნობიერების
ნადირობა: ნადირობის, მსხვერპლი, მტაცებელი, დევნა, სროლა
ლიბერალური: გულუხვი, თავისუფლად
დიდწილად: არსებითად, მნიშვნელოვნად, ყველაზე, ძირითადად, ძირითადად, დიდად, ფართოდ, უპირატესად, თავდაპირველად, არსებითად, ძირითადად, უფრო
princess: ქალიშვილი, პატარძალი
საკურთხევლის: საკურთხევლის
ვებ: ქსელი, წმინდა, ქსელის, ქსოვილის, ტილო, ქსოვა
purple: ფუქსინი
შევიკრიბოთ: შეგროვება, დაგროვება, შემცირება, აკრიფეთ, ნარჩენების
საარჩევნო: არჩევანი, ახლადარჩეულმა, ბილიკი, გამოკითხვა, whale, შერჩევა, შერჩევითი
მთვრალი: ალკოჰოლური, ლოთობა
დაასხით: გადაყენება, დაიღვარა, თამაშები, დამხობის
ლიფტით: ლიფტი, აამაღლოს, uplift, დააყენებს, ლაშქრობა
ჟესტი: ნიშანი, სიგნალი, სიმბოლო, სიმბოლური, დამოკიდებულება, პოზა, მინიშნება, მითითებით
მართვა: მართვის, ზედამხედველობა, გაუმკლავდეს, ადმინისტრაცია, არეგულირებს, იზიარებს, კონტროლის, მუშაობას, გვინდა, მოწყობა, ორგანიზება, კონფიგურაცია, ასრულებს, შენარჩუნება
გაცვლა: swap, საპასუხო, swop, ჩანაცვლება, კომუტაციური, ვალუტა, ფულადი, ალტერნატიული, გადანერგვის
გარკვეულისტატია: 
იმპერატორი: მონარქი
ფერი: მზა, დამთავრებული, ბოლოს, თაბაშირის, მეტი, გაფორმება, დასკვნა
მახინჯი: nasty, ამაზრზენი, მხიარულ, სასიამოვნო, სახალისო
ნამდვილი: ნამდვილი, რეალური, ფაქტობრივი, ვირტუალური, ზუსტი, ორიგინალური, შექმნილი, თანდაყოლილი, ძირძველი, გარკვეული, დარწმუნებული, სვეტი, გულწრფელი
inch: საბაჟო, thumb
წვერი: chin
გაანადგურეს: snatch, ეროზია
გაუძლო: ანტი, ოპოზიციის, განსხვავებით, საპროტესტო, პირიქით, ეწინააღმდეგებიან, შეუშალოს, დაპირისპირებული, უარი, უარყოფენ, განსხვავებით, ობიექტი, სიმტკიცის, მტრული, ეწინააღმდეგება
სავაჭრო: ბანკირი, ბიზნესპირი, ნაკეთობების
დამოუკიდებლობის: დამოუკიდებელი, თავისუფლების, თავისუფლად, თავისუფლების, ავტონომია, განმათავისუფლებელი
სუნი: სუნამო, არომატი, არომატი
თვრამეტი: 
ისტორიული: ისტორიულად, ისტორია, ისტორიკოსი, ისტორიული
მთლიანი: სულ, საერთო, ბინძური, ნედლეული, ნედლი, arousal, მაკრო, დიდისურვილი, მძიმე, ინტენსიური, dot, საერთო
root: ღეროვანი, ახლად, მარშრუტი, ორიგინალური, წარმოშობის
ტალახში: ნიადაგის, slime, თიხის, dirt, ყვავილების
სიმარტივის: მარტივი, humility
veil: ფარდა, sail, მცურავი, ეკრანზე, გარსის
თეატრი: თეატრი
შედარება: შედარება, შედარებითი, კორელაცია, თანაფარდობა, დაპირისპირება, შესადარებელი
შემადგენლობა: კომპონენტი, სტრუქტურა, ფორმირება, მშენებლობა, წარმოადგენს, მშენებლობა, ორგანიზება, კონფიგურაცია, კონფიგურაცია
კონკურენტი: მოწინააღმდეგე, დისიდენტი, კონკურსი, კონკურენტული, კონკურენციას, კონკურენტი, counter, წინააღმდეგობრივი, ანტი
გააცნობიეროს,: მისაღწევად, აღიარებს, აღიარება, იდენტიფიცირება, დიაგნოსტიკა, იცოდა, შეასრულოს, გრძნობს, აღიქვამს, მესმის,, შემოტევით, ზემოაღნიშნულიდან, გვემახსოვრება
ბალანსი: წონასწორობის, თანაბრად, თანასწორობა, ჰორიზონტალური, პროპორციული, par, ბიუჯეტი
მწვრთნელი: ტრენერი, პრაქტიკოსი, პედაგოგი, მენტორ
იუმორი: იუმორი, იუმორისტული, განწყობა, კომედია, ხუმრობა
რომანი: მხატვრულილიტერატურა, ახალი, ახლად
შურისძიების: grudge
რესურსები: აქტივი, წყარო, რესურსი, საშუალება, მიწოდება
ეჭვიანი: ეჭვიანობა, შური
საჭე: bike, წრე, ციკლი
დაიწვა: დამწვრობის
ფლეშ: lightning, დიზელის, shine, flashlight
ვარაუდობენ,: წინადადება, რეკომენდაცია, შესთავაზოს, რეკომენდაცია, წინადადება, დაასახელოს, გულისხმობს, კავშირი, მიუთითებს, წინადადება
imprecatoryგანწყობა: 
უმწეო: 
ჯგუფები: ჯგუფი, deck
შესვლა: წინ
წყალდიდობის: ამარცხებენ
სარგებლობის: სარგებლობენ, სიამოვნებით, სიხარული, აღფრთოვანებული, ბედნიერება, მოხარულივარ,, კმაყოფილი, აღფრთოვანებული, გულშემატკივრობენ
გულგრილობა: აპათია, უყურადღებოდ, უყურადღებობა, იგნორირება, შევჩერდეთ
ჰორიზონტზე: 
სავარაუდოგანწყობა: ჰიპოთეტურიგანწყობა
ციცაბო: ზღვისდონიდან, მართობს, ბევრი
ჰარმონია: კომპრომისი, სრულყოფილი
ბავშვობაში: 
მუხლი: lap
ორმხრივი: ერთმანეთი, საპასუხო, საერთო, ერთობლივი, ურთიერთქმედება, ინტერაქტიული
პროგრამულიუზრუნველყოფა: პროგრამა, რეპერტუარი
დაზიანება: დააზარალებს, ზიანი, დაზიანება, დაზიანების, ჭრილობა, ტრავმა, დაშავდა, დარღვევა
მიღების: მიიღოს, შესასვლელი, მიღება, მიღებას, მიღების, ვაუჩერი
დისციპლინის: სათაური
slip: მოლიპულ, slide, glide, gaffe
რევოლუცია: რევოლუციური, გადატრიალების, როტაცია, აჯანყება, აჯანყება
ფერმერი: გლეხი
ინსულტის: დარტყმა, გადატრიალების, პიკის, scramble
პრივილეგია: პრივილეგირებული, უპირატესობა, კვოტა, ფრენჩაიზია, შეთავაზება, დათმობა
სტუდენტი: სკოლისმოსწავლე, მეცნიერი, ბაკალავრიატის, სასწავლო
მღვიმე: 
ტრადიცია: ტრადიციული, ტრადიციულად, საბაჟო, კაპიტულაცია
ტრაგედია: ეპიდემია, მწუხარებას, პარადოქსი
სასტუმრო: pub
ქალიშვილი: maid
გამოსამშვიდობებელი: მშვიდობით, ნახვამდის, ნახვამდის
კრიტიკა: აკრიტიკებენ, კრიტიკა, მიმოხილვა
ბამბა: ბამბა
საავადმყოფოში: თავშესაფარი
ქირავდება: მგზავრობის, აყვანის, საგადასახადო, ხარკი, იჯარის, დასაქმება, ჩაერთონ, ნაქირავებ, წესდება
გაზის: 
გარდაუვალია: აუცილებლად
სასიკვდილო: სასიცოცხლო
ფოთოლი: ფურცელი, დანა
გამოცემა: აქვეყნებს, გამომცემლობა, ბეჭდვა, აცხადებენ, სამაუწყებლო, გათავისუფლება, გამომავალი, გავრცელების, აცხადებს
თარგმანი: თარგმნა, თარგმნა, ინტერპრეტაცია, ეპიდემია, გადაცემა, მობილური
beach: მიმართულება, სანაპირო
დაკრძალვის: დაკრძალვის, სასაფლაოზე, დასამარებას
ფქვილი: ფხვნილი, ცომი, ზუსტი, ზუსტი, ზუსტი, კვება
roar: დრამატული, shout, ხმაური
რომანტიული: წელის, თეძოს
ქოხი: კოტეჯი, lodge, დაიღვარა
mimetic: 
დოლარი: 
თექვსმეტი: სამოცი
ასამბლეის: შეხვედრის, კონფერენცია, კონგრესი, კონფიგურაცია, აქცია
კოლონია: 
ფრთა: პალატაში, suite, კიდურის, fin, ფრენა, საავიაციო
lion: 
cunning: სახიფათო, შეასრულა, ნიჭიერი, ჭკვიანი, დიპლომატიური
დრამა: ვითომ, დრამატული
mist: ნისლის
ჰიპერტექსტის: ჰიპერბმულის
მედიცინის: ნარკოტიკების, საშუალება, spray, prescription
თოთხმეტი: გარეშე, ექსკლუზიური, sine
მჟავა: მაწონი, მჟავე, მთის, mount
კერძოდ,: ნებისმიერი, ანუ
შესახებ: ბენეფიციარი, სამომხმარებლო
ეპისკოპოსი: 
orange: 
აბანო: აბაზანა, შხაპი, bathtub
წარმოებული: ნაერთი, საუკეთესო, გამომდინარეობს
პრიმიტიული: დასაწყისში, საწყისი, ძველი
კალათაში: ბინ, ჩანთა, კალათბურთი
მდივანი: რედაქტორი
ხსნა: უსაფრთხოების, განმათავისუფლებელი, hi, სამაშველო, აღდგენა, ვიღებ
დღეს: 
hodiernalდაძაბული: 
აპირებენ: განკუთვნილი, მიზანი, დაინტერესებული, დიდი, მოტივი, არსურს, დაუთმოს, მიუძღვნის, განსაზღვრა
steam: 
შხამი: შხამიანი, ტოქსიკური, ჰერბიციდი, poisson
ნიჭი: ბრწყინვალების, ნიჭიერი, კვალიფიკაცია, უნარი, რეპერტუარი
ეფექტური: ძალაშია, ეფექტურად, ეფექტური, ეფექტურობა, გავლენიანი, სასარგებლო, აქტიური, ხელმისაწვდომია, შთამბეჭდავი
სარეცხი: სარეცხი
აღიარება: აღიარებს, creed, აღიარება, მიღებას, სარჩელი
სისულელეა: ნაგვის, დაუსაბუთებელი, incongruous
ქვანახშირი: carbon
ვიცე: ასოციაციური, ნახვამდის, მოადგილე
დროებითი: ინტერვალი, ხანგრძლივობა, დროებითი, შემთხვევით, შემთხვევითი, ტაიმერი, ხოლო, თანამედროვე
delimitativeასპექტი: 
ძვლის: ფეხი, მოტეხილობა, ჩონჩხი
monday: 
სამშაბათი: მესამე
ოთხშაბათი: მეოთხე
ფედერალური: ფედერაცია, ცენტრალური
სასურველია: მიმზიდველი, ხელსაყრელი
წარმომადგენელი: წარმოადგენს, სახელით, დელეგატი, ადვოკატი, მოადგილე, პრესსპიკერმა
თეთრეულის: underwear
რადიატორის: კუთხეში, აუზის, თუთია, სინქრონიზაციის
ძმისშვილი: დისშვილი, შვილიშვილი, შვილიშვილი
ალყის: გარს, სავარძელი
კუჭის: მუცლის, მუცლის, matrix
სამიტზე: პიკი, დაბრუნება, წვერი, კონვენციის, ქედის
ექსკლუზიურიპირი: 
წართმევას: დაძლევის, შეუზღუდოს, დაკავება, დაჯავშნა, snatch, ოკუპირებული, დასაკავებლად, საჯარიმოზე, ხელშიჩაგდება, შემოტევით, აღიქვამს, მისაღებად, ამტკიცებენ,, ბურთისფლობადაფიქსირდა
ღობე: hedge
ძეგლი: ქანდაკება
ფუფუნება: 
საარტილერიო: shave
დაკავება: დაჭერა, ხელში, დაკავება, შეიკარი, შეჩერდა, კონცეფცია
პაკეტი: ამანათი, პაკეტი, პაკეტი, გადაიტანოთ, bundle, დახურულია, დახურეს, შესაფუთი, შეფუთვა
მიმდებარე: გარშემო, სამეზობლოში, მეზობელი, მეზობელი, სამეზობლოში, პერიფერიული, შემოგარენში, მიმდებარე, ყოვლისმომცველი, გარემოს, გარემოს
მკაცრად: მკაცრი, თანმიმდევრული, ზუსტად, მჭიდრო, მძიმე, რათქმაუნდა,, სრულიად, ნამდვილად, მჭიდროდ, მკაცრი, დარწმუნებულივარ,, ზუსტად, ზუსტად
დანარჩენი: დანარჩენი, დარჩენილი, გასული, ნარჩენების
ირმის: 
ბუჩქი: 
რკინიგზის: რკინიგზის, სარკინიგზო
გამონადენი: განმათავისუფლებელი, განტვირთავს, გათავისუფლება, დათმოს, განდევნა, გადასცემს
მემკვიდრე: მემკვიდრეობით, ფლობს
მუხა: 
უსიამოვნო: აღფრთოვანებული, სასიამოვნო, მძიმე, აღიზიანებთ, შემაშფოთებელია, nasty, არასასიამოვნო
ფორტეპიანო: 
დაარწმუნოს: დაარწმუნოს, აღსანიშნავად, აღსანიშნავად
უხილავი: საიდუმლო, გაქრება
კარგადცნობილი: ცნობილი, notorious, ცნობილი
სისასტიკით: 
ცდუნება: ცდუნებას
telicასპექტი: 
საერთაშორისო: გლობალური, მრავალეროვნული
ხელსუშლის: ჩარევა, ინტერვენცია, ჩაერიოს, შეუშალოს, გადაიტვირთოთ, შემაშფოთებელი, შეუშალოს, ვაწყენინო, გაღიზიანება, ავიწროვებენ, შეტაკება, შემაშფოთებელი, მიადევნე, არეულობა
დახვეწილი: მიკრო, შეასრულა, craft, დელიკატური, გლუვი, წვრილად, ჯარიმა, წვრილი, ფრთხილი, ნაზი
ფილოსოფოსი: ფილოსოფიური
ელეგანტური: მოდური, დელიკატური, მშვენიერი, შესანიშნავი, აღსანიშნავია, დიდებული, წარმოუდგენელი, ფანტასტიკური, emphatic, ფენომენალური
კეთილდღეობა: კეთილგანწყობა, კეთილდღეობა, დებულება
თევზჭერის: 
იპარავენ: ქურდობა, ძარცვა, ძარცვა, დარტყმა, პლაგიატობის, არასათანადომოპყრობის
ტუჩის: beak, ზეპირი, ზღვარზე
გადადგეს: საპენსიო, გადადგა, პენსიონრებს, უკანდახევა, დანარჩენი, დასვენების, გაიყვანოს, საპენსიო
ეკონომიკა: ეკონომიკური, ეკონომიკურად, ეკონომიკა, რეცესიის, გადარჩენის, საყოფაცხოვრებო, ეკონომისტი
მონაკვეთი: straighten, ვრცელდება, გზების, trait, ცალი, გადასასვლელი, ფრაგმენტი, ბლოკი, სეგმენტი, წილი
პარალელურად: ერთად, თავსებადი, ასოცირებული, აფიქსის, ჰორიზონტალური
atelicასპექტი: 
prohibitiveგანწყობა: prohibitiveგანწყობა
ჰალსტუხი: eagle
კვერცხი: 
ხელოვნური: სინთეზური
შთაგონების: მოტივი, მოტივაცია, იმპულსი, გააჩინოს, გონებრივიიერიში, წახალისება, ინდუქციური, სტიმულირების, სტიმული, მოტივაცია
ამასობაში: ერთდროულად
კრიზისი: საფრთხის, კრიზისის, გადაწყვეტილება, გადაწყვეტილება, სასწრაფო
თავაზიანი: გაცნობითიხასიათის, განათლებული, ეთიკური
ბეჭედი: ბეჭედი, ბეჭდვა, შთაბეჭდილება
ლანჩი: საუზმე, ვახშამი, ranch, კვება, dine
მიუხედავადიმისა,რომ: მიუხედავად, მიუხედავადიმისა,რომ, მიუხედავადიმისა,რომ
ლანდშაფტის: სცენარი, შემოგარენში, გარემოს, კონტექსტში, გარემოს, სოფლის, ბუნებრივი, კალენდარი, ხედვა, პერსპექტივა, მსოფლმხედველობა
მხატვრული: ხელოვნება, ნამუშევრები
ალიანსი: კავშირი, ლიგა, კოალიცია, გაერთიანდება, პარტნიორობა, constellation
მაქსიმალური: მაქსიმალურად, ექსტრემალური, საბოლოო, ყველაზე, მეტი, მეტი, უნდააღემატებოდეს
სასწაული: საინტერესოა
სპილენძის: ბრინჯაოს
სიწმინდეს: კასტინგი, სიზუსტით, ზუსტი
რესპუბლიკა: დემოკრატია
ტელეფონი: ტელეფონი, მობილური
whip: strap
პერანგი: მაისური
დანერგვა: შესავალი, პრეზენტაცია, დაამყაროს, ინიცირება, გაწევა, დებულება, რეკომენდაცია, რეფერალური, მიეცეს, სიტყვით, მიწოდება, ასახავს, წარმოაჩინოს, კონტაქტი, ჩადეთ
sofa: სავარძელში
პერსონალიბარათსგაატარებს: wipe, სკანირების
ქურდი: 
არხი: სანიაღვრე
რეფორმა: გაუმჯობესება, შესწორება, ევოლუცია, ცვლილებებისშეტანის, ცვლილება, დახვეწა, რევიზია, განახლება
წყურვილი: მწყურვალი
საშიში: საფრთხე, ემუქრება, საშიში
palm: 
წაახალისოს: წახალისება, გააჩინოს, დისკზე, ბიძგი, ხელიშეუწყოს, სტიმული, მოვუწოდებ, გულშემატკივრობენ
სპიკერი: პრესსპიკერმა, ლექტორი
ბარიერი: შესასვლელი, მიღებას
გამოიწვიოს: ლობის, მოვუწოდებ, მიზეზი, გავაფრთხილო, excite, უქმნის, ცდუნებას, რეზონანსი, soak, გამომდინარეობს, ინდუქციური, აფიქსის
neat: tidy, სუფთა, კარგი, მშვენიერი, ლამაზი, ლამაზად, ლამაზად
სხდომაზე: შეხვედრის, კონფერენცია, სემესტრის
წამების: დაავადებული, ტანჯვას, ძალადობა, თაროს, მრჩეველი
ნესტიან: dirt, სველი, muggy
მგზავრის: სტუმარი, მგზავრის, ტურისტული, სამგზავრო, მოგზაურობა, მოგზაურობა
mill: ქარხანა, წარმოების, ქარხანა, faucet, ლუდსახარში, ხორბლის
რუკა: ანკეტა, სქემა, გრაფაში, მგზავრობის, ბილეთის, სიმბოლო, ხატი, ხელმძღვანელობა
შადრევანი: წყარო, ჩანჩქერი, ფრაქცია
საყელო: გარს, ზონა
შეცვლის: ჩანაცვლება, გადაადგილებულ, სათადარიგო, ალტერნატიული, შემცვლელი, ცვლილება, გადაადგილების, შეცვალოს, იცვლება, ცვლილებებისშეტანის, ქვე, ცვლილებები, შეცვლა, გაათავისუფლოს, მოერგოს, აუნაზღაუროს
განზრახ: განზრახ, მიზანმიმართული, იცის, შეგნებული, purposive, შემთხვევითი
ლუდი: pint
velvet: 
დადებითად: დადებითი, აქტიურად, ემხრობა, ემხრობა, მთლიანად, სრულიად
სიმძიმის: მოზიდვას, crush, სერიოზულად
ქადაგების: ქადაგების, დისკურსი, ლექცია
პარტნიორი: თანამემამულე, ასოცირებული, მეგობარი, მეგობრის, წყვილი, mate, საერთო, ერთობლივი, აქციონერი, კოლეგა, მეუღლე
ბოროტად: ცდება, არასწორად, რა
ფარა: ჯგუფი, ნახირი, Swarm, ბიზნესმენ
ცამეტი: ოცდაათი
ამართლებს: ორდერი, თავს, ადვოკატი, გამართლება, გამართლებული, ლეგიტიმური, შეცვალოს
ხელნაწერი: კანონპროექტი, script, მოსარჩელე
პარასკევი: ვერცხლის, venus
ფუნჯი: სავარცხელი
ჩამოტვირთვა: ატვირთეთ
კრემი: ნაყინი
monster: giant, ამაზრზენი
გაყინული: გაყინვას
ბანკში: პან, ვაზა, jar, კონტეინერი, გაზქურის, pat, გემის
ბრინჯი: 
ქცევა: ქცევა, ქცევითი, ხასიათი, ჩვევა, დამახასიათებელი, ტენდენცია, ქცევის
მონეტა: ვალუტა, penny
შემოსავლების: შემოსავალი
ამტკიცებენ,: ხმამაღალი, thrust, ამტკიცებენ,, ხაზიგავუსვა, ხაზსვუსვამთ, არსებობს, დაჟინებული, მოითხოვს, ყურადღება, წევის, ხაზიგაუსვა,, ამტკიცებენ,, ამბობენ,
ნახტომი: 
apple: ბოდიშისმოხდა, ბოდიშს
განიხილავენ: დისკუსია, მოლაპარაკება, ამტკიცებენ,, hash, განხილვა
ფონზე: 
ტრანსკრიფციას: მოერგოს, ხელმეორე, სიმულაცია
გასართობი: დასვენება, მუშაკი, დასვენების, გასართობი, გასართობად, გართობა, ჰობი, დასვენების, amuse, სტუმართმოყვარეობის
ვირუსი: 
ბავშვური: soprano
robe: სამოსელი, dress, gown, უნიფორმა, outfit, კარადები
ასახავს: დაფიქრების, მედიტაცია, meditate, გამოვლენა, პროექტირება, ასახავს
დააკონვერტიროთ: შეცვალოს, გარდაქმნის, შეცვლა, მუტაციას, გარდამავალი, ტრანსფორმაციის
განტოტვილი: ნახვა, კონტური, შემაჯამებელი, ესკიზის, გამოვლენა, მიმოხილვა, პროექტი
ოპერა: 
elbow: bracket
დანართი: დანართი, კავშირი, patch, ბმული, კონექტორი
სარემონტო: აღდგენა, გაუმჯობესება, აღდგენა, შესწორება, ცვლილებებისშეტანის, ცვლილება
პირველი: punch, ძალაუფლება
საეჭვო: ეჭვი, ეჭვმიტანილი
წმინდაწერილი: ბიბლია, შრიფტი, script
pit: ხვრელი, გათხრები, აუზი, ditch, ბორის
არეულობის: ქაოსი, ანარქია, არეულობა, არეულობა, სასადილო, შემაშფოთებელია, ჩარევა, ბრალია, დაბრკოლება
ტაში: clap, მივესალმებით, დამტკიცების
ორობითი: ორადგილიანი
abbey: მონასტერი
arrow: 
როგორცწესი,: პასუხისმგებელი, როგორცწესი,, ჩვეულებრივ, ორიენტაცია, უამრავი, შედგება, დავიცვათ, ტენდენცია
შეიმუშაოს: დეტალური, განსაზღვროს, განმარტავს, განვითარება, რთული, სახიფათო, ვარჯიში
ერთგულება: ერთგული, ერთგული, ნდობის, ერთგულად, პატიოსნად, უნდობლობა, სანდოობის, რწმენა, რწმენა
კანკალს: კანკალი, ვიბრაცია
დევნილობაში: სროლა, საზღვარგარეთ, თავშესაფარი
მექანიკური: მანქანა, მექანიკოსი, მექანიკის, ინჟინერი
წარმატებით: ლამაზად, წარმატების, წარუმატებელი, შედეგი
ხაფანგში: ძალაუფლება, მსჯავრდებული
ტორტი: საკონდიტრო, ტორტი, cookie, ცომი
sir: ბატონი, mister, lord, ჯენტლმენი
მოგერიდებათ: ყოყმანის, დაარტყა, ასვენებს, სიხშირე, hover
ჩვიდმეტი: 
ქალის: ქალის, ქალი, lady, დელიკატური
თაფლი: 
აქციების: ფსონი, წილი, pile, წილი, ფრაქცია, წვლილი, აზარტული, აქციონერი
აგურის: კრამიტი
ლეგენდა: მითი
მოსავალი: მოსავლის, კულტურების
ღუმელი: გაზქურის, slab, ღუმელი, ბუხრით
მეამბოხე: აჯანყება, აჯანყება, გადატრიალების
მოძველებული: ძველი
swell: იბერება, ადიდებულმა, ინფლაციის, შეშუპება, გასადიდებლად
გაუმჯობესება: დააყენებს, აძლიერებს, დაფიქსირება, საშუალება, სამკურნალო, მოშუშებისა, გაუმჯობესება, რჩეულებში, რჩეულებში, ტირაჟირება
თასი: 
სახლიდან: დაფიქსირება, მზერა
სამრეწველო: წარმოების, ინდუსტრიალიზაცია, მრეწველობა
გასახდელი: სოუსი, bandage
თემა: თემის, მოტივი, სათაური, პრობლემა, მოტივი
ასკეტური: 
მენეჯერი: steward, მთავარი, ქურდი, ადმინისტრატორი, რეჟისორი, მოდერატორი, ლიდერი, აღმასრულებელი
drag: მიაპყროს, გაიყვანოს, haul, გაიყვანოს, გაუქმება, მაკრატელი, წევის, უჯრა, ნარკოტიკების
გუნდი: დისკზე
რაციონალური: გამართლებული, ლოგიკა, ლოგიკური, დაუსაბუთებელი, საღადმოაზროვნე, გონივრულად, გონივრული, აშკარა
დამუშავება: რედაქტირება, პროცესორი, პროცესი, პროცესები, პროცედურა
wolf: 
ხალიჩა: rug
ანტიკურ: ძველი, ეპოქაში
ნაყოფიერი: ფურიეს
ისთვის: ფლეიტა
ყველი: 
bite: chop, გაიყო, sting, ლუკმა, sip, ზიანი, აღკვეთა
ტაძარი: 
wander: გასეირნება, მიგრაცია, ლაშქრობა, გამგზავრება, დამახინჯება
მუქილურჯი: საზღვაო, ფლოტი
ნიღაბი: ფასადი, worm
ფანქარი: კალამი
ბოსტნეულის: ვეგეტარიანული
შარვალი: შარვლის, შარვალი
კორუფცია: სკანდალი, დაბინძურების
კაბინეტი: კარადა, კარადა, კარადები, ტუალეტის
წვნიანი: 
ქირურგი: ოპერაცია, ქირურგიული, ოპერაცია, ანალიტიკოსი
შემწეობა: ჩანაცვლება, შემცვლელი, კომპენსაციის, apposition, გამოყოფა, დანართი
spy: აღიქვამს
უგუნური: უყურადღებოდ, untidy, გულგრილობა, დაუსაბუთებელი
gossip: ჭორები, ჭორები, სტატისტიკა
სისტემები: სისტემაში
ნიშანი: 
აბსტრაქტული: შემაჯამებელი, სასწავლოპროგრამა
აქცენტი: შეხედულებებსა, გამოთქმა, დიალექტი, ყურადღება
გულწრფელად: პატიოსნად, სერიოზულად, გულწრფელი, ერთგულად
დაამტკიცებს: მიღება, უფლებას, დამტკიცების, ადასტურებენ, დაადასტუროს, თანხმობის, დამტკიცების, ადასტურებს, მიიღოს, გასცეს, ხელსაყრელი, სანქცია
არქიტექტურა: სტრუქტურა, მშენებლობა, ტექსტურა
crack: crevice, დაბზარული, გამგზავრება, დატოვა, მოტეხილობა
საფარის: ასალაგმად, მოედანზე, slime, ტროტუარი, walkway, შეფუთვა
გადამწყვეტი: გადამწყვეტი, სასიცოცხლო, განსაზღვრავს, გადაწყვიტოს, აგრესიული, მივანიჭოთ, დააკონკრეტა, საბოლოო, კრიტიკული, გადატრიალების
უარყოფითი: უარყოფითი, უარყოფა, უარყოფა, უარყოფს
ფესტივალი: კონცერტი, ნათლისღების, დღესასწაული
ღალატის: 
hunter: predator
snake: ქვეწარმავალი
ბატარეის: 
დეტექტივი: გამოქვითვა, გამომძიებელი
swim: საცურაო
კონვერტში: გარემოება,, ზმნიზედა
სიგარეტის: მოწევა, weed
საავტომობილო: საავტომობილო, ძრავის, მოტივი, motorbike, მოტოციკლი
მოხალისე: მიუძღვნის, ნებაყოფლობითი, საქველმოქმედო
რეაქცია: რეაქტიული, პასუხი, რეაგირება, რეაგირება, კავშირი, ექსპოზიცია, reactor
ბარგის: ბარგის, სატვირთო, მაგისტრალური, ჩემოდანი, ლოგისტიკური
ყრუ: 
წვენი: ამონაწერი
სექსუალური: sex, სექსუალობა
diamond: gem
echo: 
პირადობის: იდენტიფიცირება, საიდენტიფიკაციო, სიმბოლური, გაცნობა, იდენტიფიცირებადი, აღიარება
ელჩი: მომხმარებლები, დიპლომატი, ცვლის
lazy: ცუდი
momentaneასპექტი: 
drift: ოპერაცია, deflection, ტენდენცია, ტენდენცია, შემოვა, პოზიცია
მოჩვენებით: ლამაზი, წარმოიდგინეთ,, ფანტაზია, მხატვრულილიტერატურა, ფანტაზია, სუბიექტური
ray: სხივი, aisle, რადიუსი, ფონდი
ასვლა: მოიმატებს, ქარხანა, sow, ასვლა, creep
მელნის: ტონერი
სამახსოვრო: ცნობილი
ხმაურიანი: ხმაური, shout, ხმამაღალი, ხმამაღლა
სენატის: პარლამენტის
ტრანსპორტი: ვაგონი, სატრანსპორტო, haul, საგზაო, სამარშრუტო, გადაცემა, მეტაფორა, ჩატარების
კუბოში: გზების
მერცხალი: sip, ბევრი
indulge: განაგრძოს, დაკმაყოფილება, ითვალისწინებდეს, embed, განათავსოს
სასოფლო-სამეურნეო: სოფლისმეურნეობის, მეურნეობის, ფერმა
swing: 
მინდვრის: საძოვრების, წინასწარ, გაზონის
კომპლექსი: რთული, გაართულებს, დახვეწილი, ნაერთი, სახიფათო
გადადგომის: გადადგეს, საპენსიო, უკან, უკანდახევა, დატოვა
თავმდაბალირეგისტრაცია: 
წიწაკა: 
pony: 
კანდიდატი: განმცხადებელი, პერსპექტიული, გაწვევის
fox: 
chimney: ბუხრით, დასტის
იურისდიქცია: უფლებამოსილება, გადაწყვეტილება, გადაწყვეტილება, კომპეტენციის
ყოფილიგარდაცვლილი: 
დემოკრატიული: დემოკრატია
საბანი: ჭერი, საფარის, rug, დაფარვის
ღორის: sow
სპილოს: elephant
მსუბუქი: მწერალი
დამკვირვებელი: ხელმძღვანელი, სტუმარი, ინსპექტორი
ფრჩხილების: nail, claw
bee: 
მსახიობი: მსახიობი, შემსრულებელი, მოსარჩელე
ოფლი: სტიჩი
polish: დიალექტი, shine
ილუზია: თაღლითობის
გაურკვევლობა: გაურკვეველი, გაურკვევლობა
საშუალო: მცირე
სოფლის: პროვინციის, სოფლის, სოფლისმკვიდრი
მიმოქცევაში: loop, cycling, ციკლური, გავრცელების, გავრცელების, წრე, ციკლი, სიხშირე, როტაცია, როტაცია, საგზაო, დასათვალიერებლად, ჩატარების
groan: 
ჰგავს: მსგავსი, მსგავსება, შეგახსენებთ,, შესაბამისი, მოსწონს
პასუხის: ამონაწერი, ციტატა, unquote, სარგებლის, სესხის, სესხის, ცნობისთვის, ხარჯთაღრიცხვა, მოჰყავთ
ტომარა: გადააყენოს, გათავისუფლების, ჩანთა
გაღიზიანებას: არეულობა, ჩარევა, შეწყდეს, გაჭირვება, უსაქმურობის, გადაიტვირთოთ, ხმაური, შემაშფოთებელი
ნემსი: ინექცია, pin, მაჩვენებელი
კონტროლირებადი: კონტროლის
ბარიერი: შეზღუდვა, შეზღუდვა, შეზღუდული, აკრძალვა, აიკრძალოს, დაბრკოლება, ბლოკი, შეწყდეს, ქმედითუნარიანობა, შეუშალოს
იმედი: იმედი, მიაჩნიათ, დამოკიდებული, ნდობის, გარანტია, დაყრდნობა, დამოკიდებული, დამოკიდებულება
ქათამი: ქათამი
ბარელზე: bucket
მუდმივიასპექტი: 
ექსპერტი: სპეციალისტი, გამოცდილი, სპეციალური, კონკრეტული, სპეციალიზაცია
შთაბეჭდილება: იმოქმედებს, შთაბეჭდილება, მოზიდვა, დიდიშთაბეჭდილებამოახდინა
van: სარქველი
nod: nap
განმარტება: კომენტარი, საიდენტიფიკაციო, აღწერა, განსაზღვრა, კონტექსტში, სამართალი
დაბადებისდღე: წლისთავი
hammer: 
სურნელოვანი: სუნამო
ტრივიალური: წვრილმანი, უმნიშვნელო, მცირე, მარგინალური
გათხრები: გათხრები, საბურღი, გათხრები
ცხოველები: არსი, foster
თავისქალა: 
საკანონმდებლო: პარლამენტის, კანონმდებლობა, საკანონმდებლო
heel: ნახტომი, ტერფის
frown: 
პატენტის: ლიცენზიის, ლიცენზიის
მილიარდი: 
ქიმიური: ქიმიის, ქიმიკატების, ქიმიკოსი, ქიმიოთერაპიის
პულსი: იმპულსი, მაჯის, იმპულსი, მაქმანი
პილოტი: ექსპერიმენტი, ექსპერიმენტული, მძღოლი
კვანძი: ერთიანად, კვანძის, გამართავს, ხელშეკრულების, დავასკვნათ,, ათიწლისგანმავლობაში, იქსოვებოდა, junction, ნედლეული, ნედლი, შეუზღუდავად
skirt: როკ
დეპრესია: რეცესიის, კრიზისის, მწუხარება, მწუხარება, მწუხარებას, დეპრესიაში, სტრესი
ტექნიკური: ტექნიკა, ტექნიკა, ტექნიკურად, tech, მოწინავე
მანქანა: დისკზე, მანქანის, კალათა, საშუალება, საავტომობილო
სფერო: გაფართოება, domain, სფეროში, დიაპაზონი, მიღწევა, იმდენად,რამდენადაც
მცენარეული: ქარხანა
sunrise: 
ხელიშეუწყოს: წვლილი, დავეხმაროთ, პარტნიორობა
hook: დაკავშირებული, დაკავშირება, კორელაციურ, bracket
tiger: 
ყდის: arm, საცალო
გზატკეცილზე: გზა
მილიციის: 
მთლიანობის: კონცენტრაცია
გამჭვირვალე: გამჭვირვალობა, ნათელი, აშკარად, აშკარაა,, აშკარაა,, აშკარად, გაურკვეველია, გამოკვეთილ, პირდაპირი
ცხრამეტი: 
იმედი: იმედი, საერთო, გაანგარიშება, გამოთვლები
კვალიფიციური: უფლება, კვალიფიკაცია, შეუძლია, დამსახურებაა, იმსახურებს, კვალიფიკაციას, გამოცდილი, კომპეტენტური, ძალაშია, კომპეტენციის
ორგანული: წიაღისეული, აუცილებელია
თეოლოგია: 
float: ნავი, hover, ფლოტი
witch: 
სტუდია: ეტიკეტების, სემინარი, სასწავლო
შამპანური: 
ბანერი: დროშა, ვებ, ბილეთის
გაყრა: დაშორდნენ
bolt: lightning, nail, ირონია, screw
ვენაში: ნერვის
პასიური: აუდიტორია, შეზღუდულიშესაძლებლობებისმქონე
ხრეში: საერთო
პლანეტის: პირველადი, constellation
თაროზე: თაროს, კარადა
fan: 
ტროპიკული: ვნებიანი
ფაზა: ფოტო, ეტაპი, ვადა, მშენებლობა, ნაბიჯი
თვითნებური: სპონტანური, სურვილისამებრ, ხელშეკრულება, შეთანხმება, უკონტროლო
ექსტაზი: trance, ენთუზიაზმი, სიამოვნებით, ბედნიერება
mercury: ტემპერატურა
თვითმკვლელობა: 
რეპორტიორი: ჟურნალისტი
ართმევს: აღკვეთა, გაუქმება, გამორიცხავს, სხვაობა, უარყოფს, ძარცვა
აივნით: ტერასა, სხვენით
ჩანგალი: ხალხური
თანამშრომელი: მუშაკი, მუშა, სამუშაო, ფაქტორი, დამოკიდებული, კლერკი, პერსონალის, შრომის, შრომის, თანამშრომლები
დამსაქმებელი: ქურდი, landlord, მფლობელი
სიგანე: ფართოდ, მიწოდება, ფართო, ნახევრად
ფიცს: 
გაღიზიანებული: აღიზიანებთ, აღფრთოვანებული, გაღიზიანება, პროვოცირებას, სტიმულირების, შეწუხებული, სტიმული, სტიმულირება, სტიმული, მოტივაცია
კლასიკური: კლასიკური, ოპტიმალური
monkey: შიმპანზე
მისაღები: მიიღოს, მიღების, დამაჯერებელი
ხელმოწერა: 
მომღერალი: მკითხველს
მართლმადიდებელი: კონსერვატიული, ჩვეულებრივი, ტრადიციული
სანერგე: პლანტაცია
მიღების: დასაქმება, მიღება, მიღების, ვარაუდი, დამტკიცების, პარტიის, მიღება, მიღებას, lap, კვანტური
თავშეკავებით: ყოყმანის, dislike
იმპორტი: შესავალი, შემოსავალი
ლამპარი: 
გრამატიკა: გრამატიკული
ანაბარი: დაგროვება
კოლონიური: ემიგრანტი
yacht: საბორნე, ნავი
დააშინოს: საფრთხესთან, დაშინება, შეკავება, სიგნალიზაცია, შეაშფოთა, ასვენებს
შედეგობრივ: შედეგი, ეპიზოდი, მნიშვნელოვანი, მნიშვნელოვანი, წამყვანი, ცნობილი, მნიშვნელოვნად, მნიშვნელოვანი, მნიშვნელოვანი, მნიშვნელოვანი, არაპირდაპირი
გადაშენდა: დაკარგული, გაქრება, მკვდარი
გუმბათი: 
სისქე: 
ჯიუტი: აგრესიული
muscle: 
მასშტაბები: ზომა, ნაყარი, amplitude, წვრილი, რაოდენობა, ინტენსივობის
რუბლსშეადგენს: 
სადღეგრძელო: snack
მაუსი: rat
syllable: შრიფტი, ანბანი
ნეიტრალური: neuter, სამართლიანი, საერო
აღმოაჩინოს: შეაფასოს, საიდენტიფიკაციო, აღიარებს, იდენტიფიცირება, გამოვლენის, განთავსდება, ვიღებ, მოვძებნოთ
აყვავება: კეთილდღეობა, განვითარებისათვის, boom, ძვირფასიქვა, gem, ყვავილების
დააწესოს: ძალა, აღასრულოს, განსაზღვრავს
ანონიმური: 
ფორმალურირეგისტრაცია: 
ხბო: ჩქარობს
სახელმძღვანელო: უხელმძღვანელებს, გეგმა, სახელმძღვანელო, ბროშურა, ბრენდი, ხელმძღვანელობა, სახელმძღვანელო, ინსტრუქცია, ლიდერი, ხელმძღვანელი, დოკუმენტი, დოკუმენტაცია, ოპერაცია, წარმოების
მოლოდინში: მოსალოდნელი, პერსპექტიული, ველით, მოლოდინი, მოსალოდნელია,, პროგნოზი, პროგნოზირება, პროგნოზი, დებულება
melt: ორთქლდება, დათბობა, fusion, გაერთიანდეს, ხსნადი
ქოლგა: parachute, სოკო
boot: ფეხსაცმლის, მაგისტრალური
მინერალური: იოდის, საკვები, რკინის, მანგანუმის
ზავი: ცეცხლისშეწყვეტისშესახებ
duck: 
საპნის: 
თოჯინა: ბავშვი, სათამაშო
ვილა: ლურჯი, lodge
სამკერვალო: სტიჩი, sew
შერიგება: შუამავლისროლი, გაერთიანდეს, გააერთიანებს, შეცვალოს, რეგულირება
kettle: 
კურდღელი: 
დირიჟორი: ასვლა, ზედამხედველი, მძღოლი, ლიდერი
მოთამაშე: შემსრულებელი
insect: მავნებლის, worm, bug
რესტორანი: 
რადიკალური: სამხედრო, ექსტრემისტული, პროგრესული, რევოლუციური, ექსტრემალური, მთელი, მთელი, მთელი, აბსოლუტური, ინტეგრაცია
რეზიდენტი: მკვიდრი, შექმნილი, შიდა, ძირძველი, tenant, საცხოვრებელი
dragon: kite
აუდიტორიამტკიცებულების: 
linger: გახანგრძლივება
სახურავი: საფარის, cap, deck, სარქველი
მერი: ბაზარზე
ტექნიკა: მასალა
შემოქმედებითი: 
უმცირესობის: რამდენიმე, ათობითი
ორმოს: ditch, გათხრები
ორკესტრი: 
ბეკონი: 
დევნა: სისხლისსამართლებრივიდევნის, შემთხვევაში, სარჩელი, სამართალწარმოება, დევნა, სარჩელი, მოსარჩელე
მინუსი: დაკარგვა, აღკვეთა, უარყოფითი, ხარვეზის, ქმედითუნარიანობა, სირთულის
ქსოვილი: ქსოვილი, ტანსაცმელი, პირსახოცი, ტილო, ქსოვილის, რელიეფის, სტრუქტურა
მუსიკოსი: კომპოზიტორი, მუსიკალური
გონებრივად: სულიერი, ფსიქიკური, მორალი, mana, სუბიექტური, ფსიქოლოგიური, შემეცნებითი, ფსიქიატრიული
არასათანადო: ცდება, მიუღებელია, ყალბი, incongruous, მოსალოდნელი, უკანონო, არაადეკვატური, შეუსაბამო, უსამართლო
არქიტექტორი: 
ოთხ: 
lemon: 
ხველა: ხველების
ნაყოფიერების: რეპროდუქცია, ჯიშის, გენიტალური
შემთხვევითი: შემთხვევით, randomize, შემთხვევითი, შემთხვევით, სპონტანური, სტოქასტური
კოვზი: bucket
დღიური: ყოველდღიური, გაზეთი, ჟურნალი, კალენდარი
balloon: 
ახსნითიმტკიცებულების: 
გამომცემელი: რედაქტორი, გამომცემლობა
ნაცარი: ნაცრისფერი, ნაცრისფერი
expletive: გინება
აღორძინება: აღორძინების
მგრძნობიარე: სოციალურადდაუცველი, მგრძნობიარე, საღადმოაზროვნე, ემოციური, პასუხისმგებელი
გვირაბი: მეტრო
თავსატეხი: აღრეული, გაუგებარია
მექანიზმი: პროცედურა, რუტინული, სისტემური, მანქანა, აპარატურა, მიდგომა, პოლიტიკა
მათემატიკის: მათემატიკა, მათემატიკის, infinity
fade: 
დაბალანსებული: თანაფარდობა, კორელაცია, წილი, თანმიმდევრული, მდგრადი
sublativeშემთხვევაში: 
dip: dive, embed, ვარდნა, სარეცხის, სიხშირე, ფერდობზე, incline, გრადიენტი, soak, შემცირება, კრიზისის, ირიბი
ერთეულის: ერთიანობის, პირი, მოდული, beak, სინგულარული
მონოპოლია: ექსკლუზიური
სათამაშო: აზარტული, თამაში, მატჩი, კლირენსი, ვაჭრობა
წყალქვეშა: 
მიუხედავადიმისა,: 
მიწისძვრის: convulsion
ლაბორატორიული: ლაბორატორია
კომენტარები: კომენტარისდამატება, შენიშვნა, კომენტარი, პასუხი
გაიაროს: გაივლის, გამოცდილი, მიიღოს
თვითმმართველობისკონტროლის: 
საელჩოს: 
თავმჯდომარე: თავმჯდომარე, პრეზიდენტი
გამოგონება: გამოგონება
დეკლარაციულიგანწყობა: 
ხელთათმანი: 
დაჩოქება: 
გეოგრაფია: 
საინვესტიციო: ინვესტირებას, საწარმოს
ანალოგია: თანასწორობა, მსგავსება, affinity, ნათესაობის, თანაფარდობა
hawk: eagle, hack
ფსიქოლოგია: ფსიქოლოგიური, ფსიქოლოგიური
ჯართი: გაუქმება, ნაგვის, ნაგვის, ფრაგმენტი, Fling, hurl
მეკობრე: hacker
როლი: წილი, საფონდო, მონაწილე, შესავალი, ხასიათი, პოზიცია
დოზა: რაოდენობა, დიეტა, განაყოფის, რაციონი
ორაგული: 
pudding: დესერტი
მაგნიტური: მიმზიდველი, თავს
ტუმბოს: ბომბი, ვაკუუმი
ჟანგბადის: 
fringe: ზღვარზე, ზღვარზე, მარგინალური, ზღვარი, პერიფერიული, სასაზღვრო, საზღვრის
სერტიფიკატი: დადასტურება
მედალი: 
რიტორიკა: 
საფეხური: stair, tread, ნაბიჯი
scrape: ნულიდან, graze, შეურაცხყოფა
შესვლა: შეჭრა, შესვლა
ტელესკოპი: მიკროსკოპი
ყელსაბამი: დამარცხება, პასტა, ჯაჭვი
ორთოგრაფიული: სიტყვიერად
surf: 
ვისკი: 
camel: 
amateur: 
ზრდასრული: mature, ასაკი, ასაკის
ბიოგრაფია: ელექტროენერგიის
ვირი: 
პერსპექტივა: მსოფლმხედველობა
პრო: პროფესიული, დადებითი, ადაპტური
ყოველთვიური: ჟურნალი
დასვენება: დატოვოს, დღესასწაული, დანარჩენი
click: ხროვა, ვადამდელი, დაარტყა
ოვალური: 
ელასტიური: რეზინის, მოქნილი
ლექსიკონი: ლექსიკური, ლექსიკა, წინასწარ
დანაყოფი: გათიშე, სამმართველოს, ავარია, შესვენებისქვემოთ, იმედი, ნაწილების, განყოფილებაში, ფრაგმენტი, კომპონენტი, კომპონენტები
ham: ბარძაყის
ცისარტყელა: 
ორგანიზმის: არსება, შექმნა
spit: mate, ენა
outlet: გასასვლელი, socket, გამომავალი, გამგზავრების, ძალაუფლება, slot
სატანკო: წყალსაცავი, კონტეინერი, დღგ
პეპელა: 
გრაფიკი: სქემა, გრაფაში, გრაფიკული, გრაფიკა, სქემა, კატალოგი, კატალოგი
ტყუპი: ორმაგი, ორმაგი, რამდენიმე, წყვილი
შეურაცხმყოფელი: შეურაცხყოფად, რი, დანაშაული,, შეურაცხყოფა, დანაშაული, სიტყვიერი, შეურაცხმყოფელი
დამოუკიდებლად: დამოუკიდებელი, თავისუფლად, გარდა, თავისუფლად, ცალ-ცალკე
marsh: 
კოშმარი: ოცნება
jam: რძე, შეკუმშოს
მსმენელი: მოვუსმინოთ
მუზეუმი: 
სტაბილურობა: სტაბილიზაციას
გამჟღავნება: აცხადებს, გამოვლენა, გამოვლენის, გამოვლენა, გაუქმება, აქვეყნებს, აღმოჩენა, გარჩევა, აშკარა
აგრესიული: შეუშალოს, სასადილო, საოკუპაციო, აგრესია, შეურაცხმყოფელი, ბომბდამშენი
ხახუნის: დაპირისპირება
მონაწილეობა: დასწრება, მონაწილეობა, ჩართვა
პიერ: გზა
spider: fisher
კარტოფილის: 
maker: მწარმოებელი, მწარმოებელი, მომზადება, წარმოება, წარმოების
გაუმაძღრობით: შიმშილი, მადას
ნაადრევი: დასაწყისში
გამრავლების: მოხვდა, ჯიშის, გამრავლება, ორმაგი
სტატისტიკა: სტატისტიკური, ფიგურა, სტატისტიკა
ნომინაციაში: დაასახელოს, დანიშვნის, შერჩევა, ჩართულობის
ტრილიონი: 
სასარგებლოდგანწყობა: 
პროგრამები: აპლიკაცია, პროცესები, ვრცელდება, პროგრამა
ნომინალური: graze, მითითებული, par
უკმაყოფილება: 
ინფექციის: დაავადების, ინფიცირებული, გარდამავალი, გადაცემა, ინფექციური
გაკვირვებით: twitch
ფეხბურთი: საფეხბურთო, kick, კალციუმის
pioneer: მთავარი, ავანგარდული
პათოლოგიური: უჩვეულო, უჩვეულოდ, crackpot, საგანგებო, გაზვიადებულია, ფენომენალური, იდეალური, სინგულარული
უმოქმედობის: ძირითადად, gaffe, დეფიციტი, გულგრილობა, უყურადღებობა, აღმოფხვრა
squeeze: ხალხმრავალ, ბიძგი, knead, შემცირება, thrust, ზეწოლა, crush, შემოტევით, ძალაუფლება
პროცენტული: cent, პროცენტი
idiophone: 
ბერკეტი: 
გაყვანის: დაბრუნების, რეგრესია, უკანდახევა, socket, გაწვევას, დასკვნა, დასკვნა, გამომავალი, გავლენა, გაიყვანოს, სულ
სენატორი: 
ant: 
ორსული: დედათა, დაორსულდა
ყოველდღე: ყოველდღიური
პროვოცირება: ნალექების, ნალექი, სიჩქარე, სასწრაფო, დააჩქაროს
ცვლადი: იცვლება, ცვლადები, გლობალური, მობილური
ხვეული: curl, hurl, გადახვევა, helix
გოგირდის: გოგირდის, გატეხილი
კონტინენტურ: კონტინენტზე
უკარნახოს: ინსტრუქცია, ბრძანება
frog: 
გადაჭარბებულიშემთხვევაში: 
grind: ნახევარი, ნახევრად
irrealisგანწყობა: 
შენობაში: შიდა, დაწვრილებით, ფარგლებში
გამოყენებისათვის: გამოიყენოს, აღიქვას, მიღწევა, შეისწავლონ, ძარცვა, შთანთქმის
გეოლოგიური: მიწისქვეშა
პასპორტი: 
ამორალური: მანკიერი, ცუდი
ორცხობილა: cookie
თანამშრომლობა: ითანამშრომლოს, პარტნიორობა, ინტეგრაციის, დახმარება, წვლილი
გაყალბებას: გააკეთოს, სრული, ფორმირება, შექმნა, დაკომპლექტებას, გენერირება, გააყალბოს, font, იმეორებს
atom: ატომური, ნაწილაკების, ინდივიდუალური
შიდსის: დახმარება, რელიეფის
fastidious: დელიკატური, შემაშფოთებელი
პირამიდის: 
უკანონო: უკანონო, არასამთავრობო
shyness: მორცხვი, კლება
არფაზე: ირიბი
ასტრონომიის: 
maze: გაურკვევლობა
სტიპენდია: სპონსორობის, ჯილდო
ბოჭკოვანი: ბოჭკოვანი, bundle, შეუზღუდავად
cricket: 
მტრედი: 
ადაპტაციის: მოერგოს, საშუალებები, შესაბამისად, მოდიფიკაცია, შეცვალოს, ოპტიმიზაცია, ადაპტური, განსახლების
უკმაყოფილების: იწუნებენ, მიუღებელია, ოპოზიციის, განსხვავებით, საპროტესტო, counter, მოწინააღმდეგე, დაპირისპირებული, უარი, კვალი, უარყოფენ, გადააყენოს, ვეტო, შეურაცხყოფა, პედაგოგი, ვეთანხმები, არვეთანხმები
ოპერატორი: გადამზიდავი
სამკუთხედის: 
ხაზინადარი: მოლარე
წყალბადის: 
პრინტერი: 
choke: ცარცი
ქრონიკული: მდგრადი, სერიოზული, მძიმე, დიდად, ექსტრემალური, მწვავე, გააძლიეროს
გაუმკლავდეს: ნაცნობობა, მოერგოს, დაუპირისპირდეს, ოფსეტური, გადავლახოთ, დაძლევის, კონტრასტული, გარიგება, ზემოაღნიშნულიდან
დილემა: დაბნეული, გაუგებარია
სიმპტომია: მითითებით, შეთავაზება, ჩვენება, გამოფენა, პრეზენტაცია, მოვლენაა, დიაგნოსტიკური, სინდრომი, დამახასიათებელი
ველოსიპედი: bike, cycling, ციკლი, ride
საინჟინრო: ტექნიკა, ტექნიკურად, მექანიკის
spiral: helix, დატრიალება
კამერა: პალატა
მოცეკვავე: 
მიგრაციის: მიგრაცია, საიმიგრაციო
ჩოგბურთის: 
ნარკომანი: დამოკიდებული, დამოკიდებულება, დაყრდნობა, მონა
weave: ლენტები, იქსოვებოდა, ქსოვა, ქსოვილის, ტექსტურა
ხერხემლის: 
fry: boil
ხელიშეუწყოს: ხელიშეუწყოს, სტიმულირების, აჩქარება, foster, განმუხტვის, გაამარტივებს, დაწესებულებაში, სასარგებლო, გაათავისუფლოს
stab: sting, pierce, ხელშიჩაგდება, მცდელობა, სცადა
დაგავიწყდათ: სიგნალი, cue, სლოგანი, ჩემი, კოდი
ნახევარსფეროში: აღნიშნა, წვერი
სამწუხარო: გულდასაწყვეტია, დეპრესიაში, დაუკარგავს, მწუხარება, პროვოცირებას
სტრატეგია: სტრატეგიული, სტრატეგია, პოლიტიკა
საპატრულო: პერიოდული, ბენზინი
მყინვარი: 
შუა: ნახევარი, ნაწილობრივ, ნახევრად
მემორანდუმი: ხელშეკრულება, ხელშეკრულების, კონვენციის, შეთანხმება, ორდერი, წარმომადგენლობა
cone: 
სიმეტრია: 
მოპასუხე: ადვოკატი, დაპირისპირებული
mosque: 
გამონაბოლქვი: ემისიის, აგდებს
ჭადრაკი: 
nucleus: ბირთვული, მობილური, არსი, ძირითადი, ცენტრალური, ემბრიონის, ნაყოფის, kernel, ნივთიერება
cherry: 
stumble: სარეცხის
სატვირთო: სატვირთო, სატვირთო, სიმღერა
უკაბელო: რადიო
აუქციონზე: იყიდება
sieve: გამართვის
ცვალებადი: არასტაბილური, არასტაბილურობა, გაურკვეველი, მძიმე, დაუღალავი
ლევანგაჩეჩილაძე: აღიქვას, soak
არამეგობრული: ბოროტებად, მტრული, უარყოფითი, მავნე
მოსახლეობისაღწერის: გაანგარიშება
tiptoe: toe, მზად, მზადარის
დაძაბულია: დასასვენებლად, სიმშვიდეს, დასვენების, დასვენების, გაათავისუფლოს
უწყვეტობა: მუდმივად, გაგრძელება, ერთობლიობაში
bubble: 
გიტარა: დაა.შ.
კომპენსაცია: უპირატესობა, შეუზღუდავად, deflection
გამოუყენებელი: ნათელი, საათზე, ბრწყინვალე
რომელი: ნებისმიერი, რამნიშვნელობააქვს, რომელიც, ვინც, შორის, წყალქვეშა
ტრიკოტაჟის: ქსოვა, იქსოვებოდა, ლენტები
soar: ლაშქრობა, hover, ყელის, ფრენა, ცნობილი, თვითმფრინავი, თვითმფრინავი, თვითმფრინავი, ავიაკომპანია
ნაცვალსახელიmarker: 
spice: zest
გირაო: bond, გარანტია, დაპირება, გარანტია, სპონსორი, ძვირფასიქვა, gem
გაღიზიანება: ცდუნებას, ვაწყენინო, გაღიზიანება, აღაფრთოვანებს
java: 
რეცეპტი: მეთოდი, სტიმული, prescription, ფორმულა, ინსტრუქცია, თანხმოვანთა
გუთნის: გადაჭრა, გაიტაცეს
წყალსაწრეტი: სანიაღვრე
comet: დამნაშავე
სიახლე: აღმოჩენა, გამოგონება
შუასაუკუნეების: შუა
დეკორატიული: გაფორმება, დაამშვენებს, კოსმეტიკური
პლასტიკური: 
სქოლიო: 
რძის: რძე, ჩვეულებრივი, რეგულარული
გოლფის: 
ნულოვანი: null, ვაკანტური
zip: შეკუმშოს
გამოიწვევს: 
ჩიპი: ცალი, ფრაგმენტი, slice, ბლოკი
ზეწოლას: ჩახშობა, ჩაახშოს, დათრგუნვას, ამარცხებენ, არასათანადომოპყრობის
yawn: ორთქლდება
უთანასწორობა: 
mole: თიხის
ჭურჭელი: ნიადაგის, თიხის
დიასახლისი: 
ირაციონალური: დაუსაბუთებელი
miner: მცირე
საფუარი: ფერმენტის, ცომი, საკონდიტრო
კვეთა: ზღუდავენ, დაძლევის
პრემია: პრემია, პრიზი, ჯილდო
ვარიანტი: ალტერნატიული, შემცვლელი, ალტერნატიული, კიტრი, არჩევანი, შერჩევა, variant, ურჩევნია, უპირატესობა, სურვილისამებრ, ცვლილება, amused
უმაღლესდამთავრებული: გამოცდა, გაივლის
გაკოტრების: მარცხი
სარწყავი: 
კაპიტალისტურ: კაპიტალიზმის
ელასტიურობას: მოქნილობა
გეომეტრია: გეომეტრიული
ზვიგენი: 
შენახვის: შეინარჩუნოს, შენარჩუნებას, მაღაზია, გადარჩენის
იმედია: პერსპექტივა, მოლოდინი, ოპტიმიზმი
რეალიზმი: 
სასწრაფოდახმარების: 
საფულე: purse, პორტფელი
grimace: mug, grin, wriggle
მეცნიერი: სამეცნიერო, მეცნიერი, მკვლევარი, გამომძიებელი, ბიოლოგი
gut: ნაწლავის
equanimity: 
რეალისტური: ფაქტობრივი, ნამდვილი, ნამდვილად, რეალურად, ნამდვილად, გულწრფელი, პრაგმატული, რეალური, გამოკვეთილ
შეუსაბამო: წინააღმდეგობრივი, შეუსაბამო, incongruous, უმნიშვნელო
bean: თხილის, peanut, მარცვლეულის
არაფორმალური: ფორმალური, ოფიციალურად
შვილიშვილი: შვილიშვილი, შვილიშვილი, დისშვილი, შთამომავალი
სტეიკი: chop
აზოტის: 
mutter: whisper
berry: pluck, bay
ანალიზი: გარჩევის, ანალიტიკური, ანალიზი, ანალიზი
კონტრასტული: განსხვავებით, კონტრასტული, წინააღმდეგობრივი, განსხვავებით, პირიქით, გარჩევა, დისკრიმინაცია, დიფერენცირება, მკაფიო, სხვადასხვა
ფეიერვერკი: ფსონი, ვაჭრობა, flame
პოპ: ვადამდელი, bang
undress: ზოლები, ტანსაცმელი
დაკომპლექტდეს: დამატებითი, აღჭურვა, გარდაამისა,, დამატებითი
pegativeშემთხვევაში: 
კიბოს: 
სალომბარდო: იპოთეკური, ჯარისკაცი, დაპირება
გაჟონვის: თამაშები, დაკარგვა, ვარდნა
სიმჭიდროვე: ხალხმრავალ, ინტენსივობის
საღეჭი: 
სირთულის: გართულება
talkative: კომუნიკაციური, სწრაფი
გამართლების: თავისუფლდება, განმათავისუფლებელი, rid, გაათავისუფლოს, დამსახურებაა
polar: ექსტრემალური, ბოძზე
ფასდაკლება: გათავისუფლება, იყიდება, დათმობა, ვარაუდი
ტაქსის: ტაქსი
იერარქია: ხელმძღვანელობა, სისტემაში, უკან
snarl: 
გულუბრყვილო: წრფივი, ჩვეულებრივი
პრეზიდენტობის: საპრეზიდენტო
მყიდველი: მომხმარებელს
gallon: 
mosquito: 
სამწუხაროა,: mourn, ვგმობთ, ვნანობ
გადახრა: deflection, დამახინჯება, ოფსეტური, რაღაც
მოზაიკა: სხვადასხვა
plug: კონექტორი, ვაუჩერი
ორსულობის: კონცეფცია, დაორსულდა, განახორციელოს, დატვირთვის
სასურსათო: 
კომუნისტური: 
amaze: გასაკვირი, საოცარი, განსაცვიფრებელი, შეცდომაშიშეყვანას, აღრეული, საოცარი, ანგრევენ, გაოცებული
prosecutiveშემთხვევაში: 
დიქტატორი: 
გატაცებული: დასაქმების, შფოთვა, ფიქრი, შეშფოთება
სატელიტური: probe
სავარაუდო: დაახლოების, დაახლოებით, approximative, თითქმის, პრაქტიკულად, დაახლოებით, უხეშად
უმუშევარი: დასაქმების
განახორციელოს: განხორციელების, აღასრულოს, აღსრულების, შესრულების, შეასრულოს
ნათურა: ხახვი, სარქველი
მხარდამჭერი: თანაშემწე, სიმტკიცის, bracket
lotus: lily
ქლორიდი: 
ბაქტერიების: სოკო, ბაქტერიული
მესერის: ნიმუში
ბიოლოგიური: არსება, ბიოლოგიის
feign: ვითომ, სიმულაცია
byte: 
სეკრეციის: საიდუმლო
ბალეტი: fin, საარჩევნო
შარდის: piss
ნიორი: 
საშუალოკლასი: 
სამრეცხაო: სარეცხი
ახასიათებს: გარჩევა, დახასიათება
მარწყვის: 
ნოუთბუქი: ლეპტოპი
ტრანსცენდენტული: 
ალბომი: 
ბეისბოლის: 
მეკობრეობის: 
ბუფეტი: 
მიმღეობის: მონაწილე, აბიტურიენტი
ავტოფარეხით: 
დიაგნოზი: დიაგნოსტიკური, დიაგნოსტიკა, შემეცნებითი, აღიარებს
გამოძალვის: შანტაჟი, pluck, შეზღუდვის, იძულება
ფოსფორის: 
სტრუქტურული: სტრუქტურა, კონფიგურაცია, config, ინსტიტუციური
წებო: რეზინის
თეზისი: სადისერტაციო
ხელოსანთა: მექანიკოსი, სანტექნიკოსი
ბანანის: ქსოვილის
ნეკნი: gear
არცერთი: 
გაკეთებული: ახლა, იმყოფება, მიმდინარე, დღეს, მდგომ
ავტობუსი: მიადევნე
ცენზორი: ცენზურა, კრიტიკოსი
სარაკეტო: სარაკეტო
ძეხვი: ჰოთდოგი
მანიპულირება: მუშაობას, მანიპულირება, ოპერატიული, შეასრულა, მოტყუებას, გაუმკლავდეს, ოპერაცია, თაღლითობის
ტომატის: 
გააძლიეროს: კონსოლიდაცია, გააძლიეროს, ადასტურებენ, ძლიერი, გაძლიერება
ამოზნექილი: 
კალიუმის: 
ალგებრა: ალგებრული
საიუველირო: 
ოპტიკური: ვიზუალური
უმუშევრობის: საცხობი
განიარაღება: იარაღის, იარაღი, შეიარაღებული
solo: ცალკე, ფენომენალური, დისკრეტული, ნიადაგის, მარტო
ბრაუზერი: სკანერის
ისტორიულიდაძაბული: 
შესაძლებლობების: ეფექტურობის, პოტენციურად, მოცულობა, განაყოფის, უნარი, კომპეტენციის, წიგნიერების
სპექტრი: 
ნატრიუმის: 
ისტერიის: convulsion
რწმუნებულის: ადმინისტრატორი, ერთგული
მძევალი: იპოთეკური, დაპირება
სპორტსმენი: მათემატიკის, სპორტული
wrinkle: ნაკლი, ჩაიდინოს
მოიცავს: ითვალისწინებდეს, შინაარსი, წარმოადგენს, მშენებლობა, ჩართული, ჩაერთონ, ჩართვა, ჩართვა, შედგება, შეიცავდეს, მისაღწევად, მოიცავს
clip: staple, bracket, სტეპლერის
პრიორიტეტი: ყურადღება, უპირატესობა, ურჩევნია
გაუპატიურება: აღშფოთება, უნდააღემატებოდეს, აგრესია
მონიტორის: სიმღერა, ზედამხედველობა, დაათვალიერეს, განაგრძოს
ოლქში: ამომრჩეველთა, ამომრჩევლებთან, მსუბუქი
კულტურული: კულტურა
გენდერული: compute, sex, პენისი, სახეობების, სექსუალობა
პლატინის: 
ორმაგინომერი: 
სპეციალობით: პროფესიული, დამახასიათებელი, trait, კერძოდ,, სპეციალური, ექსპერტიზა, სპეციალისტი, ცალკე, ექსკლუზიური, სპეციალიზაცია
ფილტვის: 
super: ფენომენალური, enormously, წარმოუდგენლად, ხელმძღვანელი
trolley: ვაგონი, კალათა, უნივერსალი
სოკოს: სოკო, mold
ადგილობრივად: ადგილობრივი
უბიძგებს: excite, ვაწყენინო
ბენზინზე: ბენზინი
გოგრა: squash, ტვინის
თირკმლის: სიმაღლე, გაფართოება
ნაძარცვი: ძარცვა, ძარცვის, მტაცებელი, გააფუჭებს, ძარცვა, haul
დარიშხანის: 
snail: helix
უსასრულოდ: 
სოციალისტური: ნათესაობის
ფილტრი: 
გაფართოება: გაფართოება, ფართო, რჩეულებში, დააყენებს, აძლიერებს, ვრცელდება, ფართოდ, გაფართოება
საკამათო: დაპირისპირება, ეწინააღმდეგება, ორაზროვანი, გაუგებარია, გაურკვევლობა, წინააღმდეგობრივი
leash: იჯარის, strap
ჟოკეი: 
პნევმონია: 
უჭირავს: ბოლო
კვეთა: გადაკვეთა, junction, რიგითი
სოლიდარობა: გაერთიანდეს, აქცია, affinity, ერთიანობის, მსგავსება, ეპოქაში
hinge: დეტალური, loop, ღერძი
გრძივი: ვერტიკალური, გახანგრძლივება, სახეობების
დივიდენდი: გამოყოფა
obtuse: ნელი
skate: სათხილამურო
კრაუჩი: bend
მაჩვენებლებით: ინდექსი, ექსპონენციალური, ფრაგმენტი
ინვალიდობის: ქმედითუნარიანობა, უუნარობა, ნაკლი, არასრულყოფილი, შეზღუდულიშესაძლებლობებისმქონე, ხარვეზის
ჩემპიონატი: ჩემპიონი, გამარჯვებული, ტურნირი
ფოტოგრაფი: ფოტო
ციფრული: ფიგურა, ციფრების, ციფრული
bitch: 
ქუთუთოს: 
ქვეცნობიერი: 
წარბის: 
sneeze: 
იუმორისტული: მხიარულ, გართობა, მოხარულივარ,, სასაცილო, amused, სახალისო, გასართობი, იუმორისტული, სასაცილო, სასიამოვნო
ლტოლვილთა: ემიგრანტი
ცილის: თეთრიკვერცხი
ნაგავსაყრელი: pile, დასტის, დარბევა, ნაგვის, ნაგვის, hurl
განვითარება: ევოლუცია, განვითარება
რევა: 
გენი: გენეტიკურად, გენეტიკური
პირველკურსელთა: 
შერწყმა: fusion, გაერთიანდეს, გააერთიანებს, გაერთიანდება, კონსოლიდაცია, ინტეგრაციის, გადავიდეს, დაკავშირება
სოციოლოგიის: 
მობილობის: მობილური, პორტატული, მოძრაობა, მოძრაობის
რეგიონალური: ქვეყანა, ტერიტორიაზე, ზონა, პალატაში, სფეროში, სექტორი, პერიფერიული, პროვინციის
მოძრაობისაღმართზე: 
განზავებული: წვრილი, მსუბუქი
რეტროსპექტივა: ბოლო, introspection
inversion: ინვერტული, პირიქით, საპასუხო, შებრუნებული, კატასტროფა, ჩატარების
tv: ტელევიზია, ფილმი
cube: მყარი
სინტაქსი: სინტაქსური, საპენსიო, განლაგება
პროდუქტიულობის: შესრულების, გამომავალი
სტაფილოს: 
მოლეკულური: მოლეკულა, მრიცხველი, სუბსტრატს, ბირთვული, ატომური
კონგლომერატის: ხროვა, ჯგუფი, კასეტური
ბუღალტერი: აუდიტორის
დიფერენციაცია: დისკრიმინაციის, დისკრიმინაცია, გარჩევა, დიფერენცირება, შესვენებისქვემოთ, განსხვავება, განსხვავებით, ვარიაციები, ეწინააღმდეგება
ხელმისაწვდომობა: ხელმისაწვდომობა, შეძენის, მისაღებად, ხელმისაწვდომია, დასწრება, ეფექტურობა
orgy: 
გამხსნელი: დაითხოვოს
ფოსფატი: 
პრემიერის: სატყუარას, გაცნობა, შესავალი, პირველრიგში
მძიმით: კომა, პარტიის
შენობა: 
მოძრაობისdownhill: 
დონორი: წამყვანის
ფსიქოლოგი: 
ქლორის: თხა
კლავიატურის: 
ელიტა: უმაღლესი
ფრჩხილებში: bracket
რაგბის: 
წყლული: sore, ჭრილობა, ტრავმა, boil
inflected: 
nibble: 
აბორტი: miscarriage
სვიტრი: ქურთუკი
ევოლუციური: განვითარების, ევოლუცია, განვითარების, პროგრესიით
notation: ნიშანი, სიმბოლო, შენიშვნა
bounce: boom, ნახტომი
სასექციო: გამოყოფს, განყოფილებაში, სამმართველოს, გათიშე
cache: იმალება
სტიბიუმი: 
superessiveშემთხვევაში: 
სიმსივნური: სიმსივნური, ნაყარი
alpha: 
navel: მუცლის, ბოძზე
იმუნური: სუნთქვის, მდგრადი
ამოკლებენ: ლიმიტი, შეუზღუდოს, შეზღუდოს, შეჯამება, კომპაქტური
captivate: ხელში, აღაფრთოვანებს, ნადირობის, მოზიდვა
sock: 
ფილმის: ფილმი, კინო, ლენტი, ფირზე, ზოლიანი
კოსმოსში: სამყარო
აბინძურებს: დაბინძურების, დაავადების
gregarious: 
ალუმინის: ალუმინის
რხევის: რხევის, ვიბრაცია
ანბანური: ანბანი
ჰოროსკოპის: 
ტანგესი: 
dolphin: 
killer: 
რეზონანსი: ვიბრაცია
მაჩვენებელი: პოზა, ინდექსი, კრიტერიუმები, საჩვენებელითითი, წვრილი
დიოქსიდი: 
ბიუროკრატია: ბიუროკრატიული
დამახინჯება: შეცდომაშიშეყვანას, scramble, გაუარესდება, გააყალბოს, skew, დამახინჯება
galaxy: constellation
კლინიკური: 
რადიუმის: რადიო
მაცივარი: მაცივარი
ჰარმონიული: მუსიკალური, შესაბამისად
არქეოლოგიური: არქეოლოგია, არქეოლოგია, წიაღისეული
დაზუსტება: ნორმა, სტანდარტიზაცია, დეტალურად
ინტერპოლაცია: 
ბროშურა: ბროშურა, ბიულეტენი, handout, ფურცელი
დაუსრულებლობის: არასრულყოფილი
ანთროპოლოგია: 
გემრიელი: გემრიელი
გარდამავალი: საბაბი
უშიშარი: 
სიმულაციური: სიმულაცია, სამკერდე
საშოში: bay, მობილური
ion: 
ტურიზმი: ტურისტული, მოგზაურობა, პიკნიკი
ტრიგონომეტრია: 
გატაცების: გაიტაცეს, ჩატარების, snatch
გადახურვა: ურთიერთქმედება, ინტერაქტიული
მონახეთ: 
განდევნონ: გადაადგილებულ, განდევნა, აგდებს, დეპორტაციის, დარბევა
საპარიკმახერო: 
ფოლკლორის: ხორბლის, ხალხური
კაპილარული: 
ნაციონალიზმი: მოქალაქეობა
buttocks: თეძოს
სულემის: სუფთა, დახვეწა
ბუფერული: 
იმედგაცრუება: სასოწარკვეთა, იმედი, დაბნეული, გაუქმება, დამარცხება, იმედგაცრუებული, სხვაობა, გულდასაწყვეტია
კობალტის: 
გამოკლება: სხვაობა
მოძრაობისupriver: 
კოორდინატები: კოორდინატთა, კოორდინაცია, კოორდინაცია
ტანში: 
redundancy: უამრავი, ნარჩენი, ჭარბი, გადააყენოს, გათავისუფლების, გათავისუფლება, ჭარბი
ვიდეო: 
ბოიკოტი: ქვეყანა, განდევნილები, უყურადღებობა
ვიქტორინა: მცდელობა, გამოცდა, კითხვარი
პარტიზანული: 
მაგნიუმის: 
სარადარო: 
ხარისხიანი: ხარისხი, დამახასიათებელი
საიმედოობის: სანდოობის
მართკუთხედი: 
განზოგადება: განზოგადება, აშენება, შექმნა, დაკომპლექტებას
აღარ: ახლა, ერთხელ
კომენდანტისსაათი: 
ფორმულირება: აშენება, მშენებლობა, კონსტრუქციული, ფორმულირება, შექმნა, ფორმირება, ფორმულირება, დადგენა
ჩადის: აღორძინება
გაღვივების: 
ურანის: 
გადასახადისგადამხდელის: საგადასახადო
ინტეგრირებული: განუყოფელი
მიიჩნია,: კალენდარი, აზრი, შენიშვნა
გამა: 
სერვერზე: 
მოძრაობისdownriver: 
კოეფიციენტი: კლასის, ფაქტორი, modulus
ბისმუტის: 
მისალოცი: პოსტი, სამაგისტრო
გადაუხვიოს: უკანდახევა, გამგზავრება
მორფოლოგიური: გენეტიკური, მორფოლოგია
შეფასების: შეაფასოს, შეფასების, შეაფასოს, გამოძიება, გამოიძიოს, გამოძიება, probe, par
jeans: 
მონაცემთაბაზაში: 
კალკულატორი: კომპიუტერული
ინვესტორი: 
x-ray: 
დღისწესრიგში: პროგრამა, პროგრამა, სასწავლოგეგმა
სავიზო: 
ინფრასტრუქტურის: ძირითადი, ძირითადი, ფუნდამენტურად
detector: 
splice: აფიქსის, ცვლილებებისშეტანის, ანიჭებენ, დაკავშირება
ბრომი: 
სილიკონი: pi
hiccup: 
pastel: ღია
ზოოპარკში: 
კლინიკა: 
yoga: თანხა
წიგნისმაღაზია: bookcase, მაღაზია
საცალო: ბანკირი, გამყიდველი, მაღაზია, მიმდებარე
behead: დროული
yeah: დიახ, ya, გულწრფელი
ჯაზის: 
ვოლფრამი: 
ტერორისტული: სამხედრო, ტერორი, ექსტრემისტული
კონცეპტუალური: ლამაზი, ცნება, კონცეფცია, ვარაუდი, პარადიგმა, კონცეფცია, პროექტი
cartesian: 
dribble: slime
alimony: 
programmer: აპლიკაცია
input: 
კოსმეტიკა: კოსმეტიკა, კოსმეტიკური, შეასრულა, აუნაზღაუროს
ვაქცინა: კომენტარი, დაფარვის, ინექცია
აქსიომაა: 
ჰეროინის: 
დირექტორია: 
კათოდური: 
გრიპის: ცხელება, გავლენა
იდეოლოგია: ეგონა,
პარკირების: 
კადრი: 
anticlimax: იმედი
სელენი: 
ქერქის: ქერქი, shell, კანი
ექვივალენტობის: თანასწორობა
vertex: 
აეროპორტში: 
ამპუტაციაზე: შეუშალოს
თვითმარქვია: 
ქრომის: 
ლიტრი: ლიტრი
დაფა: პანელი, dash
ჰორმონის: 
გახვრიტეთ: pierce
animism: 
პოლიგონის: კუთხე
ფემინისტური: 
შეუღლებული: incline, დაკავშირებული, იზიარებს
ევრო: 
ალგორითმი: 
ლაზერული: 
აფთიაქი: 
მილიმეტრიანი: მილიმეტრიანი
flex: bend, curved, მოქნილი, ხელსაყრელი, საკაბელო
ანოდი: 
ნიუანსი: ჩრდილში
Snuggle: იკისროს
ნახევარიგანაკვეთი: 
მგრძობიარობა: 
mainframe: 
აქციის: გამოჩენა, ჩვენება, შესრულების, დემონსტრაცია, პრეზენტაცია
ჰელიუმი: 
ორენოვანი: 
gerund: 
პლაზმური: 
ქრომოსომის: 
რიცხვი: ციფრი, ციფრების
კილომეტრიანი: კილომეტრიანი
ფაქსი: 
გენეტიკა: გენეტიკური, გენეტიკურად
freckle: 
ბროკოლი: 
permutation: ფორმატი, მასივი, განლაგება, apposition
სპამი: 
ვექტორი: გადამზიდავი
ტაქტიკა: მოწყობილობა, მიდგომა, ტექნიკა, მეთოდოლოგია, მოიტანონ
კარგად: აღდგენა, სწორად, შეიკარი, ძალაშია, კარგი
ვიტამინი: 
კადმიუმის: 
გრაფიკული: გრაფიკული, გრაფიკა
ხელით: თავად
ტიტანის: 
splurge: brag
ვერტმფრენი: 
tellurium: სკანდიუმი, lanthanum
ბოლოვადა: ვადა
უერთდებიან: თანმიმდევრული, მასივი
ანალოგი: 
სანტიმეტრი: სანტიმეტრი
მოლიბდენის: 
lithium: 
მულტიმედია: 
calorie: 
რობოტი: 
საშინაოდავალება: თანხმობა
ლოგარითმი: 
instal: mount, ინსტალაცია, სინთეზი
glyph: რელიეფის
ეკოლოგია: ეკოლოგიური, გარემოს
დახვეწა: გააფუჭებს
თარგი: mold
ევკლიდეს: 
კილოგრამი: 
overeat: 
გამყოფი: 
უფასოდ: 
მოსმენას: 
თმისშეჭრა: 
iridium: 
რასიზმის: რასობრივი
სიჩქარის: ინტერნეტი
ოპტიმალური: დაბრუნება, ოპტიმალური, ხელსაყრელი, შეეფერება, შეცვალოს, მოერგოს, თავსებადი, ადაპტური, სათანადო, სწორი, საღადმოაზროვნე
ჰიპოტენუზა: აკორდი, ირიბი
desktop: 
შტაბი: შტაბი, სავარძელი
misplace: გაჭირვებული, დაკარგავს
ცერიუმის: 
partitiveშემთხვევაში: 
კასეტა: ფირზე
სუპერმარკეტი: mall
ნებისყოფის: სურდა, იქნება
განზომილებიანი: ზომა, ფორმა, განზომილება, სივრცითი
გასულია: 
დაშიფვრის: კრიპტოგრაფიის, encrypt, კოდირების
სინქრონიზაციისათვის: სინქრონიზაციის, ინტეგრაცია, თანამედროვე
სემინარი: 
სემანტიკური: რაციმასნიშნავს,, კონტექსტში, სათაური, ობიექტი, მასალა, ნივთიერება, აზრი, მნიშვნელოვანი
დისკო: 
neon: 
რეალურიდრო: 
ოსმიუმი: 
ცხოვრებისწესი: ცხოვრება, სიცოცხლისგანმავლობაში, გადარჩენის, ცხოვრების, კარიერა
firewall: 
კოსინუსი: გაანგარიშება, გამოთვლები
artifact: 
პლუტონიუმი: 
სამუშაო: 
yttrium: 
augmentative: 
სახელი: 
მარჯვენაფლანგიდან: 
არგონი: 
სოციალიზაციისა: ურთიერთობა, ურთიერთქმედება
გლობალიზაციის: 
secant: 
ტალღისსიგრძე: ტალღა
encode: კოდი
მეორადი: 
asymptote: 
decode: დაკმაყოფილება, გადაჭრა
რესტარტი: გადატვირთეთ, ოპერატიული
ჰეპატიტი: 
პროტონული: 
diskette: დისკი
milligram: 
pixel: 
ტანტალის: 
გადაწყვიტოს: 
გენოციდი: 
გალიუმის: 
პოპup: 
ცირკონიუმის: 
არაწრფივი: 
პესტიციდების: 
მრავალწევრის: 
ბერილიუმის: 
neuron: 
predicative: აგრესიული
როუტერი: 
factorial: ფაკულტეტი
ვიჯეტის: ჩანართი
ნეიტრონული: 
ნიობიუმის: 
გერმანიუმი: 
metalloid: არასამთავრობოლითონის
prolativeშემთხვევაში: 
ბიომრავალფეროვნების: 
ინდუსტრიალიზაცია: ინდუსტრიალიზაცია, მრეწველობა
ჯოისტიკი: 
ანტიბიოტიკი: 
actinium: 
ასტრონავტ: ფართი
ით: გაფართოება, აძლიერებს
extrapolation: 
ლოგო: უცხო
octet: 
ღიაწყარო: 
მარათონი: 
plugin: 
ტოპოლოგია: 
gigabyte: 
ionize: 
siერთეული: 
კარავში: ბანაკში
სასრულიverb: 
კრიპტონი: 
gnomicგანწყობა: 
ცვლაგასაღები: 
მოედნები: კვ
გამყიდველი: ბანკირი, გამყიდველი, კლერკი
rhenium: 
მობილურიტელეფონი: მობილურიტელეფონი, მობილურიტელეფონი, პორტატული, ლეპტოპი, მობილური
sideways: გარდა
მოდალურიშემთხვევაში: 
უსარგებლოფოსტა: 
railcar: 
clipხელოვნება: 
bookmark: 
hafnium: 
მთავარიგვერდი: 
lativeშემთხვევაში: 
nth-root: 
ბლოკ: 
შუახმა: 
მოხუცებულთა: მოხუცები
დამრგვალება: მომრგვალებული
rhodiumatom: terbiumatom, thuliumatom, თორიუმისatom, ფთორისatom, რუბიდიუმიatom, thalliumatom, ვანადიუმისatom, პოლონიუმისatom, სტრონციუმისatom, rutheniumatom
ცუდი-ხასიათზე: უხეში
obliqueშემთხვევაში: 
პაციენტიშემთხვევაში: 
წინასწარhodiernal: 
მელოტი: შიშველი, ნედლეული
მიზანიგამოიწვევს: 
praseodymium: 
პარალიზებულია: 
შესახებ: საჩივარი
toშემთხვევაში: atშემთხვევაში, შემთხვევით, საწყისიშემთხვევაში
რადიაციული: დიზელის, ემისიის
indium: 
მსახიობიროლი: 
euphoria: ენთუზიაზმი, ენთუზიაზმი, კმაყოფილება, თანხმობის, სიამოვნებით, სიხარული, ბედნიერება, აღფრთოვანებული
capsდაიბლოკოს: 
თეთრისივრცე: 
მკვეთრად: დრამატული
შოვინისტური: 
ნახვა: ნახვა, საიტი
სახლიმცენარეთა: 
სამოქალაქოუფლებები: 
protactinium: 
პროექციული: 
ორობითი-ღირებულება: 
მეკარე: 
საცალომაღაზია: 
სტატუსიბარი: 
მიკროფონი: მიკრო
ადამიანისსხეულის: 
ფიცს-in: 
ფოსტალიონი: 
centricშემთხვევაში: 
trojanცხენი: 
გადახვევაბარი: 
triple-პუნქტიანი: 
წაკითხულიმხოლოდ: 
wisecrack: ხუმრობა, ზეპირი
impermanence: არასტაბილური, არასტაბილურობა
პოეტი: 
ფონოლოგიური: 
Hypnotize: 
სასამართლონომერი: 
რეცეპტორების: მიმღები
ზმნა-სუფიქსი: 
არასამთავრობოადამიანის: 
ნაკადისმიმდინარე: 
რომ,რაც: რომ, რომელიც, ვის, რომლის
პუნქტიკუდი: 
უკუღმა: შებრუნებული, დავამარცხებთ
მაგალითად: 
ipმისამართი: 
ამენაზე: 
ინდივიდუალურად: პირადად, ინდივიდუალური, პირადი, ცალ-ცალკე, ცალკე, მკაფიო, განსხვავდება, სხვაგვარად, სივრცითი
პროწინადადება: პროფრაზა
ეპიდემიოლოგია: მექანიკის, დინამიკა
კანონმდებლობა: კანონმდებლობა, საკანონმდებლო, მოწყობა, ორგანიზება
ზოლიანი: ზოლიანი, სქემა, planner, გეგმა
strikebreaker: 
astatine: 
overcharge: 
სხვათუ: 
კუთხეების: კუთხე, აღნიშნა
გაცვეთა: 
ციტირებისფორმა: 
ერგატიულიშემთხვევაში: 
გარეუბანში: ჰამლეტ, სამგზავრო, სოფლის
საერთოგენდერული: 
სუპერკომპიუტერი: 
პირდაპირიობიექტი: არაპირდაპირიობიექტი
motorist: მძღოლი
სტატისტიკურად: სტატისტიკური, ციფრული
lutetium: 
რაციონალობა: ცნობიერების, ლოგიკა
პასიურიხმა: 
გამომწვევი: 
ცეზიუმ: 
ძიებაძრავის: 
პანელი: 
ავტომატურად: ავტომატური
californium: 
mendelevium: 
აგენტიგამოიწვევს: 
ფერიბრმა: 
კომიკურიზოლები: 
ტერმინალში: ტერმინალში
წერტილიmatrix: 
samarium: 
მოკლეჩართვა: 
შედგენა: შეგროვება
agentiveშემთხვევაში: 
შემთხვევის: crash, მსხვერპლი, შემთხვევითი, ინციდენტი, wreck
fractals: 
multalნომერი: 
დახურვა: დახურულია, დახურეს, ახლოს, გამორიცხავს
ფართო: დიდი, ფართო, ყოვლისმომცველი, ფართო, ფართოდ, საკმაო, ფართოდ, გავრცელებული, დიდი, კუთხე
adessiveშემთხვევაში: 
კოოპერატივის: კოლეგა, ითანამშრომლოს, თანამემამულე, ასოცირებული
euler'sნომერი: 
ლაზერულიპრინტერი: 
transციფრების: 
წაკითხვა: ბლოგერი
კომბინატორული: combinatorics
პითაგორა: 
abessiveშემთხვევაში: 
ლოკატიურიშემთხვევაში: 
საცურაოაუზი: აუზი, აუზის
კიბერდანაშაული: საშიში, მავნე
ფოსტა: პოსტი, ფოსტა
malware: 
ინჰიბირება: შეკავებას, ასალაგმად, ზღუდავენ, აიკრძალოს, ვეტო, შეკავება, ნუქნას
spyware: 
ჩაწერა: ჩანაწერი, ჩართვა, რეგისტრაცია, რეგისტრაციის, შესვლის, შესვლა
ინტერვიუერი: ინტერვიუ
clipფორუმში: 
ქსენონები: 
ცხრილების: 
nthძალა: 
კინო-თეატრი: კინო
შემომავალი: 
პროცენტით: პროცენტი, cent
აეროზოლური: spray
დისტრიბუტორი: 
დინამიკური: დინამიკა, მექანიკის, დინამიური
ერთიმეორე: 
subtend: უდევს
Brownian: 
ვარსკვლავიგენდერული: 
galaxyგენდერული: 
მუყაოს: ანკეტა, მუყაოს
computability: 
სხვა: სხვა, ერთმანეთი, სხვა
პოლიციისოფიცერი: 
პირველადიობიექტი: 
animateგენდერული: 
evitativeშემთხვევაში: 
მანქანაგენდერული: 
მონაცემებისამთო: 
გააჩნდაშემთხვევაში: 
americium: 
მინერალურიგენდერული: 
domainსახელი: 
წარმოსახვითიერთეული: 
neptunium: 
სიტყვიერიარსებითისახელი: 
მათემატიკოსები: 
კუთვნილებითიშემთხვევაში: კუთვნილებითიშემთხვევაში
მოდელირება: 
საბოლოონაწილაკების: 
ფლეშdrive: 
floppyდისკზე: 
მეხანძრე: 
კრიტიკულიწერტილი: 
თანამგრძნობისიხარული: 
სიტყვაპროცესორი: 
პრემიერმინისტრი: 
ვირტუალურიმეხსიერება: 
ზმნისართულშემთხვევაში: 
ethidium: 
shorts: 
სულელიგარშემო: 
განტოლებები: განტოლება
subessiveშემთხვევაში: 
შესვლაგარეთ: 
spammer: 
antessiveშემთხვევაში: 
crosswalk: გზა, walkway
შესახებინტერფეისი: 
მწერალიმოჩვენება: 
კომპიუტერულივირუსი: 
ხელშემწყობი: წამყვანის, მოდერატორი
რეაბილიტაცია: 
დამხმარეverb: 
პირველიმხრივ: პირდაპირი
დედა: თუარა
პაციენტიგამოიწვევს: 
runtime: 
კოლექტიურიარსებითისახელი: 
ყურანის: გაზეთი
ბიზნესიპირი: ბიზნესპირი
გარდამავალიverb: 
cloudკომპიუტერული: 
ვირტუალურიმანქანა: 
absolutiveშემთხვევაში: 
ვირტუალურირეალობა: 
ბოლოსრულყოფილი: 
უპიროვნოverb: 
crastinalდაძაბული: 
რეფლექსურხმა: 
აბსტრაქტულიგენდერული: 
განსხვავებულიღონისძიება: 
exocentricშემთხვევაში: 
მეორეენა: 
მხატვრულიგენდერული: 
თვითმმართველობისნდობის: 
კვლევაგენდერული: 
არაპირდაპირიგამოსვლა: 
რაიონიგენდერული: 
ფიზიკის: ფიზიკური, ფიზიკური
სამყაროგენდერული: 
დახურვის: ახლოს, დახურულია, დახურეს, off, შეწყვეტის, დატოვა, შეჩერდა
უბადლოშემთხვევაში: 
შესაბამისი: მატჩი, ხმისმიცემა, საარჩევნო, სარჩელი, შესაბამისი, შეთანხმება, შეესაბამება, შესაფერისი, შეეფერება, ემთხვევა, ფოსტა, შესაბამისი, თავსებადი
კომპიუტერულიპროგრამა: 
ანტისხეულების: 
სრულიდრო: 
propositiveგანწყობა: 
ასოციაციურიშემთხვევაში: 
inanimateგენდერული: 
ტექსტირედაქტორი: 
პლანეტარულიგენდერული: 
ოპერაციულისისტემა: 
გრამატიკულიშემთხვევაში: 
ელექტრომიმდინარე: 
საპასუხოხმა: 
ჭურჭელიდადანა: 
ძირითადიbenefactive: 
ვებმასპინძელი: 
radian: 
applicativeხმა: 
ფონემა: 
ზედიზედპუნქტი: 
ნოუთბუქიკომპიუტერული: 
გაზისპედალი: 
antipassiveხმა: 
ხალხურიმუსიკა: 
terabyte: 
სოციალურიქსელის: 
მოლაპარაკების: მოლაპარაკება, განხილვა, საუბარი, სტატისტიკა, ურთიერთქმედება, ურთიერთქმედება, კონსულტაცია, ურთიერთობა, დიალოგი
noncommittal: ბინა, ბუნდოვანი, ორაზროვანი
morpheme: 
Linker: ბმული, ერთობლიობაში
ნეოდიმი: 
რადიაციულიავადმყოფობის: 
იმყოფებამიმღეობის: 
necessitativeგანწყობა: 
ეგზისტენციალურიპუნქტი: 
გადაჭარბებულიხანგრძლივობა: 
პასიურიმიმღეობის: 
გრამატიკული-object: 
continuativeასპექტი: 
singulativeნომერი: 
luminousინტენსივობის: 
უბადლოხარისხი: 
blue-jean: 
არჩევითიკვანტიფიკატორი: 
supercriticalსითხის: 
epentheticmorpheme: 
postpositionalშემთხვევაში: 
negatoryკვანტიფიკატორი: 
შემაერთებელინაწილაკების: 
Nerium: 
უნივერსალურიკვანტიფიკატორი: 
საჰაეროძალა: 
გამოსულიყოშეთანხმება: 
კომპიუტერულიპროგრამირების: 
აგრესიულიკვანტიფიკატორი: 
frequentativeასპექტი: 
გამანაწილებელნაცვალსახელი: 
ალტერნატიულიკვანტიფიკატორი: 
ფიშინგი: 
სკალარული: 
ჰიპოთეტურიპირობითი: 
