hnit	infinitive
hnak	ករណីនាមនិទ្ទេស
hkak	ករណីកម្មការកៈ
htak	ករណីប្រធានបទ
hpap	ឪពុក
hmam	ម្តាយ
hyat	មាតាបិតា
hcan	ជំរាបសួរ
hwik	ករណីvocative
hsuc	បុព្វបុរស
htat	ជីដូនឬជីតា
hcac	ឃ្លាន
hnik	ករណីប្រដាប់បន្តពូជ
hcit	គុណនាម
hwan	និង
hman	អោយខ្ញុំ
hnan	អ្នក
hwam	ពួកយើង
htit	វា
htac	ករណីគោលដៅ
htik	ករណីសម្បតានការកៈ
hyit	អារម្មណ៍ពិតប្រាកដ
htim	អារម្មណ៍deontic
hcut	អារម្មណ៍លក្ខខណ្ឌ
hsit	អារម្មណ៍epistemic
hyak	ករណីឧបករណ៍
htan	បរិបទមហាផ្ទៃ
hpan	បរិបទមនុស្សម្នាក់
htin	ឃ្លាឯករាជ្យ
hyan	ឃ្លាពឹងផ្អែក
hfap	ទិដ្ឋភាពល្អឥតខ្ចោះ
hkat	អតីតកាល
hnin	យែនឌ័របុរស
hmak	ករណីcomitative
hnat	បច្ចុប្បន្ន​កាល
hpak	ករណីbenefactive
swik	ករណីessive
htut	កម្រិតnegatory
hsan	បរិបទផ្ទៃ
hpin	ករណីadpositional
hwin	ករណីទីតាំង
hkan	បរិបទអវកាស
hnac	ករណីវិធី
hyut	អារម្មណ៍សួរចម្លើយ
hnam	និងឬ
hkit	ផ្តាច់មុខឬ
hsuk	ករណីប្រភព
hpik	ករណីablative
hcat	ជិត
hmat	ង្ហេញ
hkuk	កន្ទុយឃ្លា
hlan	ប៉ុន្តែ
hsut	ទាំងអស់
hyin	កម្រិតចំនួនសកល
hcin	យែនឌ័រស្រី
hpac	ចំនួនពហុវចនៈ
hyik	មួយ
htic	របស់ខ្លួន
hkik	ដែល
tcat	អនាគតកាល
hsin	បរិបទសង្គម
hkac	ពេលណា​
hmip	ទិដ្ឋភាពភាពមិនល្អឥតខ្ចោះ
klan	មាន
hlak	ករណីelative
hlik	ករណីillative
htam	អារម្មណ៍សារាចរ
hlat	កម្រិតជ្រើសតាំង
hkam	អ្វី​
hwat	ពាក្យសំណួរ
htap	copula
hpat	មនុស្ស
nyan	បុរស
hkas	អាចធ្វើបាន
tcan	ផ្សេងទៀត
hnuc	លេខ
twit	កម្រិតពោលអះអាងការពារខ្លួនឫ
hsak	បរិបទពេល
htuk	ករណីខាងសាច់ឈាម
htun	តែ
htum	អារម្មណ៍ហ៊ត
hyip	ទិដ្ឋភាពឡើងវិញ
hlit	អារម្មណ៍ដោយឆន្ទះ
pcic	ត្រូវតែ
tyut	ពីរ
hsat	មើលឃើញ
hkut	បានដឹងថា
hcic	ចុះ
hcap	បន្ទាប់ពី
hpam	ដំបូង
hlac	កម្មសិទ្ធិអន្ដោប្រវេសន៍
hkap	មិនដែល
hnic	ការកាន់កាប់មិនអាចលុបបំបាត់បាន
tyat	អាយុ
tcit	អារម្មណ៍ការពិចារណា
tcin	ថ្ងៃ
hlam	មក
hwak	ស្រៈ
hkin	ចូលទៅ
lwak	ករណីPerl
hpip	ទិដ្ឋភាពរីកចម្រើន
lyan	ជាយូរមកហើយ
hsac	បាននិយាយថា
kyan	របៀប
htas	ជាថ្មីម្តងទៀត
hsic	នៅទីនេះ
hcik	គិត
hcak	ស្ថិតក្រោមបរិបទ
hfan	បានរកឃើញ
hsun	ដៃ
hyac	ផងដែរ
nwan	វ័យក្មេង
tyit	ប្រឆាំងនឹង
tlan	ព្រះ
twak	ករណីdelative
hmin	គ្មានអ្វី
hyas	ម្តង
hlap	ទិដ្ឋភាពsemelfactive
kcac	ចាកចេញ
hyic	ឃើញ
hcas	ផ្ទះ
hwac	ពិភពលោក
tyin	បី
hnun	neo
hcuk	ការផ្តោត
pyan	ស្រលាញ់
hsis	តែងតែ
hyam	យប់
hyap	ស្តេច
hkic	រវាង
hmas	ចិត្ត
cyit	បេះដូង
pluc	ចំនួនpaucal
kyik	ដោយសារតែ
ksak	ករណីធ្វើអោយ
tcun	ធ្វើ
hnim	ឈ្មោះ
tsan	នាមត្រឹមត្រូវ
klac	ប្រទេស
hpun	សួរថា
cyat	ភ័ស្តុតាងដែលអាចមើលឃើញ
pcac	ល្អប្រសើរជាងមុន
hmac	ឱកាស
hnas	មិនអាច
hwic	ទឹក
twim	អារម្មណ៍desiderative
kwan	ពន្លឺ
tlat	ពាក្យ
tyan	ទ្វារ
hsas	ព្រឹក
syat	រហូតដល់
twik	ករណីស្ថានីយ
hpit	ពណ៌ស
pcan	ប្រាក់
hyis	ជនក្រីក្រ
mwan	ការស្លាប់
hfam	ទម្រង់បែបបទ
nwik	ករណីinessive
kcat	ជាមួយគ្នា
tsac	ជាញឹកញាប់
pyat	មិត្តភក្តិ
psan	ពាក់កណ្តាល
hpim	អារម្មណ៍ការចាំបាច់
hyuc	ជុំ
hfat	ដែលបានផ្ញើ
hcis	ប្រពន្ធ
kcan	ជឿ
hsik	សាធារណៈ
htus	បរិបទរបស់រដ្ឋ
hpas	បានកូនប្រុស
clat	កុមារ
tyak	ដូច្នេះ
cwan	សង្ឃឹម
syin	ជាទីស្រឡាញ់
hkuc	ខ្ពស់
tyac	អាន
syit	ទីក្រុង
hlic	រួចទៅហើយ
hfit	ភ័ស្តុតាងfactive
tcac	ក្មេងស្រី
hcun	ស្ដាប់
ksan	យ៉ាងហោចណាស់មាន
hyaf	ប្រហែលជា
kyat	ជា​ការ​ពិត
tcic	រាងកាយ
hwit	ត្រឡប់មកវិញ
cwat	ខ្យល់
hfaf	ច្បាប់
hput	ជួយ
lyat	លិខិត
ksas	បួននាក់
hpic	អារម្មណ៍optative
hfuk	ភ្លើង
hcam	ម៉ោង
twat	សង្រ្គាម
kyak	ជាច្រើន
tlit	ជាលើកទីពីរ
pcin	នៅពីក្រោយ
hmut	ការបាត់បង់
clan	ពាន់
hfac	ក្រុមគ្រួសារ
twan	ព្រលឹង
hwas	សំណួរ
syan	សេចក្តីពិត
htis	ការធ្វើ
tsat	អារម្មណ៍សក្តានុពល
lwik	ករណីallative
nyin	យែនឌ័រanthropic
hfak	ប្រាំនាក់
tcak	សញ្ញាសម្គាល់ប្រធានបទដូចគ្នា
htuc	ប្រធានបទផ្សេងគ្នា
hnap	ចម្លើយ
hmit	សមុទ្រ
hcuc	ការភ័យខ្លាច
pcat	យល់ដឹង
syas	លក្ខខណ្ឌ
hcaf	ការសង្ស័យ
twut	អារម្មណ៍dubitative
hkis	ខ្មៅ
tlak	នាំយក
hyus	ស្រស់ស្អាត
nyit	ការតម្រៀប
htip	ទាំងដប់
ksis	រឿង
hpuk	សៀវភៅ
hlin	អេឡិចត្រូនិ
hkun	គណនី
lyas	អត្រាការប្រាក់
lyit	សរសេរ
pwat	គ្រែ
hnis	អាយុ
hnut	counterfactualលក្ខខណ្ឌ
slas	សិល្បៈ
hwis	ករណីvialis
pyak	បងប្រុស
lyin	បន្ទាត់
tyas	តារាង
hyun	ទន្លេ
kyac	ភ្នែក
tfan	ភ្លាមនោះ
kcin	ជ្រៅ
hmuc	គោលបំណង
cyac	ឈាម
hmap	កើនឡើង
tlin	ជំងឺផ្តាសាយ
hyif	ទៅមុខ
tyam	ចុង
hnaf	ឧបមាថា
hkip	ជិត
myan	របស់ខ្ញុំ
tsin	ចំណេះដឹង
hkup	ច្បាប់ចម្លង
hsam	ប្តី
hlis	ប្រាំមួយ
cwit	កំពុង​រស់នៅ
cyan	សន្តិភាព
myat	ចងចាំ
tyic	ធម្មជាតិ
hfut	ធ្លាក់ចុះ
swas	សេវាកម្ម
hsap	លើកលែងតែ
pcit	សិទ្ធិអ្នកនិពន្ធ
hyim	កងទ័ព
kyas	សេះ
plic	នាពេលអនាគត
pcak	ភាគខាងលិច
hpis	បង់ប្រាក់
hyuk	ក្រហម
hwun	មាស
twin	បំណងប្រាថ្នារបស់
plan	លេង
hpus	ការិយាល័យ
syun	រដ្ឋាភិបាល
kyic	ព្រះវិហារ
htaf	កម្លាំង
hlun	ប្រវែង
kyin	ក្រុមហ៊ុន
kyis	ក្រដាស
mlan	ប្រូបាប
hcim	ពិសេស
cyas	សូមថ្លែង
twac	បង្អួច
nyat	សម្រស់
hcus	ក្រោយមកទៀត
htup	កាតព្វកិច្ច
htif	ចម្ងាយ
pyas	ជើង
hlas	ព្រៃ
ksin	បៃតង
hmaf	បញ្ហា
myac	ស្នាមញញឹម
hsim	ការដេក
kyit	undefined
kwik	ករណីquot
fwan	ដំណើរទស្សនកិច្ច
slan	តាម
psit	វត្តមាន
hmic	ផ្អែម
hmuf	មាត់
hfin	សម្បូរបែប
tcam	សត្រូវ
psuk	ខូច
kcap	នាវា
pwan	មនុស្សម្នាក់ដែលរួមបញ្ចូល
hfic	ឥទ្ធិពល
tcuc	លេចឡើង
hkim	សម្ងាត់
pyin	សូម
pwit	អារម្មណ៍precative
pyit	ចុះឈ្មោះគួរសម
cwak	អាក្រក់
myak	ការហែក្បួន
tcas	កន្លែង
hlaf	ស្នាក់នៅ
psat	ជំនួស
nlan	ខៀវ
psac	មិនអាចទៅរួចនោះទេ
kcuk	សាលារៀន
kcit	បាន​រៀបការ
kcak	អាហារ
syis	ម្ភៃ
tlac	ស្ងប់ស្ងាត់
hcip	ទិដ្ឋភាពអនាគត
kwin	ការផ្តល់
tsit	បានបញ្ឈប់
pyac	ភាសា
hsus	សប្តាហ៍
hcup	សាល
cyap	ឆ្ងល់
tfin	កើត
fyat	តុលាការ
hnip	ទិដ្ឋភាពgnomic
tsak	ការគោរព
tlas	មានតំលៃ
syuc	ដើមឈើ
plat	ជញ្ជាំង
cyak	ស្ថានបរមសុខ*
twip	ទិដ្ឋភាពinchoative
mlat	ពាក្យបញ្ជា
swit	អារម្មណ៍jussive
mwas	ខែ
hwaf	ល្អឥតខ្ចោះ
tyap	បទពិសោធ
ksac	កាលៈទេសៈ
syac	ស្រស់
hnuk	អ្នកឧកញ៉ា
kwak	គ្របដណ្តប់
tyuk	ខាងកើត
pwac	ដុំថ្ម
hkif	សេចក្តីថ្លៃថ្នូរ
nyac	ទិសដៅ
cyis	ប្រធាន
tyuc	រង់ចាំ
tsun	ភូមិ
tyik	យល់ព្រម
hnum	អារម្មណ៍បណ្ដែតបណ្ដោយ
slak	ភាពជោគជ័យ
tsic	ការព្យាយាម
slat	ភ្នំ
hmik	តន្ត្រី
hkus	យំ
hsip	ចំនួនប្រាំពីរ
hpaf	ឯកជន
nwas	ដំណឹង
tfac	កន្លែងកើតហេតុ
fyan	សួន
cwas	ចាប់ផ្តើម
hfik	ករណីបែងចែក
lyac	រៀន
syik	នយោបាយ
clin	Henry
cyin	ការកុហក
tsas	បោះ
cyik	អាជ្ញាធរមាន
tlap	ជាន់
cyam	នៅរដូវក្តៅ
tcut	សាសនា
tcap	រត់គេចខ្លួន
hlut	អ្នកនិពន្ធ
pyun	ត្នោត
tcuk	ការឈឺចាប់
swan	និទាឃរដូវ
hmun	ទន់
kyun	ជ្រុង
nyak	យីហោ
tsis	តុលាការ
psas	បង្កើត
cyaf	សើច
hwut	ភ្លេច
hyup	អឺរ៉ុប
hwap	ប្រាំបី
psak	ការស្លាប់
kyap	គួរឱ្យខ្លាច
pyic	បានទាមទារ
hmim	មធ្យម
hsaf	ដកដង្ហើម
hmis	ប្រាជ្ញា
hsum	សញ្ញាសម្គាល់ម្ចាស់
ksat	រីករាយ
ksit	ផ្នូរ
tsap	កោះ
kyam	ការបោះជំរុំ
tcum	ប៉ះ
cyun	សំណាង
psic	ច្រាំង
tyun	ដែន
mwit	អារម្មណ៍គណៈកម្មាការ
tlut	សញ្ញាបត្រ
myit	រដូវរងារ
kfan	ការប្រព្រឹត្ដ
slac	កំពុងរត់
myin	នាទី
tyip	នាំ
klas	កញ្ចក់
pfat	ក្រុមប្រឹក្សាភិបាល
cyic	ការឥតប្រយោជន៍
swam	កិច្ចការ
syam	សុវត្ថិភាព
tsut	គ្រូពេទ្យ
hlip	ទិដ្ឋភាពទាំងស្រុង
kcas	ភាពងងឹត
nyun	ក្តៅ
hpuc	ភេសជ្ជៈ
tlam	ឧទាហរណ៍
hfun	កំហឹង
tsik	ថ្វីបើ
tsam	ដោយ​ផ្ទាល់
hmup	មួក
klak	ឆ្កែ
slin	ប្រាក់
swac	ជាអ្នកបម្រើ
kcam	មោទនភាព
pyik	រថភ្លើង
myut	តម្រា
syak	ចូល
swat	ដាវ
kyuk	ការវាយប្រហារ
clac	សុខភាព
tyaf	កថាខណ្ឌ
swic	នៃ​សង្គម
tfit	ការបង្វិលសងប្រាក់
hkaf	មន្ត្រី
pcas	glanceមួយ
nyam	សិរីរុងរឿង
tfat	ទាំងដប់ពីររូប
pcut	ចូលរួម
pwin	ស្រា
mwat	រសជាតិ
fyac	ជាតិដែក
syap	ចែកចាយ
myap	ពាណិជ្ជកម្ម
hyum	ការប្រើ
fwak	ចៅក្រម
klat	ប្រធានក្រុម
twap	ទិដ្ឋភាពcessative
kcic	ចង់ដឹងចង់ឃើញ
kwic	បរទេស
hnif	ពង្រីកកាន់
myun	សារៈសំខាន់
tlic	ទីបំផុត
cyuk	ក
syut	សេរីភាព
pfan	ភាគី
kyuc	ស្ងួត
pcap	ឡែក
tfak	ភ័ស្តុតាង
tcik	ករណីភ័ស្តុតាង
twun	ឆ្ងាយ
tyis	ការរីកចំរើន
nyap	តូចចង្អៀត
plit	អគារ
hpif	ទំព័រ
pwic	ការកាន់
syic	ការសោកស្តាយ
tsip	អំពើបាប
syim	ឈឺ
tcis	មានភាពស្មោះត្រង់
pcun	ធនាគារ
ksap	ទទួលយក
lyam	ស្ទ្រីម
tcaf	ដោយប្រុងប្រយ័ត្ន
kwac	ត្រចៀក
hpup	នំបុ័ង
kcut	ជ្រើសយក
nwam	សត្វ
hsup	យែនឌ័រzoic
nwit	អារម្មណ៍ព្រឹត្តិការណ៍
tcim	សញ្ញាសម្គាល់ព្រឹត្តិការណ៍ដូចគ្នា
tlik	ករណីគុណ
kyus	ឆ្លងកាត់
hmus	ក្រាស់
kfat	ហ៊ាន
nwat	កើនឡើង
myic	ភ្លៀងធ្លាក់
hpum	ផ្ទៃ
swut	បរិសុទ្ធ
clis	ខែកក្កដា
mwun	ម៉ូដ
hfas	ឯកសារ
cwac	ស្មា
kwat	ការលួងលោម
nwac	នរណាម្នាក់
tcip	ចង់បាន
kfac	ស្មៅ
hmuk	គូរ
plin	ការបើក
kwun	ខែមិថុនា
mlik	ត្រី
klin	រដ្ឋធានី
pfut	សុដន់
twam	ពាក្យបណ្តឹង
fyin	ការចំណាយ
nlit	របស់​អ្នក
mlin	លាននាក់
pyut	អធិស្ឋាន
hluk	ធុញទ្រាន់
ksut	សម្លាប់
cyut	ស្រមោល
psin	ទំងន់
kcis	ប្រផេះ
pyam	ក្លាហាន
mwac	ពេញចិត្ត
klam	ប្រាប់
ksam	ជាតិ
hfip	ការចុះខ្សោយ
klik	ជ្រលងភ្នំ
hkum	អារម្មណ៍ប្រថុយប្រថាន
clas	លឿង
cyuc	កំដៅ
mlac	នៅសល់
syip	ស្មើភាពគ្នា
pwak	ប្រអប់
tcif	ស្រួច
psip	គោលការណ៍
ksik	លទ្ធផល
tsim	រដូវកាល
flan	អ្នកវិទ្យាសាស្រ្ត
pcam	ជាក់ស្តែង
kcun	ធុញ
ksuk	ពូ
mlit	បញ្ជី
pcik	គ្រោះថ្នាក់
kwas	ខែសីហា
hluc	ពេញនិយម
klit	មិន​ស្គាល់
flak	ស៊ាំ
fyit	ការចុះបញ្ជីស៊ាំ
lwat	កម្មវិធីអាន
plun	ការដើរ
twas	ពីរដង
pcis	លោកបូជាចារ្យ
fyas	រងរបួស
nlat	ព្រះបរមរាជវាំង
myuk	បន្លំភ្នែក
pfak	អនុគ្រោះ
tcuf	ប្រាំបួន
cwap	ការអាណិតអាសូរ
plac	ផ្ទុះ
pyap	ដាក់
lyic	ការស្លៀកពាក់
hcum	សំលេងរំខាន
lwit	អក្សរសាស្រ្ត
tsuk	ឋានៈ
hfup	ព្យុះ
kcik	ហោប៉ៅ
nwap	ខែវិច្ឆិកា
tyim	ខែធ្នូ
psaf	អវត្តមាន
nlac	ចំនួនប្រជាជន
kyaf	សូមអរគុណ
slis	ស៊េរី
pyaf	បក្សី
mlak	ម្ចាស់
kwut	អាវធំ
hwuc	ទំនាក់ទំនង
pyis	យ៉ាងឆាប់រហ័ស
twuc	ផ្សែង
nwak	ខែមករា
mlic	ម៉ាស៊ីន
tlis	ធ្មេញ
ksun	ការដុត
clam	ការខ្មាស់អៀន
klaf	គុណភាព
clit	ចិញ្ចៀន
fyak	ឃ្លា
fyam	សញ្ញាសម្គាល់ឃ្លា
kwap	ការ៉េ
hwip	ថ្ងៃអាទិត្យ
psis	កំណាព្យ
pwut	undefined
kyim	ទិញ
clic	វាល
pyip	ខែមេសា
kfap	ខែតុលា
psut	វត្ថុ
kcuc	ជូរចត់
nlap	ទាសករ
hsok	រលុង
htet	អត្ថបទ
hbat	អាក្រក់បំផុត
hrit	ឥណទាន
hzit	លក្ខណៈពិសេស
hpet	ដប់ប្រាំ
krac	សាហាវ
hduc	ធូលីដី
hrik	ជាក់ស្តែង
hron	ប៍ន
hnus	ច្រមុះ
hric	មិត្តភាព
srik	ផ្គត់ផ្គង់
hten	កាលពីម្សិលមិញ
tlet	hesternalតានតឹង
slap	បរាជ័យ
hban	ពាក់
hdat	ពិការភ្នែក
fran	ការហោះហើរ
hdan	មារ
htec	ជាបណ្តើរ
hmon	បេសកកម្ម
cran	ការលះបង់
hran	មនសិការ
hmos	លោករដ្ឋមន្រ្តី
nrit	ថាមពល
hcet	ស្អប់
hset	កណ្តាល
hrin	យែនឌ័រសមហេតុផល
hcot	រីករាយជាមួយ
hrip	សង្ខេប
htep	គោរពបូជា
hcif	ស្បែក
hrat	ដំបូល
kran	ភ្នំពេញក្រោន
hkon	ប្រាសាទ
tran	ភាពអស់សង្ឃឹម
hmif	ម៉ាយ
trin	រង្វង់
hgin	គុក
hkop	ពែង
hcen	សមាជិក
swin	ស៊ីវិល
hrac	នៅគ្រប់ទីកន្លែង
hris	ផ្ទាល់ខ្លួន
hbin	ការក្លាយខ្លួន
hmot	សាច់
hdut	ទឹកដោះគោ
hwen	យែនឌ័ររុក្ខជាតិ
nran	កម្រ
hbac	បងប្អូនជីដូនមួយ
crut	ស្ពាន
hsoc	ភាគហ៊ុន
hsom	អំបិល
nris	គ្មានកំហុស
hbit	ជៀសវាង
crin	ការកោតសរសើរ
rwin	មហាក្សត្រី
hgut	រាប់ចំនួន
hdas	ការរាំ
hnot	សណ្ឋាគារ
hdin	បំពេញ
hton	អ្នកទោស
hdak	ហាង
hlet	ជណ្តើរ
hson	ការលើកលែងទោស
hgek	មនុស្សស្រឡាញ់ភេទដូចគ្នា
hras	ការបូមខ្សាច់
hsep	កញ្ញា
hbic	ប្រាសាទបុរាណ
hlen	អាជ្ញាប័ណ្ណ
hcon	គ្រប់គ្រាន់
hgit	សាក្សី
kfon	ផ្ទះបាយ
hbak	លក់
tlim	ការព្យាបាល
hsot	ល្បឿន
kyut	កុំព្យូទ័រ
hnen	អស់កល្បជានិច្ច
htek	បណ្ណាល័យ
hzan	មាន
hbis	មូលដ្ឋាន
hbun	ការយល់ច្រឡំ
kcus	ចុងភៅ
hgat	វាលខ្សាច់
hwus	ថើប
hbif	ទឹកកក
hbot	បាល់
hrut	អាគុយម៉ង់
hdit	អារម្មណ៍Benedict
hdis	មានកំហុស
hjan	ការផ្តន្ទាទោស
plis	ប៉ូលីសបាន
hgan	លាក់
hsen	បេសកកម្ម
nrin	ល្ងង់ខ្លៅ
hyen	ពពក
frif	កុម្ភៈ
hdik	ជំងឺ
hnek	ករណីផ្តួចផ្តើម
hbam	មីង
hmen	ដែលមានចិត្ដរាបទាប
hdip	ការចាំបាច់ពន្យាពេល
prat	ភ័ស្តុតាងដែលបានរាយការណ៍
hdet	កណ្តាលអធ្រាត្រ
hjit	ម្រាមដៃ
hmoc	កន្លែងណា
pran	កាសែត
kcec	តំបន់
hken	យឺតយ៉ាវ
hloc	ស្រងេះស្រងោច
hrak	បុគ្គលិក
htes	មើល
rwan	រង្វាន់
hdon	បរិច្ចាក
htot	ថ្ងាស
hnet	ទេវតា
hdun	ឯកវចនៈ
croc	កំហុស
hlon	ព្រឹកព្រលឹម
hyec	ចៀម
hjin	ការអត់ធ្មត់
hrec	យោង
mran	ពោត
htos	ភាគច្រើន
hcos	វិធានការ
hkoc	ម្តងម្កាល
hlif	ប្រាក់ចំណេញ
clak	ជាតិស្ករ
hjat	មនុស្សជាតិ
tram	ស៊ុម
hdic	ថាស
hkok	ឯកោ
srat	សិល្បករ
crak	ការទាក់ទាញ
hmet	អ៊ីម៉ែល
hden	ការសម្រេចចិត្ត
gran	អភិបាល
crac	សាខា
hjac	ភាពរីករាយ
hdim	អារម្មណ៍ដំបូង
hcok	ប្រញាប់
hyet	ប្រេង
pwap	បំពង់
trat	បោះពុម្ព
tcot	រូបធាតុរឹង
hdoc	អូ!
hren	បរិបទសុន្ទរកថា
tcon	ថ្ងៃត្រង់
krin	ផ្ទៃខាងក្នុងរថយន្ត
plam	សំឡេងរោទិ៍
hnes	ប្រសាទ
tcen	សង្កេត
hsek	ទិដ្ឋភាព
plik	អនុវត្ត
slik	សូត្រ
hfen	ភាគ
hgen	ភ្នាក់ងារ
hnon	សហជីព
crik	ស្ថាននរក
tcet	ជម្ងឺ
mrat	ការលាយបញ្ចូលគ្នា
hdam	អារម្មណ៍ការដាស់តឿន
hgac	មហិច្ឆតា
htoc	ដូចម្ដេច
hdac	ការប្រឹក្សា
nwin	រដ្ឋធម្មនុញ្ញ
srit	ឧបករណ៍
hret	យ៉ាងរឹងមាំ
nlin	លើបណ្តាញ
hzat	ជំនោរ
klic	មហាវិទ្យាល័យ
hkek	កន្ទុយ
nric	ជំនាន់
hgic	ហ្វូងមនុស្ស
hgak	ឆ្មា
trit	បង្ហាញភស្តុតាងដោយផ្ទាល់
tyot	សន្ធិសញ្ញា
hnok	មាតិកា
crit	បោះបង់ចោល
slen	សាវ័កដប់មួយរូប
srin	សភាវគតិ
hpok	កុលសម្ព័ន្ធ
hyot	អារម្មណ៍បារម្ភ
cric	ទីជម្រក
hruc	ឈ្លើយ
cwin	ជិះ
hzak	អ្រងួន
dyit	ឧស្សាហកម្ម
hpec	វិជ្ជាជីវៈមេធាវីជាវិជ្ជាជីវៈ
nras	គិនុប្ឋ
hcec	បង្រៀន
hbut	ស្បែកជើងមាន
hmec	មិនច្បាស់លាស់
twot	សកម្មភាព
crat	ថ្ងៃសៅរ៍
hkot	សមត្ថភាព
hnec	ពន្លឺថ្ង
hwuf	មេម៉ាយ
cren	ស្រក់
nrat	តារា
hget	ភ្ញៀវ
hbik	ប្រទានពរដល់
brin	ផ្នែកខាងក្នុង
hpot	ដែលអាចប្រើបាន
trac	ការតស៊ូ
prac	ទាញយក
hcoc	ប្រហោង
hpon	ខេត្ត
hwim	ស៊ីវិល័យ
dwan	ព្យួរ
cwok	ឆក់
hdok	ការបើកបរ
crun	ទ្រព្យសម្បត្តិ
hzik	គ្រាប់ពូជ
hrot	ថ្មីអតីតកាល
hket	ភ្ញាក់
hcek	គ្រឿងសង្ហារឹម
hrop	មិនទាន់មានច្បាប់ប្រឆាំង
mrac	ការផ្សងព្រេង
byit	ពិធីបុណ្យ
trak	ប្រចាំឆ្នាំរបស់
hzin	ភាគខាងត្បូង
sric	ពិធី
clik	ម៉ាញ់
trap	សេរី
hrim	គ្រីស្ទសាសនា
hrus	ព្រះនាង
blat	អាសនៈ
cyon	តូច
hwep	បណ្ដាញ
krat	ខា
tris	ស្វាយ
kcot	ប្រមូលផ្តុំ
hben	ការបោះឆ្នោត
trik	ស្រវឹង
kfit	ការលើក
tcec	ការផ្លាស់ប្តូរ
nrik	គុណនាមវិសេសច្បាស់លាស់
grat	អធិរាជ
dran	រដ្ឋបាល
hpen	កាលពីមុន
cluk	អាក្រក់
nrac	គ្មានការបង្កគ្រោះថ្នាក់
ryin	ការបណ្តុះបណ្តាល
hrun	រមៀល
nwic	អ៊ីញ
slit	បាញ់
gzat	កាសែត
krot	កាត់
drit	ពុកចង្ការ
hzis	ហែក
hdap	ដប់ប្រាំបី
sris	ប្រវត្តិសាស្រ្ត
mrut	សរុប
nyik	ភក់
bran	កូនក្រមុំ
drat	អាស្រ័យ
djan	យក្ស
glat	ភាពសាមញ្ញ
hpoc	រដូវស្លឹកឈើជ្រុះ
pras	ស្បៃមុខ
hgot	ការជួបជុំ
tret	ល្ខោន
tras	ប្រៀបធៀប
rwit	គូប្រជែង
hfon	បង្កើត
klot	គ្រូបង្វឹកក្រុម
hmum	កំប្លែង
drac	សុន្ទរកថា
rwas	ប្រលោមលោក
tset	សងសឹក
hdot	distalង្ហេញ
ryut	ច្រណែន
hwon	ការអញ្ជើញ
byat	ដុត
flac	ភ្លើងFlash
prot	បញ្ឈរ
crek	ផ្ដល់យោបល់
htok	ជម្លោះ
htop	ដាក់​​បណ្តាសា
prit	អារម្មណ៍imprecative
hces	អស់សង្ឃឹម
klup	ក្លិប
hnos	ទឹកជំនន់
dwin	ព្រងើយកណ្តើយ
prin	ផ្តេក
mrit	អារម្មណ៍ការសន្មត់
tcoc	ចោត
hcom	ភាពសុខដុម
grit	ផ្គរលាន់
tlot	កុមារភាព
hgik	ជង្គង់
hwes	សន្លប់
hzac	គ្នាទៅវិញទៅមក
hsec	ផ្នែកទន់
tson	ស្ថាប័ន
ryit	វិក័យប័ត្រ
dlin	វិន័យ
slip	ប័ណ្ណ
klon	បដិវត្ដន៍
hfim	កសិករ
hpom	វេទិកា
cyen	និស្សិត
hgec	រូងភ្នំ
hroc	ប្រពៃណី
srac	ដាក់
ryat	សោកនាដកម្ម
kcen	ស្ត្រីព្រហ្មចារី
hbap	លា
krik	ការរិះគន់
krap	កប្បាស
fwat	មន្ទីរពេទ្យ
kcet	ជួល
hgas	ឧស្ម័ន
pfin	ជៀសមិនរួច
dlit	ស្លឹក
ryan	ការបកប្រែ
sran	ពិធីបុណ្យ​សព
mrin	ម្សៅ
hram	រ៉ូមែនទិក
dlan	ប្រាក់ដុល្លារ
hzas	កំប្លែង
hsos	ដប់ប្រាំមួយ
klen	អាណានិគម
gyin	ស្លាប
hsif	សត្វតោ
cluc	ល្បិចកល
prip	ការត្រៀមរៀបចំ
hzut	អ័ព្ទ
dwat	ថ្នាំ
krit	ពិនិត្យមើលសំបុត្រ
sras	សំបុក
hses	ដប់បួន
brat	ការជំទាស់
flat	ទឹកអាស៊ីត
hjic	គឺ
slic	អាវុធ
hbuc	អ្នកប្រើ
tron	ទឹកក្រូច
byan	ងូតទឹក
hrif	បុព្វកាល
tlip	បង្កើត
blan	កញ្ចប់
kris	លេខាធិការ
hyon	ពេលតំណាលគ្នា
tren	ថ្ងៃនេះ
dlat	hodiernalតានតឹង
hzic	ថ្នាំពុល
tfic	កាំភ្លើង
tlen	ទេពកោសល្យ
hlim	អាកាសធាតុ
dyat	មិត្តរួម
kcon	វិវរណៈ
dlac	លាង
krak	ការសារភាព
hbas	មិនសមហេតុសមផល
hkec	ធ្យូងថ្ម
hrek	ស្តារ
hkos	ទូកកាណូ
hwif	អនុ
tric	ជាបណ្តោះអាសន្ន
hdep	ទិដ្ឋភាពសញ្ញាកំណត់ព្រំដែន
mwak	គំនរ
ksot	ឆ្អឹង
hnoc	ថ្ងៃចន្ទ
nlas	កាលពីថ្ងៃអង្គារ
brac	ថ្ងៃពុធ
frap	សហព័ន្ធ
pfit	តំណាង
pcoc	បង្គោល
lyen	ក្រណាត់ទេសឯក
swak	លិច
pcen	ប្រធាន
brit	បង្ហូរឈាម
hwec	ការឡោមព័ទ្ធ
hwet	ក្រពះ
hlos	ជាន់លើ
hbon	ផ្លាស់ប្តូរ
pcon	លង្ហិន
hsem	កិច្ចប្រជុំកំពូល
lwac	ដែលមានតំលៃថោក
tsos	ការប្រកួត
kwen	មនុស្សដែលផ្តាច់មុខ
trun	ចុះចត
trut	រូបចម្លាក់
hrap	កាំភ្លើងធំ
hgap	ចាប់ខ្លួន
trot	សីតុណ្ហាភាព
grin	សង្កាត់
hjak	ចាប់យក
hpek	កញ្ចប់
hlus	សត្វ​ក្តា​ន់
hwos	បន្ទប់គេង
tsuc	ព្រៃ
pcuc	ឆក់
cris	ទាយាទ
clun	ដើមជ្រៃ
hpes	មិនល្អ
nlet	មិនពេញលេញ
hrom	កម្មវិធី
pyon	ព្យាណូ
swet	បញ្ចុះបញ្ចូល
dric	មើលមិនឃើញ
tyen	គេស្គាល់ផងដែរ
hruk	ភាព​សាហាវ​ឃោរ​ឃៅ
frat	ដែលបានផ្ដល់
hyoc	ការល្បួង
hlep	ទិដ្ឋភាពtelic
nrot	អន្ដរជាតិ
nret	ហិង្សា
hfif	ទស្សនវិទូ
pfic	តំណាង
hmek	អក្សរតូចធំ
hfec	សុខុមាលភាព
myik	ការនេសាទត្រី
truc	ការលួច
tcop	បបូរមាត់
rwic	ចូលនិវត្តន៍
htom	សេដ្ឋកិច្ច
glan	វិចិត្រសាល
pren	ស្រប
hlek	ទិដ្ឋភាពatelic
nrak	ទ្វីប
truk	អាក្រក់
hjim	អារម្មណ៍ការហាមឃាត់
rwat	ស្មើ
hcep	កោសិកា
dyan	ស៊ុត
jrat	សិប្បនិម្មិត
nren	ការបំផុសគំនិត
ksic	វិបត្តិ
tsoc	ការស្វែងរក
lwan	អាហារថ្ងៃត្រង់
hpos	ស្រល់
hcuf	ការជំរុញ
tcus	ប្ដឹង
pset	ពង្រីក
hkep	ស្ពាន់
swis	នាវិក
prim	អធិរាជ
trip	ខ្សែតី
cras	អាវ
swap	យុទ្ធនាការ
syet	បង្ហាញប្រភេទរូបភាព
htof	ចោរ
clen	ឆានែល
kwit	បុគ្គលិកលក្ខណៈ
klok	លើស
hrok	កំណែទម្រង់
hguc	ស្រេកទឹក
kcim	ការគំរាមកំហែង
hpem	ដូង
psik	វាគ្មិន
frit	កម្រិតពន្លឺ
cret	ដាន
mrak	លំពែង
syen	សម័យ
tcup	សើម
hyek	ការធ្វើដំណើរ
trim	សំណប៉ាហាំង
plak	ពាក្យបណ្តឹង
hyok	មុំ
hgam	គោ
hmok	រោងម៉ាស៊ីនកិន
jrac	ផែនទី
kloc	កអាវ
gyit	ចេតនា
hbip	ស្រាបៀរ
mlet	កាម្ញី
lyap	ការរំលោភបំពាន
cwen	ហ្វូងចៀម
bwan	ក្មួយស្រី
tses	ដប់បី
jrit	បង្ហាញអំពីភាពត្រឹមត្រូវ
nlak	សាត្រាស្លឹករឹត
sron	អ្នកចម្បាំង
cruc	ថ្ងៃសុក្រ
broc	ជក់
dlot	ទាញយក
krim	ក្រែម
pric	ទីលាន
prut	គណៈវិនិច្ឆ័យ
hgon	កក
sram	ព្យញ្ជនៈ
pfot	សក្តានុពល
hlot	ដែលបានគ្រោងទុក
djin	កាក់
hlok	បង្គ្រប់
hpep	ផ្លែប៉ោម
hwot	ស្រស់
dlak	ពិភាក្សា
brik	ជាវជាប្រចាំ
nlis	ចម្លង
hbet	ភ្នាល់
pris	មេរោគ
hjik	បដិសណ្ឋារកិច្ច
blit	ដូចកូនក្មេង
hjap	អាវ
tfik	ឆ្លុះបញ្ចាំងពី
hdaf	សំរេចបាន
hpop	ល្ខោនអូប៉េរ៉ា
kcaf	លាក់ខ្លួន
kcoc	កែង
hrum	ជួសជុល
cyim	គួរឱ្យសង្ស័យ
dyic	ការអប់រំ
hgoc	រណ្តៅ
drak	ជំងឺ
plas	ការទះដៃ
byin	ប្រព័ន្ធគោលពីរ
hzap	Abbey
nlot	ភាពស្មោះត្រង់
mrik	មេកានិច
hsop	ដោយជោគជ័យ
crap	អន្ទាក់
kyek	នំ
nrut	ការកំសាន្ត
syes	លោក
hjet	ដប់ប្រាំពីរ
hjen	ស្រី
hmom	ទឹកឃ្មុំ
hdec	ជាអកុសល
lwen	រឿងព្រេង
slot	ចង្ក្រាន
frac	ក្រុមឧទ្ទាម
gwan	ហើម
mruk	ការកែលម្អ
swot	វាលភក់
zlan	រកប្រាក់ចំណូល
hnem	ចលនា
hdes	ការស្លៀកពាក់
prak	ប្រកាស
frin	ទេសភាព
hfet	ប្រឆាំងនឹងការ
cros	ជួយច្រៀងបន្ទរ
ryon	សមហេតុផល
tcos	ដំណាំ
tsen	ដំណើរការ
hwek	ចចក
nlik	ការបដិសេធ
klap	កំរាលព្រំ
dras	មើលងាយ
prop	មានជីជាតិ
slim	កញ្ចែ
hgis	ឈីស
krut	ខាំ
srot	ចុន
bjan	វង្វេង
nwen	កងទ័ពជើងទឹក
myas	របាំង
kwaf	ការអភិវឌ្ឍ
twis	ក្បាំងមុខ
pcip	ខ្មៅដៃ
srap	បន្លែ
sren	ពិព័រណ៍
tlun	ខោ
hrup	អំពើពុករលួយ
nrip	គណៈរដ្ឋមន្រ្តី
srup	ស៊ុប
jran	គ្រូពេទ្យវះកាត់
bjat	ប្រាក់ឧបត្ថម្ភ
gyat	ចារកម្ម
hlem	មិនប្រុងប្រយ័ត្ន
srak	អរូបី
kson	ការបញ្ចេញសំឡេង
cwis	ថ្ងៃព្រហស្បតិ៍
sret	ដោយស្មោះ
hraf	ចរាចរណ៍
hres	ស្ថាបត្យកម្ម
hsuf	ការចោល
rwak	ការបង្ក្រាប
twon	គ្រឿងតុបតែង
hfus	ការងើបឡើងវិញ
hkom	លេខកូដ
djat	នាងហិនទ័រ
nlut	ព្រឹត្តិប័ត្រ
hsef	សត្វពស់
mris	ធិបតេយ្យ
bric	ថ្ម
mlam	ក្រមួន
zran	ចែករំលែក
cron	រំភើប
hzen	ការហែលទឹក
traf	បន្ទះ
cwaf	ស្រោមសំបុត្រ
srip	បារី
mrot	ម៉ូតូ
swon	អ្នកស្ម័គ្រចិត្ត
ryak	ប្រតិកម្ម
pfun	ដោយផ្នែក
blac	ឥវ៉ាន់
mret	ក្រសួង
hjon	ផ្លូវភេទ
kcok	ពូថៅ
dram	ពេជ្រ
kren	ជំនួស
tcek	អេកូ
hdif	អត្តសញ្ញាណ
tfas	ឯកអគ្គរដ្ឋទូត
hfot	មាន
lwas	ខ្ជិល
hmep	ទិដ្ឋភាពmomentane
kfin	ការអ៊ិនកូដ
mwin	ស្រមើលស្រមៃ
hrem	កាំរស្មី
pram	ឡើង
byac	ក្រោ
mren	ចងចាំ
swen	ព្រឹទ្ធសភា
kras	មឈូស
hgun	លេបទឹកមាត់
nlok	indulge
ryic	កសិកម្ម
gwin	តំលៃ
srut	វាលស្ផោ
hkes	ស្មុគ្រស្មាញ
hfis	ការលាលែងពីតំណែង
frak	ម្តងហើយម្តងទៀត
hnom	ការឃុបឃិត
hcop	បោះពុម្ព
hlec	ម្រេច
mlot	បទភ្លេង
zrat	បេក្ខជន
proc	អ្នកឧបត្ថម្ភ
flik	កញ្ជ្រោង
cyet	undefined
hgim	បំពង់ផ្សែង
slet	ការពារហានិភ័យ
tcok	ភាពត្រឹមត្រូវ
bjit	អតីតស្លាប់
brot	bud
bwat	ភួយ
hdus	ជ្រូក
gwat	ភ្លុក
kret	ការដកស្រង់
nwet	អ្នកសង្កេតការណ៍
jwan	ផ្លូវ
nwis	ក្រចក
mwic	សត្វឃ្មុំ
bzat	តារាសម្តែង
gyan	ញើស
zyit	ប្រតិបត្តិ
blic	ការបំភាន់
pcet	ភាពមិនច្បាស់លាស់
tsot	បត់
bwit	ព្រំដែន
tres	ភាពតានតឹង
hkof	ការប្រើប្រាស់
nyen	ថូរ
hles	ស្រដៀងទៅនឹង
cyek	បាវ
hjis	ម្ជុល
gjan	បាតុភូត
prec	មានឥរិយាបទ
drot	បានត្រួតពិនិត្យ
kcek	ខ្សែកោង
twic	សាច់​មាន់
brak	ធុង
zwat	ទម្លាប់
clap	ទិដ្ឋភាពធម្មតា
tsec	អ្នកជំនាញ
bwin	គួរឱ្យចាប់អារម្មណ៍
cwet	bounded
hbek	លោកBaker
zlin	អូលីវ
mron	ឡាន
drin	លះបង់
psap	បកអាក្រាត
gjin	ថ្ងៃខួបកំណើត
clut	ញញួរ
cwun	ក្រអូប
twaf	រឿងតូចតាច
pcot	ចិញ្ចឹម
krok	លលាដ៍ក្បាល
dlik	អង្គនីតិបញ្ញត្តិ
cwic	សំណាងល្អ
srun	ចងចិញ្ចើម
crec	បំផ្លាញ
jlan	រឹម
kcip	ជើងឯក
blin	ពាន់លាន
ryik	គីមី
mlas	ជីពចរ
flit	សាកល្បង
hzet	រៀបការ
cwik	មហាអស្ចារ្យ
twet	សំពត់
mwik	ប្រចាំសប្តាហ៍
tfis	បច្ចេកទេស
tlon	រថយន្ត
cram	undefined
grac	ពង្រឹង
kraf	ក្អេក
trup	គុណលក្ខណៈ
hduk	ទំពក់
cruk	សត្វខ្លា
nrap	ផ្ទះ
crot	ផ្លូវហាយវ៉េ
mlip	កងជីវពល
hfoc	រូបថត
nres	បូរណភាព
plos	បូក
tfam	តម្លាភាព
nlic	ដប់របា
hwok	មានលក្ខណៈសម្បត្តិគ្រប់គ្រាន់
nlen	អត្ថបទ
fyic	ប្រសិទ្ធិភាព
hwuk	តែមួយគត់
hgok	សរីរាង្គ
flic	ទេវវិទ្យា
flot	អ​ណ្តែ​ត
hboc	កាតព្វកិច្ច
hwoc	មេធ្មប់
syot	ស្ទូឌីយោ
cwip	ស្រា​សំ​ប៉ា​ញ
hbes	បដា
lwic	ការលែងលះ
blot	ន្លឹ
cwot	ឈ្លើយ
cwam	សរសៃ
prik	អកម្ម
hfum	ស្នោ
grik	ក្រួស
zrin	អាវអៀម
gren	ភពផែនដី
hfuc	ការរស់ឡើងវិញ
claf	ធ្នើ
flas	អ្នកគាំទ្រ
hjot	តំបន់ត្រូពិក
hbim	ដោយបំពាន
krek	បារត
hbec	undefined
tsaf	ធ្វើអត្តឃាត
pwas	ហ
plot	រាយការណ៍
kfak	ចំណាយ
blak	យ៉រ
hdos	ស្នាមប្រឡាក់
kwis	បុរាណ
kcos	ចោទ​ប្រកា​ន
psen	ប្រាក់សោធននិវត្តន៍
kres	កិរិយាស័ព្ទ
hzon	ស្វា
srim	ហត្ថលេខា
glin	ការស្ទាក់ស្ទើរ
mlut	មានកេរ្តិ៍ឈ្មោះ
myot	ការនាំចូល
fwac	ស្ថាបនិក
troc	ពិល
hgaf	វេយ្យាករណ៍
hyop	ទូក
ksip	ផុតពូជ
sres	ដំណើរកំសាន្ត
hnup	លំហ
hzun	រឹងរូស
mric	សាច់ដុំ
gjat	រ៉ិចទ័រ
hros	ការលុប
zrac	កំសាក
tros	នំបុ័ងអាំង
myus	កណ្តុរ
dwac	កិច្ចពិភាក្សា
byak	ពពែ
htef	ជាងកាត់ដេរ
hfek	មានការរីកចំរើន
dzan	ដាក់
nyon	អនាមិក
zrit	ការចុះបញ្ជីជាផ្លូវការ
pcos	កីឡា
hjec	រលាយ
dlas	លុប
mras	ឆ័ត្រ
mram	រ៉ែ
cwut	បទឈប់បាញ់
hbok	ទា
swun	សាប៊ូ
dwak	តុក្កតា
plif	វីឡា
slon	ដេរ
tfut	សូមអបអរសាទរ
djac	ផ្សះផ្សា
hjas	ការគាបសង្កត់
kric	ទន្សាយ
kwot	ចំហាយ
gzan	ការធានា
clot	កីឡាករ
ksek	សត្វល្អិត
psam	ឥរិយាបថ
mwut	សត្វទីទុយ
htem	ជាអចិន្ត្រៃ
clon	វីយូឡុង
dzin	អ្នកស្រុក
rwim	រៀង
hyof	ប្រយោជន៍
dron	នាគ
dwit	ភ័ស្តុតាងauditory
sroc	ការនាំចេញ
hzot	បញ្ចប់
djik	linger
kfik	គំរប
ryun	បទប្បញ្ញត្តិ
hmes	ចៅហ្វាយក្រុង
rwac	ផ្នែករឹង
sruk	សៀក
sros	ជនជាតិភាគតិច
bzan	កុបកម្ម
kset	វង់តន្រ្តី
bjon	កិត្តិយស
hjut	គ្មានដែនកំណត់
tfen	ការពារ
zwac	គុណវិបត្តិ
dyin	ការពិភាក្សា
myis	តន្ត្រីករ
mlis	បញ្ញាស្មារតី
pret	មិនគ្រប់គ្រាន់
tsek	ស្ថាបត្យករ
hlom	ក្រូចឆ្មា
ksos	ក្អក
crok	ឈឺក្បាល
flin	ជីជាតិ
mrun	ជាងឈើ
swec	ចៃដន្យ
syuk	ស្លាបព្រា
blun	ប៉េងប៉ោង
tcep	ដីស
fric	កម្លាំងចិត្ដឡើងវិញ
rwik	បញ្ឈរ
rwen	ការការពារ
flet	ភ័ស្តុតាងinferential
pfac	ចាងហ្វាងការផ្សាយ
srek	ទឹកខ្មេះ
tfun	ផ្លូវរូងក្រោមដី
pwet	ផ្ដុំរូប
gyik	គណិតវិទ្យា
fwot	បន្ថយ
lwin	តុល្យភាព
jwin	ថ្លើម
bwik	ករណីsublative
hdup	ការធ្លាក់ចុះ
hnop	ផ្តាច់មុខ
bwic	នាវាមុជទឹក
ryen	ដោយមិនគិត
hcem	ការរញ្ជួយដី
hbos	មន្ទីរពិសោធន៍
nrek	កម្មករ
ryim	ចង្វាក់
nyic	បកស្រាយ
dwas	ស្ថានទូត
rwok	បង្ក
kram	អសមត្ថភាព
ksim	អារម្មណ៍ប្រកាស
clok	សូកូឡា
pcec	ដែលមានសិទ្ធិ
nyis	តាឥសី
tyoc	ចៃដន្យ
grak	កោស
zlat	ស្រោមដៃ
hjuk	លត់ជង្គង់
trif	ភូមិសាស្ដ្រ
djit	ប្រព័ន្ធ
pson	undefined
mwis	ការវិនិយោគ
cwec	ពាក្យសំដី
hdek	ដែលមិនមានសាសនា
blik	ស្ទាំង
sloc	ចិត្តវិទ្យា
brap	សំណល់អេតចាយ
jlat	ចោរ
dros	ម្ត
slam	ត្រីសាម៉ុង
pwun	pudding
gwik	ម៉េញ៉ទិក
pcop	ការបូម
myen	ដូចគ្នានេះដែរ
ksen	អុកស៊ីសែន
mrap	មេ
tfot	វិញ្ញាបនបត្រ
ksus	ចង្កោម
trok	វោហារសាស្ត្រ
tloc	សំន់
zyan	រចវា
nlun	ចូល
hlop	កែវពង្រីក
jlin	អក្ខរាវិរុទ្ធ
lyut	ពពក
hsof	ការsurf
fyik	ស្រាវីស្គី
klet	ទាក់ទង
hwof	willow
hlum	សត្វអូដ្ឋ
myet	ស្ម័គ្រចិត្ត
klis	ភាពឯកោ
hbaf	ជីវប្រវត្តិ
gwac	សត្វលា
hwum	ពាក្យចចាមអារាម
pwik	ទស្សនៈ
pron	គាំទ្រ
myes	ប្រចាំខែ
mwen	undefined
kfic	វិស្សមកាល
klek	ការចុច
cwon	រាងពងក្រពើ
lyak	យឺត
kwon	វចនានុក្រម
hjam	Ham
rwon	ឥន្ធនូ
crip	សូម
zwan	កើតមានឡើង
srok	ការបោះពុម្ពផ្សាយ
craf	ក្រុមហ៊ុន
tlok	ធុង
brip	មេអំបៅ
tfap	តារាង
jwat	ភ្លោះ
pros	ប្រតិបត្ដិការ
psun	ប្រផ្នូល
clet	undefined
hbus	ឫស្សី
dyas	អ្នកចែកបៀ
klun	ជាដុំ
jlit	ជាឯកច្ឆន្ទ
hdom	សុបិន្តអាក្រក់
kron	កាបូន
hzam	ស្ទះ
cyot	ស្តាប់
hmem	សារមន្ទីរ
lwam	អក្ខរក្រម
fras	វិធី
psoc	កណ្តាប់ដៃ
hgum	ស្ករកៅស៊ូ
brek	ហ្វ្រាំង
glit	ស្ថិរភាព
frun	បុក
gris	ឈ្លានពាន
mroc	កកិត
bzit	ពីងពាង
plut	ដំឡូង
glac	លោភលន់
gzac	គុណ
prun	បង្កើនបន្ថយ
jlet	ប្រតិទិន
nyim	ការតែងតាំង
tlos	ពាន់ពាន់លាន
slut	សាឡាត់
fwit	អារម្មណ៍វិជ្ជមាន
pyen	កម្មវិធី
nlon	បន្ទាប់បន្សំ
dren	បង្ហាញពី
drun	ការមិនពេញចិត្ត
cyok	កន្ដើ
hfop	បាល់ទាត់
ryac	ភាពជាដៃគូ
gzin	ជាអ្នកត្រួសត្រាយ
hgip	ស្ព
tyet	កីឡា
hdof	ideophone
hwup	មិនអាចកាត់ថ្លៃបាន
lwek	ដងថ្លឹង
syec	សមាជិកព្រឹទ្ធសភា
jyak	ផ្ទុក
mlim	ស្រមោច
fwic	ប្រសិទ្ធិភាព
gzit	មានផ្ទៃពោះ
blas	ការពឹងផ្អែក
jrin	ជា​រៀងរាល់ថ្ងៃ
gwak	កជើង
drik	ចម្លែក
prif	អថេរ
jwit	ភាពសម្បូរបែប
krip	ការរើសអើង
ryot	undefined
nwut	ចិញ្ចើមផ្លូវ
kcif	យ៉ាងសកម្ម
jrak	កង្កែប
twek	ករណីexessive
psot	ដង្វាយធួន
pfon	អេប៉ុង
sluk	កំប្រុក
nlim	អារម្មណ៍irrealis
ksaf	កង្វះខាត
glak	ភ្នំភ្លើង
plen	លំនឹង
kfaf	កន្សែង
kyon	ទាញយក
jlik	ភូមិសាស្ត្រ
psop	លិខិតឆ្លងដែន
kfis	ទំនេរ
fyon	ដូចគ្នា
nram	ប្រាសចាក
hbuk	biscuit
gras	Trance
hyos	បារម្ភ
flim	ខ្សែភាពយន្ត
plet	កុំព្យូទ័របន្ទះ
rwam	អាតូម
blis	vanilla
zlit	ជំនួយ
fyut	មានfastidious
crim	សាជីជ្រុង
hjif	ខុសច្បាប់
crif	shyness
lwap	Lute
tyon	វិស័យតារាសាស្ត្រ
mrim	ផ្ទាំងសិលា
drut	បរិយាយ
nrim	អាហារូបករណ៍
kruc	អណ្តើក
kwam	ទីប្រឹក្សា
jrik	កីឡាcricket
dlut	បញ្ជាក់
pyot	ព្រាប
dyon	ការបន្សាំ
prap	ប្រតិបត្តិករ
bzin	ផ្លាកសញ្ញា
tyek	ត្រីកោណ
trec	ហេរញ្ញិក
nron	អ៊ីដ្រូសែន
pyet	ម៉ាស៊ីនបោះពុម្ព
tsok	choke
zyin	រ៉ាំរ៉ៃ
slek	កង់
jyin	វិស្វកម្ម
ryas	ការបញ្ជូន
zrak	ធ្វើឱ្យស្រស់
nyas	អ្នករាំរបាំ
gric	ការធ្វើចំណាកស្រុក
zlak	រំលោភលើ
tces	កីឡាវាយកូនបាល់
hjun	ខ្យល់
twen	ត្បាញ
kyet	អ្នកប្រមូល
gwit	ឆ្អឹងខ្នង
kyot	អង្កត់ធ្នូ
fwin	ប្រេកង់
tfuc	loom
dlet	ថត
pfik	អ្នកគិត
bjet	ថវិកា
trek	ជាយុទ្ធសាស្រ្ត
kros	រ៉ែថ្មខៀវ
gjit	កន្ត្រៃ
gwic	ការផ្លាស់ប្តូរ
frik	ទ្រឹស្តី
tluc	កន្សែង
pruc	ល្បាត
glic	ផែនទឹកកក
krun	ភាពពេញលេញ
bjin	ការព្យាករ
tlaf	ចូលរួម
tfet	ក្រុមហ៊ុនផលិត
bras	នៅពេលក្រោយ
dwik	ជនជាប់ចោទ
clec	ផ្សង
cres	អុក
tcef	cherry
tcom	ជំពប់ដួល
nyot	បកប្រែ
tyok	រថយន្តដឹកទំនិញ
cyip	កើនលើស
grot	ល្អិត
bris	ឥតខ្សែ
nlam	លក់ដេញថ្លៃ
slif	Sieveបាន
hgos	ច្រែះ
swoc	មិននឹងនរ
jyat	ក្ស័យធន
slum	សាសនាអ៊ីស្លាម
hjes	ការធ្វើជំរឿន
dzat	tiptoe
slun	ផ្អាក
nwot	បន្ត
gyic	ហ្គីតា
pfas	ភាពលំអៀង
zyik	ស័ង្កសី
blen	ភ្លឺចាំង
hyem	elm
hnep	វីវក់
nyut	knitted
ryam	សញ្ញាសម្គាល់សព្វនាម
clim	គ្រឿងទេស
jret	ក្រុមហ៊ុនSharp
tfon	និយាយលេង
jwac	Java
hrep	រូបមន្ត
dyac	ស៊េរីរឿង
myip	ម៉ែត្រ
rwis	ពូជសាសន៍
hkem	ផ្កាយដុះកន្ទុយ
nwon	ការបង្កើតថ្មី
zwin	ការហាមឃាត់
dyis	មជ្ឈិមសម័យ
mrec	ចាប
fyot	លេខយោង
mlon	ការវាស់វែង
pfis	ការផ្តល់សច្ចាប័ន
rwot	គន្លង
hfok	សន្សំសំចៃ
glof	កីឡាវាយកូនគោល
zron	សូន្យ
hzip	បង្ហាប់
hwom	គ្មានផ្ទះសម្បែង
bjic	ការទំពារ
pcim	បំពេញ
hjip	បន្ទះឈីប
bwac	សាប
mlos	mole
mrip	គ្រឿងស្មូន
bron	អំប្រ៊ីយ៉ុង
ksoc	ការដក
cyum	ផ្សិត
jyan	ភាសា
plim	ព្រូន
mwet	កន្លែងបញ្ចុះសព
ryet	បញ្ចប់ការសិក្សា
glik	ប្រព័ន្ធធារាសាស្ដ្រ
plap	មូលធន
tsif	ការបត់បែន
gyak	ត្រីឆ្លាម
djon	លំនាំដើម
nwun	ទៀងទាត់
cles	របាកដនិយម
dris	រឹតតែ​កើនឡើង
hkef	ហាងកាហ្វេ
blus	រថយន្តសង្គ្រោះបន្ទាន់
blap	កាបូបលុយ
bjak	undefined
klim	grimace
gyac	វិទ្យាសាស្រ្ត
jyit	equanimity
dzit	ប្រាកដនិយម
bwak	ក្រៅ
dyot	វិទ្យុ
bwon	សណ្តែក
fris	ក្រៅផ្លូវការ
klut	មានការរំពឹងទុក
tfek	steak
nrok	អាសូត
zyat	ឡាម
bram	Mutter
ryis	ណែនាំ
nlip	វិភាគ
nros	ផ្ទុយ
hcof	រសាយ
tfif	ការលើកទឹកចិត្ត
kroc	furrow
hdum	សាសនា
pses	អ្នកទទួល
plok	បំពេញបន្ថែម
lyet	កញ្ចក់
pwek	ករណីpegative
kfas	ជំងឺមហារីក
pwen	កូនអុក
nrun	ការ​រំលឹក
clek	លេចធ្លាយ
pcif	កែតម្រូវ
glas	ភាព​ស្មុគស្មាញ
zwit	និយាយ​ច្រើន
kces	គ្រប់គ្រាន់
crem	លក់​រាយ
grap	ការចាប់យក
kwip	អន្តរាគមន៍
dyut	ការបញ្ចុះតំលៃ
crus	ឋានានុក្រម
gyet	Jade
gram	snarls
kyip	សត្វ
nyet	បន្ទះ
crop	ទឹកជ្រោះ
glon	ហ្គាឡុង
mrok	មូស
fluc	ស្ទាត់ជំនាញ
dwic	គម្លាត
slec	ការរុករកប្រេង
srec	undefined
blut	ចំបាប់
myok	ប្រជាជនទាំងនេះ
tlek	ដោត
nruk	ឆ្លង
nwoc	undefined
bjut	អង្គុយ
hges	មានផ្ទៃពោះ
twoc	គ្រឿងទេស
kyos	កុម្មុយនិស្ត
mrek	ឆល់
clip	ការទន់ទាប
pwok	ករណីកាត់ទោស
dwot	ជនផ្តាច់ការ
zyac	ការកាន់កាប់
jlic	ផ្កាយរណប
slop	ស្បែកជើង
ryip	សមាមាត្រ
psim	ប្រហាក់ប្រហែល
byet	គ្មានការងារធ្វើ
cyop	ចំណង់ចំណូលចិត្ត
rwun	លក្ខណៈវិនិច្ឆ័យ
blop	អំពូល
syok	អ្នកគាំទ្រ
klos	ក្លរីន
lwot	ក្លរួ
byic	បាក់តេរី
lyik	ស្អិត
blok	ជីវសាស្រ្ត
jlac	feign
bret	បៃ
krif	ការបញ្ចេញ
blet	រាំរបាំបាឡេ
nruc	ទឹកនោម
tsus	ខ្ទឹម
dyak	វណ្ណៈកណ្តាល
tcem	តុង
cyoc	បញ្ហាប្រឈម
trep	strawberry
dlun	ការបំពុល
hlup	អាល់ប៊ុម
hbep	កីឡាបេស្បល
praf	ការលួចចម្លង
pwis	participle
grek	ហ្គារ៉ា
kruk	ឈើច្រត់
hfof	ផូស្វ័រ
rwut	រចនាសម្ព័ន្ធ
myam	កន្លែងហាត់កីឡា
krec	រថយន្តស្ទូច
jras	ចុះកិច្ចសន្យា
zrik	ជូនដំណឹងដល់
blam	សាល
klip	សិប្បករ
hwef	គ្មានប្រាក់ខែ
zlac	ចេក
gret	ម៉ាស៊ីនភ្លើង
lwuk	ឆ្អឹងជំនី
nyek	នីកែល
blos	រថយន្ដក្រុង
sles	ចាប់ពិរុទ្ធ
tlif	ក្បឿង
kses	សាច់ក្រក
mwot	ប៉េងប៉ោះ
lyot	រថយន្ត
tsom	ប៉ូតាស្យូម
brut	និម្មិត
djap	ពិជគណិត
hjok	ទូទៅ
kfen	គំនិត
pcok	អុបទិក
bzut	budge
syek	ភាពអត់ការងារធ្វើ
mruc	ដង្កូ
bwas	កម្មវិធីរុករក
klif	ជាតិកាល់ស្យូម
rwet	ពីចម្ងាយអតីតកាល
srif	ប្រវត្តិសាស្រ្តមានភាពតានតឹង
hwem	វិសាលគម
syom	សូដ្យូម
tyos	ប្រឹក្សាភិបាល
jyic	ចំណាប់ខ្មាំង
hguk	ឃ្លោក
dwun	ជ្រួញ
swip	កើន
tlec	ធីក
blaf	ការរំលោភសេពសន្ថវៈ
tsem	មិនជឿព្រះ
mloc	ម៉ូនីទ័រ
gyot	លក្ខខណ្ឌ
trop	ការស៊ើបអង្កេត
rwap	ប្រចាំត្រីមាស
hjep	យែនឌ័រ
pyim	ផ្លាទីន
dlon	ចំនួនប្រភេទdual
pcep	សួត
twuk	scouring
tyec	ស្លាក
syup	ទំនើប
trom	រទេះ
nyip	ក្នុងមូលដ្ឋាន
glis	សាំង
gjik	តម្រងនោម
hjos	ចោល
hjuc	ប្លន់
swek	undefined
psek	សារធាតុអាសេនិច
twok	ស្ថិតិ
tsep	កណ្ដូប
slos	សង្គមនិយម
nwim	អារម្មណ៍ភ័ស្តុតាងញ្ញា
tlop	tablecloth
trus	ចម្រូងចម្រាស់
pwot	ខ្សែ
djot	ល្បាប់
nloc	snub
mwon	ភាសាចិនកុកងឺ
hjek	អ្នកជិះសេះ
crom	សហការ
myon	ជំងឺរលាកសួត
twec	situate
ryek	រ៉ុក្កែត
dlic	ភាគលាភ
kwet	ជិះស្គីក្ដារ
bwen	គិតមមៃ
plon	ចំនែក
syon	ខោ
djis	ឌីជីថល
byut	ឆ្កេ
hyep	ត្របកភ្នែក
dwon	អង្កត់ទ្រូង
byis	subconscious
brec	ចិញ្ចើម
cyec	កណ្តាស់
hwop	វ៉ាត់
clus	រីករាយរួម
kfun	ការកាន់កាប់
nwum	សាសនាហិណ្ឌូ
fyim	ជនភៀសខ្លួន
cwos	យាន
tfoc	undefined
pwon	ប្រូតេអ៊ីន
sraf	undefined
hbom	កំអួត
gyen	ហ្សែន
drim	វិទ្យា
trem	accoutrements
tsup	បំបែក
slok	សង្គមវិទ្យា
kwoc	ការបំផ្លាញ
bwam	ឈ្មោះអ្នកបោះឆ្នោត
mlok	ការចល័ត
kyen	ក្នុងតំបន់
hmop	ចលនាលំបាក
rwek	ឡើងវិញ
kfup	គូប
grok	ការ៉ុត
drap	undefined
lwis	ម៉ូលេគុល
ksuc	គណនេយ្យករ
tsop	ក្លិនស្អុយ
kyok	ត្រសក់
nroc	orgy
jlot	សារធាតុរំលាយ
psof	ផូ
hgif	ចាប់អារម្មណ៍
kfim	អាល់កាឡាំង
psos	អត្តពលកម្ម
pfen	ការផ្ទៀងផ្ទាត់
kcom	សេដ្ឋវិទូ
krom	សញ្ញាក្បៀស
tluk	wriggle
hyom	ជាតិអ៊ីយ៉ូត
nwuc	ចលនាចុះ
gjac	ការរលូតកូន
pcom	កួរភ្ជាប់
dzic	អ្នករចនាម៉ូដ
grun	bragging
dzot	ម្ចាស់ជំនួយ
hzek	ម៉ង់ហ្គាណែ
kfot	ក្តារចុច
jlas	មិនគួរទុកចិត្ត
lyim	វី​រៈ​ជន
jyen	ប្រាក់យ៉េន
pcaf	វង់ក្រចក
rwip	កីឡាបាល់ឱប
blip	ព្រះគម្ពីរ
kyoc	លើសហេតុកម្ម
lyon	ដំបៅ
flis	ឆ្លុះ
nrif	nibble
kfam	កង់ទិច
swes	អាវយឺត
lwon	ការវិវត្ត
drec	វិភាគការប្រើប្រាស់
gjap	ស្ប៉ា
lyec	លីនេអ៊ែរ
tyom	Antimony
pwuk	ករណីsuperessive
flaf	អាល់ហ្វា
myim	ភាពស៊ាំ
pcek	ការចាប់ជម្រិត
bjac	រោងចក្រ
bzac	abridge
bzak	ស្រោមជើង
twes	ទូរទស្សន៍
dwut	ឯកសារ
ksom	cosmos
lyis	ព្រៃឈើ
lwim	អាលុយមីញ៉ូម
ksok	horoscope
sruc	ពន្លឿនការ
dlif	ត្រី​ដូ​ហ្វី​ន
byik	ឃាតករ
tfec	សម្ភារៈការិយាល័យ
hjaf	ថនិកសត្វ
ryok	ពិធីការ
dwis	ឌីអុកស៊ីត
jlon	ពោះវៀនធំ
brus	ការិយាធិបតេយ្យ
gjak	កាឡាក់ស៊ី
lyip	ព្យាបាល
ryem	រ៉ាដ្យូម
href	rarefied
prok	ទូទឹកកក
slep	undefined
dret	ការនិយាយឡើងវិញ
kluk	បុរាណវត្ថុ
dlis	idiosyncrasy
kfip	មិនអាចទទួលយកបាន
mlec	ម៉ាស្សា
pfif	ការបញ្ជាក់លម្អិត
nrec	ញ្ញា
pfet	ខិត្តប័ណ្ណ
hzoc	ដើមចម
dlam	តាមឧត្ដមគតិ
nlec	នរវិទ្យា
kluc	ហ៊ាន
dyet	រថយន្ត
tyif	ការផ្លាស់ប្តូរ
krus	ភ័យខ្លាច
nluc	ផ្កាឈូករ័ត្ន
lyun	អ៊ីយ៉ុង
zrot	ការធ្វើបត្យាប័ន
ksif	បន្លំ
psif	ការបំភាយ
crup	ត្រួតស៊ីគ្នា
fret	ឧបករណ៍រក
grut	ដាក់​​បញ្ច្រាស
ksec	មិត្ត​រួម​ថ្នាក់
jric	ផ្លូវ
mrop	មីក្រូ
srus	ទម្លាក់
gyas	សក់
floc	រឿងនិទាន
plek	capillary
nwop	បាត
nrom	ឧបករណ៍បញ្ជា
twos	អំពើភេរវកម្ម
lwok	ពាក្យស្លោក
dwet	ហួសពេល
slem	sublimate
grip	ដុត
gwas	វ៉ោ​វ
kwok	Cobalt
gwon	oat
hdop	ចលនាupriver
glam	រន្ធគូថ
bwot	bovine
bren	ពោះវៀន
byot	វីដេអូ
bjik	ធ្វើពហិការ
kwim	សំណួរ
cwek	ហុកគី
grif	ទ័ពព្រៃ
hgem	ម៉ាញ៉េស្យូម
hyes	ការយល់ដឹង
fram	ឱសថស្ថាន
nwos	undefined
ryap	រៀបចំ
cwim	ភាពអាចជឿជាក់បាន
klep	kelp
psec	សង
djic	នៅទូទាំងពិភពលោក
kfut	បម្រាមគោចរ
crep	ហាំបឺហ្គ័
frim	ទ្រឹស្តីបទ
gjas	ឆេះ
hdef	ឥណពន្ធ
ryum	អ៊ុយរ៉ាញ៉ូម
pluk	វាយតម្លៃ
krop	សំរបសំរួល
nraf	អ្នកជាប់ពន្ធ
tyes	រួមបញ្ចូលគ្នា
plip	opine
hgom	ហ្គាម៉ា
hgus	មេគុណ
cwuc	ម៉ាស៊ីន​កំ​ដៅ
zret	ដក
nles	អ្នកវិភាគ
trof	intransitive
hmof	ផ្សារ​ទំនើប
hzim	subsalicylateជាមួយនឹងថ្នាំ
dzac	diner
psok	កាតប៉ូស្ដាល់
blon	ចំណុច
djet	digress
ksum	ម្ចាស់ភាគហ៊ុន
mrup	មេរោគ
clif	Helix
cloc	morphological
tfes	អ្នកចាត់ចែងម្ហូបអាហារ
gjis	ខោ​ខូ​វ​ប៊​យ
jren	តម្រឹម
tlep	មូលដ្ឋានទិន្នន័យ
kcup	ប័ណ្ណ
glot	វ៉ុល
glut	ការគណនា
srep	ត
nwes	វិនិយោគិន
ksef	កាំរស្មីX
bzis	ទិដ្ឋាការ
frut	ហេដ្ឋារចនាសម្ព័ន្ធ
nyuk	Firefly
dyik	ឧបករណ៍ចាប់
plec	splices
brom	bromine
plop	ប៉ាឡាដ្យូម
zlik	ស៊ីលី
flut	វ៉ុល
ksop	កែសម្ផស្ស
gjun	កូនកំលោះ
kfok	ត្អើក
hpof	ពោត​លីង
hzuk	សួនសត្វ
nyoc	ន័យ
jwak	យូហ្គា
brim	ស្រដៀងនឹងបារីយ៉ូម
kles	កាត់ក្បាល
mwam	យាយ
fwik	កាំជ្រួច
djas	ចង្វាក់jazz
dyim	អូឌីយ៉ូ
tsum	ស្តែន
drip	dribble
lyaf	សោធនអាហារកិច្ច
prom	អ្នកសរសេរកម្មវិធី
nrup	ការបញ្ចូល
hfes	បត់បែន
rwaf	chrysanthemum
dlen	ឯកសារ
byas	វ៉ាក់សាំង
fron	ហេរ៉ូអ៊ីន
dluk	ផ្ដាច់
dyun	ការធ្វើរោគវិនិច្ឆ័យ
flap	ថត
kfet	កាតូត
dlim	មនោគមវិជ្ជា
prek	កន្លែងចតរថយន្ត
syoc	រូបថត
slus	មធ្យោបាយងាយស្រួល
nlos	anticlimax
mlen	សារជាតិselenium
pres	ស្រោម
hlof	ស្ពាន់ធ័រ
nlek	សញ្ញាសម្គាល់ពាក់ព័ន្ធបច្ចុប្បន្ន
gwot	ព្រ​លាន​យន្តហោះ
mwip	ក្លែងបន្លំ
klop	កន្លាត
kwom	ក្រូមីញ៉ូ
hl6t	លីត្រ
nwec	ផ្ទុយ
glip	រង្វិល
nrop	បញ្ជីបើកប្រាក់ខែ
crum	អរម៉ូន
dlep	អ្នកអភិវឌ្ឍ
frot	perforate
bwoc	ការបំផ្លិចបំផ្លាញដោយចេតនា
fwis	ស្ត្រីនិយម
djok	conjugate
draf	ធ្វើទំនើបកម្ម
trum	ជ្រុលនិយម
graf	ក្បួនដោះស្រាយ
lwes	ឡាស៊ែរ
mlem	មិល្លីម៉ែត្រ
flen	Flex
zlot	អាណូត
swok	snuggle
klec	undefined
pwim	ក្រៅ​ម៉ោង
htuf	ត្រីធូណា
fyis	រោងចក្រចម្រាញ់ប្រេង
lwet	ការប្រែលប្រួល
mrem	mainframe
jwic	rejuvenation
droc	បាតុករ
clem	អេលីយ៉ូម
dzik	ពីរភាសា
psem	ប្លាស្មា
hjom	ក្រូម៉ូសូម
rwuc	បូរណសំខ្យា
tyus	ចំនួនគត់
klom	គីឡូម៉ែត្រ
hfos	ទូរសារ
nwek	ហ្សែន
jrap	ទួណឺវីស
zwas	appetizer
bwok	ខាត់ណា
dwap	អាដាប់ធ័រ
syem	សារ​ឥត​បាន​ការ
blek	វ៉ិចទ័រ
tlus	យុទ្ធសាស្រ្ត
pyif	មិនបានបញ្ជាក់
cwoc	អី
mrep	អំពែ
hbem	វីតាមីន
hxan	ការdoorman
hxut	ឧបត្ថម្ភធន
hk6m	កាតមីញ៉ូម
hxin	ក្នុងពេលដំណាលគ្នា
txin	ទីតាញ៉ូម
kxin	undefined
klum	រួមសង្វាស
xlis	នាឡិកា
hqak	ជាវាក្យសម្ព័ន្ធ
hxat	គំនិតច្នៃប្រឌិត
hxik	សៀវភៅអេឡិចត្រូនិ
hxas	កន្លែងការងារ
bxon	boron
dxin	undefined
hxit	ឧទ្ធម្ភាគចក្រ
tlum	Tellurium
txit	ផុតកំណត់
kxat	អុកស៊ីតកម្ម
hvik	តម្រឹម
nluk	អាណាឡូក
nyem	សង់ទីម៉ែត្រ
hm6t	molybdenum
hl6m	លីចូម
ht6t	ពហុមេឌៀ
xlit	កាឡូរី
ryop	មនុស្សយន្ត
pxas	ឱសថការី
hxak	កិច្ចការ​ផ្ទះ
lwif	locative
grim	លោការីត
hqat	Mantis
qlit	បរិស្សានវិទ្យា
xlik	ស្មុគ្រស្មាញ
mlep	ពុម្ព
hqit	វិទ្យុសកម្ម
kxim	គីឡូក្រាម
hxen	អ្នកជួល
hxot	overeat
kyif	អ័
fwet	freeware
txet	សំណុំរង
hs6n	តគ្នា
hxet	លួចតាមដាន
xrat	កាត់សក់
hqan	impound
hr6t	Iridium
bxat	កម្រិតបញ្ជូន
dxet	ផ្ទៃតុ
hxis	អិចស្ប៉ូណង់ស្យែល
hxok	ទីស្នាក់ការ
hxek	ដាក់​​ខុសកន្លេង
srem	Cerium
hp6t	ភាគថាស
pxik	ករណីភាគថាស
kxet	កាសែត
pruk	ផ្សារទំនើប
hvit	ឃើញនូវថាមពល
xlin	ក្រៅបណ្តាញ
frip	ការអ៊ិនគ្រីប
hvep	បង់ប្រាក់យ៉ាងច្រើន
hxon	ធ្វើសមកាលកម្ម
kxit	ជាអតិបរមា
hqin	សិក្ខាសាលា
tr6n	ស្តេរ៉េអូ
ht6n	រុំ
hvat	នាពេលខាងមុខ
sl6s	អង្សារសេ
hn6n	អ៊ីយូតា
ts6t	ពេលវេលា​ពិតប្រាកដ
hvin	ការផ្សព្វផ្សាយ
pxat	Newsstand
myoc	ម៉ូឌុល
ps6s	pasta
bwek	ថង់យយ
dlok	នៅទំនេរ
fraf	ជញ្ជាំងភ្លើង
hr6k	វត្ថុបុរាណ
txat	អាហារ​ថ្ងៃត្រង់
hqon	ការoregano
pxun	ការplutonium
ks6n	ស្ថានីយការងារ
slef	ជណ្តើរយន្ត
xrit	អ្នកយាម
hvut	ភាពចង្អៀតណែន
xrim	yttrium
hx6t	ស្ទាប
hqum	ឈ្មោះ​អ្នកប្រើប្រាស់
hl6n	អ្នកលក់
gron	Argon
pxan	ផ្សព្វផ្សាយ
hvac	ម៉ា​សុ​ី​ន​លោង​ចាន
xlan	សកលភាវូបនីយកម្ម
txon	រលក
xrik	កែច្នៃឡើងវិញ
hxap	កាបូបស្ពាយ
hxac	ចាប់ផ្ដើមឡើងវិញ
xyat	ជំងឺរលាកថ្លើមប្រភេទ
cwep	ប្រាក់ខែ
hxos	ថូរ៉ាស់
txif	លក្ខណៈអក្សរ
qlat	អចលនទ្រព្យ
txot	ពាក់កណ្តាលរដូវស្លឹកឈើជ្រុះ
hxam	មីលីក្រាម
pxis	ភីកសែល
pwif	មើលជាមុន
txam	សារធាតុចំនួនម៉ាស់អាតូម
myek	ទែរម៉ូឌីណាមិច
hbop	បំបែកក្នុង
hqot	ដំណោះស្រាយ
xlic	រទេះរុញ
gxit	អំពើប្រល័យពូជសាសន៍
hvan	ពន្លត់អគ្គិភ័យ
glim	ការgallium
pfop	ផុស​ឡើង
hzum	zirconium
xlon	ទូរស័ព្ទទំនាក់ទំនង
qlin	ត្រង់
kxam	Scandium
blim	beryllium
kxik	កំណត់រចនាសម្ព័ន្ធ
nr6n	ណឺរ៉ូន
hpef	predicate
hruf	រ៉ោតទ័រ
kxan	ហ្វាក់តូរីយ្យែល
hxic	គោលការណ៍ណែនាំ
xlip	បាល់ទះ
dyek	បំបាត់កំហុស
hxop	នាឡិកាដៃ
qrot	នឺត្រុង
nwip	niobium
hs6t	បន្ទប់ទឹក
grem	Germanium
tles	metalloid
hp6k	ករណីprolative
qyin	ជីវចំរុះ
txak	ថ្នាំសំលាប់មេរោគ
mlun	immobile
txan	actinium
xran	អវកាស
dres	ពន្លា
tr6t	extraterrestrial
hk6t	octet
hxus	ប្រភព​បើក​ចំហ
xlat	crackpot
mraf	រត់ម៉ារ៉ាត​​ុង
ts6n	និទាឃរដូវពាក់កណ្តាល
ht6s	ជំងឺautism
nlif	បង្កើតអ៊ីយ៉ូដ
txut	គួរឱ្យកត់សម្គាល់
hm6n	បញ្ចេញ
kxis	គំនូរ​រូបភាព
xrin	ការទទួល
xren	បង្វែរ
bxak	ចំណាំ
pfos	ឃ្លាដែលគាំទ្រ
hvis	លាមក
hd6n	ភាគបែង
brum	ខ្វែងគំនិតគ្នា
hqis	chauvinist
hk6n	ចងក្រង
xyit	គន្លឹះក្នុងការផ្លាស់ប្តូរ
xyin	មួយ​វិនាទី
hxun	ការរស់នៅពឹងផ្អែក
hvas	តួនាទី
glok	កំណត់ហេតុបណ្ដាញ
hvak	meandering
pxit	អាសយដ្ឋានip
hvet	នៅ​ក្បែរ
xram	safflower
hc6n	ជាក់ស្តែង
qran	គម្ពីរកូរ៉ាន
zyen	xenon
hqas	ស្បថក្នុង
bzas	blase
hj6n	មិនមែនមនុស្ស
hnof	nonremittal
txas	ក្រុមហ៊ុនផលិត
hbum	ព្រះពុទ្ធសាសនា
ts6s	រឿងទាស់ទែងគ្នា
pxin	គ្រឿងផ្សំ
hr6n	របប
hxim	ពាក់កណ្តាលរដូវក្តៅ
dxit	រដូវរងារពាក់កណ្តាល
hxaf	ចិក
nlus	ការhouseplant
txap	របារស្ថានភាព
vrit	ghostwriter
kxak	បន្លំ​ភ្នែក​នៅ​ជុំវិញ
bxin	រាងកាយ​មនុស្ស
hqik	raincoat
hxes	Hertz
hxif	hypnothize
xras	ម៉ោង
pl6k	ជំនួយមេធាវី
dxat	កន្ទួល
hxip	អង្គបដិបក្ខ
vrat	ខ្លី
hqek	reshaping
qrit	បន្ទាត់រាងប៉ូល
pxot	ការិយាល័យ​ប្រៃសណីយ៍
hxom	សារ​ឥតប្រយោជន៍
hqic	ពិនិត្យ
lwun	ខូវប៊យ
hp6n	ពេលកាលកំណត់
dxan	ការភ្ជាប់
xrak	តួនាទីតារាសម្តែង
dxak	គ្រោះថ្នាក់ចរាចរណ៍
hven	ធុង
mwap	បន្ទះកំប្លែង
qlan	ប៍នពិការភ្នែក
xros	undressing
srom	បន្ទប់តាំងបង្ហាញ
hc6t	ការជជែកកំសាន្ត
qrat	ទ្រ​លប់​ចុះក្រោម
hn6t	រារាំង
hqet	តំបន់បណ្តាញ
fres	រៃអង្គាសថវិកា
froc	forging
xlak	តំណខ្ពស់
vlat	volubility
dvan	disembarking
gxin	ដណ្តើមយក
ryes	អ្នកទទួលភ្ញៀវ
kxot	ឧបករណ៍ភ្ជាប់
xyan	ការកំណត់
vlan	ផ្សាយពាណិជ្ជកម្ម
ryom	អាតូមthorium
hluf	មាន​អាយុ​ចាស់
hquk	ចាក់
lyum	thuliumអាតូម
tyem	អាតូមTerbium
hp6m	praseodymium
txic	ទំព័រដើម
mros	អ្នកបើកបរម៉ូតូ
dyam	អាតូមរ៉ូដឌៀ
pc6n	ចំនួនការជំនុំជម្រះក្តី
nyos	ក្នុងប្រអប់
pyek	ការបញ្ចាំង
kxon	krypton
hxuc	សង្គ្រោះ
qrik	ករណីចំណុចកណ្ដាល
xwin	ខ្វះបទពិសោធន៍
kxic	ប្រដាប់ពន្លត់អគ្គិភ័យ
hvot	គំនូសតាងលំហូរ
dxot	ទឹកដោះគោយ៉ាអួ
hqut	ចាកចេញ
pxen	អង្គភាព
drok	គន្លឹះគោលដៅ
flon	ទូរស័ព្ទចល័ត
txos	សំឡេងកណ្តាល
hqok	ករណីមួយoblique
xwik	ករណីអ្នកជំងឺ
hx6n	prehodiernal
txik	ម្រាម​ដៃ​ចង្អុល
hqen	អ្នកផ្ញើ
mlap	មេរោគ
hvun	suasion
hvon	ពាក់ចេញ
vran	ក្រុមហ៊ុនអាកាសចរណ៍សំបុត្រ
pfes	សាស្រ្តាចារ្យ
pwip	កំណាព្យ
hqam	ធ្វើការ
gxat	ភាពស្របច្បាប់
ks6t	មូលហេតុ
vrin	ជ្រើសរើស
kxip	ក្រុមប្រឹក្សាភិបាលឈុត
sr6n	ខកចិត្ត
vlit	យ
tyup	ជាយក្រុង
mrom	morpheme
xron	កាស
gxak	ថ្លៃ
hrof	សេះTrojan
xlas	ពិការ
dzet	redecorate
txac	ការចុះចាញ់
xrot	ដែលមិនបានប្រើ
txis	ម៉ាទ្រីសចំណុច
syif	គ្រឿងស៊ី
xrac	គួរ​ឱ្យ​ភ្ញាក់ផ្អើល
brif	តម្លៃគោលពីរ
dlos	ករណីម៉ូត
txun	គុណលក្ខណៈ
dvat	អាក្រក់រឹងមាំ
psom	ដៃជាលើកដំបូង
gjek	ផ្សេងទៀតប្រសិនបើ
nlem	ឯកតានៃម៉ាស់
qret	ហាងលក់រាយ
txip	ចំណុចបីដង
dlek	បុគ្គល
lwut	បច្ចុប្បន្នលំហូរ
dxis	យ៉ាងខ្លាំង
hs6m	Cesium
vlak	railcar
hn6m	netium
kxap	រកដាសរឹង
bxan	ការចាកចេញ
myem	ខែឧសភា
gxik	សិទ្ធិស៊ីវិល
hxoc	ទ័ព​ជើងអាកាស
xrok	អ្នករួមការងារ
kr6t	រូបថតអេក្រង់
txok	ដោយស្វ័យប្រវត្តិ
hxep	skateboard
srop	ស្មាតហ្វូន
pxak	សោ​រ​អក្សរ​ធំ
hk6k	តន្ត្រីស្រុកស្រែ
hl6k	អយល័រចំនួន
pyom	អាតូមប៉ូឡូញ៉ូម
xyam	អាតូមthallium
hvic	ការឈ្លានពាន
lyok	ករណីlocative
xlot	ផ្ទះល្វែង
txen	restatement
kxac	counterattack
qrak	strikebreaker
hbup	អាងហែលទឹក
txuk	សៀគ្វីខ្លី
tsef	ពន្លឿន
bxit	ម៉ាស៊ីនបណ្តាញ
ksem	អាច​បាន​តែ​អាន
byim	អាតូមrubidium
hvam	vanadiumអាតូម
lw6n	lanthanum
frum	អាតូមfluorine
nyom	neodymium
mlom	ចំនួនmultal
kxas	បដិរូបកម្ម
xret	តេរ៉ាបៃ
hs6k	ម៉ាស៊ីន​ស្វែងរក
frus	បំផ្លាញ
gxan	យែនឌ័រកាឡាក់ស៊ី
vlas	សំលេង
glet	ឈ្នាន់ឧស្ម័ន
hvim	ពេលរត់
bxip	រូបភាព
qrin	យែនឌ័រតារា
bvak	ករណីabessive
pxon	មិនអាចប្រើបាន
dvik	ករណីadessive
dvek	ករណីភ្នាក់ងារ
hlef	គន្លឹះភ្នាក់ងារ
kwek	ទៅនឹងករណី
kxen	យែនឌ័រជារឿងធម្មតា
ht6m	សំណុំបែបបទដែលបានអំណះអំណាង
tsuf	លេខឆ្លង
hf6n	ផាកពិន័យ
tc6t	វត្ថុដោយផ្ទាល់
gvik	ករណីergative
gxon	បែងចែក
ksep	ទទួល
vyin	រោង​ភាព​យ​ន្ដ
pyos	សំលេងអកម្ម
hnef	កិរិយាស័ព្ទកំណត់
xwit	វត្ថុបឋម
hqim	អារម្មណ៍gnomic
jlak	ទូទៅ
vrik	ភាគល្អិតចុងក្រោយ
qyan	ឯកតាប្រឌិត
kxaf	ល្បឿននៃពន្លឺ
xyic	ការលួចបន្លំ
qyit	ចំណុចសំខាន់
hvek	ករណីevitative
bvik	ករណីsubessive
hzes	ករណីpossessed
prus	មេរោគកុំព្យូទ័រ
ples	ដំណើរការ
pxif	ការិយាល័យ​ប៉ូ​លី​ស
dvak	ករណីlative
brun	ទេសចរណ៍
tsi_k	ករណីantessive
tyum	អាតូមruthenium
vyak	ករណីadverbial
pxim	នាយករដ្ឋមន្ត្រី
syum	អាតូមstrontium
sy6n	គួរឱ្យសង្ស័យ
hy6n	ចលនាយេនឌ័រ
pxac	អំណរសប្បាយដោយយល់អារម្មណ៍
vlin	យែនឌ័ររថយន្ត
qwin	យែនឌ័ររ៉ែ
hr6s	ការបញ្ជូន
tf6n	&amp;‧;
xris	ចំណុចប្រទាក់អ្នកប្រើ
hw6n	ការស្បថ
xlen	នាមពាក្យសំដី
pyec	សៀវភៅបញ្ជី
vlim	សតិនិម្មិត
bres	កម្មវិធីវាយអត្ថបទ
hqip	ពពកកុំព្យូទ័រ
vlic	ម៉ាស៊ីននិម្មិត
pfam	spammer
dyap	ភាសាទីពីរ
txek	ឫសទីn
dxen	រុករករ៉ែទិន្នន័យ
byip	អ្នកជំនួញ
hs6c	ទំនុកចិត្ត​លើ​ខ្លួនឯង
txim	សំដៅ
hb6t	ការផ្លាស់ប្តូរនៃព្រឹត្តិការណ៍
hdem	ឈ្មោះដែន
dxon	ព្រឹត្តិការណ៍ផ្សេងគ្នា
lwaf	ដ្រាយពន្លឺflash
sl6t	crastinalតានតឹង
xyik	ថាសទន់
fyif	សំឡេងបត់បែន
bvin	យែនឌ័រសកលលោក
hm6p	motherboard
tfip	ការផ្លាស់ប្តូរកិរិយាស័ព្ទ
jlen	យែនឌ័រតំបន់
xrap	ឆ្នូត
tc6n	យែនឌ័រស្រាវជ្រាវ
sl6n	យែនឌ័រសិល្បៈ
xrek	គន្លឹះអ្នកជំងឺ
xwan	យែនឌ័រអរូបី
dxif	សន្និសីទវីដេអូ
dyip	សុន្ទរកថាដោយប្រយោល
zrek	ករណីexocentric
hvuk	រំលឹកអំពី
xwat	ល្អឥតខ្ចោះកន្លងមក
hr6m	rhenium
txaf	បង្កឱ្យមាន
hmef	កិរិយាស័ព្ទដែរ
tx6t	កម្មវិធីនិពន្ធអត្ថបទ
txes	នាមសមូហភាព
bvat	ការប្រព្រឹត្តមិនត្រឹមត្រូវទៅលើ
bvuk	ករណីដាច់ខាត
ry6t	រ៉ាដ្យង់
vlis	ការពិតនិម្មិត
qren	យែនឌ័រភព
gvak	ករណីវេយ្យាករណ៍
bxok	ទំពែក
mrum	កម្មវិធីកុំព្យូទ័រ
ps6t	ប្រព័ន្ធ​ប្រតិបត្តិការ
hfom	មូលសទ្ទ
tlem	អានអង្គចងចាំតែប៉ុណ្ណោះ
pwam	spyware
kfif	ស្នូលbenefactive
qwit	សនិទានភាព
nlaf	ការដំឡើង
nwok	ករណីសមាគម
dzas	មិនសប្បាយចិត្ត
swuk	ករណីខ្ពង់ខ្ពស់បំផុត
syos	សង្ខេប
kr6n	ចរន្តអគ្គិសនី
dvin	យែនឌ័រគ្មានជីវិត
pxom	អារម្មណ៍សំណើរសុំ
vris	សំឡេងចំរាស់
rwos	រស់
dr6t	distractor
ht6k	ទូរគមនាគមន៍
slaf	ប​ណ្តា​ញ​សង្គម
lyuk	ឃ្លាបន្តបន្ទាប់
qras	ថ្នាក់លើ
ty6n	teminal
gwet	ភាពតានតឹងនាពេលអនាគតឆាប់
hp6s	សំឡេងអនុវត្តបាន
tsof	សំឡេងantipassive
ht6p	ទិដ្ឋភាពcontinutive
hn6f	អារម្មណ៍necessitative
pfip	participleអកម្ម
glap	របារឧបករណ៍
sy6k	ឃ្លាសព្វ
qyat	អាំងតង់ស៊ីតេluminous
hy6t	វត្ថុវេយ្យាករណ៍
vyan	ប្រកាសសាលដីកាស្ថាពរ
sluf	ចំនួនsingulative
dvit	រយៈពេលច្រើនហួសប្រមាណ
qyak	កិរិយាស័ព្ទសកម្មភាពតែ
bzik	រូបវិទ្យា
xlet	សញ្ញាបត្រខ្ពង់ខ្ពស់បំផុត
hqap	participleបច្ចុប្បន្ន
qwat	ចំនួនទឹកប្រាក់នៃសារធាតុ
qyik	ភាគល្អិតភ្ជាប់
sr6t	សារធាតុរាវsupercritical
hfem	morphemeepenthetic
tl6t	នាពេលអនាគតពីចម្ងាយតានតឹង
mrif	មីក្រូហ្វូន
pcuk	ករណីpostpositional
tfim	សតិក្នុងការចូលចៃដន្យ
fwim	ethium
ly6t	កិច្ចព្រមព្រៀងallocutive
hvap	របាររមូរ
hfep	ទិដ្ឋភាពជាញឹកញាប់
bvan	សព្វនាមបែងចែក
fyun	ចំនួនចំណុចអណ្តែតទឹក
xyas	លុប
hvif	កិរិយាស័ព្ទaffix
xyis	participleអកម្មកន្លងមក
tl6n	អង្គភាពដំណើរការកណ្តា
tfok	ករណីទិសlocative
qwan	សំណួរ​ដែលគេ​ច្រើន​សួរ
