hnit	bendratis
hnak	vardininkasatvejis
hkak	galininkoatvejis
htak	temaatvejis
hpap	tėtis
hmam	mama
hyat	tėvų
hcan	Labas
hwik	šauksmininkoatvejis
hsuc	protėvis
htat	senelių
hcac	alkanas
hnik	kilmininkoatvejis
hcit	būdvardis
hwan	ir
hman	man
hnan	Jūs
hwam	mums
htit	tai
htac	paskirtiesvietaatvejis
htik	naudininkasatvejis
hyit	REALISnuotaika
htim	deonticnuotaika
hcut	sąlyginisnuotaika
hsit	episteminisnuotaika
hyak	instrumentinisatvejis
htan	interjeraskontekstas
hpan	asmuokontekstas
htin	gramatiniscentras
hyan	priklausomasišlyga
hfap	Tobulasaspektas
hkat	praeitisįtempti
hnin	vyriškaslytis
hmak	comitativeatvejis
hnat	dovanaįtempti
hpak	benefactiveatvejis
swik	essiveatvejis
htut	Neigiamaiquantifier
hsan	paviršiuskontekstas
hpin	adpositionalatvejis
hwin	vietaatvejis
hkan	erdvėkontekstas
hnac	būdasatvejis
hyut	klausiamasisnuotaika
hnam	irarba
hkit	išskirtinė-arba
hsuk	šaltinisatvejis
hpik	įnagininkoatvejis
hcat	artimumas
hmat	demonstratyvus
hkuk	sąlygauodegą
hlan	bet
hsut	visi
hyin	universalusquantifier
hcin	moteriškaslytis
hpac	daugiskaitosskaičius
hyik	vienas
htic	jų
hkik	kas
tcat	ateitisįtempti
hsin	socialiniskontekstas
hkac	kada
hmip	imperfectiveaspektas
klan	ten
hlak	santykinisatvejis
hlik	Išreiškiaišvadaatvejis
htam	direktyvanuotaika
hlat	pasirenkamasquantifier
hkam	ką
hwat	klausimasžodis
htap	copula
hpat	asmuo
nyan	Vyras
hkas	galėtų
tcan	kitas
hnuc	skaičius
twit	užsispyręsquantifier
hsak	laikaskontekstas
htuk	laikoatvejis
htun	tik
htum	Hortativenuotaika
hyip	retrospektyvusaspektas
hlit	Volitivenuotaika
pcic	turi
tyut	du
hsat	pamatyti
hkut	žinoti
hcic	žemyn
hcap	po
hpam	pirmas
hlac	nusavinamasturėjimas
hkap	niekada
hnic	neatimamasturėjimas
tyat	senas
tcit	svarstymonuotaika
tcin	diena
hlam	ateiti
hwak	balsis
hkin	eiti
lwak	perlativeatvejis
hpip	progresuojantisaspektas
lyan	ilgai
hsac	pasakyti
kyan	kaip
htas	vėl
hsic	čia
hcik	galvoti
hcak	pagalkontekstas
hfan	rasti
hsun	ranka
hyac	taippat
nwan	jaunas
tyit	prieš
tlan	dievas
twak	delativeatvejis
hmin	niekas
hyas	kartą
hlap	semelfactiveaspektas
kcac	įkairę
hyic	pjūklas
hcas	namas
hwac	pasaulis
tyin	trys
hnun	Neo
hcuk	fokusas
pyan	meilė
hsis	visada
hyam	naktis
hyap	karalius
hkic	tarp
hmas	protas
cyit	širdis
pluc	paucalskaičius
kyik	nes
ksak	priežastinisatvejis
tcun	padaryta
hnim	Pavadinimas
tsan	tinkamasdaiktavardis
klac	šalis
hpun	paklausė
cyat	matomaspagrįstasįrodymu
pcac	geriau
hmac	momentas
hnas	negali
hwic	vanduo
twim	desiderativenuotaika
kwan	šviesa
tlat	žodis
tyan	durys
hsas	rytas
syat	iki
twik	terminativeatvejis
hpit	baltas
pcan	pinigai
hyis	prastas
mwan	mirtis
hfam	forma
nwik	inessiveatvejis
kcat	kartu
tsac	dažnai
pyat	draugas
psan	pusė
hpim	imperatyvasnuotaika
hyuc	turas
hfat	išsiuntė
hcis	žmona
kcan	tikėti
hsik	visuomenės
htus	valstybėskontekstas
hpas	sūnus
clat	vaikai
tyak	taip
cwan	tikiuosi
syin	brangusis
hkuc	aukštas
tyac	skaityti
syit	miestas
hlic	jau
hfit	priežastinispagrįstasįrodymu
tcac	mergina
hcun	Klausyk
ksan	mažiau
hyaf	gal
kyat	išties
tcic	kūnas
hwit	sugrįžimas
cwat	oro
hfaf	teisė
hput	padėti
lyat	laiškas
ksas	keturi
hpic	geidžiamojinuosakanuotaika
hfuk	ugnis
hcam	valanda
twat	karas
kyak	keletas
tlit	antra
pcin	už
hmut	prarastas
clan	tūkstantis
hfac	šeimos
twan	siela
hwas	klausimas
syan	tiesa
htis	gamyba
tsat	potencialasnuotaika
lwik	allativeatvejis
nyin	žmogausveikloslytis
hfak	penki
tcak	taspatstemažymeklis
htuc	kitokstema
hnap	atsakymas
hmit	jūra
hcuc	baimė
pcat	suprasti
syas	sąlygos
hcaf	abejonė
twut	dubitativenuotaika
hkis	juodas
tlak	atnešti
hyus	gražus
nyit	rūšiuoti
htip	dešimt
ksis	istorija
hpuk	knyga
hlin	elektroninis
hkun	sąskaita
lyas	palūkanos
lyit	rašyti
pwat	lova
hnis	amžius
hnut	priešingossąlyginis
slas	menas
hwis	VIALISatvejis
pyak	brolis
lyin	linija
tyas	lentelė
hyun	upė
kyac	akis
tfan	staiga
kcin	giliai
hmuc	tikslas
cyac	kraujas
hmap	rožė
tlin	šaltas
hyif	Pirmyn
tyam	vėlai
hnaf	tarkime
hkip	beveik
myan	mano
tsin	žinios
hkup	kopija
hsam	vyras
hlis	šeši
cwit	gyvenimas
cyan	taika
myat	prisiminti
tyic	natūralus
hfut	kristi
swas	tarnyba
hsap	išskyrus
pcit	autorinėsteisės
hyim	kariuomenė
kyas	arklys
plic	ateitis
pcak	įvakarus
hpis	mokėti
hyuk	raudonas
hwun	auksas
twin	noras
plan	Groti
hpus	biuras
syun	vyriausybė
kyic	bažnyčia
htaf	stiprumas
hlun	ilgis
kyin	įmonė
kyis	popierius
mlan	tikimybė
hcim	ypač
cyas	turėti
twac	langas
nyat	grožis
hcus	pastarasis
htup	pareiga
htif	atstumas
pyas	pėda
hlas	laukinis
ksin	žalias
hmaf	bėda
myac	šypsena
hsim	miegas
kyit	kotiruojamos
kwik	quotativeatvejis
fwan	apsilankymas
slan	sekti
psit	buvimas
hmic	saldus
hmuf	burna
hfin	turtingas
tcam	priešas
psuk	sugedęs
kcap	laivas
pwan	imtinaiasmuo
hfic	įtaka
tcuc	pasirodyti
hkim	paslaptis
pyin	Prašom
pwit	precativenuotaika
pyit	mandagusregistruotis
cwak	blogis
myak	Kovas
tcas	vietos
hlaf	pasilikti
psat	užuot
nlan	mėlynas
psac	neįmanomas
kcuk	mokykla
kcit	vedęs
kcak	maistas
syis	dvidešimt
tlac	ramus
hcip	būsimasaspektas
kwin	suteikiant
tsit	sustojo
pyac	kalba
hsus	savaitė
hcup	salė
cyap	stebėtis
tfin	gimęs
fyat	teismas
hnip	Gnomicznyaspektas
tsak	pagarba
tlas	vertas
syuc	medis
plat	sienos
cyak	dangus
twip	inchoativeaspektas
mlat	komanda
swit	Liepiamojinuotaika
mwas	mėnuo
hwaf	puikus
tyap	patirtis
ksac	sąlygos
syac	šviežias
hnuk	kunigaikštis
kwak	taikoma
tyuk	įrytus
pwac	akmuo
hkif	kilnus
nyac	kryptis
cyis	kėdė
tyuc	laukimas
tsun	kaimas
tyik	sutikti
hnum	liberalusnuotaika
slak	sėkmė
tsic	bando
slat	kalnas
hmik	muzika
hkus	šauksmas
hsip	septyni
hpaf	privatus
nwas	naujienos
tfac	scena
fyan	sodas
cwas	pradėti
hfik	skirstomasisatvejis
lyac	sužinoti
syik	politinis
clin	Henry
cyin	melas
tsas	mesti
cyik	valdžia
tlap	aukštas
cyam	vasara
tcut	religija
tcap	pabėgti
hlut	autorius
pyun	rudas
tcuk	skausmas
swan	pavasaris
hmun	minkštas
kyun	kampas
nyak	prekiųženklai
tsis	teisingumas
psas	gaminti
cyaf	juokas
hwut	pamiršti
hyup	Europa
hwap	aštuoni
psak	perėjimas
kyap	baisus
pyic	reikia
hmim	vidutinis
hsaf	kvėpavimas
hmis	protingas
hsum	savininkiškasžymeklis
ksat	malonus
ksit	kapas
tsap	sala
kyam	stovykla
tcum	liesti
cyun	turtas
psic	Krantas
tyun	domenas
mwit	commissivenuotaika
tlut	laipsnis
myit	žiema
kfan	elgesys
slac	bėgimas
myin	minutė
tyip	vadovauti
klas	stiklas
pfat	lenta
cyic	tuščias
swam	klausimai
syam	saugus
tsut	gydytojas
hlip	Kompletywnyaspektas
kcas	tamsa
nyun	šiltas
hpuc	gėrimas
tlam	pavyzdys
hfun	pyktis
tsik	pyktis
tsam	tiesiogiai
hmup	skrybėlė
klak	šuo
slin	sidabras
swac	tarnas
kcam	pasididžiavimas
pyik	traukinys
myut	moralinis
syak	įeiti
swat	kardas
kyuk	ataka
clac	sveikata
tyaf	pastraipa
swic	socialinis
tfit	pinigųgrąžinimas
hkaf	oficialus
pcas	pažvelgti
nyam	šlovė
tfat	dvylika
pcut	užsiima
pwin	vyno
mwat	skonis
fyac	geležies
syap	paskirstyti
myap	prekyba
hyum	naudojant
fwak	teisėjas
klat	kapitonas
twap	nutraukimasaspektas
kcic	smalsus
kwic	užsienio
hnif	stiprinimo
myun	svarba
tlic	pagaliau
cyuk	kaklas
syut	laisvė
pfan	pusių
kyuc	sausas
pcap	įšalį
tfak	pagrįstasįrodymu
tcik	pagrįstasįrodymuatvejis
twun	tolimas
tyis	pažanga
nyap	siauras
plit	pastatas
hpif	puslapis
pwic	laikydami
syic	liūdnas
tsip	nuodėmė
syim	sergantis
tcis	sąžiningas
pcun	bankas
ksap	priimti
lyam	srautas
tcaf	atsargiai
kwac	ausis
hpup	duona
kcut	pasirinkti
nwam	gyvūnas
hsup	geologinƳlytis
nwit	eventivenuotaika
tcim	taspatsrenginysžymeklis
tlik	dauginamasisatvejis
kyus	kirsti
hmus	storas
kfat	išdrįsti
nwat	augti
myic	lietus
hpum	paviršius
swut	šventas
clis	liepa
mwun	mada
hfas	byla
cwac	petys
kwat	komfortas
nwac	betkas
tcip	geidžiamas
kfac	žolė
hmuk	atkreipti
plin	atidarymas
kwun	birželis
mlik	žuvis
klin	kapitalas
pfut	krūtinė
twam	reikalavimas
fyin	išlaidos
nlit	tavo
mlin	milijonas
pyut	melstis
hluk	pavargęs
ksut	nužudyti
cyut	šešėlis
psin	svoris
kcis	pilkas
pyam	drąsus
mwac	patenkintas
klam	pasakojimas
ksam	nacionalinis
hfip	silpnas
klik	slėnis
hkum	spekuliacinisnuotaika
clas	geltonas
cyuc	šiluma
mlac	palaikai
syip	vienodai
pwak	dėžė
tcif	smailus
psip	principas
ksik	pasekmė
tsim	sezonas
flan	mokslas
pcam	matyt
kcun	gręžinys
ksuk	dėdė
mlit	sąrašas
pcik	pavojingas
kwas	Rugpjūtis
hluc	populiarus
klit	nežinomas
flak	susipažinęs
fyit	susipažinęsregistruotis
lwat	skaitytojas
plun	vaikščiojimas
twas	dvigubai
pcis	kunigas
fyas	sužeistas
nlat	rūmai
myuk	kvailas
pfak	palaikyti
tcuf	devyni
cwap	užuojauta
plac	sprogimas
pyap	išleidimą
lyic	apsirengęs
hcum	triukšmas
lwit	literatūra
tsuk	rangas
hfup	audra
kcik	kišenė
nwap	lapkritis
tyim	gruodis
psaf	nebuvimas
nlac	gyventojai
kyaf	dėkoti
slis	serija
pyaf	paukštis
mlak	savininkas
kwut	kailis
hwuc	santykiai
pyis	greitai
twuc	dūmai
nwak	sausis
mlic	mašina
tlis	dantys
ksun	deginimas
clam	gėda
klaf	kokybė
clit	žiedas
fyak	frazė
fyam	frazėžymeklis
kwap	aikštė
hwip	sekmadienis
psis	poezija
pwut	išankstonumatyti
kyim	nupirkti
clic	laukai
pyip	Balandis
kfap	spalis
psut	objektai
kcuc	kartus
nlap	vergas
hsok	laisvas
htet	tekstas
hbat	blogiausia
hrit	kreditas
hzit	funkcijos
hpet	penkiolika
krac	žiaurus
hduc	dulkės
hrik	praktinis
hron	spalva
hnus	nosis
hric	draugiškas
srik	tiekimas
hten	vakar
tlet	hesternalįtempti
slap	žlugti
hban	dėvėti
hdat	aklas
fran	skraidyti
hdan	velnias
htec	palaipsniui
hmon	misija
cran	auka
hran	sąžinė
hmos	ministras
nrit	energija
hcet	nekęsti
hset	centras
hrin	racionaluslytis
hcot	mėgautis
hrip	trumpas
htep	garbinimas
hcif	oda
hrat	stogas
kran	karūna
hkon	pilis
tran	neviltis
hmif	mylia
trin	ratas
hgin	kalėjimas
hkop	taurė
hcen	narys
swin	civilinis
hrac	visur
hris	paprotys
hbin	tampa
hmot	mėsa
hdut	pienas
hwen	augalinislytis
nran	retas
hbac	pusbrolis
crut	tiltas
hsoc	ištekliai
hsom	druska
nris	nekaltas
hbit	išvengti
crin	susižavėjimas
rwin	karalienė
hgut	skaičiuoti
hdas	šokis
hnot	viešbutis
hdin	pildyti
hton	kalinys
hdak	parduotuvė
hlet	laiptai
hson	malonė
hgek	gėjus
hras	smėlis
hsep	rugsėjis
hbic	griuvėsiai
hlen	licencija
hcon	pakankamai
hgit	liudytojas
kfon	virtuvė
hbak	parduoti
tlim	gydymas
hsot	greitis
kyut	kompiuteris
hnen	amžinas
htek	biblioteka
hzan	kuriameyra
hbis	bazė
hbun	painiava
kcus	virėjas
hgat	dykuma
hwus	bučinys
hbif	ledas
hbot	kamuolys
hrut	argumentas
hdit	palaiminimasnuotaika
hdis	kaltas
hjan	bausmė
plis	policija
hgan	paslėpti
hsen	ekspedicija
nrin	neišmanantis
hyen	debesis
frif	vasaris
hdik	liga
hnek	iniciatyvaatvejis
hbam	teta
hmen	nuolankus
hdip	atidėtasimperatyvas
prat	pranešėpagrįstasįrodymu
hdet	vidurnakčio
hjit	pirštas
hmoc	kažkur
pran	spauda
kcec	regionas
hken	pastaruojumetu
hloc	melancholija
hrak	personalas
htes	žvilgsnis
rwan	apdovanojimas
hdon	dovanoti
htot	kakta
hnet	angelas
hdun	vienaskaitos
croc	klaida
hlon	aušra
hyec	avis
hjin	kantrybė
hrec	referuoto
mran	kukurūzai
htos	dauguma
hcos	priemonės
hkoc	retkarčiais
hlif	pelnas
clak	cukrus
hjat	žmonija
tram	kadras
hdic	diskas
hkok	vienišas
srat	menininkas
crak	žavesys
hmet	siųsti
hden	sprendimas
gran	gubernatorius
crac	filialas
hjac	entuziazmas
hdim	indukcinisnuotaika
hcok	skubėti
hyet	alyva
pwap	vamzdis
trat	spausdinti
tcot	kietasreikalas
hdoc	oi
hren	diskursaskontekstas
tcon	vidurdienis
krin	kabina
plam	žadintuvas
hnes	nervų
tcen	stebėjimas
hsek	aspektas
plik	taikomas
slik	šilkas
hfen	centas
hgen	agentas
hnon	sąjunga
crik	pragaras
tcet	defektinis
mrat	mišrus
hdam	perspėjimasnuotaika
hgac	ambicija
htoc	kažkaip
hdac	patarimas
nwin	konstitucija
srit	instrumentas
hret	stipriai
nlin	prisijungęs
hzat	banga
klic	kolegija
hkek	uodega
nric	karta
hgic	perpildytas
hgak	katė
trit	tiesioginispagrįstasįrodymu
tyot	sutartis
hnok	turinys
crit	apleistas
slen	vienuolika
srin	instinktas
hpok	gentis
hyot	sumanusnuotaika
cric	pastogė
hruc	grubus
cwin	jodinėjimas
hzak	purtyti
dyit	pramonė
hpec	profesija
nras	slaugytoja
hcec	mokymas
hbut	avalynė
hmec	neaiškus
twot	veikla
crat	šeštadienis
hkot	talpa
hnec	saulėsšviesa
hwuf	našlė
cren	mesti
nrat	žvaigždė
hget	svečias
hbik	palaiminti
brin	vidinis
hpot	pasiekiamas
trac	atsparumas
prac	gauti
hcoc	tuščiaviduris
hpon	provincija
hwim	civilizacija
dwan	padvisinti
cwok	šokas
hdok	vairavimas
crun	lobis
hzik	sėklos
hrot	naujaspraeitisįtempti
hket	budrus
hcek	baldai
hrop	virvė
mrac	nuotykis
byit	šventė
trak	metinis
hzin	pietų
sric	ceremonija
clik	medžioklė
trap	liberalus
hrim	krikščionybė
hrus	princesė
blat	altorius
cyon	mažytis
hwep	tinklas
krat	kardinolas
tris	purpurinis
kcot	surinkti
hben	rinkimai
trik	girtas
kfit	keltuvas
tcec	mainai
nrik	neabejotinasstraipsnis
grat	imperatorius
dran	administracija
hpen	anksčiau
cluk	bjaurus
nrac	nekenksmingas
ryin	mokymas
hrun	ritinys
nwic	colis
slit	šaudyti
gzat	laikraštis
krot	pjovimas
drit	barzda
hzis	ašara
hdap	aštuoniolika
sris	istorinis
mrut	bruto
nyik	purvas
bran	nuotaka
drat	priklausyti
djan	milžinas
glat	paprastumas
hpoc	ruduo
pras	šydas
hgot	rinkimas
tret	teatras
tras	palyginimas
rwit	varžovų
hfon	formavimas
klot	treneris
hmum	humoras
drac	diskursas
rwas	romanas
tset	kerštas
hdot	distalinėsdemonstratyvus
ryut	pavydus
hwon	kvietimas
byat	sudegino
flac	blykstė
prot	portretas
crek	pasiūlyti
htok	konfliktas
htop	prakeikimas
prit	prakeikiantisnuotaika
hces	bejėgis
klup	klubas
hnos	potvynis
dwin	abejingumas
prin	horizontas
mrit	arogantiškasnuotaika
tcoc	status
hcom	harmonija
grit	perkūnas
tlot	vaikystė
hgik	kelis
hwes	besąmonės
hzac	abipusis
hsec	programinėįranga
tson	institucijos
ryit	gavimas
dlin	disciplina
slip	slydimas
klon	revoliucija
hfim	ūkininkas
hpom	platforma
cyen	studentas
hgec	urvas
hroc	tradicija
srac	pateikti
ryat	tragedija
kcen	mergelė
hbap	atsisveikinimas
krik	kritika
krap	medvilnė
fwat	ligoninė
kcet	nuoma
hgas	dujos
pfin	neišvengiamas
dlit	lapas
ryan	vertimas
sran	laidotuvės
mrin	miltai
hram	romantiškas
dlan	doleris
hzas	juokas
hsos	šešiolika
klen	kolonija
gyin	sparnas
hsif	liūtas
cluc	gudrus
prip	rengimas
hzut	rūkas
dwat	medicina
krit	taisytikorektūrą
sras	lizdas
hses	keturiolika
brat	prieštaravimas
flat	rūgštis
hjic	būtent
slic	ginklas
hbuc	vartotojas
tron	oranžinis
byan	vonia
hrif	primityvus
tlip	nustatyti
blan	krepšys
kris	sekretorius
hyon	tuotarpu
tren	šiandien
dlat	hodiernalįtempti
hzic	nuodai
tfic	šautuvas
tlen	talentas
hlim	klimatas
dyat	draugas
kcon	apreiškimas
dlac	skalbimas
krak	išpažintis
hbas	nesąmonė
hkec	anglis
hrek	atkurti
hkos	kanoja
hwif	yda
tric	laikinas
hdep	delimitativeaspektas
mwak	krūva
ksot	kaulas
hnoc	pirmadienis
nlas	antradienis
brac	trečiadienis
frap	federalinis
pfit	atstovas
pcoc	polius
lyen	linas
swak	kriauklė
pcen	prezidentas
brit	kruvinas
hwec	apgula
hwet	skrandis
hlos	laiptaisįviršų
hbon	įvairus
pcon	žalvaris
hsem	viršūnė
lwac	pigus
tsos	konkursas
kwen	išskirtinisasmuo
trun	nusileidimas
trut	statula
hrap	artilerija
hgap	suimti
trot	temperatūra
grin	kaimynystė
hjak	apkabinti
hpek	paketas
hlus	elnias
hwos	miegamasis
tsuc	krūmas
pcuc	iškrovimas
cris	įpėdinis
clun	ąžuolas
hpes	nemalonus
nlet	Nebaigtas
hrom	programa
pyon	pianinas
swet	įtikinti
dric	nematomas
tyen	garsus
hruk	žiaurumas
frat	priskirti
hyoc	pagunda
hlep	TELICaspektas
nrot	tarptautinis
nret	smarkiai
hfif	filosofas
pfic	atstovavimas
hmek	jautrus
hfec	gerovė
myik	žvejyba
truc	pavogti
tcop	lūpa
rwic	išeitiįpensiją
htom	ekonomika
glan	galerija
pren	lygiagretus
hlek	atelicaspektas
nrak	žemynas
truk	trankyti
hjim	neįperkamasnuotaika
rwat	kaklaraištis
hcep	ląstelė
dyan	kiaušinis
jrat	dirbtinis
nren	įkvėpimas
ksic	krizė
tsoc	ieškoti
lwan	pietūs
hpos	pušis
hcuf	stumti
tcus	iškeltibylą
pset	išplėsti
hkep	varis
swis	jūreivis
prim	imperinis
trip	plakti
cras	marškiniai
swap	valymas
syet	eskizas
htof	vagis
clen	kanalas
kwit	asmenybė
klok	perteklius
hrok	reforma
hguc	troškulys
kcim	grasinantis
hpem	palmė
psik	garsiakalbis
frit	slenkstis
cret	pėdsakai
mrak	ietis
syen	sesija
tcup	drėgnas
hyek	keliautojas
trim	skarda
plak	skundas
hyok	kampas
hgam	karvė
hmok	malūnas
jrac	žemėlapis
kloc	apykaklė
gyit	sąmoningai
hbip	alus
mlet	aksomas
lyap	piktnaudžiavimas
cwen	pulkas
bwan	dukterėčia
tses	trylika
jrit	pateisinti
nlak	rankraštis
sron	karys
cruc	penktadienis
broc	šepetys
dlot	parsisiųsti
krim	kremas
pric	pikis
prut	žiuri
hgon	užšalęs
sram	pažodžiui
pfot	puodas
hlot	planuojamas
djin	moneta
hlok	šuolis
hpep	obuolys
hwot	vytos
dlak	aptarti
brik	prenumeruoti
nlis	transkribuoti
hbet	lažybos
pris	virusas
hjik	svetingumas
blit	vaikiškas
hjap	apdaras
tfik	atspindėti
hdaf	pasiekti
hpop	opera
kcaf	slėpimas
kcoc	alkūnė
hrum	remontas
cyim	įtartinas
dyic	mokymo
hgoc	duobė
drak	sutrikimas
plas	plojimai
byin	dvejetainis
hzap	abatija
nlot	lojalumas
mrik	mechaninis
hsop	sėkmingai
crap	gaudyklė
kyek	tortas
nrut	linksminti
syes	seras
hjet	septyniolika
hjen	moteriškas
hmom	medus
hdec	deja
lwen	legenda
slot	viryklė
frac	sukilėlių
gwan	bangavimas
mruk	pagerinti
swot	pelkė
zlan	uždirbti
hnem	animacinis
hdes	padažas
prak	pamokslauti
frin	peizažas
hfet	priešintis
cros	choras
ryon	racionalus
tcos	derlius
tsen	apdorojimas
hwek	vilkas
nlik	atsisakymas
klap	kilimas
dras	niekinti
prop	derlingas
slim	švilpukas
hgis	sūris
krut	įkąsti
srot	palyda
bjan	nuklysti
nwen	karinisjūrųlaivynas
myas	kaukė
kwaf	plėtoti
twis	Taksi
pcip	pieštukas
srap	daržovių
sren	eksponatas
tlun	kelnės
hrup	korupcija
nrip	kabinetas
srup	sriuba
jran	chirurgas
bjat	pašalpa
gyat	šnipas
hlem	neapgalvotas
srak	abstraktus
kson	akcentas
cwis	ketvirtadienis
sret	nuoširdžiai
hraf	eismas
hres	architektūra
hsuf	atsikratymas
rwak	krekas
twon	ornamentas
hfus	atsigavimas
hkom	kodas
djat	medžiotojas
nlut	naujienlaiškis
hsef	gyvatė
mris	demokratija
bric	baterija
mlam	vaškas
zran	dalintis
cron	suvirpinti
hzen	plaukti
traf	juostelė
cwaf	vokas
srip	cigaretė
mrot	variklis
swon	savanoris
ryak	reakcija
pfun	išdalies
blac	bagažas
mret	ministerija
hjon	seksualinis
kcok	kirvis
dram	deimantas
kren	atsarginis
tcek	aidas
hdif	tapatybė
tfas	ambasadorius
hfot	būti
lwas	tingus
hmep	momentaneaspektas
kfin	kodavimas
mwin	įsivaizduojamas
hrem	spindulys
pram	vijoklinis
byac	rūsys
mren	įsimintinas
swen	senatas
kras	karstas
hgun	nuryti
nlok	atsiduoti
ryic	žemėsūkio
gwin	sūpynės
srut	pieva
hkes	kompleksas
hfis	atsistatydinimas
frak	pakartotinai
hnom	sąmokslas
hcop	baras
hlec	paprika
mlot	melodija
zrat	kandidatas
proc	globėjas
flik	lapė
cyet	apgailestavo,
hgim	kaminas
slet	gyvatvorė
tcok	tikslumas
bjit	buvęsvelionis
brot	pumpuras
bwat	antklodė
hdus	kiaulė
gwat	drambliokaulas
kret	ekstraktas
nwet	stebėtojas
jwan	alėja
nwis	nagai
mwic	bitė
bzat	aktorius
gyan	prakaitas
zyit	vykdomasis
blic	iliuzija
pcet	neapibrėžtumas
tsot	sulankstyti
bwit	riba
tres	stresas
hkof	vartojimas
nyen	dejavimas
hles	priminti
cyek	maišas
hjis	adata
gjan	reiškinys
prec	elgtis
drot	kontroliuojamomis
kcek	kreivė
twic	vištiena
brak	statinė
zwat	įprastas
clap	įprastasaspektas
tsec	ekspertas
bwin	įteigti
cwet	apriboti
hbek	kepėjas
zlin	alyvmedis
mron	furgonas
drin	skirti
psap	atskleisti
gjin	gimimodiena
clut	plaktukas
cwun	gardus
twaf	trivialus
pcot	glamonėti
krok	kaukolė
dlik	teisėsaktųleidėjas
cwic	laimei
srun	raukytis
crec	naikinantis
jlan	marža
kcip	čempionas
blin	milijardų
ryik	cheminis
mlas	pulsas
flit	pilotas
hzet	mazgas
cwik	didingas
twet	sijonas
mwik	kassavaitę
tfis	techninis
tlon	transportopriemonė
cram	gražus
grac	stiprinti
kraf	varna
trup	atributas
hduk	kablys
cruk	tigras
nrap	namųšeimininkė
crot	greitkelis
mlip	milicija
hfoc	nuotrauka
nres	vientisumas
plos	plius
tfam	skaidrus
nlic	devyniolika
hwok	kvalifikuotas
nlen	esė
fyic	efektyvumas
hwuk	unikalus
hgok	organinis
flic	teologija
flot	plūdė
hboc	įpareigoti
hwoc	ragana
syot	studija
cwip	šampanas
hbes	vėliava
lwic	skyrybos
blot	varžtas
cwot	nelaisvė
cwam	vena
prik	pasyvus
hfum	puta
grik	žvyras
zrin	prijuostė
gren	planeta
hfuc	atgaivinimas
claf	lentyna
flas	ventiliatorius
hjot	tropinis
hbim	savavališkas
krek	gyvsidabris
hbec	palankus
tsaf	savižudybė
pwas	pešti
plot	reporteris
kfak	išleisti
blak	balkonas
hdos	dėmė
kwis	klasikinis
kcos	apkaltinti
psen	pensija
kres	veiksmažodis
hzon	beždžionė
srim	parašas
glin	nenoras
mlut	pagarsėjęs
myot	importas
fwac	įkūrėjas
troc	deglas
hgaf	gramatika
hyop	jachta
ksip	užgesęs
sres	ekskursija
hnup	kupolas
hzun	užsispyręs
mric	raumuo
gjat	dydis
hros	patrinti
zrac	bailiai
tros	skrebutis
myus	pelė
dwac	dialogas
byak	ožka
htef	siuvėjas
hfek	klestėti
dzan	primesti
nyon	anoniminis
zrit	formalusregistruotis
pcos	sporto
hjec	išlydyti
dlas	panaikinti
mras	skėtis
mram	mineralinis
cwut	paliaubos
hbok	antis
swun	muilas
dwak	lėlė
plif	vila
slon	siuvimas
tfut	pasveikinti
djac	suderinti
hjas	slopinti
kric	triušis
kwot	dirigentas
gzan	garantija
clot	žaidėjas
ksek	vabzdys
psam	laikysena
mwut	pelėda
htem	nuolat
clon	smuikas
dzin	gyventojas
rwim	atitinkamai
hyof	naudingas
dron	drakonas
dwit	girdimasispagrįstasįrodymu
sroc	eksportuoti
hzot	nutraukimas
djik	užgaišti
kfik	dangtis
ryun	reguliavimas
hmes	meras
rwac	techninėįranga
sruk	cirkas
sros	mažuma
bzan	riaušės
kset	orkestras
bjon	bekonas
hjut	neribotas
tfen	ginti
zwac	nenauda
dyin	apdairumas
myis	muzikantas
mlis	protiškai
pret	netinkamas
tsek	architektas
hlom	citrina
ksos	kosulys
crok	galvosskausmas
flin	vaisingumas
mrun	dailidė
swec	atsitiktinis
syuk	šaukštas
blun	balionas
tcep	kreida
fric	pasistiprinimas
rwik	vertikalus
rwen	užkirstikelią
flet	Netiesiogiaipagrįstasįrodymu
pfac	leidėjas
srek	actas
tfun	tunelis
pwet	dėlionės
gyik	matematika
fwot	blukinti
lwin	subalansuotas
jwin	kepenys
bwik	sublativeatvejis
hdup	panirti
hnop	monopolija
bwic	povandeninislaivas
ryen	nesvarbu
hcem	žemėsdrebėjimas
hbos	laboratorija
nrek	darbuotojas
ryim	ritmas
nyic	interpretuoti
dwas	ambasada
rwok	išprovokuoti
kram	nesugebėjimas
ksim	deklaratyvusnuotaika
clok	šokoladas
pcec	privilegijuotas
nyis	atsiskyrėlis
tyoc	sutapimas
grak	įdrėskimas
zlat	pirštinė
hjuk	atsiklaupti
trif	geografija
djit	sistemingas
pson	nenugalimas
mwis	investicija
cwec	žodinis
hdek	pasaulietinis
blik	vanagas
sloc	psichologija
brap	metalolaužas
jlat	piratas
dros	dozė
slam	lašiša
pwun	pudingas
gwik	magnetinis
pcop	siurblys
myen	panašiai
ksen	deguonis
mrap	Meistras
tfot	pažymėjimas
ksus	klasteris
trok	retorika
tloc	skersinis
zyan	irkluotojas
nlun	Prisijungti
hlop	teleskopas
jlin	rašyba
lyut	drumstas
hsof	bangųmūša
fyik	viskis
klet	palyginti
hwof	gluosnis
hlum	kupranugaris
myet	mėgėjas
klis	izoliacija
hbaf	biografija
gwac	asilas
hwum	gandas
pwik	perspektyva
pron	už
myes	kasmėnesį
mwen	svajingumas
kfic	atostogos
klek	spragtelėjimas
cwon	ovalus
lyak	elastingas
kwon	žodynas
hjam	kumpis
rwon	vaivorykštė
crip	šiuo
zwan	vyksta
srok	redakcijos
craf	kapralas
tlok	bakas
brip	drugys
tfap	schema
jwat	dvynys
pros	veiklos
psun	ženklas
clet	menkystė
hbus	bambukas
dyas	prekiautojas
klun	kaupimas
jlit	vieningas
hdom	košmaras
kron	anglis
hzam	uogienė
cyot	klausytojas
hmem	muziejus
lwam	abėcėlė
fras	sklaida
psoc	punšas
hgum	guma
brek	stabdys
glit	stabilumas
frun	puvinys
gris	agresyvus
mroc	trintis
bzit	voras
plut	bulvės
glac	godumas
gzac	daugintis
prun	sukinys
jlet	kalendorius
nyim	skyrimas
tlos	trilijonas
slut	salotos
fwit	teigiamasnuotaika
pyen	programos
nlon	nominalus
dren	įrodyti
drun	nepasitenkinimas
cyok	trūkčiotipečiais
hfop	futbolas
ryac	partnerystė
gzin	pradininkas
hgip	kopūstai
tyet	Atletiškas
hdof	saviskambių
hwup	neįkainojamas
lwek	svirtis
syec	senatorius
jyak	apgyvendinti
mlim	skruzdė
fwic	efektyviai
gzit	nėščia
blas	priklausomybė
jrin	kiekvienądieną
gwak	kulkšnis
drik	keistai
prif	kintamas
jwit	įvairovė
krip	diskriminacija
ryot	awed
nwut	šaligatvis
kcif	aktyviai
jrak	varlė
twek	perdėtasatvejis
psot	atpirkimas
pfon	kempinė
sluk	voverė
nlim	irrealisnuotaika
ksaf	trūkumas
glak	vulkanas
plen	pusiausvyra
kfaf	šalikas
kyon	išnaudoti
jlik	geologinis
psop	pasas
kfis	laisvavieta
fyon	giminingumas
nram	amoralus
hbuk	biskvitas
gras	transas
hyos	sumanus
flim	filmas
plet	tabletė
rwam	atomas
blis	vanilė
zlit	AIDS
fyut	išrankus
crim	piramidė
hjif	neteisėtas
crif	drovumas
lwap	liutnia
tyon	astronomija
mrim	labirintas
drut	aprašomasis
nrim	stipendija
kruc	vėžlys
kwam	patarėjas
jrik	Kriketas
dlut	pažymėti
pyot	karvelis
dyon	pritaikymas
prap	operatorius
bzin	ženklelis
tyek	trikampis
trec	iždininkas
nron	vandenilis
pyet	spausdintuvas
tsok	droselinėsklendė
zyin	lėtinis
slek	dviratis
jyin	inžinerija
ryas	transmisija
zrak	atnaujinti
nyas	šokėjas
gric	migracija
zlak	pažeisti
tces	tenisas
hjun	vėjuotas
twen	pynimas
kyet	kolektorius
gwit	stuburas
kyot	styga
fwin	dažnis
tfuc	staklės
dlet	katalogas
pfik	mąstytojas
bjet	biudžetas
trek	strategija
kros	kvarcas
gjit	žirklės
gwic	jungiklis
frik	teorinis
tluc	rankšluostis
pruc	patrulis
glic	ledynas
krun	užbaigtumas
bjin	prognozė
tlaf	dalyvauti
tfet	gamintojas
bras	šoninis
dwik	atsakovas
clec	išmetamosiosdujos
cres	Šachmatai
tcef	vyšnių
tcom	suklupti
nyot	vertėjas
tyok	sunkvežimis
cyip	pralenkdama
grot	garstyčių
bris	bevielis
nlam	aukcionas
slif	sietas
hgos	rūdys
swoc	netvirtas
jyat	bankrotas
slum	islamas
hjes	surašymas
dzat	pasistiebus
slun	sustabdyti
nwot	nenutrūkstamumas
gyic	gitara
pfas	šališkumas
zyik	cinkas
blen	blizgus
hyem	guoba
hnep	peštynės
nyut	megztas
ryam	įvardisžymeklis
clim	prieskonis
jret	aštrumas
tfon	erzinti
jwac	Java
hrep	receptas
dyac	frančizė
myip	matuoklis
rwis	rasinis
hkem	kometa
nwon	naujovė
zwin	draudimas
dyis	viduramžių
mrec	žvirblis
fyot	išnaša
mlon	matavimas
pfis	ratifikavimas
rwot	orbita
hfok	kuklus
glof	golfas
zron	nulis
hzip	užtrauktukas
hwom	benamis
bjic	kramtomas
pcim	įvykdyti
hjip	lustas
bwac	žiovulys
mlos	molis
mrip	keramika
bron	embrionas
ksoc	atskaita
cyum	mielės
jyan	žargonas
plim	slyva
mwet	kapinės
ryet	absolventas
glik	drėkinimas
plap	kapitalistas
tsif	elastingumas
gyak	ryklys
djon	numatytasis
nwun	punktualus
cles	realizmas
dris	vislabiau
hkef	kavinė
blus	greitosiospagalbosautomobilis
blap	piniginė
bjak	ekstaziškas
klim	kraipytis
gyac	mokslininkas
jyit	šaltakraujiškumas
dzit	realus
bwak	lauko
dyot	radijo
bwon	pupa
fris	neoficialus
klut	spėlioti
tfek	kepsnys
nrok	azotas
zyat	skustuvas
bram	burzdėti
ryis	įžanginis
nlip	analizuoti
nros	kontrastingos
hcof	nusirengti
tfif	paskata
kroc	vaga
hdum	judaizmas
pses	Gavėjas
plok	papildymas
lyet	lęšis
pwek	pegativeatvejis
kfas	Vėžys
pwen	pėstininkas
nrun	priminimas
clek	nutekėjimas
pcif	apgynimas
glas	sudėtingumas
zwit	kalbus
kces	pakankamumas
crem	mažmeninė
grap	patraukti
kwip	įsikišti
dyut	nuolaida
crus	hierarchija
gyet	nuvarytas
gram	urzgimas
kyip	driežas
nyet	bloknotas
crop	krioklys
glon	galonas
mrok	uodas
fluc	sklandus
dwic	nukrypimas
slec	tyrinėtojas
srec	baigiasi
blut	ristis
myok	mozaika
tlek	kištukas
nruk	užkrečiamas
nwoc	nuošiol
bjut	pritūpęs
hges	nėštumas
twoc	bakalėjos
kyos	komunistas
mrek	stebinti
clip	atgaila
pwok	prosecutiveatvejis
dwot	diktatorius
zyac	susirūpinimas
jlic	palydovas
slop	šlepetė
ryip	proporcingas
psim	apytikslis
byet	bedarbis
cyop	hobis
rwun	kriterijus
blop	lemputė
syok	rėmėjas
klos	chloras
lwot	chloridas
byic	bakterijos
lyik	lipnus
blok	biologinis
jlac	apsimesti
bret	baitų
krif	sekrecija
blet	baletas
nruc	šlapimas
tsus	česnakas
dyak	vidurinėklasė
tcem	žnyplės
cyoc	sudėtinga
trep	žemuogė
dlun	tarša
hlup	albumas
hbep	beisbolas
praf	piratavimas
pwis	dalyvis
grek	garažas
kruk	ramentas
hfof	fosforas
rwut	struktūrinis
myam	gimnazija
krec	kranas
jras	rangovas
zrik	pranešti
blam	Balus
klip	amatininkas
hwef	neapmokamas
zlac	bananas
gret	generatorius
lwuk	šonkaulis
nyek	nikelis
blos	autobusas
sles	cenzūruoti
tlif	čerpė
kses	dešra
mwot	pomidoras
lyot	automatinis
tsom	kalis
brut	virtualus
djap	algebros
hjok	bendras
kfen	sąvokos
pcok	optinis
bzut	judintis
syek	nedarbas
mruc	vikšras
bwas	naršyklė
klif	kalcis
rwet	Nuotolinispraeitisįtempti
srif	istorinisįtempti
hwem	spektras
syom	natris
tyos	globėjas
jyic	įkaitas
hguk	moliūgas
dwun	raukšlėtis
swip	smaigalys
tlec	erkė
blaf	rapsas
tsem	ateizmas
mloc	monitorius
gyot	sąlyginis
trop	zondas
rwap	kasketvirtį
hjep	Lytis
pyim	platina
dlon	dvigubasskaičius
pcep	plaučių
twuk	šveitimo
tyec	etiketė
syup	Super
trom	vežimėlis
nyip	vietoje
glis	benzinas
gjik	inkstas
hjos	bepriežiūros
hjuc	plėšikauti
swek	persidirbęs
psek	arsenas
twok	statistinis
tsep	žiogas
slos	socialistinė
nwim	sensorinispagrįstasįrodymunuotaika
tlop	staltiesė
trus	prieštaringas
pwot	pasaitėlis
djot	nuosėdos
nloc	paniekinti
mwon	mandarinas
hjek	menestrelis
crom	bendradarbiauti
myon	plaučiųuždegimas
twec	išdėstyti
ryek	raketa
dlic	dividendas
kwet	raja
bwen	manija
plon	paskirstymas
syon	alsuoti
djis	skaitmeninis
byut	kalė
hyep	akiesvokas
dwon	įstrižainė
byis	pasąmonė
brec	antakis
cyec	čiaudėti
hwop	vatas
clus	labailinksmas
kfun	užimtumas
nwum	induizmas
fyim	pabėgėlis
cwos	Pervežimas
tfoc	skaudėti
pwon	baltymas
sraf	savarankiškaipatenkinti
hbom	vemti
gyen	genas
drim	pirmakursis
trem	ekipuote
tsup	subyrėti
slok	sociologija
kwoc	skvošas
bwam	rinkėjas
mlok	judrumas
kyen	regioninis
hmop	judėjimasįkalną
rwek	retrospektyvus
kfup	kubas
grok	morka
drap	apgauti
lwis	Molekulinė
ksuc	buhalteris
tsop	tvaikas
kyok	agurkas
nroc	orgija
jlot	tirpiklis
psof	fosfatas
hgif	žavėti
kfim	šarminis
psos	gimnastika
pfen	patikrinimas
kcom	ekonomistas
krom	kablelis
tluk	kraipytis
hyom	jodas
nwuc	judėjimasžemyn
gjac	persileidimas
pcom	ankštis
dzic	dizaineris
grun	Samochwalstwo
dzot	donoras
hzek	manganas
kfot	klaviatūra
jlas	nepatikimas
lyim	elitas
jyen	jena
pcaf	įterptinys
rwip	Regbis
blip	Biblija
kyoc	priežastinioryšio
lyon	opa
flis	fleksyjnych
nrif	kandinėti
kfam	Quantum
swes	megztinis
lwon	evoliucinis
drec	skrodimas
gjap	spa
lyec	linijinis
tyom	stibis
pwuk	superessiveatvejis
flaf	alfa
myim	imuninis
pcek	pagrobimas
bjac	alausdarykla
bzac	sutrumpinti
bzak	puskojinė
twes	televizija
dwut	dokumentinis
ksom	kosmosas
lyis	miškininkystė
lwim	aliuminis
ksok	horoskopas
sruc	pagreitinti
dlif	delfinas
byik	žudikas
tfec	Raštinėsreikmenys
hjaf	žinduolis
ryok	protokolas
dwis	dvideginis
jlon	dvitaškis
brus	biurokratija
gjak	galaktika
lyip	klinikinis
ryem	radis
href	praretinta
prok	šaldytuvas
slep	satyras
dret	iteracija
kluk	archeologinis
dlis	Idiosinkrāzija
kfip	nepriimtinas
mlec	masažas
pfif	detalizavimas
nrec	sensorinis
pfet	lapelis
hzoc	gulėti
dlam	idealiai
nlec	antropologija
kluc	skanus
dyet	sedanas
tyif	pereinamas
krus	susigūžti
nluc	saulėgrąža
lyun	jonų
zrot	ekstradicija
ksif	klastoti
psif	emisija
crup	išdaliessutapti
fret	ieškiklis
grut	invertuoti
ksec	klasėsdraugas
jric	maršrutas
mrop	mikrobangųkrosnelė
srus	išstumti
gyas	kirpėjas
floc	folkloras
plek	kapiliarinis
nwop	užpakalis
nrom	kontrolierius
twos	terorizmas
lwok	šūkis
dwet	sulaiku
slem	sublimuoti
grip	grotelės
gwas	Oho
kwok	kobaltas
gwon	aviža
hdop	judėjimasPriešsrovę
glam	išangės
bwot	jaučio
bren	žarnyno
byot	video
bjik	boikotas
kwim	viktorina
cwek	ledoritulys
grif	partizanas
hgem	magnis
hyes	sąmoningumo
fram	vaistinė
nwos	siekių
ryap	pertvarkyti
cwim	patikimumas
klep	rusviejidumbliai
psec	atlyginti
djic	pasaulinis
kfut	komendantovalanda
crep	mėsainis
frim	teorema
gjas	užsidegti
hdef	debetas
ryum	uranas
pluk	įvertinti
krop	koordinuoti
nraf	mokesčiųmokėtojas
tyes	integruota
plip	išreiškėnuomonę,
hgom	gama
hgus	koeficientas
cwuc	šildytuvas
zret	atimti
nles	analitikas
trof	negalininkinis
hmof	prekyboscentras
hzim	bismuto
dzac	pietautojas
psok	atvirukas
blon	konvergencija
djet	nutolti
ksum	akcininkas
mrup	mikrobas
clif	sraigtas
cloc	morfologinis
tfes	tiekėjas
gjis	džinsai
jren	išlyginimas
tlep	duomenųbazė
kcup	kuponas
glot	įtampa
glut	skaičiuoklė
srep	kibernetinėerdvė
nwes	investuotojas
ksef	rentgeno
bzis	viza
frut	infrastruktūra
nyuk	žibukas
dyik	detektorius
plec	sudurti
brom	bromas
plop	paladis
zlik	silicis
flut	voltas
ksop	kosmetinis
gjun	Grooming
kfok	žagsėti
hpof	pūsti
hzuk	zoologijossodas
nyoc	konotacija
jwak	joga
brim	baris
kles	nukirstigalvą
mwam	Taip
fwik	protrūkiai
djas	džiazas
dyim	garso
tsum	volframas
drip	driblingas
lyaf	alimentai
prom	programuotojas
nrup	indėlis
hfes	sangrąžinis
rwaf	chrizantema
dlen	dokumentacija
byas	vakcina
fron	heroinas
dluk	atjungti
dyun	diagnozuoti
flap	aplankas
kfet	katodas
dlim	ideologija
prek	automobiliųstovėjimoaikštelė
syoc	momentinėnuotrauka
slus	prieinamumas
nlos	atoslūgis
mlen	selenas
pres	žievė
hlof	siera
nlek	dabartinisaktualumasžymeklis
gwot	orouostas
mwip	apgavikai
klop	tarakonas
kwom	chromas
hl6t	litras
nwec	visdėlto
glip	ciklinis
nrop	darboužmokesčio
crum	hormonas
dlep	programuotojas
frot	pradurti
bwoc	diversija
fwis	feministų
djok	sujungtas
draf	modernizuoti
trum	ekstremistas
graf	algoritmas
lwes	lazeris
mlem	milimetras
flen	lankstytis
zlot	anodas
swok	prisiglausti
klec	šuopavargęs
pwim	nevisądarbolaiką
htuf	tunas
fyis	naftosperdirbimogamyklos
lwet	jautrumas
mrem	Universaliejikompiuteriai
jwic	atjauninimas
droc	demonstruotojas
clem	helis
dzik	dvikalbis
psem	plazma
hjom	chromosoma
rwuc	kelintinis
tyus	sveikasisskaičius
klom	kilometras
hfos	faksas
nwek	genetika
jrap	atsuktuvas
zwas	užkandis
bwok	Brokoliai
dwap	adapteris
syem	šlamštas
blek	vektorius
tlus	taktika
pyif	nepatikslinti
cwoc	gerai
mrep	amperas
hbem	vitaminas
hxan	durininkas
hxut	subsidijuoti
hk6m	kadmio
hxin	vienalaikiškumas
txin	titanas
kxin	kilogramas
klum	poruotis
xlis	smėliolaikrodis
hqak	sintaksinis
hxat	kūrybiškumas
hxik	eknyga
hxas	darbovietoje
bxon	boro
dxin	induktyvumas
hxit	sraigtasparnis
tlum	telūras
txit	terminas
kxat	oksiduoti
hvik	lygiuoti
nluk	analogas
nyem	centimetras
hm6t	molibdeno
hl6m	ličio
ht6t	daugialypėterpė
xlit	kalorija
ryop	robotas
pxas	vaistininkas
hxak	namųdarbai
lwif	vietininkas
grim	logaritmas
hqat	Mantis
qlit	ekologija
xlik	padirbinėti
mlep	šablonas
hqit	radioaktyvumas
kxim	kilogramas
hxen	nuomininkas
hxot	persivalgyti
kyif	kopijuoklis
fwet	nemokamaprograma
txet	poaibis
hs6n	nuoseklus
hxet	nusiklausyti
xrat	kirpimas
hqan	įginti
hr6t	iridis
bxat	pralaidumo
dxet	darbastalio
hxis	eksponentinis
hxok	Buveinės
hxek	nudėti
srem	cerio
hp6t	dalijamasis
pxik	dalijamasisatvejis
kxet	kasetė
pruk	prekyboscentras
hvit	valios
xlin	neprisijungęs
frip	šifravimo
hvep	permokėti
hxon	sinchronizuoti
kxit	maksimizuoti
hqin	seminaras
tr6n	aparatūra
ht6n	segė
hvat	Artėjantis
sl6s	Celsijaus
hn6n	neonas
ts6t	nekilnojamasislaikas
hvin	racionalizuoti
pxat	laikraščiųkioskas
myoc	modulis
ps6s	makaronai
bwek	portfelis
dlok	prabangus
fraf	užkarda
hr6k	artefaktas
txat	pietų
hqon	raudonėlis
pxun	plutonis
ks6n	darbostotis
slef	eskalatorius
xrit	asmenssargybinis
hvut	perpildyti
xrim	itris
hx6t	patobulintus
hqum	Vartotojovardas
hl6n	pardavėjai
gron	argonas
pxan	reklamos
hvac	indaplovė
xlan	globalizacija
txon	bangosilgis
xrik	pakartotinaipanaudoti
hxap	kuprinė
hxac	perkrauti
xyat	hepatito
cwep	paycheck
hxos	toras
txif	šrifto
qlat	maklerio
txot	vidurioruduo
hxam	miligramas
pxis	pikselių
pwif	Peržiūrėti
txam	tantalas
myek	termodinamis
hbop	įsilaužti
hqot	tirpinys
xlic	neįgaliųjųvežimėlis
gxit	genocidas
hvan	ugniesgesinimas
glim	galio
pfop	popmuzikaaukštyn
hzum	cirkonio
xlon	karštojilinija
qlin	netiesinė
kxam	skandis
blim	Berilis
kxik	konfigūruoti
nr6n	neuronas
hpef	predikatinis
hruf	maršrutizatorius
kxan	faktorialas
hxic	Gairės
xlip	tinklinis
dyek	derinti
hxop	laikrodis
qrot	neutronas
nwip	niobio
hs6t	tualetas
grem	germanis
tles	Nemetāls
hp6k	prolativeatvejis
qyin	biologinėįvairovė
txak	antibiotikas
mlun	imobilizavimo
txan	Actinium
xran	astronautas
dres	sumažintislėgimą
tr6t	esantisužžemėsribų
hk6t	oktetas
hxus	atvirasšaltinis
xlat	Głupek
mraf	maratonas
ts6n	viduriopavasarį
ht6s	autizmas
nlif	jonizuoti
txut	įžymumas
hm6n	skleidžiančių
kxis	klipasmenas
xrin	vyksta
xren	Skamb
bxak	Pažymėti
pfos	užfrazė
hvis	išmatos
hd6n	vardiklis
brum	salę
hqis	šovinistas
hk6n	sudaryti
xyit	perėjimasraktas
xyin	vienasekundė
hxun	egzistuojančias
hvas	vaidmenys
glok	Dienoraštis
hvak	Vingiuotos
pxit	IPadresas
hvet	šalia
xram	dygminų
hc6n	akivaizdumas
qran	Koranas
zyen	xenon
hqas	prisiekiu-in
bzas	Zblazowany
hj6n	nežmogaus
hnof	neįpareigojanti
txas	kūrėjai
hbum	budizmas
ts6s	konfliktus
pxin	ingridientai
hr6n	racionas
hxim	viduriovasarą
dxit	viduriožiemos
hxaf	iškasti
nlus	namasaugalas
txap	statusasbaras
vrit	svetimųkalboje
kxak	kvailioti
bxin	Žmogauskūnas
hqik	lietpaltis
hxes	Hertz
hxif	hipnotizuoti
xras	valandinis
pl6k	paralegal
dxat	skubotumas
hxip	antikūno
vrat	šortai
hqek	performavimas
qrit	poliškumas
pxot	paštas
hxom	šlamštaspaštas
hqic	recenzentas
lwun	mėlyna-Jean
hp6n	brendimas
dxan	pritvirtinti
xrak	aktoriusvaidmuo
dxak	avarija
hven	konteineriai
mwap	komiksųjuostelės
qlan	neskiriantisspalvų
xros	išsirengimas
srom	salonas
hc6t	kalbasi
qrat	aukštynkojomis
hn6t	slopinimas
hqet	Internetosvetainė
fres	fundraise
froc	kalimas
xlak	hipersaitą
vlat	plepumas
dvan	išlipant
gxin	užkariauja
ryes	registratorė
kxot	jungtys
xyan	ribųnustatymas
vlan	reklamuotojas
ryom	torisatomas
hluf	senatvė
hquk	švirkšti
lyum	tulisatomas
tyem	terbisatomas
hp6m	praseodymium
txic	namaipuslapis
mros	automobilistas
dyam	rodisatomas
pc6n	bandomasisskaičius
nyos	paštodėžutę
pyek	projektorius
kxon	kriptonas
hxuc	išgelbėjimas
qrik	orientuotasatvejis
xwin	nepatyrimas
kxic	gesintuvas
hvot	struktūrinėschema
dxot	jogurtas
hqut	registruotiiš
pxen	departamentų
drok	tikslasgaidukas
flon	Mobilusistelefonas
txos	vidurysbalsas
hqok	įstrižasatvejis
xwik	pacientasatvejis
hx6n	priešhodiernal
txik	rodomasispirštas
hqen	siuntėjas
mlap	kenkėjiškaprograma
hvun	Perswazja
hvon	susidėvėti
vran	paštovežėjas
pfes	profesorius
pwip	poetas
hqam	sportuoti
gxat	teisėtumas
ks6t	priežastinis
vrin	verbuotojas
kxip	klipaslenta
sr6n	nepritariama
vlit	vertinamasis
tyup	priemiestis
mrom	Morpheme
xron	ausinių
gxak	brangus
hrof	Trojosarklys
xlas	paralyžiuotas
dzet	perdekoruoti
txac	atiduoda
xrot	nepanaudotas
txis	taškasmatrica
syif	sivienetai
xrac	stebėtinai
brif	dvejetainisvertė
dlos	modalinisatvejis
txun	atributai
dvat	Gderliwy
psom	išpirmųrankų
gjek	dar-jei
nlem	vienetas-of-mas
qret	mažmeninėprekybaparduotuvė
txip	trigubastaškas
dlek	atskirai
lwut	srautosrovė
dxis	dramatiškai
hs6m	cezio
vlak	Torpeda
hn6m	Nerium
kxap	kartonas
bxan	išvykstantiems
myem	gegužėsmėnesį
gxik	civilines-teises
hxoc	oropajėgos
xrok	bendradarbis
kr6t	screenshot
txok	automatiškai
hxep	riedlentė
srop	smartfon
pxak	kepurėsspyna
hk6k	liaudiesmuzika
hl6k	euler'snumeris
pyom	polonisatomas
xyam	talisatomas
hvic	invazija
lyok	vietininkasatvejis
xlot	Butai
txen	Perskaičiuojant
kxac	kontrataka
qrak	streiklaužys
hbup	plaukiojimobaseinas
txuk	trumpassujungimas
tsef	nusmailintas
bxit	tinklaskariuomenė
ksem	skaitytitik
byim	rubidžioatomas
hvam	vanadžioatomas
lw6n	lantano
frum	fluorasatomas
nyom	neodimio
mlom	multalskaičius
kxas	individualizuoti
xret	terabaito
hs6k	Paieškavariklis
frus	korozijos
gxan	galaktikalytis
vlas	vocalizations
glet	greičiopedalas
hvim	runtime
bxip	bitmap
qrin	žvaigždėlytis
bvak	abessiveatvejis
pxon	nepasiekiamas
dvik	adessiveatvejis
dvek	agentiveatvejis
hlef	agentasgaidukas
kwek	įatvejis
kxen	bendraslytis
ht6m	citataforma
tsuf	Transskaitvardis
hf6n	baudimas
tc6t	tiesioginisobjektas
gvik	ergatyvinisatvejis
gxon	skilimas
ksep	receptorius
vyin	kinoteatras
pyos	pasyvusbalsas
hnef	baigtinisveiksmažodis
xwit	pagrindinisobjektas
hqim	Gnomicznynuotaika
jlak	apibendrinimas
vrik	galutinisdalelė
qyan	įsivaizduojamavienetų
kxaf	greitisnuošviesos
xyic	Phishing
qyit	kritinistaškas
hvek	evitativeatvejis
bvik	subessiveatvejis
hzes	apsėstasatvejis
prus	kompiuteriųvirusų
ples	procesorius
pxif	policijapareigūnas
dvak	liacinėsatvejis
brun	turistinis
tsi_k	antessiveatvejis
tyum	rutenisatomas
vyak	prieveiksminisatvejis
pxim	ministrasPirmininkas
syum	stroncioatomas
sy6n	įtarumas
hy6n	pagyvintilytis
pxac	empatiškasdžiaugsmas
vlin	transportopriemonėlytis
qwin	mineralinislytis
hr6s	kreipimosi
tf6n	tonerio
xris	Vartotojassąsaja
hw6n	barimas
xlen	žodinisdaiktavardis
pyec	skaičiuoklės
vlim	virtualusatmintis
bres	žodisprocesorius
hqip	debesisKompiuterija
vlic	virtualusmašina
pfam	paštošiukšlintojas
dyap	antrakalba
txek	n-ojošaknis
dxen	duomenyskasybos
byip	verslasasmuo
hs6c	savarankiškaipasitikėjimas
txim	nuoroda
hb6t	pokytisišrenginys
hdem	domenasvardas
dxon	kitoksrenginys
lwaf	blykstėvairuoti
sl6t	crastinalįtempti
xyik	padribęsdiskas
fyif	sangrąžinisbalsas
bvin	visatalytis
hm6p	plokštė
tfip	pereinamasveiksmažodis
jlen	vietovėlytis
xrap	dryžuotas
tc6n	tyrimaslytis
sl6n	meninislytis
xrek	pacientasgaidukas
xwan	abstraktuslytis
dxif	videokonferencija
dyip	netiesioginiskalbos
zrek	exocentricatvejis
hvuk	žadina
xwat	praeitisTobulas
hr6m	renis
txaf	sukėlė
hmef	beasmenisveiksmažodis
tx6t	tekstasredaktorius
txes	kolektyvasdaiktavardis
bvat	išnaudodami
bvuk	absolutiveatvejis
ry6t	radianas
vlis	virtualusrealybė
qren	planetinislytis
gvak	gramatinėatvejis
bxok	nuplikęs
mrum	kompiuterisprograma
ps6t	veiklossistema
hfom	fonema
tlem	skaitytitikatmintis
pwam	šnipinėjimo
kfif	šerdisbenefactive
qwit	racionalumas
nlaf	montavimas
nwok	asociatyvusatvejis
dzas	nepatenkinti
swuk	aukščiausiasatvejis
syos	Apibendrinus
kr6n	elektrosdabartinis
dvin	negyvaslytis
pxom	propositivenuotaika
vris	abipusisbalsas
rwos	aerozolio
dr6t	dėmesioišblaškytojo
ht6k	telekomunikacijų
slaf	socialinistinklų
lyuk	nuoseklusišlyga
qras	vyresnieji
ty6n	terminalas
gwet	greitaiateitisįtempti
hp6s	TAIKOMOSIOSbalsas
tsof	antipassivebalsas
ht6p	Continuativeaspektas
hn6f	necessitativenuotaika
pfip	pasyvusdalyvis
glap	įrankiųjuosta
sy6k	egzistencinisišlyga
qyat	šviečiantisintensyvumas
hy6t	gramatinėobjektų
vyan	Pareiškimą
sluf	singulativeskaičius
dvit	perdėtastrukmė
qyak	vienasveiksmasveiksmažodis
bzik	fizika
xlet	aukščiausiaslaipsnis
hqap	dovanadalyvis
qwat	sumaišmedžiaga
qyik	jungiamasisdalelė
sr6t	superkritinisskystis-
hfem	epentetinismorpheme
tl6t	Nuotolinisateitisįtempti
mrif	mikrofonas
pcuk	postpositionalatvejis
tfim	atsitiktinispriėjimasatmintis
fwim	etidžio
ly6t	Kreipimasissusitarimas
hvap	ritinysbaras
hfep	dažninisaspektas
bvan	skirstomasisįvardis
fyun	slankauskablelionumeris
xyas	trinti
hvif	veiksmažodžiopriesaga-
xyis	praeitispasyvusdalyvis
tl6n	centrinisapdorojimasvienetas
tfok	vietininkaskryptiesatvejis
qwan	dažnaipaklausėklausimai
