hnit	matoanteny
hnak	Anaranatranga
hkak	Opentranga
htak	lohahevitratranga
hpap	Dada
hmam	Neny
hyat	rayaman-dreny
hcan	Salama
hwik	Zavatratsytranga
hsuc	razana
htat	raibesyrenibe
hcac	noana
hnik	Anaranatranga
hcit	mpamaritra
hwan	ary
hman	ahy
hnan	ianao
hwam	antsika
htit	izany
htac	toeranahalehanytranga
htik	Anaranatranga
hyit	realistoe-po
htim	deontictoe-po
hcut	fepetratoe-po
hsit	epistemictoe-po
hyak	Zavatratranga
htan	Interiortenymanodidina
hpan	olonatenymanodidina
htin	tsymiankinafepetra
hyan	miankinafepetra
hfap	perfectivelafiny
hkat	lasahenjana
hnin	Anaranaiombonanaamin&#39;nylahysynyvavy
hmak	comitativetranga
hnat	ankehitriny
hpak	benefactivetranga
swik	essivetranga
htut	negatoryquantifier
hsan	surfacetenymanodidina
hpin	adpositionaltranga
hwin	toeranatranga
hkan	toeranatenymanodidina
hnac	fombatranga
hyut	interrogativetoe-po
hnam	aryna
hkit	ireryna
hsuk	loharanotranga
hpik	Anaranatranga
hcat	akaiky
hmat	demonstrative
hkuk	fepetrarambony
hlan	fa
hsut	rehetra
hyin	rehetraizaoquantifier
hcin	SAMPAtsyampyamin&#39;nylahysynyvavy
hpac	tenyisa
hyik	iray
htic	ny
hkik	izay
tcat	hoavyhenjana
hsin	ara-tsosialytenymanodidina
hkac	rahoviana
hmip	imperfectivelafiny
klan	Ery
hlak	elativetranga
hlik	Hamoronakaontytranga
htam	toromarikatoe-po
hlat	fifidiananaquantifier
hkam	inona
hwat	fanontanianateny
htap	copula
hpat	olona
nyan	lahy
hkas	afaka
tcan	hafa
hnuc	isa
twit	assertivequantifier
hsak	nytenymanodidina
htuk	trangaara-nofo
htun	ihany
htum	hortativetoe-po
hyip	retrospectivelafiny
hlit	volitivetoe-po
pcic	diatsymaintsy
tyut	roa
hsat	jereo
hkut	mahalala
hcic	midina
hcap	rehefa
hpam	voalohany
hlac	alienablefananany
hkap	naoviananaoviana
hnic	azoesorinafananany
tyat	antitra
tcit	fandinihanatoe-po
tcin	andro
hlam	hoavy
hwak	zana-tsoratra
hkin	mandeha
lwak	perlativetranga
hpip	miandalanalafiny
lyan	ela
hsac	milaza
kyan	Ahoana
htas	indray
hsic	Eto
hcik	mieritreritra
hcak	teoambanin&#39;nytenymanodidina
hfan	hita
hsun	tanana
hyac	koa
nwan	tanora
tyit	manohitra
tlan	andriamanitra
twak	delativetranga
hmin	nainonanainona
hyas	indraymandeha
hlap	semelfactivelafiny
kcac	sisa
hyic	tsofa
hcas	trano
hwac	izaotontoloizao
tyin	telo
hnun	Neo
hcuk	ifantohana
pyan	fitiavana
hsis	foana
hyam	alina
hyap	mpanjaka
hkic	eo
hmas	-tsaina
cyit	am-po
pluc	paucalisa
kyik	satria
ksak	causaltranga
tcun	vita
hnim	anarana
tsan	anaranaiombonana
klac	firenena
hpun	nanontany
cyat	hitaevidential
pcac	tsarakokoa
hmac	fotoana
hnas	tsyafaka
hwic	rano
twim	desiderativetoe-po
kwan	fahazavana
tlat	teny
tyan	av
hsas	maraina
syat	mandra-
twik	terminativetranga
hpit	fotsy
pcan	nyvola
hyis	mahantra
mwan	fahafatesana
hfam	teny
nwik	inessivetranga
kcat	miaraka
tsac	matetika
pyat	namana
psan	antsasany
hpim	filazamandidynytoe-po
hyuc	manodidina
hfat	naniraka
hcis	vady
kcan	mino
hsik	-bahoaka
htus	panjakanatenymanodidina
hpas	zanak&#39;i
clat	ankizy
tyak	diatoyizanyno
cwan	manantena
syin	malala
hkuc	ambony
tyac	vakiony
syit	tanàna
hlic	efa
hfit	factiveevidential
tcac	ankizivavy
hcun	Mihainoa
ksan	kelyindrindra
hyaf	angamba
kyat	tokoa
tcic	vatana
hwit	hiverina
cwat	rivotra
hfaf	lalàna
hput	Vonjeo
lyat	taratasy
ksas	efatra
hpic	optativetoe-po
hfuk	afo
hcam	ora
twat	ady
kyak	maro
tlit	faharoa
pcin	aoriana
hmut	very
clan	arivo
hfac	family
twan	fanahy
hwas	fanontaniana
syan	fahamarinana
htis	kevitra
tsat	metyhotoe-po
lwik	allativetranga
nyin	anthropiclahysynyvavy
hfak	dimy
tcak	foto-kevitrairayihanyfanamarihanatoerana
htuc	foto-kevitrasamyhafa
hnap	valiny
hmit	ranomasina
hcuc	tahotra
pcat	hahatakatra
syas	Anaranaiombonana
hcaf	antoka
twut	dubitativetoe-po
hkis	mainty
tlak	mitondra
hyus	tsaratarehy
nyit	sort
htip	folo
ksis	Tantara
hpuk	boky
hlin	elektronika
hkun	kaonty
lyas	liana
lyit	manoratra
pwat	fandriana
hnis	taona
hnut	counterfactualfepetra
slas	kanto
hwis	vialisraharaha
pyak	rahalahy
lyin	tsipika
tyas	table
hyun	river
kyac	maso
tfan	tampoka
kcin	lalina
hmuc	tanjona
cyac	ra
hmap	nitsangana
tlin	hatsiaka
hyif	handroso
tyam	tara
hnaf	Aokahatao
hkip	efaho
myan	mine
tsin	fahalalana
hkup	dikamitovy
hsam	lahy
hlis	enina
cwit	velona
cyan	fandriampahalemana
myat	tsarovy
tyic	voajanahary
hfut	latsaka
swas	fanompoana
hsap	afa-tsy
pcit	Copyright
hyim	tafika
kyas	soavaly
plic	hoavy
pcak	west
hpis	vola
hyuk	mena
hwun	volamena
twin	faniriana
plan	milalao
hpus	birao
syun	fitondram-panjakana
kyic	fiangonana
htaf	hery
hlun	halavan&#39;ny
kyin	orinasa
kyis	taratasy
mlan	mety
hcim	indrindra
cyas	hitondra
twac	varavarankely
nyat	hatsaran-tarehy
hcus	farany
htup	adidy
htif	lavitra
pyas	tongotra
hlas	bibidia
ksin	maitso
hmaf	fahoriana
myac	tsiky
hsim	torimaso
kyit	undefined
kwik	quotativetranga
fwan	fitsidihana
slan	manaraka
psit	anatrehan&#39;ny
hmic	mamy
hmuf	vava
hfin	manan-karena
tcam	fahavalo
psuk	tapaka
kcap	sambo
pwan	manavakaolona
hfic	fitarihana
tcuc	hita
hkim	zava-miafina
pyin	Mbamiangavyre
pwit	precativetoe-po
pyit	nahalalafombafiraketana
cwak	ratsy
myak	diabe
tcas	toerana
hlaf	mijanona
psat	fatsy
nlan	manga
psac	azoatao
kcuk	am-pianarana
kcit	manambady
kcak	sakafo
syis	roa-polo
tlac	mangina
hcip	tendrenaholafiny
kwin	manome
tsit	nitsahatra
pyac	teny
hsus	herinandro
hcup	efitrano
cyap	manontanytena
tfin	Teraka
fyat	fitsarana
hnip	gnomiclafiny
tsak	fanajana
tlas	mendrika
syuc	hazo
plat	rindrina
cyak	anyan-danitra
twip	inchoativelafiny
mlat	didy
swit	jussivetoe-po
mwas	volana
hwaf	tongalafatra
tyap	traikefa
ksac	toe-javatra
syac	vaovao
hnuk	loham-
kwak	nandrakotra
tyuk	east
pwac	vato
hkif	mendri-kaja
nyac	tari-dalana
cyis	seza
tyuc	miandry
tsun	tanàna
tyik	manaiky
hnum	hilefitratoe-po
slak	fahombiazana
tsic	manandrana
slat	colina
hmik	mozika
hkus	mitaraina
hsip	Fito
hpaf	tsymiankina
nwas	vaovao
tfac	sehatra
fyan	zaridaina
cwas	manomboka
hfik	distributivetranga
lyac	mianatra
syik	ara-politika
clin	Henry
cyin	lainga
tsas	nandroaka
cyik	fahefana
tlap	tany
cyam	fahavaratra
tcut	fivavahana
tcap	afa-mandositra
hlut	mpanoratra
pyun	Brown
tcuk	fanaintainana
swan	lohataona
hmun	malefaka
kyun	zoro
nyak	famantarana
tsis	nyrariny
psas	voka-pambolenasyfiompiana
cyaf	laugh
hwut	manadino
hyup	Eoropa
hwap	valo
psak	mandalo
kyap	mahatahotra
pyic	ilaina
hmim	antonony
hsaf	fofonaina
hmis	hendry
hsum	possessivefanamarihanatoerana
ksat	mahafinaritra
ksit	am-pasana
tsap	nosy
kyam	toby
tcum	mikasika
cyun	harena
psic	amoron-dranomasina
tyun	sehatra
mwit	commissivetoe-po
tlut	diplaoma
myit	ririnina
kfan	fitondran-tena
slac	mihazakazaka
myin	minitra
tyip	mitarika
klas	fitaratra
pfat	board
cyic	zava-poana
swam	raharaha
syam	azoantoka
tsut	dokotera
hlip	completivelafiny
kcas	haizina
nyun	mafana
hpuc	zava-pisotro
tlam	ohatra
hfun	fahatezerana
tsik	nadiateoaza
tsam	mivantana
hmup	satroka
klak	alika
slin	volafotsy
swac	mpanompo
kcam	nyavonavona
pyik	fiaran-dalamby
myut	fitondran-tena
syak	miditra
swat	sabatra
kyuk	fanafihana
clac	fahasalamana
tyaf	fehintsoratra
swic	ara-tsosialy
tfit	refund
hkaf	ofisialy
pcas	jerena
nyam	voninahitra
tfat	roaambin&#39;nyfolo
pcut	mpifamofo
pwin	divay
mwat	tsiro
fyac	vy
syap	hizara
myap	varotra
hyum	mampiasa
fwak	mpitsara
klat	komandin&#39;ny
twap	cessativelafiny
kcic	liana
kwic	vahiny
hnif	intensifier
myun	zava-dehibe
tlic	farany
cyuk	vozony
syut	fahafahana
pfan	lafiny
kyuc	maina
pcap	kely
tfak	evidential
tcik	evidentialtranga
twun	lavitra
tyis	fandrosoana
nyap	tery
plit	trano
hpif	pejy
pwic	mitazona
syic	mampalahelo
tsip	fahotana
syim	marary
tcis	marina
pcun	banky
ksap	manaiky
lyam	Stream
tcaf	tsara
kwac	sofina
hpup	mofo
kcut	mifidy
nwam	biby
hsup	zoiclahysynyvavy
nwit	eventivetoe-po
tcim	hetsikaihanyfanamarihanatoerana
tlik	multiplicativetranga
kyus	hiampita
hmus	matevina
kfat	sahy
nwat	mitombo
myic	orana
hpum	surface
swut	masina
clis	Jolay
mwun	lamaody
hfas	rakitra
cwac	soroka
kwat	fampiononana
nwac	naizanaiza
tcip	irina
kfac	ahitra
hmuk	hantsaka
plin	fanokafana
kwun	Jona
mlik	trondro
klin	Renivohitra
pfut	tratra
twam	Fitarainana
fyin	fandaniana
nlit	anao
mlin	tapitrisa
pyut	Mivavaha
hluk	reraka
ksut	mamono
cyut	aloka
psin	lanja
kcis	grey
pyam	beherim-po
mwac	afa-po
klam	milaza
ksam	-pirenena
hfip	malemy
klik	-dohasaha
hkum	tombantombanatoe-po
clas	mavo
cyuc	hafanana
mlac	sisatavela
syip	mitovy
pwak	boaty
tcif	fefy
psip	fitsipika
ksik	vokany
tsim	vanim-potoana
flan	siansa
pcam	Toa
kcun	niteraka
ksuk	rahalahin-drain&#39;i
mlit	lisitra
pcik	mampidi-doza
kwas	Aogositra
hluc	malaza
klit	tsyfantatra
flak	mahazatra
fyit	mahazatrafiraketana
lwat	mpamaky
plun	mandeha
twas	indroa
pcis	mpisorona
fyas	naratra
nlat	lapan&#39;ny
myuk	adala
pfak	fo
tcuf	sivy
cwap	fiaraha-miory
plac	vaky
pyap	mametraka
lyic	niakanjo
hcum	tabataba
lwit	bokysygazety
tsuk	laharana
hfup	tafio-drivotra
kcik	paosy
nwap	Novambra
tyim	Desambra
psaf	tsyfisian&#39;ny
nlac	mponina
kyaf	misaotra
slis	andian-dahatsoratra
pyaf	vorona
mlak	tompony
kwut	akanjo
hwuc	fifandraisana
pyis	haingana
twuc	setroka
nwak	Janoary
mlic	milina
tlis	nify
ksun	fandoroana
clam	henatra
klaf	kalitao
clit	peratra
fyak	andian-teny
fyam	andian-tenyfanamarihanatoerana
kwap	kianja
hwip	Alahady
psis	tononkalo
pwut	undefined
kyim	mividy
clic	saha
pyip	Aprily
kfap	Oktobra
psut	zavatra
kcuc	mangidy
nlap	mpanompo
hsok	hamaha
htet	lahatsoratra
hbat	ratsyindrindra
hrit	bola
hzit	Toetoetra
hpet	dimyambin&#39;nyfolo
krac	lozabe
hduc	vovoka
hrik	azoampiharina
hron	loko
hnus	orona
hric	friendly
srik	famatsiana
hten	omaly
tlet	hesternalhenjana
slap	tsy
hban	mitafy
hdat	jamba
fran	manidina
hdan	Devoly
htec	tsikelikely
hmon	asafitoriana
cran	sorona
hran	feon&#39;nyfieritreretana
hmos	fanompoam-pivavahana
nrit	angovo
hcet	mankahala
hset	Center
hrin	misainalahysynyvavy
hcot	mankafy
hrip	fohy
htep	fanompoam-pivavahana
hcif	hoditra
hrat	tafo
kran	satro-boninahitra
hkon	lapan&#39;nympanjaka
tran	kivy
hmif	kilaometatra
trin	faribolana
hgin	am-ponja
hkop	kapoaka
hcen	member
swin	sivily
hrac	naaizanaaiza
hris	fanao
hbin	lasa
hmot	hena
hdut	ronono
hwen	vegetallahysynyvavy
nran	tsyfahitafiry
hbac	mpiraytam-po
crut	tetezana
hsoc	tahiry
hsom	sira
nris	tsymanan-tsiny
hbit	tsy
crin	fankasitrahana
rwin	mpanjakavavy
hgut	manisa
hdas	dihy
hnot	tranofandraisam-bahiny
hdin	fenoy
hton	voafonja
hdak	tsena
hlet	tohatra
hson	famelan-keloka
hgek	pelaka
hras	fasika
hsep	septembre
hbic	faharavana
hlen	Mombamombanympanoratra
hcon	ampy
hgit	vavolombelona
kfon	lakozia
hbak	mivarotra
tlim	fitsaboana
hsot	hafainganam-pandeha
kyut	solosaina
hnen	mandrakizay
htek	fitehirizam-boky
hzan	misy
hbis	base
hbun	fifanjevoana
kcus	Cook
hgat	efitra
hwus	oroka
hbif	ranomandry
hbot	baolina
hrut	kevitra
hdit	benedictivetoe-po
hdis	meloka
hjan	sazy
plis	polisy
hgan	afeno
hsen	fanafihana
nrin	tsynahalala
hyen	rahona
frif	février
hdik	aretina
hnek	hetsikatranga
hbam	nenitoa
hmen	manetrytena
hdip	tarafilazamandidyny
prat	nitatitraevidential
hdet	mamatonalina
hjit	rantsan-
hmoc	anyhoany
pran	gazety
kcec	faritra
hken	tatohoato
hloc	alahelo
hrak	mpiasa
htes	falymijery
rwan	valisoa
hdon	hanome
htot	handriny
hnet	anjely
hdun	Anaranaiombonana
croc	fahadisoana
hlon	mangiran-dratsy
hyec	ondry
hjin	faharetana
hrec	referential
mran	katsaka
htos	maroan&#39;isa
hcos	fepetra
hkoc	indraindray
hlif	tombony
clak	siramamy
hjat	maha-olona
tram	filanjana
hdic	kapila
hkok	manirery
srat	mpanakanto
crak	hatsarany
hmet	mailaka
hden	fanapahan-kevitra
gran	governora
crac	sampana
hjac	hafanam-po
hdim	inductivetoe-po
hcok	haingana
hyet	menaka
pwap	sodina
trat	Print
tcot	zavatramafyorina
hdoc	Oh
hren	kabarytenymanodidina
tcon	mitataovovonana
krin	efitra
plam	fanairana
hnes	natahotra
tcen	fandinihana
hsek	lafiny
plik	azoampiharina
slik	landy
hfen	-jaton&#39;ny
hgen	mpandraharaha
hnon	firaisana
crik	helo
tcet	tsininy
mrat	mifangaro
hdam	admonitivetoe-po
hgac	faniriana
htoc	toa
hdac	torohevitra
nwin	lalam-panorenana
srit	fitaovana
hret	mafy
nlin	-tserasera
hzat	onja
klic	oniversite
hkek	rambony
nric	taranaka
hgic	feno
hgak	saka
trit	mivantanaevidential
tyot	fifanekena
hnok	HevitraatoAnatiny
crit	nandao
slen	iraikaambin&#39;nyfolo
srin	voajanaharyamin&#39;ny
hpok	firenena
hyot	Natahotratoe-po
cric	fialofana
hruc	tsymahalalafomba
cwin	mitaingina
hzak	hampihorohoroiko
dyit	orinasa
hpec	asa
nras	mpitsabompanampy
hcec	fampianarana
hbut	kiraro
hmec	manjavozavo
twot	asa
crat	Asabotsy
hkot	fahafahana
hnec	masoandro
hwuf	mpitondratena
cren	nandatsaka
nrat	kintana
hget	vahiny
hbik	hitahy
brin	anaty
hpot	misy
trac	fanoherana
prac	misintona
hcoc	hollow
hpon	faritany
hwim	fandrosoana
dwan	Hang
cwok	tohina
hdok	mitondrafiara
crun	harena
hzik	voa
hrot	vaohainganalasahenjana
hket	Mifohaza
hcek	fanaka
hrop	tady
mrac	traikefanahafinaritra
byit	fanasana
trak	isan-taona
hzin	atsimo
sric	lanonana
clik	fihazana
trap	liberaly
hrim	FivavahanaKristianina
hrus	andriambavy
blat	alitara
cyon	kely
hwep	Malagasy
krat	kardinaly
tris	volomparasy
kcot	hanangona
hben	fifidianana
trik	mamo
kfit	atraka
tcec	fifanakalozana
nrik	voafaritra
grat	mpanjaka
dran	fitantanan-draharaha
hpen	teoaloha
cluk	ratsytarehy
nrac	tsymampidi-doza
ryin	fiofanana
hrun	horonan-taratasy
nwic	santimetatra
slit	mitifitra
gzat	gazety
krot	fanapahana
drit	saoka
hzis	hamiravira
hdap	valoambin&#39;nyfolo
sris	ara-tantara
mrut	lehibe
nyik	fotaka
bran	ampakarina
drat	miankina
djan	goavam-be
glat	tsotra
hpoc	fararano
pras	voaly
hgot	fanangonana
tret	teatra
tras	fampitahana
rwit	mpifanandrina
hfon	mamorona
klot	mpanazatra
hmum	hatsikana
drac	lahateny
rwas	tantara
tset	valifaty
hdot	distaldemonstrative
ryut	saro-piaro
hwon	fanasana
byat	fanatitra
flac	Flash
prot	Mombamombanympanoratra
crek	soso-kevitra
htok	fifandirana
htop	ozona
prit	imprecativetoe-po
hces	tsyafa-manoatra
klup	Club
hnos	tondra-drano
dwin	tsyfiraharahiana
prin	faravodilanitra
mrit	assumptivetoe-po
tcoc	hantsana
hcom	firindrana
grit	kotrokorana
tlot	fahazazana
hgik	lohalika
hwes	tsymahatsiarotena
hzac	fiaraha-mientanaifampizarana
hsec	rindrambaiko
tson	andrim-panjakana
ryit	fandraisana
dlin	famaizana
slip	taratasymi-
klon	revolisiona
hfim	mpamboly
hpom	sehatra
cyen	mpianatra
hgec	lava-bato
hroc	fomban-drazana
srac	manaiky
ryat	loza
kcen	virjiny
hbap	veloma
krik	tsikera
krap	landihazo
fwat	hopitaly
kcet	hofan-trano
hgas	mandatsa-dranomaso
pfin	tsyazoihodivirana
dlit	ravina
ryan	fandikan-teny
sran	fandevenana
mrin	lafarinina
hram	tantaram-pitiavana
dlan	dolara
hzas	jest
hsos	eninaambin&#39;nyfolo
klen	zanatany
gyin	elatra
hsif	nyliona
cluc	fetsy
prip	fanomanana
hzut	zavon
dwat	fanafody
krit	nahitsin&#39;i
sras	akaniny
hses	efatraambin&#39;nyfolo
brat	fanoherana
flat	asidra
hjic	izanyhoe
slic	fitaovam-piadiana
hbuc	mpampiasa
tron	voasary
byan	fandroana
hrif	faran&#39;izaytsotra
tlip	mametraka
blan	harona
kris	mpitan-tsoratra
hyon	Mandritraizanyfotoanaizany
tren	amin&#39;izaofotoanaizao
dlat	hodiernalhenjana
hzic	poizina
tfic	basy
tlen	talenta
hlim	toetrandro
dyat	vady
kcon	fanambarana
dlac	Wash
krak	fiaiken-keloka
hbas	tsymisydikany
hkec	arintany
hrek	indray
hkos	lakana
hwif	lefitra
tric	vonjimaika
hdep	delimitativelafiny
mwak	antontany
ksot	taolana
hnoc	Alatsinainy
nlas	Talata
brac	Alarobia
frap	federaly
pfit	solontenan&#39;ny
pcoc	pole
lyen	rongony
swak	hilatsaka
pcen	Filoha
brit	ramandriaka
hwec	fahirano
hwet	vavony
hlos	ambonyrihana
hbon	isan-karazany
pcon	varahina
hsem	fihaonanaan-tampony
lwac	levitra
tsos	fifaninanana
kwen	irerynyolona
trun	fiantsonana
trut	sarivongana
hrap	fitaovam-piadiana
hgap	hisambotra
trot	hafanana
grin	Manodidina
hjak	manaiky
hpek	entana
hlus	serfa
hwos	efi-trano
tsuc	voaroy
pcuc	mararymitsika
cris	mpandova
clun	hazoterebinta
hpes	mahafinaritra
nlet	tsyfeno
hrom	fandaharana
pyon	Piano
swet	mandresylahatra
dric	tsyhitamaso
tyen	tsarafantatra
hruk	habibiana
frat	notendrena
hyoc	fakam-panahy
hlep	teliclafiny
nrot	iraisam-pirenena
nret	keriny
hfif	filozofa
pfic	fanehoana
hmek	mora
hfec	fifanampiana
myik	fanjonoana
truc	hangalatra
tcop	molotra
rwic	misotroronono
htom	Toe-karena
glan	Gallery
pren	mitovy
hlek	ateliclafiny
nrak	Kontinenta
truk	dondony
hjim	prohibitivetoe-po
rwat	tie
hcep	sela
dyan	atody
jrat	solon-
nren	fitaomam-panahy
ksic	krizy
tsoc	mitady
lwan	sakafoatoandro
hpos	kesika
hcuf	Atoseho
tcus	Sue
pset	hanitatra
hkep	varahina
swis	tantsambo
prim	amperora
trip	karavasy
cras	lobaka
swap	Fafao
syet	Sketch
htof	mpangalatra
clen	fantsona
kwit	toetra
klok	beloatra
hrok	fanavaozana
hguc	hetaheta
kcim	fandrahonana
hpem	rofia
psik	mpandaha-teny
frit	tokonam-baravarana
cret	soritra
mrak	lefona
syen	fivoriana
tcup	mando
hyek	dialavitra
trim	firapotsy
plak	fitarainana
hyok	zoro
hgam	ombivavy
hmok	bary
jrac	Map
kloc	vozon&#39;akanjoko
gyit	minia
hbip	labiera
mlet	Velvet
lyap	fanararaotana
cwen	ondry
bwan	zanakavavin&#39;nyanabaviko
tses	teloambin&#39;nyfolo
jrit	fialan-tsiny
nlak	sora-tanana
sron	mpiady
cruc	Zoma
broc	borosy
dlot	Download
krim	fanosotra
pric	dity
prut	mpitsara
hgon	nivaingana
sram	ara-bakiteny
pfot	vilany
hlot	nomanina
djin	volamadinika
hlok	dingana
hpep	paoma
hwot	manolanahevi-
dlak	midinika
brik	famandrihana
nlis	hanoratra
hbet	Bet
pris	tsimokaretina
hjik	vahiny
blit	jaza
hjap	akanjo
tfik	taratra
hdaf	hahazo
hpop	opéra
kcaf	manafina
kcoc	kiho
hrum	fanamboarana
cyim	mampiahiahy
dyic	fanabeazana
hgoc	lavaka
drak	fikorontanana
plas	tehaka
byin	mimari-droa
hzap	Abbey
nlot	tsyfivadihana
mrik	mekanika
hsop	soaaman-tsara
crap	fandrika
kyek	mofomamy
nrut	voly
syes	tompoko
hjet	fitoambin&#39;nyfolo
hjen	Anaranaiombonanaamin&#39;ny
hmom	tantely
hdec	indrisy
lwen	angano
slot	fatana
frac	mpikomy
gwan	nivonto
mruk	manatsara
swot	swamp
zlan	hahazoana
hnem	Animated
hdes	fitafiny
prak	mitoria
frin	toeranamanodidina
hfet	manohitra
cros	AVERINAiSAN&#39;ANDININY
ryon	misaina
tcos	crop
tsen	fanodinana
hwek	amboadia
nlik	fandavana
klap	karipetra
dras	tsinontsinona
prop	mahavokatra
slim	sifflet
hgis	fromazy
krut	manaikitra
srot	manara-maso
bjan	mirenireny
nwen	tafikaan-dranomasina
myas	hanafina
kwaf	hampivelarana
twis	fiarakaretsaka
pcip	penina
srap	legioma
sren	fampirantiana
tlun	pataloha
hrup	kolikoly
nrip	kabinetra
srup	Lasopy
jran	mpandidy
bjat	hanina
gyat	mpitsikilo
hlem	Sahisahyratsy
srak	saro-takarina
kson	lantom-peony
cwis	Alakamisy
sret	amin-kitsimpo
hraf	fifamoivoizana
hres	maritrano
hsuf	fanariana
rwak	mitresaka
twon	haingo
hfus	sitrana
hkom	fehezan-dalàna
djat	mpihaza
nlut	Newsletter
hsef	bibilava
mris	demokrasia
bric	bateria
mlam	savoka
zran	fizarana
cron	mampangitakitaka
hzen	milomano
traf	esory
cwaf	valopy
srip	sigara
mrot	maotera
swon	mpilatsakaan-tsitrapo
ryak	fanehoan-kevitra
pfun	amin&#39;nyampahany
blac	Entana
mret	fanompoana
hjon	firaisanaara-nofo
kcok	famaky
dram	diamondra
kren	Alternate
tcek	RuNet
hdif	maha-
tfas	masoivoho
hfot	noaharetan&#39;ny
lwas	kamo
hmep	momentanelafiny
kfin	Encoding
mwin	an&#39;eritreritra
hrem	Ray
pram	rehefaniakatra
byac	lakaly
mren	tsyhayhadinoina
swen	Antenimieran-doholona
kras	vatam-paty
hgun	mitelina
nlok	po
ryic	fambolena
gwin	savily
srut	tanin&#39;ahitra
hkes	sarotra
hfis	fialana
frak	imbetsaka
hnom	niraytetika
hcop	Pub
hlec	sakay
mlot	fiderana
zrat	kandidà
proc	mpiaro
flik	amboahaolo
cyet	undefined
hgim	fivoahan-tsetroka
slet	fefy
tcok	marina
bjit	teoalohanodimandry
brot	kiboriny
bwat	bodofotsy
hdus	kisoa
gwat	ivoara
kret	nalaina
nwet	mpanara-maso
jwan	Avenue
nwis	fantsika
mwic	renitantely
bzat	mpilalao
gyan	hatsembohana
zyit	mpanatanteraka
blic	nofinofy
pcet	nytsyfahazoanaantoka
tsot	aforeto
bwit	sisin-tany
tres	adin-tsaina
hkof	fihinanana
nyen	fisentoan&#39;ny
hles	mitovy
cyek	lasakanyavy
hjis	fanjaitra
gjan	javatra
prec	hitondratena
drot	Fehezotsara
kcek	curve
twic	akoho
brak	barika
zwat	fahazarana
clap	zatralafiny
tsec	manam-pahaizana
bwin	hampiaikyvolana
cwet	atsy
hbek	mpanaomofo
zlin	oliva
mron	Van
drin	manokana
psap	hampiharihary
gjin	fitsingerenan&#39;nyandronahaterahana
clut	tantanana
cwun	manitra
twaf	misydikany
pcot	Pet
krok	karan-doha
dlik	mpanaolalàna
cwic	soaihany
srun	niketrona
crec	mandringana
jlan	sisiny
kcip	tompon-daka
blin	lavitrisa
ryik	simika
mlas	hanin-kotrana
flit	mpanamory
hzet	fatotra
cwik	malaza
twet	zipo
mwik	isan-kerinandro
tfis	ara-teknika
tlon	fiara
cram	undefined
grac	hanamafyorina
kraf	crow
trup	toetra
hduk	hook
cruk	tigra
nrap	mpila
crot	lalambe
mlip	milisy
hfoc	sary
nres	mivadika
plos	miampy
tfam	mangarahara
nlic	sivyambin&#39;nyfolo
hwok	mahay
nlen	lahatsoratra
fyic	fahombiazana
hwuk	tsymanam-paharoa
hgok	voajanahary
flic	teolojia
flot	float
hboc	manery
hwoc	mpamosavy
syot	Studio
cwip	Champagne
hbes	Sary
lwic	fisaraham-panambadiana
blot	bolt
cwot	babo
cwam	fihadiana
prik	matoantenin&#39;nyatao
hfum	sombin-javatra
grik	vatokely
zrin	apron
gren	planeta
hfuc	fitsangananaamin&#39;nymaty
claf	talantalana
flas	mpankafy
hjot	tanymafana
hbim	jadona
krek	volavelona
hbec	undefined
tsaf	famonoan-tena
pwas	hanapaka
plot	baovao
kfak	mahafoy
blak	lavarangana
hdos	tasy
kwis	mahazatra
kcos	miampanga
psen	fisotroan-dronono
kres	Endrikynymatoantenyamin&#39;ny
hzon	gidro
srim	sonia
glin	fisalasalany
mlut	malaza
myot	Import
fwac	mpanorina
troc	fanilo
hgaf	fitsipi-pitenenana
hyop	Yacht
ksip	lanytamingana
sres	fitsangatsanganana
hnup	dome
hzun	mafyloha
mric	hozatra
gjat	maridrefy
hros	RUB
zrac	kanosa
tros	toast
myus	totozy
dwac	fifanakalozan-kevitra
byak	osilahy
htef	Tailor
hfek	hiroborobo
dzan	hametraka
nyon	tsyfantatraanarana
zrit	formalfiraketana
pcos	fanatanjahan-tena
hjec	kivy
dlas	hamafa
mras	elo
mram	mineraly
cwut	fampiatoan&#39;ady
hbok	gana
swun	savony
dwak	saribakoly
plif	Villa
slon	manjaitra
tfut	hiarahaba
djac	hampihavanaantsika
hjas	hanafoanana
kric	bitro
kwot	mpitarika
gzan	antoka
clot	mpilalao
ksek	bibikely
psam	fihetsika
mwut	vorondolo
htem	maharitra
clon	lokanga
dzin	mponina
rwim	mifanaraka
hyof	mahasoa
dron	dragona
dwit	havananaamin&#39;nysofinaevidential
sroc	fanondranana
hzot	famaranana
djik	Mijanòna
kfik	sarony
ryun	lalàna
hmes	ben&#39;nytanàna
rwac	Hardware
sruk	fampisehoana
sros	vitsyan&#39;isa
bzan	rotaka
kset	orkesitra
bjon	Bacon
hjut	manam-petra
tfen	miaro
zwac	tombon-dahiny
dyin	délibération
myis	mozika
mlis	ara-tsaina
pret	hotsymahay
tsek	mpanaomari-trano
hlom	voasarymakirana
ksos	mikohaka
crok	aretin&#39;andoha
flin	fiterahana
mrun	mpandrafitra
swec	kisendrasendra
syuk	loviakely
blun	balloon
tcep	tsaoka
fric	famelombelomana
rwik	mitsangana
rwen	manakana
flet	inferentialevidential
pfac	publisher
srek	vinaingitra
tfun	tonelina
pwet	Ve?
gyik	Matematika
fwot	mihavasoka
lwin	voalanjalanja
jwin	aty
bwik	sublativetranga
hdup	mandroboka
hnop	ampihimamba
bwic	sambompisitrika
ryen	nainonanainona
hcem	horohoron-tany
hbos	laboratoara
nrek	mpiasa
ryim	Rhythm
nyic	mandikateny
dwas	Masoivoho
rwok	nampahatezitra
kram	tsyfahafahany
ksim	voambaratoe-po
clok	sôkôla
pcec	tombontsoa
nyis	mpitoka-moninairery
tyoc	kisendrasendra
grak	rangotra,ratrakely
zlat	glove
hjuk	mandohalika
trif	jeografia
djit	mitohy
pson	undefined
mwis	fampiasam-bola
cwec	am-bava
hdek	tsyara-pivavahana
blik	Hawk
sloc	psikolojia
brap	tamy
jlat	Pirate
dros	levitra
slam	saumon
pwun	pudding
gwik	andriamby
pcop	paompy
myen	Toyizanykoa
ksen	oksizenina
mrap	mpiambina
tfot	taratasyfanamarinana
ksus	sampahom-boaloboka
trok	kabarytsaralahatra
tloc	zana
zyan	oar
nlun	Hiditra
hlop	teleskaopy
jlin	tsipelina
lyut	clouds
hsof	Surf
fyik	whisky
klet	somary
hwof	hazomalahelo
hlum	rameva
myet	mpankafy
klis	fitokana-monina
hbaf	tantaram-piainany
gwac	boriky
hwum	tsaho
pwik	fombafijery
pron	mpanohana
myes	isam-bolana
mwen	undefined
kfic	fialan-tsasatra
klek	Click
cwon	Boriborysomarylavalava
lyak	lasitike
kwon	malagasy
hjam	lambosira
rwon	avana
crip	Izao
zwan	mitranga
srok	matoan-dahatsoratra
craf	Corporal
tlok	tanky
brip	lolo
tfap	tabilao
jwat	kambana
pros	fandidiana
psun	fambara
clet	undefined
hbus	volotsangana
dyas	mpivarotra
klun	fanangonan-karena
jlit	niarahananiombon-kevitra
hdom	nofyratsy
kron	karbaona
hzam	Jak
cyot	mpihaino
hmem	mozea
lwam	abidy
fras	aelezo
psoc	totohondriny
hgum	hihy
brek	notapahiny
glit	fahamarinan-toerana
frun	rot
gris	maherysetra
mroc	friction
bzit	hala
plut	ovy
glac	fitiavam-bolatafahoatra
gzac	maro
prun	namoly
jlet	kalandrie
nyim	fanendrena
tlos	tapitrisatapitrisa
slut	salady
fwit	affirmativetoe-po
pyen	fampiharana
nlon	anarana
dren	hanehoana
drun	tsyfahafaham-po
cyok	mampiaka-tsoroka
hfop	baolinakitra
ryac	fiaraha-miasa
gzin	mpisavalalana
hgip	laisoa
tyet	fanatanjahan-tena
hdof	ideophone
hwup	sarobidy
lwek	fanoitra
syec	Senatera
jyak	handraisana
mlim	vitsika
fwic	-pahombiazana
gzit	bevohoka
blas	fianteherana
jrin	isan&#39;andro
gwak	diafehin
drik	Hafahafaihany
prif	miova
jwit	fahasamihafana
krip	fanavakavahana
ryot	undefined
nwut	sisin-dalana
kcif	mavitrika
jrak	sahona
twek	exessivetranga
psot	fanavotana
pfon	sponjy
sluk	squirrel
nlim	irrealistoe-po
ksaf	fahampian
glak	volkano
plen	equilibrium
kfaf	fehy
kyon	mitrandraka
jlik	vahaolana
psop	pasipaoro
kfis	toeranabanga
fyon	vinanton&#39;i
nram	halotofitondran-tena
hbuk	biscuit
gras	azon-tsindrimandry
hyos	Natahotra
flim	horonan-tsary
plet	takelaka
rwam	tsivaky
blis	lavanila
zlit	SIDA
fyut	fombafisakafo
crim	piramida
hjif	ara-dalàna
crif	menatra
lwap	valiha
tyon	astronomia
mrim	Misafotofoto
drut	famaritana
nrim	manam-pahaizana
kruc	sokatra
kwam	mpanolotsaina
jrik	lalaocricket
dlut	diamaneho
pyot	voromailala
dyon	fampifanarahana
prap	mpandraharaha
bzin	karatra
tyek	telozoro
trec	mpitahiryvola
nron	hidrozenina
pyet	mpanonta
tsok	mangeja
zyin	mitaiza
slek	bisikileta
jyin	injeniera
ryas	fifindran&#39;ny
zrak	Refresh
nyas	mpandihy
gric	fifindra-monina
zlak	mandika
tces	tenisy
hjun	rivotra
twen	Miahyazy
kyet	hetra
gwit	hazondamosiko
kyot	Chord
fwin	hatetika
tfuc	toaolana
dlet	lahatahiry
pfik	mpandinika
bjet	teti-bola
trek	tetika
kros	quartz
gjit	hety
gwic	jiro
frik	teorika
tluc	lambafamaohana
pruc	fisafoana
glic	Glacier
krun	fahafenoana
bjin	hoavy
tlaf	mandrayanjara
tfet	mpanamboatra
bras	lateral
dwik	voampanga
clec	Exhaust
cres	chess
tcef	serizy
tcom	tafintohina
nyot	mpandikateny
tyok	kamiao
cyip	haben&#39;ny
grot	voan-tsinapy
bris	Wireless
nlam	lavanty
slif	sivana
hgos	harafesina
swoc	miovaova
jyat	bankirompitra
slum	nyfinoanasilamo
hjes	fanisam-bahoaka
dzat	tiptoe
slun	hampiato
nwot	fitohizan&#39;ny
gyic	gitara
pfas	fitongilanana
zyik	fanitso
blen	mamirapiratra
hyem	elm
hnep	scramble
nyut	banataony
ryam	mpisolofanamarihanatoerana
clim	zava-manitra
jret	fombahenjana
tfon	mpandrangitra
jwac	java-
hrep	fombafahandro
dyac	franchise
myip	metatra
rwis	ara-poko
hkem	comet
nwon	zava-baovao
zwin	fandrarana
dyis	MoyenÂge
mrec	fody
fyot	fanamarihanaambanypejy
mlon	fandrefesana
pfis	fanamafisana
rwot	mihodina
hfok	mihafysymitsi-
glof	Golf
zron	aotra
hzip	Zip
hwom	tsymanan-kialofana
bjic	fitsakoana
pcim	hanatanteraka
hjip	Chip
bwac	manoaka
mlos	tana
mrip	tanimanga
bron	embryon
ksoc	deduction
cyum	masirasira
jyan	teknika,
plim	paisom-bazaha
mwet	fasana
ryet	nahazodiplaoma
glik	fitarihan-drano
plap	kapitalista
tsif	fihenjanan&#39;nyresaoro
gyak	antsantsa
djon	toeranamisyanao
nwun	marim-potoana
cles	realism
dris	mitombo
hkef	Cafe
blus	fiarampitondramarary
blap	kitapom-batsy
bjak	undefined
klim	grimace
gyac	mpahaysiansa
jyit	equanimity
dzit	zava-misy
bwak	ivelan&#39;nytrano
dyot	onjam-peo
bwon	tsaramaso
fris	tsyara-potoana
klut	manombantombana
tfek	steak
nrok	azota
zyat	hareza
bram	nimonomononamoramora
ryis	fampidirana
nlip	hadihadiana
nros	mifanohitra
hcof	Esorynyakanjo
tfif	mandrisika
kroc	vavasa
hdum	Jodaisma
pses	mpandray
plok	famenon&#39;ny
lyet	family
pwek	pegativetranga
kfas	homamiadana
pwen	kilalaon&#39;ny
nrun	fampahatsiahivana
clek	niparitaka
pcif	fanamarinana
glas	pitsiny
zwit	beresaka
kces	ampy
crem	antsinjarany
grap	handrapaka
kwip	-tsehatra
dyut	fihenam-bidy
crus	ambaratongam-pahefana
gyet	Jade
gram	snarl
kyip	androngo
nyet	pad
crop	riandrano
glon	gallon
mrok	moka
fluc	mahaytsara
dwic	nyfahadisoan-dàlana
slec	mpikarokatanyvaovao
srec	undefined
blut	hitolona
myok	Mosaic
tlek	manatsatoka
nruk	areti
nwoc	undefined
bjut	squat
hges	bevohoka
twoc	Grocery
kyos	kaomionista
mrek	velivelymampitolagaga
clip	fanenenana
pwok	prosecutivetranga
dwot	mpanaodidyjadona
zyac	preoccupation
jlic	zanabolana
slop	slipper
ryip	mitanila
psim	tokotokony
byet	tsyan&#39;asa
cyop	fialam-boly
rwun	fepetra
blop	jiro
syok	mpanohana
klos	chlore
lwot	klôro
byic	bakteria
lyik	dity
blok	biolojika
jlac	nody
bret	byte
krif	secretion
blet	resakateatra,dihy
nruc	fisotrony
tsus	tongologasy
dyak	sarangaantonony
tcem	hetin
cyoc	mampihaika
trep	frezy
dlun	fandotoana
hlup	raki-kira
hbep	baolina
praf	piraty
pwis	teny
grek	garazy
kruk	tehina
hfof	phosphore
rwut	ara-drafitra
myam	kianja
krec	vanobekoasamy
jras	mpiantoka
zrik	hampandre
blam	ballroom
klip	mpanaoasatanana
hwef	handraisam-bola
zlac	akondro
gret	gropy
lwuk	taolan-tehezana
nyek	nikela
blos	fiarafitateram-bahoaka
sles	sivana
tlif	kapilatanimanga
kses	saosisy
mwot	voatabia
lyot	fiara
tsom	potasioma
brut	virtoaly
djap	alijebra
hjok	levitra
kfen	hevitra
pcok	Optical
bzut	manetsika
syek	tsyfanananaasa
mruc	sompanga
bwas	navigateur
klif	kalsioma
rwet	mitokanalasahenjana
srif	manan-tantarahenjana
hwem	karazany
syom	nysodium
tyos	pananana
jyic	takalon&#39;aina
hguk	tanantanamanga
dwun	fiketronana
swip	lalamby
tlec	mifidy
blaf	fanolanana
tsem	tsyhinoan&#39;Andriamanitra
mloc	Monitor
gyot	fepetra
trop	fangadiana
rwap	isakynytelovolana
hjep	lahysynyvavy
pyim	platinina
dlon	fiavianaroaisa
pcep	havokavoka
twuk	nikaroka
tyec	tenifototra
syup	Super
trom	Trolley
nyip	eoan-toerana
glis	lasantsy
gjik	voa
hjos	nikarakara
hjuc	zavatrababon&#39;ny
swek	undefined
psek	arsenika
twok	antontan&#39;isa
tsep	valala
slos	sosialista
nwim	vavahadinevidentialtoe-po
tlop	lamban-databatra
trus	mampiady
pwot	leash
djot	antsanga
nloc	snub
mwon	Anaranaiombonana
hjek	Jockey
crom	miara-miasa
myon	pnemonia
twec	monina
ryek	balafomanga
dlic	hitoriana
kwet	patin
bwen	obsession
plon	anjara
syon	azadiamihanahanamiandrandra
djis	Hafanàm-poan
byut	Bitch
hyep	hodi-maso
dwon	diagonal
byis	nohaniny
brec	eyebrow
cyec	sneeze
hwop	Watt
clus	mahatsikaiky
kfun	hitoetraao
nwum	Hindoisma
fyim	mpitsoa-ponenana
cwos	mivezivezy
tfoc	undefined
pwon	proteinina
sraf	undefined
hbom	loa
gyen	Gene
drim	freshman
trem	accoutrements
tsup	manorotoro
slok	sosiolojia
kwoc	voatavokorza
bwam	mpifidy
mlok	mihetsika
kyen	isam-paritra
hmop	mihetsikamanatrikailayhavoana
rwek	retrospective
kfup	goba
grok	karaoty
drap	undefined
lwis	molekiolan&#39;ny
ksuc	kaonty
tsop	maimbo
kyok	kaokaombira
nroc	orgy
jlot	solvent
psof	phosphate
hgif	tenamahaliana
kfim	alkaline
psos	fanatanjahan-tena
pfen	fanamarinana
kcom	mpahaytoekarena
krom	faingo
tluk	wriggle
hyom	iode
nwuc	mihetsikadownhill
gjac	afa-jaza
pcom	pod
dzic	endrika
grun	mpirehareha
dzot	mpanome
hzek	manganese
kfot	Ohatra
jlas	tsyazoantoka
lyim	sangany
jyen	Yen
pcaf	parenthesis
rwip	baolinalavalava
blip	Malagasy
kyoc	causation
lyon	fery
flis	fototeny
nrif	manandranandrana
kfam	atsanganahitondra
swes	akanjoba
lwon	minonyevolisiona
drec	fandidianafaty
gjap	Spa
lyec	Linear
tyom	antimony
pwuk	superessivetranga
flaf	Alfa
myim	hery
pcek	fakànaan-keriny
bjac	labiera
bzac	abridge
bzak	sock
twes	fahitalavitra
dwut	fanadihadiana
ksom	tontoloizaovoarindra
lyis	ala
lwim	aluminium
ksok	tonon&#39;andro
sruc	expedite
dlif	feso
byik	mpamonoolona
tfec	avoaky
hjaf	bibymampinono
ryok	Protocol
dwis	karbonika
jlon	Colon
brus	birao
gjak	vahindanitra
lyip	pitsaboana
ryem	radium
href	rarefied
prok	vatafampangatsiahana
slep	undefined
dret	iteration
kluk	zavatrahitan&#39;nympikaroka
dlis	javatramampiavaka
kfip	tsyazoekena
mlec	fanorana
pfif	famaritana
nrec	vavahadin
pfet	trakta
hzoc	underlie
dlam	Nytenatsara
nlec	anthropology
kluc	matsiro
dyet	sedan
tyif	:transitive
krus	natahoran&#39;i
nluc	voanatanamasoandroeran&#39;ny
lyun	Ion
zrot	extradition
ksif	hosoka
psif	émission
crup	hifanindry
fret	izaynahita
grut	Ampifamadiho
ksec	mpiara-mianatrataminy
jric	lalaandehana
mrop	microwave
srus	oust
gyas	mpanaovolo
floc	Folklore
plek	capillary
nwop	fitombenako
nrom	maso
twos	fampihorohoroana
lwok	tenyfilamatra
dwet	rehefaela
slem	sublimate
grip	Grill
gwas	Wow
kwok	kobalta
gwon	OAnyam-
hdop	mihetsikaupriver
glam	anus
bwot	bovine
bren	tsinay
byot	Video
bjik	ankivy
kwim	quiz
cwek	matoanteny
grif	adyanatyakata
hgem	manezioma
hyes	fanentanana
fram	levitra
nwos	undefined
ryap	nanova
cwim	azoantoka
klep	kelp
psec	manonitra
djic	maneran-tany
kfut	fahazoanamivezivezyamin&#39;nyalina
crep	Hamburger
frim	theorem
gjas	handrehitra
hdef	debit
ryum	oraniôma
pluk	hanombana
krop	mandrindra
nraf	mpandoahetra
tyes	Integrated
plip	opine
hgom	Gamma
hgus	coefficient
cwuc	heater
zret	analana
nles	mpandalina
trof	Endrika:intransitive
hmof	mall
hzim	bismuth
dzac	Fisakafoananahariva
psok	cartepostale
blon	convergence
djet	manalavitra
ksum	mpampiasavola
mrup	microbe
clif	helix
cloc	morphological
tfes	caterer
gjis	patalohajeans
jren	fampifanarahana
tlep	Database
kcup	tapakila
glot	Zintin&#39;aratra
glut	fanaovanakajy
srep	tontolon&#39;nyaterineto
nwes	mpampiasavola
ksef	XRay
bzis	visaho
frut	foto-drafitr&#39;asa
nyuk	firefly
dyik	detector
plec	splice
brom	brome
plop	palladium
zlik	silisiôma
flut	volt
ksop	tarehy
gjun	fisehoanaankapobe
kfok	hiccup
hpof	Poakatsaka
hzuk	Zoo
nyoc	heviny
jwak	nyyoga
brim	baryum
kles	hotapahinanylohan&#39;i
mwam	Eny
fwik	firework
djas	Jazz
dyim	teny
tsum	tungstène
drip	dribble
lyaf	alimony
prom	programa
nrup	fahan&#39;ny
hfes	taitaitra
rwaf	Chrysanthemum
dlen	tahirin-kevitra
byas	vaksiny
fron	herôinina
dluk	elektrônika
dyun	mamantatra
flap	lahatahiry
kfet	cathode
dlim	foto-kevitra
prek	fijanonana
syoc	Snapshot
slus	Accessibility
nlos	anticlimax
mlen	sélénium
pres	cortex
hlof	solifara
nlek	dehibeamin&#39;izaofotoanaizaofanamarihanatoerana
gwot	seranam-piaramanidina
mwip	imposter
klop	kalalao
kwom	chrome
hl6t	litatra
nwec	Naizanyaza
glip	cyclic
nrop	Payroll
crum	hormonina
dlep	developer
frot	perforate
bwoc	nanelingelina
fwis	vehivavy
djok	conjugate
draf	manavao
trum	mampidi-doza
graf	algorithm
lwes	tamin&#39;nylaser
mlem	milimetatra
flen	Flex
zlot	anode
swok	snuggle
klec	undefined
pwim	tapak&#39;andro
htuf	lamàtra
fyis	orinasampanadio
lwet	fahatsapana
mrem	mainframe
jwic	rejuvenation
droc	fihetsiketsehana
clem	hélium
dzik	fitenyroa
psem	ranon-dra
hjom	krômôzôma
rwuc	ordinal
tyus	integer
klom	kilometatra
hfos	Fax
nwek	fototarazo
jrap	screwdriver
zwas	appetizer
bwok	broccoli
dwap	adaptatera
syem	spam
blek	Vector
tlus	paikady
pyif	Tsylazaina
cwoc	ekena
mrep	ampere
hbem	vitaminina
hxan	doorman
hxut	hamatsyvola
hk6m	cadmium
hxin	simultaneity
txin	titane
kxin	undefined
klum	copulate
xlis	hourglass
hqak	syntactic
hxat	famoronana
hxik	yboky
hxas	toeram-piasana
bxon	bore
dxin	undefined
hxit	angidimby
tlum	tellure
txit	fe-potoana
kxat	oxidize
hvik	mampifanaraka
nluk	Analog
nyem	centimeter
hm6t	molybdène
hl6m	Lithium
ht6t	Multimedia
xlit	calorie
ryop	Robot
pxas	pharmacist
hxak	enti-mody
lwif	locative
grim	logarithm
hqat	mantis
qlit	tontoloiainana
xlik	sophisticate
mlep	môdely
hqit	radioactivity
kxim	kilao
hxen	renter
hxot	overeat
kyif	copier
fwet	freeware
txet	subset
hs6n	sequential
hxet	henoinynyresaka
xrat	hihetyvolo
hqan	impound
hr6t	iridium
bxat	passante
dxet	biraonao
hxis	exponential
hxok	foibe
hxek	hanary
srem	cérium
hp6t	partitiva
pxik	partitivatranga
kxet	horonam-peo
pruk	sipermarse
hvit	tsitrapo
xlin	ivelan&#39;nyaterineto
frip	encryption
hvep	overpay
hxon	synchronize
kxit	hanomezanavahanany
hqin	seminera
tr6n	Stereo
ht6n	fastener
hvat	hoavy
sl6s	Celsius
hn6n	néon
ts6t	amin&#39;nyfotoanakatroka
hvin	streamline
pxat	newsstand
myoc	Module
ps6s	paty
bwek	kitapo
dlok	Deluxe
fraf	Firewall
hr6k	artifact
txat	orafisakafoanaantoandro
hqon	oregano
pxun	plutonium
ks6n	workstation
slef	escalator
xrit	Mpamonjyaina
hvut	overcrowd
xrim	yttrium
hx6t	augmentative
hqum	Anaran&#39;nympampiasa
hl6n	salespeople
gron	argon
pxan	fampahafantarana
hvac	fanasanavilia
xlan	fanatontoloana
txon	halavan&#39;nyonjam
xrik	efaniasa
hxap	kitapo
hxac	haverinavelomina
xyat	hepatita
cwep	karamabebe
hxos	torus
txif	typeface
qlat	realtor
txot	tapakynyvolanafararano
hxam	milligram
pxis	Pixel
pwif	topi-maso
txam	tantale
myek	thermodynamic
hbop	miditraan-tery
hqot	solute
xlic	sezamisykodiarana
gxit	famonoana
hvan	famonoanaafo
glim	gallium
pfop	popup
hzum	zirconium
xlon	HOTLINE
qlin	nonlinear
kxam	scandium
blim	béryllium
kxik	fampiendrehana
nr6n	neuron
hpef	predicative
hruf	nyrouter
kxan	factorial
hxic	tondrozotra
xlip	volley
dyek	debug
hxop	wristwatch
qrot	neutron
nwip	taharoniobium
hs6t	tranofivoahana
grem	germanium
tles	metalloid
hp6k	prolativetranga
qyin	zavamananaina
txak	antibiotika
mlun	immobilization
txan	actinium
xran	mpanamorysambon-danitra
dres	decompress
tr6t	extraterrestrial
hk6t	octet
hxus	misokatraloharano
xlat	crackpot
mraf	hazakazakalavitraezaka
ts6n	tapakynylohataona
ht6s	autiste
nlif	ionize
txut	notability
hm6n	emitting
kxis	Clipkanto
xrin	miaritra
xren	Redirecting
bxak	Diary
pfos	mpombaandian-teny
hvis	fivalanana
hd6n	denominator
brum	boardroom
hqis	chauvinist
hk6n	hanangonana
xyit	fanovanamanan-danja
xyin	irayfaharoa
hxun	velombelon&#39;ny
hvas	andraikitra
glok	bilaogy
hvak	Meandering
pxit	adiresyIP
hvet	eoakaikin&#39;ny
xram	safflower
hc6n	obviousness
qran	Kôrana
zyen	xénon
hqas	mianianaamin&#39;ny
bzas	blase
hj6n	tsyolombelona
hnof	nonremittal
txas	mpamorona
hbum	Bodisma
ts6s	fifandirana
pxin	sakafo
hr6n	ration
hxim	tapakynyvolanafahavaratra
dxit	tapakynyvolanaririnina
hxaf	excavate
nlus	houseplant
txap	toe-bara
vrit	ghostwriter
kxak	adalamanodidina
bxin	vatan&#39;olombelona
hqik	lambatsylena
hxes	Hertz
hxif	hypnothize
xras	isan&#39;ora
pl6k	paralegal
dxat	rashness
hxip	antibody
vrat	kilaoty
hqek	reshaping
qrit	polarity
pxot	paositra
hxom	tratran&#39;nympanaranamanySary
hqic	mpanomehevitra
lwun	mangaJean
hp6n	maturation
dxan	mifandray
xrak	mpilalaoanjara
dxak	loza
hven	fitoeran
mwap	tantaraan-tsaryesory
qlan	lokojamba
xros	undressing
srom	showroom
hc6t	Niadyhevitra
qrat	ambonyambany
hn6t	inhibition
hqet	tranonkala
fres	fundraise
froc	manorina
xlak	rohibe
vlat	volubility
dvan	disembarking
gxin	handresy
ryes	mpandray
kxot	connectors
xyan	délimitation
vlan	mpanaodokam-barotra
ryom	thoriumtsivaky
hluf	antitra
hquk	mampiditra
lyum	thuliumtsivaky
tyem	terbiumtsivaky
hp6m	praséodyme
txic	an-tranopejy
mros	motorist
dyam	rhodiumtsivaky
pc6n	fitsaranaisa
nyos	Inbox
pyek	fandefasana
kxon	krypton
hxuc	hanavotana
qrik	centrictranga
xwin	inexperience
kxic	extinguisher
hvot	flowchart
dxot	yogurt
hqut	miala
pxen	departemanta
drok	tanjonatrigger
flon	finday
txos	afovoanyfeo
hqok	obliquetranga
xwik	mararytranga
hx6n	prehodiernal
txik	fanondro
hqen	sender
mlap	malware
hvun	suasion
hvon	rovitra
vran	mitondranamanySary
pfes	mpampianatra
pwip	poeta
hqam	mikotrana
gxat	mahaara-dalàna
ks6t	causative
vrin	recruiter
kxip	Clipboard
sr6n	disapproving
vlit	manombatombana
tyup	manamorona
mrom	morpheme
xron	headphone
gxak	lafo
hrof	Trojansoavaly
xlas	nalemy
dzet	hanaingoana
txac	fileferana
xrot	maromaro
txis	tebokamatrix
syif	sivondrona
xrac	mahagaga
brif	mimari-droasanda
dlos	Modalraharaha
txun	toetra
dvat	malemyfanahyratsy
psom	tananavoalohany
gjek	hafaraha
nlem	vondronafaobe
qret	fivarotanaantsinjarany
txip	tebokatelo
dlek	tsirairay
lwut	mikorianaankehitriny
dxis	be
hs6m	cesium
vlak	railcar
hn6m	netium
kxap	baoritra
bxan	miala
myem	volanaMey
gxik	zosivily
hxoc	tafikaan&#39;habakabaka
xrok	mpiara-miasa
kr6t	pikantsary
txok	hoazy
hxep	skateboard
srop	findayavolenta
pxak	sorabaventyranoray
hk6k	Folkmozika
hl6k	eulersisa
pyom	poloniumtsivaky
xyam	thalliumtsivaky
hvic	mpanani-bohitra
lyok	locativetranga
xlot	fisaka
txen	restatement
kxac	panafihana
qrak	strikebreaker
hbup	pisinina
txuk	fohyfaritra
tsef	tapered
bxit	Malagasymiaramila
ksem	mamakyihany
byim	rubidiumtsivaky
hvam	vanadiumtsivaky
lw6n	lanthane
frum	fluortsivaky
nyom	néodyme
mlom	multalisa
kxas	personalize
xret	terabyte
hs6k	fikarohana
frus	corroding
gxan	vahindanitralahysynyvavy
vlas	vocalizations
glet	entonapedal
hvim	runtime
bxip	bitmap
qrin	kintanalahysynyvavy
bvak	abessivetranga
pxon	Tsyvonona
dvik	adessivetranga
dvek	agentivetranga
hlef	mpandraharahatrigger
kwek	nyraharaha
kxen	iombonanalahysynyvavy
ht6m	ambadikateny
tsuf	transsexuelleAnaranaiombonana
hf6n	fining
tc6t	mivantanazavatra
gvik	ergativetranga
gxon	Nizarazara
ksep	receptor
vyin	sarimihetsikateatra
pyos	matoantenin&#39;nyataofeo
hnef	voafetranymatoantenyamin&#39;ny
xwit	Kilongazavatra
hqim	gnomictoe-po
jlak	generalization
vrik	faranysombiny
qyan	an&#39;eritreritravondrona
kxaf	hafainganam-pandehan&#39;nyhazavana
xyic	phishing
qyit	fanakiananahevitra
hvek	evitativetranga
bvik	subessivetranga
hzes	nahazotranga
prus	solosainaotrik&#39;aretina
ples	processeur
pxif	biraon&#39;nypolisy
dvak	lativetranga
brun	eran&#39;iBoligaria
tsi_k	antessivetranga
tyum	ruthéniumtsivaky
vyak	fanononanatranga
pxim	Praiminisitra
syum	strontiumtsivaky
sy6n	suspiciousness
hy6n	selan&#39;izylahysynyvavy
pxac	nangorakafifaliana
vlin	fiaralahysynyvavy
qwin	mineralylahysynyvavy
hr6s	anarana
tf6n	Toner
xris	mpampiasainterfacetsara
hw6n	fianianana
xlen	am-bavaiombonana
pyec	kajy
vlim	virtoalyfahatsiarovana
bres	tenyprocesseur
hqip	rahonacomputing
vlic	virtoalymilina
pfam	mpanaospam
dyap	faharoateny
txek	nthfaka
dxen	angonafitrandrahana
byip	raharaham-barotranyolona
hs6c	tenamatoky
txim	miresaka
hb6t	fanovananyhetsika
hdem	sehatraanarana
dxon	hetsikasamihafa
lwaf	Flashfiara
sl6t	crastinalhenjana
xyik	Floppykapila
fyif	taitaitrafeo
bvin	izaorehetraizaoMiralenta
hm6p	motherboard
tfip	Endrikynymatoantenyamin&#39;ny:transitive
jlen	asezarelahysynyvavy
xrap	sadika
tc6n	fikarohanalahysynyvavy
sl6n	kantolahysynyvavy
xrek	mararytrigger
xwan	saro-takarinalahysynyvavy
dxif	videoconference
dyip	indirectteny
zrek	exocentrictranga
hvuk	evoking
xwat	lasaperfective
hr6m	rhénium
txaf	Niteraka
hmef	tsymanananymahaEndrikynymatoantenyamin&#39;ny
tx6t	mpandrarylahatsoratra
txes	iombonanaiombonana
bvat	nampijaly
bvuk	absolutivetranga
ry6t	radian
vlis	virtoalyzava-misy
qren	planetalahysynyvavy
gvak	fitsipi-pitenenanatranga
bxok	sola
mrum	programan&#39;ordinatera
ps6t	rafitrafikirakirana
hfom	phoneme
tlem	mamakyihanynofahatsiarovana
pwam	spyware
kfif	fototrabenefactive
qwit	rationality&#39;
nlaf	fametrahana
nwok	associativetranga
dzas	dissatisfy
swuk	indrindratranga
syos	mamintina
kr6n	herinaratra
dvin	mananaainalahysynyvavy
pxom	propositivetoe-po
vris	reciprocalfeo
rwos	aerosol
dr6t	distractor
ht6k	fifandraisan-davitra
slaf	fifaneraserana
lyuk	nifandimbyfepetra
qras	lehibeny
ty6n	teminal
gwet	hoavytsyhoelahenjana
hp6s	applicativefeo
tsof	antipassivefeo
ht6p	continutivelafiny
hn6f	necessitativetoe-po
pfip	matoantenin&#39;nyataoamin&#39;nyteny
glap	anjan&#39;ny
sy6k	existentialfepetra
qyat	mamiratrahamafin&#39;ny
hy6t	fitsipi-pitenenanazavatra
vyan	manonona
sluf	singulativeisa
dvit	beloatrafaharetan&#39;ny
qyak	Endrikynymatoantenyamin&#39;nyasatokana
bzik	Fizìka
xlet	indrindradiplaoma
hqap	endrika
qwat	habetsahan&#39;nyfananana
qyik	connectivesombiny
sr6t	supercriticaltsiranoka
hfem	epentheticmorpheme
tl6t	mitokanahoavyhenjana
mrif	microphone
pcuk	postpositionaltranga
tfim	kisendrasendrafidiranafahatsiarovana
fwim	ethium
ly6t	allocutivefifanarahana
hvap	horonam-bokyfisotroana
hfep	frequentativelafiny
bvan	distributivempisolo
fyun	mitsingevanatebokamaro
xyas	famafàna
hvif	Endrikynymatoantenyamin&#39;nytahirin-tsiry
xyis	lasamatoantenin&#39;nyataoamin&#39;nyteny
tl6n	foibefikarakaranavondrona
tfok	locativedirectionaltranga
qwan	matetikananontanyfanontaniana
