hnit	infinitive
hnak	ആഖിബ്
hkak	ദിതീയവിഭക്തികേസ്
htak	വിഷയംകേസ്
hpap	അച്ഛന്
hmam	മാം
hyat	രക്ഷാകർതൃ
hcan	ഹലോ
hwik	vocativeകേസ്
hsuc	പൂര്വ്വികന്
htat	മുത്തച്ഛൻ
hcac	വിശന്നു
hnik	callerഇംഗ്ലീഷ്കേസ്
hcit	നാമവിശേഷണം
hwan	ഒപ്പം
hman	എന്നോട്
hnan	നിങ്ങളെ
hwam	ഞങ്ങളെ
htit	അത്
htac	ലക്ഷ്യസ്ഥാനംകേസ്
htik	ഉദാത്തംകേസ്
hyit	realisമാനസികാവസ്ഥ
htim	deonticമാനസികാവസ്ഥ
hcut	സോപാധികമാനസികാവസ്ഥ
hsit	epistemicമാനസികാവസ്ഥ
hyak	പേരകമായകേസ്
htan	ഇന്റീരിയർസന്ദർഭ
hpan	വ്യക്തിസന്ദർഭ
htin	സ്വതന്ത്രക്ലോസ്
hyan	ആശ്രിതക്ലോസ്
hfap	perfectiveവശം
hkat	ഭൂതകാലം
hnin	പുല്ലിംഗമായ
hmak	comitativeകേസ്
hnat	വര്ത്തമാനകാലം
hpak	benefactiveകേസ്
swik	essiveകേസ്
htut	negatoryക്വാണ്ടിഫയർ
hsan	ഉപരിതലസന്ദർഭ
hpin	adpositionalകേസ്
hwin	ലൊക്കേഷൻകേസ്
hkan	സ്പെയ്സ്സന്ദർഭ
hnac	വഴികേസ്
hyut	interrogativeമാനസികാവസ്ഥ
hnam	അല്ലെങ്കിൽ
hkit	എക്സ്ക്ലൂസീവ്അല്ലെങ്കിൽ
hsuk	ഉറവിടകേസ്
hpik	ablativeകേസ്
hcat	ചേര്ച്ച
hmat	പ്രകടനാത്മകമായ
hkuk	ക്ലോസ്വാൽ
hlan	പക്ഷേ
hsut	എല്ലാം
hyin	യൂണിവേഴ്സൽക്വാണ്ടിഫയർ
hcin	തുല്യാവകാശംലിംഗഭേദം
hpac	പദത്തിന്റെനമ്പർ
hyik	ഒന്ന്
htic	അവരുടെ
hkik	ആര്
tcat	ഭാവികാലം
hsin	സോഷ്യൽസന്ദർഭ
hkac	എപ്പോൾ
hmip	imperfectiveവശം
klan	അവിടെ
hlak	elativeകേസ്
hlik	illativeകേസ്
htam	നിർദ്ദേശംമാനസികാവസ്ഥ
hlat	തിരഞ്ഞെടുക്കാവുന്നത്ക്വാണ്ടിഫയർ
hkam	എന്ത്
hwat	ചോദ്യംവചനം
htap	copula
hpat	വ്യക്തി
nyan	ആൺ
hkas	could
tcan	മറ്റ്
hnuc	അക്കം
twit	അവകാശസ്ഥാപകമായക്വാണ്ടിഫയർ
hsak	സമയംസന്ദർഭ
htuk	യുനാനികേസ്
htun	മാത്രം
htum	hortativeമാനസികാവസ്ഥ
hyip	മുൻകാലവശം
hlit	volitiveമാനസികാവസ്ഥ
pcic	ആവശമാകുന്നു
tyut	രണ്ട്
hsat	കാണുക
hkut	അറിയുക
hcic	താഴേക്ക്
hcap	ശേഷം
hpam	ആദ്യം
hlac	alienableഅവകാശമായ
hkap	ഒരിക്കലും
hnic	inalienableഅവകാശമായ
tyat	പഴയ
tcit	deliberativeമാനസികാവസ്ഥ
tcin	ദിവസം
hlam	വരിക
hwak	സരം
hkin	പോയി
lwak	perlativeകേസ്
hpip	പുരോഗമനവശം
lyan	നീളമുള്ള
hsac	പറയുക
kyan	എങ്ങനെ
htas	വീണ്ടും
hsic	ഇവിടെ
hcik	ചിന്തിക്കുക
hcak	സന്ദർഭകീഴിൽ
hfan	കണ്ടെത്തി
hsun	കൈ
hyac	ഇതും
nwan	യുവ
tyit	എതിരായി
tlan	ദൈവം
twak	delativeകേസ്
hmin	ഒന്നും
hyas	ഒരിക്കല്
hlap	semelfactiveവശം
kcac	ഇടത്തെ
hyic	അറക്കവാള്
hcas	വീട്
hwac	ലോകം
tyin	മൂന്ന്
hnun	നവ
hcuk	ഫോക്കസ്
pyan	സ്നേഹം
hsis	എല്ലായിപ്പോഴും
hyam	രാത്രി
hyap	രാജാവ്
hkic	ഇടയില്
hmas	മനസ്സ്
cyit	ഹൃദയം
pluc	paucalനമ്പർ
kyik	കാരണം
ksak	കാര്യകാരണങ്ങളെകേസ്
tcun	പൂർത്തിയായതായി
hnim	പേര്
tsan	സംജ്ഞാനാമം
klac	രാജ്യം
hpun	ചോദിച്ചു
cyat	ദൃശ്യമായevidential
pcac	മെച്ചപ്പെട്ട
hmac	നിമിഷം
hnas	ഒന്നുംകഴിയില്ല
hwic	വെള്ളം
twim	desiderativeമാനസികാവസ്ഥ
kwan	വെളിച്ചം
tlat	വാക്ക്
tyan	വാതില്
hsas	രാവിലെ
syat	വരുവോളം
twik	terminativeകേസ്
hpit	വെളുത്ത
pcan	പണം
hyis	പാവപ്പെട്ട
mwan	മരണം
hfam	രൂപം
nwik	inessiveകേസ്
kcat	ഒന്നിച്ച്
tsac	അടിക്കടി
pyat	സ്നേഹിതന്
psan	പകുതി
hpim	ഒഴിച്ചുകൂടാനാവാത്തതാണ്മാനസികാവസ്ഥ
hyuc	ചുറ്റും
hfat	അയച്ചു
hcis	ഭാര്യ
kcan	വിശ്വസിക്കുകയും
hsik	പൊതു
htus	സംസ്ഥാനസന്ദർഭ
hpas	മകൻ
clat	മക്കൾ
tyak	ഇങ്ങനെ
cwan	പ്രത്യാശ
syin	പ്രിയ
hkuc	ഉയർന്ന
tyac	വായിക്കുക
syit	നഗരം
hlic	ഇതിനകം
hfit	factiveevidential
tcac	പെണ്കുട്ടി
hcun	കേള്ക്കുക
ksan	കുറഞ്ഞത്
hyaf	ഒരുപക്ഷേ
kyat	തീർച്ചയായും
tcic	ശരീരം
hwit	മടക്കം
cwat	എയർ
hfaf	നിയമം
hput	സഹായിക്കൂ
lyat	അക്ഷരം
ksas	നാല്
hpic	optativeമാനസികാവസ്ഥ
hfuk	തീ
hcam	മണിക്കൂര്
twat	യുദ്ധം
kyak	നിരവധി
tlit	സെക്കന്റ്
pcin	പിന്നാലെ
hmut	നഷ്ടപ്പെട്ട
clan	ആയിരം
hfac	കുടുംബം
twan	ആത്മാവ്
hwas	ചോദ്യം
syan	സത്യം
htis	നിർമ്മാണം
tsat	സാധ്യതയുള്ളമാനസികാവസ്ഥ
lwik	allativeകേസ്
nyin	ആന്ത്രോപിക്ലിംഗഭേദം
hfak	അഞ്ച്
tcak	അതേവിഷയംമാർക്കർ
htuc	വ്യത്യസ്തവിഷയം
hnap	ഉത്തരം
hmit	കടൽ
hcuc	പേടി
pcat	മനസ്സിലാക്കുക
syas	നിബന്ധനകൾ
hcaf	സംശയം
twut	dubitativeമാനസികാവസ്ഥ
hkis	കറുത്ത
tlak	കൊണ്ടുവരിക
hyus	മനോഹരമായ
nyit	അടുക്കുക
htip	പത്ത്
ksis	കഥ
hpuk	പുസ്തകം
hlin	ഇലക്ട്രോണിക്
hkun	കണക്ക്
lyas	പലിശ
lyit	എഴുതുക
pwat	കിടക്ക
hnis	പ്രായം
hnut	counterfactualസോപാധിക
slas	കല
hwis	vialisകേസ്
pyak	സഹോദരൻ
lyin	വര
tyas	മേശ
hyun	നദി
kyac	കണ്ണ്
tfan	പെട്ടെന്ന്
kcin	ആഴമുള്ള
hmuc	ഉദ്ദേശ്യം
cyac	രക്തം
hmap	പനിനീര്പ്പൂവ്
tlin	തണുത്ത
hyif	മുന്നോട്ട്
tyam	വൈകി
hnaf	സങ്കല്പിക്കുക
hkip	മിക്കവാറും
myan	എന്റേതല്ല
tsin	അറിവ്
hkup	പകര്പ്പ്
hsam	ഭര്ത്താവ്
hlis	ആറ്
cwit	ജീവനുള്ള
cyan	സമാധാനം
myat	സ്മരിക്കുക
tyic	പ്രകൃതി
hfut	വീഴ്ച
swas	സേവനം
hsap	ഒഴികെ
pcit	പകർപ്പവകാശ
hyim	സൈന്യം
kyas	കുതിര
plic	ഭാവി
pcak	പടിഞ്ഞാറ്
hpis	കൂലി
hyuk	ചുവന്ന
hwun	സ്വർണം
twin	ആഗ്രഹം
plan	കളി
hpus	ഓഫീസ്
syun	സര്ക്കാര്
kyic	പള്ളി
htaf	ബലം
hlun	നീളം
kyin	സംഘം
kyis	കടലാസ്
mlan	സംഭാവത
hcim	വിശേഷാല്
cyas	കരടി
twac	ജാലകം
nyat	സൗന്ദര്യം
hcus	പിന്നത്തെ
htup	കടമ
htif	അകലം
pyas	പാദം
hlas	കാട്ടു
ksin	പച്ചയായ
hmaf	കഷ്ടത
myac	പുഞ്ചിരി
hsim	ഉറക്കം
kyit	ഉദ്ധരിച്ച
kwik	quotativeകേസ്
fwan	സന്ദര്ശനം
slan	പിന്തുടരുക
psit	സാന്നിദ്ധ്യം
hmic	മധുരം
hmuf	വായ
hfin	സമ്പന്നമായ
tcam	ശത്രു
psuk	പൊട്ടിയ
kcap	കപ്പൽ
pwan	ഇൻക്ലൂസീവ്വ്യക്തി
hfic	സ്വാധീനം
tcuc	ദൃശ്യമാകും
hkim	രഹസ്യ
pyin	ദയവായി
pwit	precativeമാനസികാവസ്ഥ
pyit	വിനീതമായരജിസ്റ്റർചെയ്യുക
cwak	ദുഷിച്ച
myak	മാര്ച്ച്
tcas	സ്ഥലങ്ങൾ
hlaf	താമസിക്കാൻ
psat	പകരം
nlan	നീല
psac	അസാധ്യമാണ്
kcuk	സ്കൂൾ
kcit	വിവാഹിതനായ
kcak	ഭക്ഷണം
syis	ഇരുപത്
tlac	സ്വസ്ഥമായിരുന്നു
hcip	വരനുംവശം
kwin	നൽകുന്ന
tsit	നിർത്തി
pyac	ഭാഷ
hsus	ആഴ്ച
hcup	ഹാൾ
cyap	അത്ഭുതവും
tfin	ജനിച്ച
fyat	കോടതി
hnip	gnomicവശം
tsak	ബഹുമാനം
tlas	രൂപയുടെ
syuc	വൃക്ഷം
plat	ചുവര്
cyak	സ്വർഗ്ഗത്തിൽ
twip	inchoativeവശം
mlat	കമാൻഡ്
swit	jussiveമാനസികാവസ്ഥ
mwas	മാസം
hwaf	തികഞ്ഞ
tyap	പരിചയം
ksac	സാഹചര്യങ്ങൾ
syac	പുതിയ
hnuk	ഡ്യൂക്ക്
kwak	മൂടി
tyuk	കിഴക്ക്
pwac	കല്ല്
hkif	വിശുദ്ധ
nyac	സംവിധാനം
cyis	കസേര
tyuc	കാത്തിരിക്കുന്നു
tsun	ഗ്രാമം
tyik	സമ്മതിക്കുന്നു
hnum	അനുവാദാത്മകമാനസികാവസ്ഥ
slak	വിജയം
tsic	ശ്രമിക്കുന്നു
slat	കുന്ന്
hmik	സംഗീതം
hkus	നിലവിളി
hsip	ഏഴ്
hpaf	സ്വകാര്യ
nwas	വാര്ത്ത
tfac	രംഗം
fyan	തോട്ടം
cwas	ആരംഭിക്കുന്നു
hfik	വിതരണാത്മകമായകേസ്
lyac	പഠിക്കാൻ
syik	രാഷ്ട്രീയ
clin	ഹെൻറി
cyin	നുണ
tsas	ഉരുക്കിവാര്ക്കുക
cyik	അധികാരം
tlap	തറ
cyam	വേനൽ
tcut	മതം
tcap	എസ്കേപ്പ്
hlut	രചയിതാവ്
pyun	തവിട്ട്
tcuk	വേദന
swan	സ്പ്രിംഗ്
hmun	മൃദുവായ
kyun	മൂല
nyak	ട്രേഡ്മാർക്ക്
tsis	നീതി
psas	ഉൽപ്പാദിപ്പിക്കുക
cyaf	ചിരിക്കുക
hwut	മറക്കരുത്
hyup	യൂറോപ്പ്
hwap	എട്ട്
psak	പാസിംഗ്
kyap	ഭയങ്കരൻ
pyic	ആവശ്യമാണ്
hmim	ഇടത്തരം
hsaf	ശ്വാസം
hmis	ജ്ഞാനികൾ
hsum	കൈയടക്കിവയ്ക്കുവാൻമാർക്കർ
ksat	പ്രസന്നമായ
ksit	കുഴിമാടം
tsap	ദ്വീപ്
kyam	പാളയം
tcum	ടച്ച്
cyun	സന്വത്ത്
psic	കടല്ത്തീരം
tyun	ഡൊമെയ്ൻ
mwit	commissiveമാനസികാവസ്ഥ
tlut	ഡിഗ്രി
myit	ശീതകാലം
kfan	നടത്ത
slac	പ്രവർത്തിക്കുന്ന
myin	മിനിറ്റ്
tyip	ഈയം
klas	ഗ്ലാസ്
pfat	പലക
cyic	വൃഥാ
swam	വിദേശകാര്യവും
syam	സുരക്ഷിതമായ
tsut	ഡോക്ടര്
hlip	completiveവശം
kcas	അന്ധകാരം
nyun	ഊഷ്മള
hpuc	പാനീയം
tlam	ഉദാഹരണം
hfun	കോപം
tsik	ആയിട്ടും
tsam	നേരിട്ട്
hmup	തൊപ്പി
klak	നായ്
slin	വെള്ളി
swac	ദാസൻ
kcam	അഹങ്കാരം
pyik	തീവണ്ടി
myut	സദാചാര
syak	നൽകുക
swat	വാള്
kyuk	ആക്രമണം
clac	ആരോഗ്യം
tyaf	ഖണ്ഡിക
swic	സാമൂഹിക
tfit	തിരികെകൊടുക്കുക
hkaf	ഔദ്യോഗിക
pcas	കണ്ണോടിക്കുക
nyam	മഹത്വം
tfat	പന്ത്രണ്ടു
pcut	ഏർപ്പെട്ടിരിക്കുന്ന
pwin	വൈൻ
mwat	രുചി
fyac	ഇരുമ്പ്
syap	വിതരണംചെയ്യുക
myap	വ്യാപാരം
hyum	ഉപയോഗിച്ച്
fwak	ജഡ്ജി
klat	ക്യാപ്റ്റൻ
twap	cessativeവശം
kcic	കൗതുകകരമായ
kwic	വിദേശ
hnif	intensifier
myun	പ്രാധാന്യം
tlic	അവസാനമായി
cyuk	കഴുത്ത്
syut	സ്വാതന്ത്ര്യം
pfan	വശങ്ങളും
kyuc	ഉണങ്ങിയ
pcap	വേറിട്ടു
tfak	evidential
tcik	evidentialകേസ്
twun	ദൂരെയുള്ള
tyis	പുരോഗതി
nyap	വീതികുറഞ്ഞ
plit	കെട്ടിടം
hpif	പേജ്
pwic	holding
syic	ദുഃഖകരമായ
tsip	പാപം
syim	രോഗികളെ
tcis	സത്യസന്ധമായ
pcun	ബാങ്ക്
ksap	അംഗീകരിക്കുക
lyam	സ്ട്രീം
tcaf	ശ്രദ്ധാപൂർവം
kwac	ചെവി
hpup	റൊട്ടി
kcut	തിരഞ്ഞെടുക്കുക
nwam	ജന്തു
hsup	zoicലിംഗഭേദം
nwit	eventiveമാനസികാവസ്ഥ
tcim	ഒരേഇവന്റ്മാർക്കർ
tlik	ഗുണനത്തിലുംകേസ്
kyus	കുരിശ്
hmus	കട്ടിയുള്ള
kfat	തുനിയുന്നില്ല
nwat	വളരുക
myic	മഴ
hpum	ഉപരിതലം
swut	വിശുദ്ധമായ
clis	ജൂലൈ
mwun	ഫാഷൻ
hfas	ഫയല്
cwac	തോൾ
kwat	സൗകര്യങ്ങൾ
nwac	ആർക്കും
tcip	ആവശ്യമുള്ള
kfac	പുല്ല്
hmuk	വര്ണിക്കുക
plin	ഉദ്ഘാടനം
kwun	ജൂണ്
mlik	മത്സ്യം
klin	തലസ്ഥാനം
pfut	മുല
twam	അവകാശം
fyin	ചെലവ്
nlit	നിങ്ങളുടേത്
mlin	ദശലക്ഷം
pyut	പാര്ത്ഥിക്കുക
hluk	ക്ഷീണിച്ച
ksut	കൊല്ലുക
cyut	നിഴല്
psin	ഭാരം
kcis	ചാര
pyam	ധീരതയുള്ള
mwac	സംതൃപ്തിയുണ്ട്
klam	കളവ്
ksam	ദേശീയ
hfip	ദുർബലമായ
klik	താഴ്വര
hkum	ഊഹക്കച്ചവടമാനസികാവസ്ഥ
clas	മഞ്ഞ
cyuc	ചൂട്
mlac	ഭൗതികാവശിഷ്ടം
syip	തുല്യ
pwak	പെട്ടി
tcif	കൂർത്തതും
psip	തത്ത്വം
ksik	പരിണതഫലം
tsim	കാലം
flan	ശാസ്ത്രം
pcam	പ്രത്യക്ഷമായും
kcun	തുളയ്ക്കുക
ksuk	അമ്മാവൻ
mlit	പട്ടിക
pcik	അപകടകരമായ
kwas	ആഗസ്റ്റ്
hluc	പ്രശസ്തമായ
klit	അറിയപ്പെടാത്ത
flak	പരിചിതമായ
fyit	പരിചിതമായരജിസ്റ്റർചെയ്യുക
lwat	വായനക്കാരൻ
plun	നടന്നു
twas	രണ്ടുതവണ
pcis	പുരോഹിതന്
fyas	മുറിവേറ്റ
nlat	കൊട്ടാരം
myuk	മൂഢൻ
pfak	പ്രീതി
tcuf	ഒന്പത്
cwap	സഹതാപം
plac	പിഴുത്
pyap	ഇടുന്നതു
lyic	ധരിച്ച
hcum	ശബ്ദം
lwit	സാഹിത്യം
tsuk	പദവി
hfup	കൊടുങ്കാറ്റ്
kcik	കീശ
nwap	നവംബര്
tyim	ഡിസംബർ
psaf	അഭാവത്തിൽ
nlac	ജനസംഖ്യ
kyaf	നന്ദിപറയുക
slis	പരമ്പര
pyaf	പക്ഷി
mlak	ഉടമ
kwut	അങ്കി
hwuc	ബന്ധങ്ങൾ
pyis	അതിവേഗം
twuc	പുക
nwak	ജനുവരി
mlic	മെഷീൻ
tlis	പല്ലുകൾ
ksun	കത്തുന്ന
clam	ലജ്ജ
klaf	ഗുണമേന്മയുള്ള
clit	വളയം
fyak	പദപ്രയോഗം
fyam	വാചകംമാർക്കർ
kwap	സമചതുരം
hwip	ഞായറാഴ്ച
psis	കവിത
pwut	നിയമിച്ച
kyim	വാങ്ങാൻ
clic	നിലങ്ങളും
pyip	ഏപ്രിൽ
kfap	ഒക്ടോബർ
psut	വസ്തുക്കൾ
kcuc	കയ്പേറിയ
nlap	അടിമ
hsok	അയഞ്ഞ
htet	ടെക്സ്റ്റ്
hbat	മോശപ്പെട്ട
hrit	ക്രെഡിറ്റ്
hzit	സവിശേഷതകൾ
hpet	പതിനഞ്ച്
krac	ക്രൂരവും
hduc	പൊടി
hrik	പ്രായോഗിക
hron	നിറം
hnus	മൂക്ക്
hric	ഫ്രണ്ട്ലി
srik	ജലവിതരണം
hten	ഇന്നലെ
tlet	നാമവിശേഷണhesternal
slap	പരാജയപ്പെടും
hban	ധരിക്കാൻ
hdat	അന്ധനായ
fran	ഈച്ച
hdan	പിശാച്
htec	ക്രമേണ
hmon	ദൗത്യം
cran	യാഗം
hran	മനസ്സാക്ഷി
hmos	മന്ത്രി
nrit	ഊര്ജം
hcet	വെറുപ്പ്
hset	കേന്ദ്രം
hrin	യുക്തിബോധംലിംഗഭേദം
hcot	ആസ്വദിക്കാൻ
hrip	ചുരുക്കത്തിലുള്ള
htep	ആരാധന
hcif	ത്വക്ക്
hrat	മേല്ക്കൂര
kran	കിരീടം
hkon	കോട്ട
tran	നിരാശപ്പെടരുത്
hmif	നാഴിക
trin	വലയം
hgin	കാരാഗൃഹം
hkop	കോപ്പ
hcen	അംഗം
swin	സിവിൽ
hrac	എല്ലായിടത്തും
hris	കസ്റ്റം
hbin	ഭീമേശ്വരി
hmot	മാംസം
hdut	പാൽ
hwen	vegetalലിംഗഭേദം
nran	അപൂർവ
hbac	മച്ചുനന്
crut	പാലം
hsoc	സംഭരിക്കുക
hsom	ഉപ്പ്
nris	നിരപരാധികളായ
hbit	ഒഴിവാക്കുക
crin	ആരാധനാപാതം
rwin	രാജ്ഞി
hgut	എണ്ണം
hdas	നൃത്തം
hnot	ഹോട്ടല്
hdin	നിറയ്ക്കുക
hton	തടവുകാരന്
hdak	കട
hlet	ഏണിപ്പടി
hson	മാപ്പ്
hgek	ഗേ
hras	മണല്
hsep	സെപ്റ്റംബർ
hbic	ശിഷ്ടം
hlen	അനുമതി
hcon	ആവശ്യത്തിനുള്ള
hgit	സാക്ഷി
kfon	അടുക്കള
hbak	വിൽക്കാൻ
tlim	ചികിത്സ
hsot	വേഗം
kyut	കമ്പ്യൂട്ടർ
hnen	നിത്യ
htek	ലൈബ്രറി
hzan	അടങ്ങുന്ന
hbis	അടിത്തറ
hbun	ചിന്താക്കുഴപ്പം
kcus	പാചകക്കാരി
hgat	ഏകാന്ത
hwus	ചുംബനം
hbif	ഐസ്
hbot	പന്ത്
hrut	വാദം
hdit	benedictiveമാനസികാവസ്ഥ
hdis	കുറ്റവാളികളായ
hjan	ശിക്ഷ
plis	പോലീസ്
hgan	മറയ്ക്കുക
hsen	പരവേഷണം
nrin	അറിവില്ലാത്ത
hyen	മേഘം
frif	ഫെബ്രുവരി
hdik	രോഗം
hnek	മുൻകൈകേസ്
hbam	അമ്മായി
hmen	എളിയ
hdip	ഒഴിച്ചുകൂടാനാവാത്തതാണ്വൈകും
prat	റിപ്പോർട്ട്evidential
hdet	അർദ്ധരാത്രി
hjit	വിരല്
hmoc	ഏതെങ്കിലുംസ്ഥലത്ത്
pran	അമർത്തുക
kcec	പ്രദേശം
hken	കുറെമുന്പേ
hloc	അനാട്ടമി
hrak	സ്റ്റാഫ്
htes	നോട്ടം
rwan	പ്രതിഫലം
hdon	സംഭാവനചെയ്യുക
htot	നെറ്റി
hnet	മാലാഖ
hdun	ക്രിയ
croc	പിശക്
hlon	പ്രഭാതത്തെ
hyec	ആടുകൾ
hjin	ക്ഷമ
hrec	റെഫെറെൻഷ്യൽ
mran	ചോളം
htos	ഭൂരിപക്ഷം
hcos	നടപടികൾ
hkoc	ഇടയ്ക്കിടെ
hlif	ലാഭം
clak	പഞ്ചസാര
hjat	മനുഷ്യരാശിക്കെതിരായ
tram	ചട്ടക്കൂട്
hdic	ഡിസ്ക്
hkok	ഏകാന്തമായ
srat	കലാകാരന്
crak	വശത
hmet	ഇമെയിൽ
hden	തീരുമാനം
gran	ഗവര്ണര്
crac	ശാഖ
hjac	ആവേശം
hdim	ഇൻഡക്റ്റീവ്മാനസികാവസ്ഥ
hcok	ധൃതികൂട്ടുക
hyet	എണ്ണ
pwap	കുഴല്
trat	അച്ചടിക്കുക
tcot	സോളിഡ്കാര്യം
hdoc	ഓ
hren	വ്യവഹാരത്തിന്റെസന്ദർഭ
tcon	ഉച്ചയ്ക്ക്
krin	ചെറിയമുറി
plam	അലാറം
hnes	നാഡീബലമുള്ള
tcen	നിരീക്ഷണം
hsek	വീക്ഷണ
plik	ബാധകമായ
slik	പട്ട്
hfen	ശതമാനം
hgen	ഏജന്റ്
hnon	യൂണിയൻ
crik	നരകം
tcet	കുറവുള്ള
mrat	മിക്സഡ്
hdam	admonitiveമാനസികാവസ്ഥ
hgac	അധികാരതൃഷ്ണ
htoc	ഏതുവിധേനയും
hdac	ആലോചന
nwin	ഭരണഘടന
srit	ഉപകരണം
hret	ഉറച്ചു
nlin	ഓൺലൈൻ
hzat	വേലിയേറ്റം
klic	കോളേജ്
hkek	വാല്
nric	തലമുറ
hgic	തിങ്ങിയ
hgak	പൂച്ച
trit	നേരിട്ടുള്ളevidential
tyot	കരാര്
hnok	ഉള്ളടക്കങ്ങൾ
crit	ഉപേക്ഷിക്കപ്പെട്ട
slen	പതിനൊന്ന്
srin	സഹജവാസന
hpok	ഗോത്രം
hyot	വിവേകബുദ്ധിയുള്ളമാനസികാവസ്ഥ
cric	അഭയം
hruc	അപമര്യാദയായ
cwin	സവാരി
hzak	ഇളക്കുക
dyit	വ്യവസായം
hpec	തൊഴില്
nras	ആയ
hcec	അദ്ധ്യാപന
hbut	ഷൂസ്
hmec	അവക്തമായ
twot	പ്രവർത്തനം
crat	ശനിയാഴ്ച
hkot	ശേഷി
hnec	സൂരപകാശം
hwuf	വിധവ
cren	ചൊരിഞ്ഞ
nrat	നക്ഷത്ര
hget	അതിഥി
hbik	അനുഗ്രഹിക്കും
brin	ഉള്ളിലുള്ള
hpot	ലഭ്യമായ
trac	പ്രതിരോധം
prac	ഉരുത്തിരിഞ്ഞതാണ്
hcoc	പൊള്ളയായ
hpon	പ്രവിശ്യ
hwim	നാഗരികത
dwan	തൂക്കിയിടുക
cwok	ഞെട്ടുക
hdok	ഡ്രൈവിംഗ്
crun	നിധി
hzik	വിത്ത്
hrot	ഭൂതകാലംസമീപകാല
hket	ഉണരുക
hcek	മരസാമഗികള്
hrop	കയര്
mrac	സാഹസികത
byit	ഉത്സവം
trak	വാർഷിക
hzin	തെക്കൻ
sric	ചടങ്ങിൽ
clik	വേട്ടയാടൽ
trap	ഉദാരമായ
hrim	ക്രിസ്തുമസ്
hrus	രാജകുമാരി
blat	ബലിപീഠം
cyon	തീരെച്ചെറിയ
hwep	വെബ്
krat	കർദ്ദിനാൾ
tris	പർപ്പിൾ
kcot	കൂട്ടിച്ചേർക്കും
hben	തിരഞ്ഞെടുപ്പ്
trik	മദ്യപിച്ച്
kfit	ലിഫ്റ്റ്
tcec	കൈമാറ്റം
nrik	കൃത്യമായലേഖനം
grat	ചക്രവർത്തി
dran	ഭരണകൂടം
hpen	മുമ്പ്
cluk	അവലക്ഷണമായ
nrac	നിര്ദോഷകരമായ
ryin	പരിശീലനം
hrun	ഉരുളുക
nwic	ഇഞ്ച്
slit	വെടിവയ്ക്കുക
gzat	മൾട്ടി
krot	മുകുളം
drit	താടി
hzis	വേര്പെടുത്തല്
hdap	പതിനെട്ടു
sris	ചരിത്രപരമായ
mrut	മൊത്ത
nyik	ചെളി
bran	വധു
drat	ആശയിക്കുക
djan	ഭീമൻ
glat	ലാളിത്യം
hpoc	ശരത്കാലം
pras	മറ
hgot	ശേഖരണം
tret	തിയേറ്റർ
tras	താരതമ്യത്തിന്
rwit	എതിരാളിയായ
hfon	രൂപപ്പെടുകയും
klot	കോച്ച്
hmum	നര്മ്മം
drac	വ്യവഹാരത്തിന്റെ
rwas	നോവൽ
tset	പതികാരം
hdot	പ്രകടനാത്മകമായdistal
ryut	അസൂയാലുവായ
hwon	ക്ഷണം
byat	ചുട്ടുകളഞ്ഞു
flac	ഫ്ലാഷ്
prot	ഛായാചിത്രം
crek	നിർദ്ദേശിക്കുന്നു
htok	സംഘർഷം
htop	ശാപം
prit	imprecativeമാനസികാവസ്ഥ
hces	നിസ്സഹായനായ
klup	ക്ലബ്ബ്
hnos	വെള്ളപ്പൊക്കം
dwin	സാധാരണത്വം
prin	ചക്രവാളം
mrit	assumptiveമാനസികാവസ്ഥ
tcoc	കിഴക്കാംതൂക്കായ
hcom	പൊരുത്തം
grit	ഇടി
tlot	കുട്ടിക്കാലം
hgik	കാല്മുട്ട്
hwes	അബോധാവസ്ഥയിൽ
hzac	പരസ്പര
hsec	സോഫ്റ്റ്വെയർ
tson	സ്ഥാപനങ്ങൾ
ryit	രസീത്
dlin	അച്ചടക്കം
slip	തെന്നുക
klon	വിപ്ളവം
hfim	കൃഷിക്കാരന്
hpom	വേദി
cyen	വിദ്യാർത്ഥി
hgec	ഗുഹ
hroc	പാരമ്പര്യം
srac	submit
ryat	ദുരന്തം
kcen	കന്യക
hbap	വിടവാങ്ങല്
krik	വിമർശനം
krap	പരുത്തി
fwat	ആശുപത്രി
kcet	വാടക
hgas	വാതകം
pfin	അനിവാര്യമായ
dlit	ഇല
ryan	വിവർത്തനം
sran	ശവസംസ്കാരം
mrin	മാവു
hram	കാല്പനികമായ
dlan	ഡോളർ
hzas	തമാശയും
hsos	പതിനാറ്
klen	കോളനി
gyin	ചിറക്
hsif	സിംഹം
cluc	വിവരമുള്ള
prip	ഒരുക്കം
hzut	മൂടല്മഞ്ഞ്
dwat	മരുന്ന്
krit	ഇടൂ
sras	പക്ഷിക്കൂട്
hses	പതിന്നാല്
brat	തടസ്സം
flat	ആസിഡ്
hjic	അതായത്
slic	ആയുധം
hbuc	ഉപയോക്താവ്
tron	ഓറഞ്ച്
byan	കുളി
hrif	ആദിമമായ
tlip	സ്ഥാപിക്കുക
blan	കൊട്ടയിൽ
kris	സെക്രട്ടറി
hyon	അതേസമയം
tren	ഇന്ന്
dlat	നാമവിശേഷണhodiernal
hzic	വിഷം
tfic	തോക്ക്
tlen	ടാലന്റ്
hlim	കാലാവസ്ഥ
dyat	ഇണയെ
kcon	വെളിപ്പെടുന്ന
dlac	കഴുകല്
krak	ഏറ്റുപറച്ചിൽ
hbas	അസംബന്ധം
hkec	കൽക്കരി
hrek	വീണ്ടെടുക്കുക
hkos	തോണി
hwif	വൈസ്
tric	താൽക്കാലിക
hdep	delimitativeവശം
mwak	മരത്തൂണ്
ksot	അസ്ഥി
hnoc	തിങ്കളാഴ്ച
nlas	ചൊവ്വാഴ്ച
brac	ബുധനാഴ്ച
frap	സംയുക്തമായ
pfit	പ്രതിനിധി
pcoc	കഴുക്കോല്
lyen	പഞ്ഞിനൂൽ
swak	മുങ്ങുക
pcen	പ്രസിഡന്റ്
brit	രക്തമയമായ
hwec	ഉപരോധം
hwet	വയറ്
hlos	മുകള്ത്തട്ടിലേക്ക്
hbon	നിറുത്തലാക്കുകയും
pcon	താമ്രം
hsem	പരകോടി
lwac	വിലകുറഞ്ഞ
tsos	മത്സരം
kwen	എക്സ്ക്ലൂസീവ്വ്യക്തി
trun	താഴെയിറങ്ങുക
trut	പ്രതിമ
hrap	പീരങ്കിപ്പട
hgap	അറസ്റ്റ്
trot	താപനില
grin	അയല്പക്കം
hjak	പുണരുക
hpek	കെട്ടാക്കുക
hlus	മാന്
hwos	കിടപ്പറ
tsuc	കുറ്റിക്കാട്
pcuc	വിടുതലാക്കുക
cris	അവകാശി
clun	ഓക്ക്
hpes	അസുഖകരമായ
nlet	അപൂര്ണ്ണമായ
hrom	പ്രോഗ്രാം
pyon	പിയാനോ
swet	പേരിപ്പിക്കുക
dric	അദൃശ്യനായ
tyen	നന്നായിഅറിയപ്പെടുന്ന
hruk	ക്രൂരത
frat	നിയോഗിച്ചിട്ടുള്ള
hyoc	പ്രലോഭനങ്ങൾ
hlep	telicവശം
nrot	അന്താരാഷ്ട്ര
nret	ഉഗ്രമായി
hfif	തത്ത്വചിന്തകൻ
pfic	പതിപാദനം
hmek	സെൻസിറ്റീവ്
hfec	ക്ഷേമ
myik	മീൻ
truc	മോഷ്ടിക്കാൻ
tcop	അധരം
rwic	വിരമിക്കുക
htom	സമ്പദ്
glan	ഗാലറി
pren	സമാന്തരമായ
hlek	atelicവശം
nrak	ഭൂഖണ്ഡം
truk	മുട്ടുക
hjim	prohibitiveമാനസികാവസ്ഥ
rwat	ടൈ
hcep	കോശം
dyan	മുട്ട
jrat	കൃതിമമായ
nren	പ്രചോദനം
ksic	പ്രതിസന്ധി
tsoc	തിരച്ചില്
lwan	ഉച്ചഭക്ഷണം
hpos	ദേവദാരു
hcuf	തള്ളുക
tcus	അപേക്ഷിക്കുക
pset	നീട്ടുക
hkep	ചെമ്പ്
swis	നാവികന്
prim	സാമാജപരമായ
trip	പഹരിക്കുക
cras	ഷർട്ട്
swap	അടിച്ചുവാരുക
syet	ബാഹരേഖാചിതം
htof	കള്ളന്
clen	ചാനൽ
kwit	വ്യക്തിത്വം
klok	അധിക
hrok	പുനഃസംഘടന
hguc	ദാഹം
kcim	ഭീഷണിപ്പെടുത്തിയ
hpem	പന
psik	സ്പീക്കർ
frit	ഉമ്മറം
cret	ട്രെയ്സുകൾ
mrak	കുന്തം
syen	സമ്മേളനം
tcup	നനവുള്ള
hyek	സഞ്ചാരി
trim	വെള്ളീയം
plak	പരാതി
hyok	കോൺ
hgam	പശു
hmok	അരയ്ക്കുക
jrac	ഭൂപടം
kloc	കുപ്പായക്കഴുത്ത്
gyit	കരുതിക്കൂട്ടി
hbip	ബിയർ
mlet	വെല്വെറ്റ്
lyap	ദുരുപയോഗം
cwen	ആട്ടിൻ
bwan	അനന്തരവന്
tses	പതിമൂന്ന്
jrit	ന്യായീകരിക്കാൻ
nlak	കയ്യെഴുത്തുപ്രതി
sron	യോദ്ധാവ്
cruc	വെള്ളിയാഴ്ച
broc	ഉരസുക
dlot	ഡൗൺലോഡ്
krim	ക്രീം
pric	പിച്ച്
prut	വവഹാരവിചാരകസമിതി
hgon	മരവിച്ച
sram	പദാനുപദമായി
pfot	കലം
hlot	ആസൂത്രിതമായ
djin	നാണയം
hlok	കുതിക്കുക
hpep	ആപ്പിൾ
hwot	പിരിച്ച
dlak	ചർച്ച
brik	സബ്സ്ക്രൈബുചെയ്യുന്നതിനും
nlis	ട്രാൻസ്ക്രൈബുചെയ്യാനായില്ല
hbet	പന്തയം
pris	വൈറസ്
hjik	ആതിഥം
blit	ബാലിശമായ
hjap	മേലങ്കി
tfik	ചിന്തിക്കുന്ന
hdaf	നേടാനാവില്ല
hpop	സംഗീതനാടകം
kcaf	ഒളിഞ്ഞിരിക്കുന്നത്
kcoc	കൈമുട്ട്
hrum	കേടുപാടുതീര്ക്കുക
cyim	സംശയാസ്പദമായ
dyic	വിദ്യാഭ്യാസ
hgoc	കുഴി
drak	അവവസ്ഥ
plas	കരഘോഷം
byin	ബൈനറി
hzap	ആശ്രമത്തിൽ
nlot	കൂറ്
mrik	യന്തസംബന്ധമായ
hsop	വിജയകരമായി
crap	കെണി
kyek	കേയ്ക്ക്
nrut	വിനോദിപ്പിക്കുക
syes	സാർ
hjet	പതിനേഴ്
hjen	സ്തൈണം
hmom	തേന്
hdec	നിര്ഭാഗവശാല്
lwen	ഇതിഹാസം
slot	ചൂള
frac	വിമത
gwan	വീങ്ങുക
mruk	മെച്ചപ്പെടുത്തുക
swot	ചതുപ്പുനിലം
zlan	നേടാൻ
hnem	ആനിമേറ്റഡ്
hdes	മരുന്നുചെയ്യല്
prak	മതപസസംഗംനടത്തുക
frin	പകൃതിദൃശം
hfet	എതിർക്കാനും
cros	ഗായകസംഘം
ryon	യുക്തിയുക്തമായ
tcos	വിള
tsen	നടപടി
hwek	ചെന്നായ
nlik	നിരസനം
klap	പരവതാനി
dras	വെറുക്കുക
prop	സമൃദ്ധമായ
slim	ചൂളമടിക്കുക
hgis	ചീസ്
krut	കടിക്കുക
srot	തുണപോവുക
bjan	ചുറ്റിത്തിരിയുക
nwen	കപ്പല്വൂഹം
myas	പൊയ്മുഖം
kwaf	വികസിപ്പിക്കുക
twis	വാടകവണ്ടി
pcip	പെന്സില്
srap	പച്ചക്കറി
sren	പദര്ശിപ്പിക്കുക
tlun	നീണ്ടകാല്ച്ചട്ട
hrup	അഴിമതി
nrip	മന്ത്രിസഭാ
srup	സൂപ്പ്
jran	സര്ജന്
bjat	അനുമതിനല്കുക
gyat	ചാരൻ
hlem	സാഹസികമായ
srak	വേര്പെട്ടുനില്ക്കുന്ന
kson	സരഭാരം
cwis	വ്യാഴാഴ്ച
sret	ആത്മാര്ത്ഥതയോടെ
hraf	ട്രാഫിക്
hres	വാസ്തുവിദ്യ
hsuf	തീർപ്പ്
rwak	പിളര്പ്പ്
twon	ആഭരണം
hfus	വീണ്ടെടുക്കൽ
hkom	കോഡ്
djat	വേട്ടക്കാരന്
nlut	വാർത്താക്കുറിപ്പ്
hsef	പാമ്പ്
mris	ജനാധിപത്യം
bric	ബാറ്ററി
mlam	മെഴുക്
zran	പങ്കിടുന്നു
cron	സന്തോഷം
hzen	നീന്തുക
traf	സ്ട്രിപ്പ്
cwaf	കവര്
srip	സിഗരട്ട്
mrot	യന്തവാഹനം
swon	സദ്ധന്നസേവിക
ryak	പ്രതികരണത്തിലൂടെ
pfun	ഭാഗികമായും
blac	ബാഗ്
mret	മന്ത്രാലയം
hjon	ലൈംഗികമായ
kcok	കോടാലി
dram	വജം
kren	ഏകാന്തരക്രമത്തിൽ
tcek	പതിധനി
hdif	ഐഡന്റിറ്റി
tfas	സ്ഥാനപതി
hfot	ഉള്ക്കൊള്ളുക
lwas	മടിയനായ
hmep	momentaneവശം
kfin	എൻകോഡിംഗ്
mwin	സാങ്കല്പികമായ
hrem	കിരണം
pram	മലകയറ്റം
byac	നിലവറ
mren	അവിസ്മരണീയമായ
swen	സെനറ്റ്
kras	ശവപ്പെട്ടി
hgun	വിഴുങ്ങാൻ
nlok	ഭോഗാസക്തി
ryic	കാർഷിക
gwin	ഊഞ്ഞാലാടുക
srut	പുല്ത്തകിടി
hkes	സമുച്ചയം
hfis	രാജി
frak	ആവർത്തിച്ച്
hnom	ഗൂഢാലോചന
hcop	പൊതുമദശാല
hlec	കുരുമുളക്
mlot	മാധുരമായ
zrat	സ്ഥാനാര്ഥി
proc	രക്ഷാധികാരിയായി
flik	കുറുക്കന്
cyet	ഖേദം
hgim	ചിമ്മിനി
slet	കുറ്റിച്ചെടി
tcok	കൃതത
bjit	മുൻമരിച്ചത്
brot	മൊട്ട്
bwat	കരിന്വടം
hdus	പന്നി
gwat	ആനക്കൊമ്പ്
kret	സത്തിൽ
nwet	നിരീക്ഷകൻ
jwan	നടവഴി
nwis	നഖം
mwic	തേനീച്ച
bzat	നടൻ
gyan	വിയര്പ്പ്
zyit	എക്സിക്യൂട്ടീവ്
blic	മിഥാബോധം
pcet	അനിശ്ചിതത്വം
tsot	മടക്കുക
bwit	അതിർത്തി
tres	സമ്മര്ദ്ദം
hkof	ഉപഭോഗം
nyen	ആര്ത്തനാദം
hles	സദൃശമായിരിക്കുക
cyek	ചാക്ക്
hjis	സൂചി
gjan	പ്രതിഭാസം
prec	പെരുമാറുക
drot	നിയന്ത്രിതമായ
kcek	വളവ്
twic	കോഴി
brak	വീപ്പ
zwat	ഒൺലൈൻ
clap	ഒൺലൈൻവശം
tsec	വിദഗ്ധ
bwin	അതിസ്തുതിചെയ്യുക
cwet	അതിരുകള്
hbek	റൊട്ടിക്കാരന്
zlin	ഒലിവ്
mron	വാന്
drin	സമര്പ്പിക്കുക
psap	വെളിപ്പെടുത്തുക
gjin	ജന്മദിനം
clut	ചുറ്റിക
cwun	സുഗന്ധിയായ
twaf	പേജുകളുള്ള
pcot	വളര്ത്തുമൃഗം
krok	തലയോട്
dlik	നിയമനിര്മ്മാണസഭ
cwic	ഭാഗവശാല്
srun	മുഖംചുളിക്കുക
crec	നശിപ്പിക്കുന്ന
jlan	മാർജിൻ
kcip	ചാമ്പ്യൻ
blin	നൂറുകോടി
ryik	രാസവസ്തു
mlas	ഹൃദയത്തുടിപ്പ്
flit	പൈലറ്റ്
hzet	കുരുക്ക്
cwik	പ്രൗഢോജ്ജ്വലമായ
twet	പാവാട
mwik	പ്രതിവാര
tfis	സാങ്കേതികമായ
tlon	വാഹനം
cram	കപടമുള്ള
grac	ബലപ്പെടുത്തുക
kraf	കാക്ക
trup	ആട്രിബ്യൂട്ട്
hduk	കൊളുത്ത്
cruk	കടുവ
nrap	കാല്പൂർണിയയെപ്പോലെ
crot	ഹൈവേ
mlip	എന്നപേരിലുള്ള
hfoc	ഫോട്ടോഗാഫ്
nres	സമഗ്രത
plos	കൂടി
tfam	സുതാരമായ
nlic	പത്തൊന്പത്
hwok	യോഗമായ
nlen	ഉപന്യാസം
fyic	കാര്യക്ഷമത
hwuk	അതുല്യമായ
hgok	ജൈവ
flic	ദൈവശാസ്ത്രം
flot	ഒഴുകുക
hboc	എല്ലാസമയത്തും
hwoc	മന്തവാദിനി
syot	സ്റ്റുഡിയോ
cwip	ഷാംപെയിൻ
hbes	ബാനർ
lwic	വിവാഹമോചനം
blot	ബോൾട്
cwot	പ്രവാസികളെ
cwam	സിര
prik	നിഷ്കിയമായ
hfum	നുരയെ
grik	ചരല്ക്കല്ല്
zrin	പുറങ്കുപ്പായം
gren	ഗ്രഹം
hfuc	പുനരുത്ഥാനം
claf	ചുവരലമാര
flas	ആരാധകന്
hjot	ഉഷ്ണമേഖലയിലുള്ള
hbim	സേച്ഛാചാരിയായ
krek	മെർക്കുറി
hbec	ഷാജഹാനെ
tsaf	ആത്മഹത്യ
pwas	പറിച്ചെടുക്കുക
plot	ലേഖകന്
kfak	ചെലവഴിക്കുകയും
blak	മുകപ്പ്
hdos	കറ
kwis	ക്ലാസിക്
kcos	ബോധിപ്പിക്കുന്ന
psen	പെൻഷൻ
kres	കിയാപദം
hzon	കുരങ്ങ്
srim	കയ്യൊപ്പ്
glin	മനസ്സില്ലായ്മ
mlut	കുപസിദ്ധിയുള്ള
myot	ഇമ്പോർട്ട്
fwac	സ്ഥാപക
troc	പന്തം
hgaf	വാകരണം
hyop	കളിവള്ളം
ksip	വംശനാശം
sres	ഉല്ലാസയാത
hnup	താഴികക്കുടം
hzun	വഴങ്ങാത്ത
mric	മാംസപേശി
gjat	റിക്ടർ
hros	തടവുക
zrac	ഭീരുത്വം
tros	മൊരിക്കുക
myus	ചുണ്ടെലി
dwac	ഡയലോഗ്
byak	ആട്
htef	തുന്നല്ക്കാരന്
hfek	.ദൈവിക
dzan	ചുമത്തുന്നതു
nyon	പേരറിയാത്ത
zrit	ഔപചാരികമായരജിസ്റ്റർചെയ്യുക
pcos	സ്പോർട്സ്
hjec	ഉരുകുക
dlas	ഇല്ലാതാക്കുക
mras	കുട
mram	അയിര്
cwut	തല്ക്കാലികയുദ്ധവിരാമം
hbok	ഡക്ക്
swun	സോപ്പ്
dwak	പാവ
plif	വില്ല
slon	തയ്യൽ
tfut	അനുമോദിക്കുക
djac	രഞ്ജിപ്പുണ്ടാക്കണം
hjas	അടിച്ചമര്ത്തുക
kric	മുയൽ
kwot	മേല്നോട്ടക്കാരി
gzan	ഗ്യാരണ്ടി
clot	കളിക്കാരന്
ksek	പുഴു
psam	നില
mwut	മൂങ്ങ
htem	ശാശ്വതമായി
clon	വയലിന്
dzin	റസിഡന്റ്
rwim	യഥാക്രമം
hyof	പ്രയോജനകരമായ
dron	ഡ്രാഗൺ
dwit	ശ്രവണevidential
sroc	എക്സ്പോർട്ടുചെയ്യുന്നത്
hzot	അവസാനിപ്പിക്കല്
djik	കാരണമുള്ള
kfik	അടപ്പ്
ryun	നിയന്തിക്കല്
hmes	നഗരാധക്ഷന്
rwac	ഹാർഡ്വെയർ
sruk	സര്ക്കസ്
sros	ന്യൂനപക്ഷം
bzan	കമസമാധാനലംഘനം
kset	വാദസംഘം
bjon	ഉപ്പിട്ടുണക്കിയപന്നിയിറച്ചി
hjut	പരിമിതികളില്ലാത്ത
tfen	ന്യായീകരിച്ച്
zwac	അസൗകരം
dyin	ഓതികൊടുക്കേണ്ടതിനായി
myis	സംഗീതജ്ഞൻ
mlis	മാനസികമായി
pret	അപരാപ്തമായ
tsek	വാസ്തുശില്പി
hlom	ചെറുനാരങ്ങ
ksos	ചുമ
crok	തലവേദന
flin	ഫെർട്ടിലിറ്റി
mrun	ആശാരി
swec	വികലമായ
syuk	കരണ്ടി
blun	ബലൂണ്
tcep	ചോക്ക്
fric	ആശ്വാസം
rwik	ലംബമായ
rwen	തടയുന്നതും
flet	inferentialevidential
pfac	പ്രസാധകൻ
srek	വിനാഗിരി
tfun	തുരങ്കം
pwet	പദപശ്നം
gyik	ഗണിതശാസ്തം
fwot	മങ്ങുക
lwin	സമതുലിതമായ
jwin	കരള്
bwik	sublativeകേസ്
hdup	മുക്കുക
hnop	കുത്തക
bwic	അന്തര്വാഹിനി
ryen	പരിഗണിക്കാതെ
hcem	ഭൂമികുലുക്കം
hbos	പരീക്ഷണശാല
nrek	തൊഴിലാളിക്ക്
ryim	താളം
nyic	വാഖാനിക്കുക
dwas	നയതന്താലയം
rwok	കോപിപ്പിപ്പാൻ
kram	അശക്തി
ksim	പ്രസ്താവനമാനസികാവസ്ഥ
clok	ചോക്കലേറ്റ്
pcec	വിശേഷാധികാരമുള്ളതായി
nyis	തപസി
tyoc	യാദൃശ്ചികതം
grak	പോറല്
zlat	കയ്യുറ
hjuk	മുട്ടുകുത്തുക
trif	ഭൂമിശാസ്തം
djit	വവസ്ഥാനുസൃതമായ
pson	അജയ്യനായ
mwis	നിക്ഷേപം
cwec	വാക്കാലുള്ള
hdek	മതേതര
blik	കഴുകന്
sloc	മനഃശാസ്ത്രം
brap	സ്ക്രാപ്പ്
jlat	കടല്ക്കള്ളന്
dros	ഡോസ്
slam	സാൽമൺ
pwun	പുഡ്ഡിംഗ്
gwik	കാന്തിക
pcop	അടിച്ചുകയറ്റുക
myen	സമാനമായി
ksen	ഓക്സിജൻ
mrap	അയാളുടെ
tfot	സർട്ടിഫിക്കറ്റ്
ksus	ക്ലസ്റ്റർ
trok	വാചാടോപം
tloc	ഗ്രോത്ത്
zyan	തുഴ
nlun	ലോഗിൻ
hlop	ദൂരദര്ശിനി
jlin	അക്ഷരംവായിക്കല്
lyut	തെളിഞ്ഞ
hsof	സർഫ്
fyik	വിസ്കി
klet	ആപേക്ഷികത
hwof	വീതം
hlum	ഒട്ടകം
myet	കലാസക്തന്
klis	ഒറ്റപ്പെടുത്തല്
hbaf	ജീവചരിത്രം
gwac	കഴുത
hwum	കിംവദന്തി
pwik	കാഴ്ചപ്പാട്
pron	പ്രോ
myes	പ്രതിമാസ
mwen	reverie
kfic	വിശമകാലം
klek	ക്ലിക്കിൽ
cwon	ദീര്ഘവൃത്തമായ
lyak	ഇലാസ്റ്റിക്
kwon	നിഘണ്ടു
hjam	പന്നിത്തുട
rwon	മഴവില്ല്
crip	താഴെ
zwan	സംഭവിക്കുന്നതുപോലെ
srok	എഡിറ്റോറിയൽ
craf	സൈനികോദ്ധോഗസ്ഥന്
tlok	ടാങ്ക്
brip	ചിതശലഭം
tfap	ചാർട്ട്
jwat	ഇരട്ട
pros	ഓപ്പറേറ്റിങ്
psun	ദുശ്ശകുനമായി
clet	അരിഷ്ടത
hbus	മുള
dyas	ഡീലർ
klun	കൂന്വാരം
jlit	ഐകകണ്ഠ്യേന
hdom	പേടിസപ്നം
kron	കരി
hzam	ജാം
cyot	കേള്വിക്കാരി
hmem	കാഴ്ചബംഗ്ലാവ്
lwam	അക്ഷരമാല
fras	ചിന്നിച്ചിതറുക
psoc	പഞ്ച്
hgum	ഗം
brek	ബ്രേക്ക്
glit	ഉറപ്പ്
frun	ചീയുക
gris	ആകമിക്കുന്ന
mroc	സംഘര്ഷം
bzit	ചിലന്തി
plut	ഉരുളക്കിഴങ്ങ്
glac	കൊതി
gzac	പെരുക്കുക
prun	നൂല്ക്കുക
jlet	പഞ്ചാംഗം
nyim	നോമിനേഷൻ
tlos	ട്രില്യൺ
slut	സാലഡ്
fwit	ഉറപ്പിക്കുന്നമാനസികാവസ്ഥ
pyen	പ്രയോഗങ്ങൾ
nlon	നാമമാത്ര
dren	വിശദീകരിക്കുക
drun	അസംതൃപ്തിയും
cyok	ത്രയംബകം
hfop	ഫുട്ബോൾ
ryac	കൂട്ടുകച്ചവടം
gzin	മുന്ഗാമി
hgip	കാബേജ്
tyet	അത്ലറ്റിക്
hdof	ideophone
hwup	വിലമതിക്കാനാവാത്ത
lwek	തുലനയന്തം
syec	സെനറ്ററായ
jyak	കൊള്ളിക്കുക
mlim	ഉറുന്വ്
fwic	ഫലപ്രദമായി
gzit	ഗര്ഭിണിയായ
blas	റിലയൻസ്
jrin	എല്ലാദിവസവും
gwak	കണങ്കാല്
drik	ശിവറാം
prif	വേരിയബിൾ
jwit	വൈവിധ്യം
krip	വിവേചനം
ryot	ഗീതാലാപനമാണ്
nwut	വക്കുവഴികള്
kcif	സജീവമായി
jrak	തവള
twek	exessiveകേസ്
psot	പ്രായശ്ചിത്തം
pfon	സ്പഞ്ച്
sluk	അണ്ണാന്
nlim	irrealisമാനസികാവസ്ഥ
ksaf	ക്ഷാമ
glak	അഗ്നിപര്വ്വതം
plen	സന്തുലിതത്വം
kfaf	കവണി
kyon	ചൂഷണം
jlik	ഭൂമിശാസ്ത്ര
psop	പാസ്പോര്ട്ട്
kfis	ഒഴിവ്
fyon	സംബന്ധം
nram	ദുര്മാര്ഗിയായ
hbuk	ബിസ്ക്കറ്റ്
gras	വിവശത
hyos	വിവേകബുദ്ധിയുള്ള
flim	സിനിമ
plet	ടാബ്ലെറ്റ്
rwam	പരമാണു
blis	വാനില
zlit	എയ്ഡ്സ്
fyut	ഗദ്യശൈലിയുടെ
crim	പിരമിഡ്
hjif	നിയമവിരുദ്ധമായ
crif	ലജ്ജാശീലം
lwap	വീണയും
tyon	ജ്യോതിശാസ്ത്രം
mrim	സങ്കീർണ്ണമായ
drut	വിവരണാത്മക
nrim	പാണ്ഡിതം
kruc	കടലാമ
kwam	ഉപദേഷ്ടാവ്
jrik	ക്രിക്കറ്റ്
dlut	എസില്
pyot	പ്രാവ്
dyon	അനുകൂലനം
prap	ഓപ്പറേറ്റർ
bzin	മുദ
tyek	തികോണം
trec	ട്രഷറർ
nron	ഹൈഡ്രജൻ
pyet	പ്രിന്റർ
tsok	വീര്പ്പുമുട്ടുക
zyin	വിട്ടുമാറാത്ത
slek	സൈക്കിൾ
jyin	എഞ്ചിനീയറിംഗ്
ryas	സംപേഷണം
zrak	ഉന്മേഷംവീണ്ടെടുക്കുക
nyas	നര്ത്തകി
gric	മൈഗ്രേഷൻ
zlak	ലംഘിക്കുന്നതായി
tces	ടെന്നീസ്
hjun	കാറ്റുള്ള
twen	നെയ്യുക
kyet	കലക്ടർ
gwit	നട്ടെല്ല്
kyot	ശബ്ദവലയം
fwin	ആവൃത്തി
tfuc	ലൂം
dlet	ഡയറക്ടറി
pfik	ചിന്തകനും
bjet	ബജറ്റ്
trek	കൗശലം
kros	ക്വാർട്സ്
gjit	കതിക
gwic	മാറുക
frik	സൈദ്ധാന്തിക
tluc	തൂവാല
pruc	പാറാവ്
glic	ഹിമപ്പരപ്പ്
krun	പൂർണത
bjin	പ്രവചന
tlaf	പങ്കെടുക്കുക
tfet	നിര്മ്മാതാവ്
bras	ലാറ്ററൽ
dwik	എതൃകക്ഷി
clec	ഉപയോഗിച്ചുതീരുക
cres	ചതുരംഗം
tcef	ചെറി
tcom	കാലിടറുക
nyot	വിവര്ത്തകന്
tyok	വണ്ടി
cyip	മറികടന്നത്
grot	കടുക്
bris	വയർലെസ്
nlam	ലേലം
slif	അരിപ്പ
hgos	തുരുന്വ്
swoc	ഇടറുന്ന
jyat	നിര്ദ്ധനന്
slum	ഇസ്ലാം
hjes	കാനേഷുമാരി
dzat	ജാർഡിൻ
slun	സസ്പെൻഡ്
nwot	തുടര്ച്ച
gyic	ഗിത്താര്
pfas	ബയസ്
zyik	പിച്ചള
blen	തിളങ്ങുന്ന
hyem	എൽമ്
hnep	തൃഷ്ണകളെ
nyut	ഊടയിലോ
ryam	സർവ്വനാമംമാർക്കർ
clim	സുഗന്ധദവം
jret	മൂര്ച്ച
tfon	കളിയാക്കുക
jwac	ജാവ
hrep	പാചകവിധി
dyac	ഫ്രാഞ്ചൈസി
myip	മീറ്റർ
rwis	വംശീയവും
hkem	ധൂമകേതു
nwon	പുതുമ
zwin	നിരോധനം
dyis	മധ്യകാല
mrec	കുരുവി
fyot	അടിക്കുറിപ്പ്
mlon	അളവ്
pfis	പതിമൂന്നാം
rwot	ഭ്രമണപഥത്തിൽ
hfok	ഒതുങ്ങി
glof	ഗോള്ഫ്
zron	പൂജ്യം
hzip	സിപ്പ്
hwom	വീടില്ലാത്ത
bjic	മണ്ണ്
pcim	നിറവേറ്റുക
hjip	ചിപ്പ്
bwac	കോട്ടുവായിടുക
mlos	പെരുച്ചാഴി
mrip	കളിമണ്പാതങ്ങള്
bron	ഭൂണം
ksoc	കുറയ്ക്കല്
cyum	യീസ്റ്റ്
jyan	സാങ്കേതികപദ
plim	പ്ലം
mwet	ശ്മശാനഭൂമി
ryet	ബിരുദധാരി
glik	ജലസേചനം
plap	മുതലാളി
tsif	ഇലാസ്തികത
gyak	സ്രാവ്
djon	സ്ഥിര
nwun	സമയനിഷ്ഠയുള്ള
cles	യാഥാര്ഥത
dris	കൂടുതലായി
hkef	കഫേ
blus	ആംബുലന്സ്
blap	ഭാണ്ഡം
bjak	താമസ്സസ്ഥലവുമായി
klim	ഗോഷ്ടിച്ചിരി
gyac	ശാസ്ത്രജ്ഞൻ
jyit	socio-
dzit	റിയലിസ്റ്റിക്
bwak	സ്മോക്കിംഗ്
dyot	റേഡിയോ
bwon	അമര
fris	അനൗപചാരികമായ
klut	ഊഹിക്കുക
tfek	സ്റ്റീക്ക്
nrok	നൈട്രജൻ
zyat	കത്തി
bram	ജപിക്കുകയും
ryis	ആമുഖ
nlip	വിശകലനംചെയ്യുക
nros	വ്യത്യസ്ഥമാക്കുന്നു
hcof	വസ്തമഴിക്കുക
tfif	പോത്സാഹകമായ
kroc	കയറിട്ടു
hdum	ജൂദായിസം
pses	സീകരിക്കുന്നവള്
plok	പരിപൂരകമാണ്
lyet	ലെന്സ്
pwek	pegativeകേസ്
kfas	കാൻസർ
pwen	കാലാൾ
nrun	ഓർമ്മപ്പെടുത്തൽ
clek	ചോര്ച്ച
pcif	പരിരക്ഷകൾ
glas	സങ്കീർണ്ണതാ
zwit	ക്ഷമയറ്റ
kces	സമൃദ്ധിയുടെ
crem	റീട്ടെയിൽ
grap	പിടിച്ചുപറിക്കുക
kwip	ഇടപെടുക
dyut	കുറഞ്ഞ
crus	അധികാരശ്രേണി
gyet	ജേഡ്
gram	snarl
kyip	ഗൗളി
nyet	പാഡ്
crop	വെള്ളച്ചാട്ടം
glon	വീണേനെ
mrok	കൊതുക്
fluc	ഒഴുകുന്ന
dwic	വതിചലനം
slec	പരവേക്ഷകന്
srec	കാലഹരണപ്പെടുന്ന
blut	wrestle
myok	മൊസൈക്ക്
tlek	പ്ളഗ്
nruk	സാംകമികമായ
nwoc	ഇനി
bjut	വക്രമായിരിക്കാൻ
hges	ഗര്ഭം
twoc	പലചരക്ക്
kyos	കമ്മ്യൂണിസ്റ്റ്
mrek	അന്വരപ്പിക്കുക
clip	contrition
pwok	prosecutiveകേസ്
dwot	ഏകാധിപതി
zyac	ചിന്ത
jlic	സാറ്റലൈറ്റ്
slop	സ്ളീപ്പര്
ryip	അനുപാതത്തിലായിരിക്കും
psim	ഏകദേശമായ
byet	തൊഴിലില്ലാത്ത
cyop	ഹോബി
rwun	മാനദണ്ഡം
blop	ബൾബ്
syok	സഹായിയെയും
klos	ക്ലോറിൻ
lwot	ക്ലോറൈഡ്
byic	ബാക്ടീരിയ
lyik	പശിമയുള്ള
blok	ജീവശാസ്ത്രപരമായ
jlac	നടിക്കുന്ന
bret	ബൈറ്റ്
krif	secretion
blet	ബാലെ
nruc	മൂത്രം
tsus	വെളുത്തുള്ളി
dyak	മധ്യവർഗം
tcem	പുഷ്പങ്ങൾ
cyoc	വെല്ലുവിളിനിറഞ്ഞ
trep	സ്ട്രോബെറി
dlun	അശുദ്ധമാക്കല്
hlup	ആൽബം
hbep	ബേസ്ബോൾ
praf	പൈറസി
pwis	രൂപവും
grek	ഗാരേജ്
kruk	താങ്ങുവടി
hfof	ഫോസ്ഫറസ്
rwut	ഘടനാപരമായ
myam	കളരി
krec	കൊക്ക്
jras	കരാറുകാരൻ
zrik	അറിയിക്കില്ല
blam	ബോൾറൂം
klip	artisan
hwef	അടയ്ക്കാത്ത
zlac	വാഴപ്പഴം
gret	വൈദുതോല്പാദനയന്തം
lwuk	വാരിയെല്ല്
nyek	നിക്കൽ
blos	ബസ്
sles	ഗുണദോഷപരിശോധകന്
tlif	ടൈൽ
kses	സോസേജ്
mwot	തക്കാളി
lyot	ഓട്ടോ
tsom	പൊട്ടാസ്യം
brut	വെർച്വൽ
djap	ബീജഗണിതം
hjok	ജനറിക്
kfen	സങ്കല്പങ്ങൾ
pcok	കാഴ്ചയെസംബന്ധിച്ച
bzut	ജഗതിയുടെ
syek	തൊഴിലില്ലായ്മ
mruc	ചിതശലഭപ്പുഴു
bwas	ബ്രൗസർ
klif	കാൽസ്യം
rwet	വിദൂരഭൂതകാലവുംനാമവിശേഷണ
srif	നാമവിശേഷണചരിത്ര
hwem	സ്പെക്ട്രം
syom	സോഡിയം
tyos	ടസ്റ്റി
jyic	ബന്ധി
hguk	പാവയ്ക്ക
dwun	ചുളുക്ക്
swip	കതിരിലും
tlec	ചെള്ള്
blaf	ബലാത്സംഗം
tsem	നിരീശരമതം
mloc	നിരന്തരംനിരീക്ഷിക്കുക
gyot	സോപാധികമായ
trop	അന്വേഷണം
rwap	ത്രൈമാസ
hjep	ലിംഗഭേദം
pyim	പ്ലാറ്റിനം
dlon	ഡ്യുവൽനമ്പർ
pcep	ശാസകോശം
twuk	എച്ചിലും
tyec	ടാഗ്
syup	സൂപ്പർ
trom	ട്രോളി
nyip	പ്രാദേശികമായി
glis	ഗാസോലിന്
gjik	വൃക്ക
hjos	ശ്രദ്ധിക്കപ്പെടാത്ത
hjuc	കൊള്ള
swek	അനുഷ
psek	ആർസെനിക്
twok	സ്റ്റാറ്റിസ്റ്റിക്കൽ
tsep	പുല്ച്ചാടി
slos	സ്ഥിതിസമതവാദി
nwim	സെൻസറിevidentialമാനസികാവസ്ഥ
tlop	മേശവിരി
trus	വിവാദ
pwot	ധനികവർഗ്ഗത്തിന്റെ
djot	ഊറല്
nloc	അവഹേളനം
mwon	മാൻഡറിൻ
hjek	ജോക്കി
crom	സഹകരിക്കുക
myon	നൂമോണിയ
twec	പ്രദേശത്തുള്ള
ryek	വാണം
dlic	ലാഭവിഹിതം
kwet	സ്കേറ്റ്
bwen	ഒഴിയാബാധ
plon	അലോട്ട്മെന്റ്
syon	പാൻറ്
djis	ഡിജിറ്റൽ
byut	പെണ്പട്ടി
hyep	കണ്പോള
dwon	ഡയഗണൽ
byis	ഉപബോധമനസ്സ്
brec	പുരികം
cyec	തുമ്മുക
hwop	വാട്ട്
clus	നിലനില്ക്കുകയും
kfun	ആക്യുപെന്സീ
nwum	ഹിന്ദുമതം
fyim	അഭയാര്ത്ഥി
cwos	ഷട്ടിൽ
tfoc	twinge
pwon	പ്രോട്ടീൻ
sraf	സ്വയംതൃപ്തി
hbom	ഛര്ദ്ദിക്കുക
gyen	ജീൻ
drim	.സാബ്രിയും
trem	accoutrements
tsup	തകര്ക്കുക
slok	സോഷ്യോളജി
kwoc	സ്ക്വാഷ്
bwam	വോട്ടർ
mlok	ചലനക്ഷമത
kyen	റീജിയണൽ
hmop	മോഷൻകയറ്റത്തിൽ
rwek	മുന്കാല
kfup	ക്യൂബ്
grok	കാരറ്റ്
drap	പിടിക്കും
lwis	മോളിക്കുലാർ
ksuc	കണക്കെഴുത്തുകാരന്
tsop	നാറ്റം
kyok	വെള്ളരിക്ക
nroc	orgy
jlot	ലായനിയായി
psof	ഫോസ്ഫേറ്റ്
hgif	ആകർഷിക്കുന്ന
kfim	ക്ഷാര
psos	വായാമവിദ
pfen	പരിശോധന
kcom	സാമ്പത്തികശാസ്ത്രജ്ഞനായ
krom	അര്ധവിരാമചിഹ്നം
tluk	കുതറിമാറാൻ
hyom	അയഡിന്
nwuc	ഇറക്കംചലനം
gjac	ഗര്ഭമലസല്
pcom	പാകമായ
dzic	ആലേഖകന്
grun	പരിചയപ്പെടുത്തുക
dzot	ദാതാവ്
hzek	മാംഗനീസ്
kfot	കീബോര്ഡ്
jlas	വിശ്വസനീയരല്ലാത്ത
lyim	എലൈറ്റ്
jyen	യെൻ
pcaf	പരാന്തിസിസ്
rwip	റഗ്ബി
blip	ബൈബിള്
kyoc	മാത്തു
lyon	വണം
flis	വിഭക്തി
nrif	nibble
kfam	ക്വാണ്ടം
swes	സെറ്റര്
lwon	പരിണാമ
drec	മുന്നിര
gjap	സ്പാ
lyec	ലീനിയർ
tyom	ആന്റിമണി
pwuk	superessiveകേസ്
flaf	ആൽഫ
myim	പതിരോധശക്തിയുള്ള
pcek	തട്ടിക്കൊണ്ടുപോകല്
bjac	വാറ്റുകേന്ദം
bzac	സംഗ്രഹിക്കൂ
bzak	സോക്ക്
twes	ടെലിവിഷൻ
dwut	ഡോക്യുമെന്ററി
ksom	പ്രപഞ്ചത്തിന്റെ
lyis	വനശാസ്തം
lwim	അലുമിനിയംലോഹം
ksok	അവര്ക്കു
sruc	വേഗത്തിലാക്കാൻ
dlif	കടല്പ്പന്നി
byik	കൊലയാളി
tfec	സ്റ്റേഷനറി
hjaf	സസ്തനജീവി
ryok	പ്രോട്ടോക്കോൾ
dwis	ഡൈ
jlon	കോളൻ
brus	ഉദോഗസ്ഥമേധാവിത്തം
gjak	ഗാലക്സി
lyip	ചികിത്സാലയപരമായ
ryem	റേഡിയം
href	നേരിയതാണ്
prok	റഫിജറേറ്റര്
slep	സറ്റൈറിനെ
dret	ആവർത്തനം
kluk	പുരാവസ്തു
dlis	idiosyncrasy
kfip	അസ്വീകാര്യമായ
mlec	തിരുമ്മുക
pfif	സ്പെസിഫിക്കേഷൻ
nrec	സെൻസറി
pfet	ലേഖയിൽ
hzoc	.ബഹ്റൈനില്
dlam	എബൌട്ട്
nlec	നരവംശശാസ്ത്രം
kluc	രുചിയുള്ള
dyet	സെഡാൻ
tyif	സകർമ്മകം
krus	ശൈലിക്ക്
nluc	സൂര്യകാന്തി
lyun	അയൺ
zrot	കൈമാറൽ
ksif	തള്ളുകയാണ്
psif	മലിനീകരണ
crup	ഓവർലാപ്പ്
fret	ഫൈൻഡർ
grut	വിപരീതം
ksec	സഹപാഠിയുടെ
jric	യാതാപരിപാടി
mrop	കോളുകള്
srus	.പഞ്ചിമ
gyas	ക്ഷുരകന്
floc	നാട്ടറിവ്
plek	ശ്വാസകോശത്തിൽ
nwop	നിതംബം
nrom	കണ്ട്രോളർ
twos	തീവ്രവാദം
lwok	മുദ്രാവാക്യം
dwet	അധികസമയം
slem	ഉത്പതനത്തിന്
grip	വരട്ടുക
gwas	വൗ
kwok	കൊബാൾട്ട്
gwon	ഓട്സ്
hdop	upriverചലനം
glam	ഗുദം
bwot	ദിവ്യമായിക്കാണുന്നതിലാണു്
bren	മലവിസർജ്ജനം
byot	വീഡിയോ
bjik	വിലക്കിനു
kwim	പശ്നോത്തരി
cwek	ഹോക്കി
grif	ഗറില്ലാ
hgem	മഗ്നീഷ്യം
hyes	അവബോധം
fram	ഔഷധകിയവിദ
nwos	unambitious
ryap	പുനകമീകരിക്കുക
cwim	വിശ്വാസ്യത
klep	kelp
psec	പരിഹാരംകൊടുക്കുക
djic	ലോകവ്യാപകമായി
kfut	കർഫ്യു
crep	പെണ്കുട്ടിയുടെ
frim	സിദ്ധാന്തം
gjas	കത്തിക്കുക
hdef	ഡെബിറ്റ്
ryum	യുറേനിയം
pluk	തിട്ടപ്പെടുത്തുക
krop	ഏകീകരിക്കുക
nraf	ദായകരുടെ
tyes	ഇന്റഗ്രേറ്റഡ്
plip	ചകിരിയാക്കി
hgom	ഗാമ
hgus	ഗുണക
cwuc	ചൂടാക്കാനുള്ളഉപകരണം
zret	കുറയ്ക്കുക
nles	വിദഗ്ദനായ
trof	അകർമ്മകമായ
hmof	മാൾ
hzim	ആന്റിമണിയോ
dzac	ഭോജനശാല
psok	തപാല്കാര്ഡ്
blon	സമ്പൂര്ണ്ണമായ
djet	വെയില്
ksum	പങ്കുകാരന്
mrup	microbe
clif	ഹെലിക്സ്
cloc	morphological
tfes	കേറ്ററർ
gjis	ജീൻസ്
jren	വിന്യാസം
tlep	ഡാറ്റാബേസ്
kcup	കൂപ്പൺ
glot	വോൾട്ടേജ്
glut	കണക്കുകൂട്ടല്യന്തം
srep	സൈബർ
nwes	നിക്ഷേപകന്
ksef	എക്സ്കിരണം
bzis	വിസ
frut	ഇൻഫ്രാസ്ട്രക്ചർ
nyuk	Firefly
dyik	ഡിറ്റക്ടർ
plec	Splice
brom	ബ്രോമിൻ
plop	പലേഡിയം
zlik	സിലിക്കൺ
flut	വോള്ട്ട്
ksop	കോസ്മെറ്റിക്
gjun	ചമയം
kfok	ഏന്വക്കം
hpof	പോപ്പ്കോൺ
hzuk	മൃഗശാല
nyoc	ദുരർത്ഥമാണുള്ളത്
jwak	യോഗ
brim	ബേരിയം
kles	ബന്ധിക്കുക
mwam	ഭാവാഭിനയം
fwik	പടക്കം
djas	ജാസ്
dyim	ഓഡിയോ
tsum	ടങ്ങ്സ്റ്റണ്
drip	dribble
lyaf	ജീവനാംശം
prom	പ്രോഗ്രാമർ
nrup	ഇൻപുട്ട്
hfes	റിഫ്ലെക്സീവ്
rwaf	രക്തനെല്ലി
dlen	ഡോക്യുമെന്റേഷൻ
byas	വാക്സിന്
fron	ഹീറോയിന്
dluk	വേര്പ്പെടുത്തുക
dyun	രോഗംനിര്ണയിക്കുക
flap	ഫോൾഡർ
kfet	കാഥോഡ്
dlim	പ്രത്യയശാസ്ത്രം
prek	പാർക്കിങ്
syoc	സ്നാപ്പ്ഷോട്ട്
slus	പ്രവേശനക്ഷമത
nlos	anticlimax
mlen	സെലീനിയം
pres	കോർട്ടെക്സ്
hlof	സൾഫർ
nlek	നിലവിലെപ്രസക്തിമാർക്കർ
gwot	വിമാനത്താവളം
mwip	സത്യത
klop	പാറ്റ
kwom	ക്രോമിയം
hl6t	ലിറ്ററിന്
nwec	രണ്ടേ
glip	ചാക്രിക
nrop	ശന്വളപ്പട്ടിക
crum	ഹോർമോൺ
dlep	ഡെവലപ്പർ
frot	perforate
bwoc	അട്ടിമറി
fwis	ഫെമിനിസ്റ്റ്
djok	.സമ്മിശ്രസംഖ്യാഗണ
draf	ആധുനീകരിക്കുക
trum	തീവ്ര
graf	അൽഗോരിതം
lwes	ലേസർ
mlem	മില്ലിമീറ്റർ
flen	ഫ്ളക്സ്
zlot	ആനോഡ്
swok	നമസ്ക്കാരം
klec	നായക്ഷീണിതനാണ്
pwim	ഭാഗികസമയം
htuf	കള്ളച്ചെടി
fyis	ശുദ്ധീകരണശാല
lwet	സൂക്ഷ്മസംവേദനശക്തി
mrem	മെയിൻഫ്രെയിം
jwic	വത്തമാനകാലം
droc	demonstrator
clem	ഹീലിയം
dzik	രണ്ടുഭാഷകളിലുള്ള
psem	പ്ലാസ്മ
hjom	ക്രോമസോം
rwuc	ORDINAL
tyus	പൂർണ്ണസംഖ്യ
klom	കിലോമീറ്റര്
hfos	ഫാക്സ്
nwek	ജനിതക
jrap	സ്കൂഡൈവര്
zwas	വിശപ്പു
bwok	ബ്രോക്കോളി
dwap	അഡാപ്റ്റർ
syem	സ്പാം
blek	വെക്റ്റർ
tlus	തന്ത്രം
pyif	വ്യക്തമാക്കാതെ
cwoc	ശരിയാകും
mrep	ampere
hbem	വിറ്റാമിന്
hxan	കാവൽക്കാരൻ
hxut	സഹായധനംനല്കുക
hk6m	കാഡ്മിയം
hxin	simultaneity
txin	ടൈറ്റാനിയം
kxin	കിലോ
klum	copulate
xlis	മണൽഘടികാരവും
hqak	വായനാനുഭവം
hxat	ക്രിയാത്മകതയും
hxik	ഇപുസ്തകം
hxas	ജോലിസ്ഥലത്ത്
bxon	ബോറോൺ
dxin	inductance
hxit	ഹെലിക്കോപ്റ്റര്
tlum	കരുതപ്പെടുന്നു
txit	സമയപരിധി
kxat	ഓക്സീകരിക്കപ്പെടുന്നു
hvik	അണിനിരത്തുക
nluk	അനലോഗ്
nyem	സെന്റീമീറ്റര്
hm6t	മൊളിബ്ഡെനം
hl6m	ലിഥിയം
ht6t	മൾട്ടിമീഡിയ
xlit	താപമാത
ryop	യന്തമനുഷന്
pxas	ഔഷധവാപാരി
hxak	ഹോംവർക്ക്
lwif	locative
grim	ലോഗരിതം
hqat	മാന്റിസ്
qlit	പരിസ്ഥിതിവിജ്ഞാനം
xlik	sophisticate
mlep	ടെംപ്ലേറ്റ്
hqit	റേഡിയോആക്ടിവിറ്റിയുമായി
kxim	കിലോഗ്രാം
hxen	കുണുങ്ങി
hxot	അചഛന്
kyif	കോപ്പിയർ
fwet	ഫ്രീവെയർ
txet	ഉപഗണം
hs6n	തുടർച്ചയായ
hxet	ഒളിഞ്ഞുകേൾക്കുന്നു
xrat	മുടിവെട്ട്
hqan	impound
hr6t	ഇറിഡിയം
bxat	ബാൻഡ്വിഡ്ത്ത്
dxet	ഡെസ്ക്ടോപ്പ്
hxis	എക്സ്പൊണൻഷ്യൽ
hxok	ആസ്ഥാനമായ
hxek	അസ്ഥാനത്ത്വെയ്ക്കുക
srem	സെറിയം
hp6t	partitive
pxik	partitiveകേസ്
kxet	കാസറ്റ്
pruk	സൂപ്പർമാർക്കറ്റ്
hvit	ചോറുവേണം
xlin	ഓഫ്ലൈൻ
frip	എൻക്രിപ്ഷൻ
hvep	overpay
hxon	സമന്വയിപ്പിക്കുക
kxit	maximize
hqin	സെമിനാര്
tr6n	സ്റ്റീരിയോ
ht6n	ഫാസ്റ്റ്നെർ
hvat	വരാനിരിക്കുന്ന
sl6s	സെൽഷ്യസ്
hn6n	നിയോൺ
ts6t	തൽസമയം
hvin	കഴിവുറ്റതാക്കാനും
pxat	ന്യൂസ്സ്റ്റാൻ
myoc	ഘടകം
ps6s	പാസ്ത
bwek	ബീഫ്കേസ്
dlok	ഡീലക്സ്
fraf	ഫയർവാൾ
hr6k	ചെപ്പേടു
txat	ഉച്ചഭക്ഷണസമയം
hqon	.പോട്ടേ
pxun	പ്ലൂട്ടോണിയം
ks6n	വർക്ക്സ്റ്റേഷൻ
slef	എസ്കലേറ്റർ
xrit	ലൈഫ്ഗാർഡ്
hvut	overcrowd
xrim	യ്ട്രിയം
hx6t	augmentative
hqum	ഉപയോക്തൃനാമം
hl6n	വിൽപനക്കാരുടെ
gron	ആർഗൺ
pxan	പ്രൊമോഷണൽ
hvac	ഡിഷ്വാഷർ
xlan	ആഗോളവൽക്കരണം
txon	തരംഗദൈർഘ്യം
xrik	പുനര്നിര്മ്മാണം
hxap	തോള്പെട്ടി
hxac	പുനരാരംഭിക്കുക
xyat	ഹെപ്പറ്റൈറ്റിസ്
cwep	ശമ്പളം
hxos	ടോറസ്
txif	ടൈപ്പ്ഫേസ്
qlat	റിയൽ
txot	മിഡ്ശരത്കാലം
hxam	സർകലാശാലയിൽ
pxis	പിക്സൽ
pwif	പ്രിവ്യൂ
txam	ടാന്ടലം
myek	thermodynamic
hbop	ബ്രേക്ക്ഇൻ
hqot	സങ്കര
xlic	വീല്ചെയര്
gxit	വംശഹത്യ
hvan	അഗ്നിശമനം
glim	ഗാലിയം
pfop	പൊന്തിവരിക
hzum	സിർക്കോണിയത്തിന്റെ
xlon	ഹോട്ട്ലൈൻ
qlin	രേഖീയമല്ലാത്തതിനാൽ
kxam	സ്കാൻഡിയം
blim	ബെറിലിയം
kxik	കോൺഫിഗർ
nr6n	ന്യൂറോൺ
hpef	predicative
hruf	റൂട്ടർ
kxan	ഫാക്റ്റോറിയൽ
hxic	മാർഗരേഖ
xlip	വോളിബോൾ
dyek	ഡീബഗ്
hxop	വാച്ച്
qrot	ന്യൂട്രോൺ
nwip	നയോബിയത്തിന്റെയും
hs6t	റെസ്റ്റ്റൂം
grem	ജെർമേനിയം
tles	മെറ്റലോയ്ഡ്
hp6k	prolativeകേസ്
qyin	ജൈവവൈവിധ്യം
txak	രോഗനാശിനി
mlun	പേശീസംയുക്തകോശങ്ങളോ
txan	ആക്ടീനിയം
xran	ബഹിരാകാശയാതികന്
dres	decompress
tr6t	അന്യഗ്രഹ
hk6t	ഒക്ടെറ്റ്
hxus	ഓപ്പൺസോഴ്സ്
xlat	crackpot
mraf	മാരത്തൺ
ts6n	മിഡ്സ്പ്രിംഗ്
ht6s	ഓട്ടിസം
nlif	അയണീകരിക്കുന്നതിലാൽ
txut	ശ്രദ്ധേയത
hm6n	എമിറ്റിങ്
kxis	ക്ലിപ്പ്ആർട്ട്
xrin	വിധേയമായ
xren	റീഡയറക്ട്
bxak	ബുക്ക്മാർക്ക്
pfos	പ്രോപദപ്രയോഗം
hvis	മലവും
hd6n	ഛേദംഏറ്റുവംകൂടുതല്
brum	boardroom
hqis	സങ്കുചിത
hk6n	സമാഹരിക്കുക
xyit	ഷിഫ്റ്റ്കീ
xyin	ഒരുനിമിഷം
hxun	കീഴൊതുങ്ങിയിരിക്കുന്നു
hvas	റോളുകൾ
glok	ബ്ലോഗ്
hvak	പക്ഷെഅവള്
pxit	IPവിലാസം
hvet	അടുത്തതായി
xram	safflower
hc6n	obviousness
qran	ഖുര്ആന്
zyen	സിനോൺ
hqas	ഉറപ്പിച്ചു
bzas	blase
hj6n	നോൺമനുഷ്യ
hnof	nonremittal
txas	നിർമാതാക്കൾ
hbum	ബുദ്ധമതം
ts6s	വഴക്കോ
pxin	ചേരുവകൾ
hr6n	ക്ലിപ്തഓഹരി
hxim	മിഡ്സമ്മർ
dxit	മിഡ്ശീതകാലം
hxaf	കുഴിക്കുക
nlus	houseplant
txap	സ്റ്റാറ്റസ്ബാർ
vrit	ഒരാൾ
kxak	ചുറ്റുംകഷ്ടപ്പെടുന്ന
bxin	മനുഷ്യശരീരം
hqik	മാങ്ങക്കും
hxes	ശബ്ദത്തിന്റെ
hxif	hypnothize
xras	മണിക്കൂര്തോറും
pl6k	പോളിഡിപ്ലോമക്ക്
dxat	ഒരുഭരണി
hxip	ആന്റീബോഡിയും
vrat	വസ്ത്രത്തിനു
hqek	reshaping
qrit	അദേഹത്തെ
pxot	പോസ്റ്റ്ഓഫീസ്
hxom	ജെങ്ക്മെയില്
hqic	നിരൂപകൻ
lwun	നീലജീൻ
hp6n	maturation
dxan	അറ്റാച്ചുചെയ്യുന്നതിൽ
xrak	നടൻറോൾ
dxak	അപകടം
hven	കണ്ടെയ്നറുകൾ
mwap	കോമിക്സ്ട്രിപ്പ്
qlan	വർണ്ണാന്ധത
xros	ചെമ്മച്ചനി
srom	ഷോറൂം
hc6t	ചാറ്റിംഗ്
qrat	തലകീഴായി
hn6t	inhibition
hqet	വെബ്സൈറ്റ്
fres	fundraise
froc	സൃഷ്ടിക്കുന്നുണ്ട്
xlak	ഹൈപ്പർലിങ്ക്
vlat	volubility
dvan	അറൈവലിനായി
gxin	കീഴടക്കിയത്
ryes	റിസപ്ഷനിസ്റ്റ്
kxot	ഡയ
xyan	മണ്ഡല
vlan	പരസ്യദാതാവ്
ryom	തോറിയംആറ്റവും
hluf	വാർദ്ധക്യം
hquk	കുത്തിവയ്ക്കുക
lyum	തൂലിയംഅണുവിൻറെ
tyem	ടെര്ബിയംഅണുവിൻറെ
hp6m	പ്രാസിയോഡിമിയം
txic	ഹോംപേജ്
mros	മോട്ടോര്ഓടിക്കുന്നവന്
dyam	റോഡിയംആറ്റവും
pc6n	ട്രയൽനമ്പർ
nyos	ഇൻബോക്സ്
pyek	പ്രൊജക്ടർ
kxon	ക്രിപ്റ്റോൺ
hxuc	യുദ്ധകാലാടിസ്ഥാനത്തിൽ
qrik	കേന്ദ്രീകൃതകേസ്
xwin	ആർ.അശ്വിൻ
kxic	കെടുത്തുന്ന
hvot	ഫ്ലോചാര്ട്ട്
dxot	തൈര്
hqut	ലോഗ്ഔട്ട്
pxen	വകുപ്പുതല
drok	ലക്ഷ്യംട്രിഗർ
flon	മൊബൈൽഫോൺ
txos	മിഡിൽശബ്ദം
hqok	ചരിഞ്ഞകേസ്
xwik	ക്ഷമകേസ്
hx6n	prehodiernal
txik	ചൂണ്ടുവിരല്
hqen	അയച്ചയാളെ
mlap	മാൽവെയർ
hvun	suasion
hvon	ഉള്ളുകൊണ്ടു
vran	മെയിൽകാരിയർ
pfes	പ്രൊഫസർ
pwip	കവി
hqam	വർക്കൗട്ട്
gxat	നിയമവിധേയമായും
ks6t	ജനറർ
vrin	റിക്രൂട്ട്
kxip	ക്ലിപ്പ്ബോർഡ്
sr6n	നിഷേധസ്വഭാവമുള്ളവയത്രെ
vlit	വിലയിരുത്തലാണോ
tyup	പട്ടണപാന്തം
mrom	morpheme
xron	ഹെഡ്ഫോൺ
gxak	വിലകൂടിയ
hrof	ട്രോജൻകുതിര
xlas	പക്ഷവാതം
dzet	redecorate
txac	കീഴടങ്ങുന്നതിന്
xrot	ഉപയോഗിക്കാത്ത
txis	ഡോട്ട്മാട്രിക്സ്
syif	SIയൂണിറ്റ്
xrac	അത്ഭുതമെന്നു
brif	ബൈനറിമൂല്യം
dlos	മോഡൽകേസ്
txun	ഗുണവിശേഷങ്ങൾ
dvat	കോപിമോശം
psom	ആദ്യകൈ
gjek	മറ്റാരോ
nlem	പിണ്ഡംയൂണിറ്റ്
qret	റീട്ടെയിൽസ്റ്റോർ
txip	ട്രിപ്പിൾപോയിന്റ്
dlek	വ്യക്തിഗതമായി
lwut	ഫ്ലോനിലവിലെ
dxis	നാടകീയമായി
hs6m	സീസിയം
vlak	railcar
hn6m	netium
kxap	പലകക്കടലാസ്
bxan	പോയ
myem	മെയ്മാസത്തിൽ
gxik	പൗരാവകാശങ്ങള്
hxoc	വായുസേന
xrok	സഹപ്രവർത്തകൻ
kr6t	സ്ക്രീൻഷോട്ട്
txok	ഓട്ടോമാറ്റിയ്ക്കായി
hxep	സ്കേറ്റ്ബോർഡിൽ
srop	സ്മാർട്ട്ഫോൺ
pxak	വലിയക്ഷരം
hk6k	നാടോടിസംഗീതം
hl6k	eulersനമ്പർ
pyom	പൊളോണിയംആറ്റവും
xyam	ഥാലിയംആറ്റവും
hvic	സാവി
lyok	locativeകേസ്
xlot	ഫ്ലാറ്റ്
txen	restatement
kxac	counterattack
qrak	strikebreaker
hbup	നീന്തൽക്കുളം
txuk	ഷോർട്ട്സർക്യൂട്ട്
tsef	നീണ്ടതും
bxit	വെബ്ഹോസ്റ്റ്
ksem	വായിക്കാൻമാത്രം
byim	റുബീഡിയംആറ്റവും
hvam	വനേഡിയംആറ്റവും
lw6n	ലന്താനം
frum	ഫ്ലൂറിൻആറ്റവും
nyom	നിയോഡൈമിയം
mlom	multalനമ്പർ
kxas	വ്യക്തിഗതമാക്കുന്നതിന്
xret	ടെറാബൈറ്റ്
hs6k	തിരയല്യന്ത്രം
frus	corroding
gxan	ഗാലക്സിലിംഗഭേദം
vlas	ഉച്ചാരണങ്ങൾ
glet	ഗ്യാസ്ചവിട്ടുപടി
hvim	റൺടൈം
bxip	ബിറ്റ്മാപ്പ്
qrin	നക്ഷത്രലിംഗഭേദം
bvak	abessiveകേസ്
pxon	ലഭ്യമല്ല
dvik	adessiveകേസ്
dvek	agentiveകേസ്
hlef	ഏജന്റ്ട്രിഗർ
kwek	കേസിൽ
kxen	സാധാരണലിംഗഭേദം
ht6m	സൈറ്റേഷൻഫോം
tsuf	ട്രാൻസ്അക്കം
hf6n	പുടം
tc6t	നേരിട്ടുള്ളഒബ്ജക്റ്റ്
gvik	ergativeകേസ്
gxon	പിളർപ്പുകൾ
ksep	receptor
vyin	സിനിമാതീയേറ്റർ
pyos	കർമ്മണിപ്രയോഗത്തിൽ
hnef	ജനകമായക്രിയ
xwit	പ്രാഥമികഒബ്ജക്റ്റ്
hqim	gnomicമാനസികാവസ്ഥ
jlak	സാമാന്യമായ
vrik	അവസാനകണം
qyan	സാങ്കൽപ്പികയൂണിറ്റ്
kxaf	പ്രകാശത്തിന്റെവേഗത
xyic	ഫിഷിംഗ്
qyit	വൈകിപ്പോയി
hvek	evitativeകേസ്
bvik	subessiveകേസ്
hzes	കൈവശമാക്കികേസ്
prus	കമ്പ്യൂട്ടർവൈറസ്
ples	പ്രോസസ്സർ
pxif	പോലീസ്ഉദ്യോഗസ്ഥന്
dvak	lativeകേസ്
brun	ടൂറിംഗ്
tsi_k	antessiveകേസ്
tyum	റുഥീനിയംആറ്റവും
vyak	adverbialകേസ്
pxim	പ്രധാനമന്ത്രി
syum	സ്ട്രോൺഷിയംആറ്റവും
sy6n	suspiciousness
hy6n	ലിംഗഭേദംആനിമേറ്റുചെയ്യുന്നതിന്
pxac	കഴിവുറ്റസന്തോഷം
vlin	വാഹനംലിംഗഭേദം
qwin	ധാതുലിംഗഭേദം
hr6s	റഫറൽ
tf6n	ടോണർ
xris	യൂസർഇന്റർഫേസ്
hw6n	സത്യപ്രതിജ്ഞാ
xlen	പദനാമം
pyec	സ്പ്രെഡ്ഷീറ്റ്
vlim	വെർച്വൽമെമ്മറി
bres	വേഡ്പ്രോസസർ
hqip	ക്ലൗഡ്കമ്പ്യൂട്ടിംഗ്
vlic	വെർച്വൽമെഷീൻ
pfam	സ്പാമർ
dyap	രണ്ടാംഭാഷ
txek	.അതെറൂട്ട്
dxen	ഡാറ്റഖനനം
byip	കച്ചവടക്കാരൻ
hs6c	ആത്മവിശ്വാസം
txim	അപ്ടേറ്റ്
hb6t	ഇവന്റ്മാറ്റം
hdem	ഡൊമെയ്ൻനാമം
dxon	വിവിധഇവന്റ്
lwaf	ഫ്ലാഷ്ഡ്രൈവ്
sl6t	നാമവിശേഷണcrastinal
xyik	ഫ്ലോപ്പിഡിസ്ക്
fyif	റിഫ്ലെക്സീവ്ശബ്ദം
bvin	പ്രപഞ്ചംലിംഗഭേദം
hm6p	മദർബോഡ്
tfip	സകർമ്മകംക്രിയ
jlen	ലൊക്കാലിറ്റിലിംഗഭേദം
xrap	വരയൻ
tc6n	ഗവേഷണലിംഗഭേദം
sl6n	കലാപരമായലിംഗഭേദം
xrek	ക്ഷമട്രിഗ്ഗർ
xwan	അബ്സ്ട്രാക്റ്റ്ലിംഗഭേദം
dxif	കോൺഫറൻസ്
dyip	പരോക്ഷമായപ്രസംഗം
zrek	exocentricകേസ്
hvuk	evoking
xwat	perfectiveകഴിഞ്ഞ
hr6m	റീനിയം
txaf	പ്രവർത്തനക്ഷമമാക്കി
hmef	അമൂർത്തക്രിയ
tx6t	ടെക്സ്റ്റ്എഡിറ്റർ
txes	കൂട്ടായനാമം
bvat	ദൈവഭയം
bvuk	absolutiveകേസ്
ry6t	റേഡിയൻ
vlis	വെർച്വൽറിയാലിറ്റി
qren	ഗ്രഹങ്ങളുടെലിംഗഭേദം
gvak	വ്യാകരണകേസ്
bxok	കഷണ്ടിയായ
mrum	കമ്പ്യൂട്ടർപ്രോഗ്രാം
ps6t	ഓപ്പറേറ്റിംഗ്സിസ്റ്റം
hfom	phoneme
tlem	ഒൺലിമെമ്മറി
pwam	സ്പൈവെയർ
kfif	കോർbenefactive
qwit	യുക്തിഭദ്രതയും
nlaf	ഇൻസ്റ്റാൾ
nwok	associativeകേസ്
dzas	dissatisfy
swuk	അതിശ്രേഷ്ഠകേസ്
syos	സംഗ്രഹിച്ചുകൊണ്ട്
kr6n	വൈദ്യുതി
dvin	നിർജീവലിംഗഭേദം
pxom	propositiveമാനസികാവസ്ഥ
vris	മിഷൻപ്രവർത്തനങ്ങൾക്കായിശബ്ദം
rwos	aerosol
dr6t	distractor
ht6k	ടെലികമ്യൂണിക്കേഷൻ
slaf	സോഷ്യൽനെറ്റ്വർക്കിംഗ്
lyuk	തുടർച്ചയായക്ലോസ്
qras	മേലുദ്യോഗസ്ഥരുടെ
ty6n	teminal
gwet	ഉടൻഭാവികാലം
hp6s	applicativeശബ്ദം
tsof	antipassiveശബ്ദം
ht6p	continutiveവശം
hn6f	necessitativeമാനസികാവസ്ഥ
pfip	സ്വായത്തമാക്കാൻരൂപവും
glap	ഉപകരണബാർ
sy6k	നിലനിൽപ്പിന്റെക്ലോസ്
qyat	പ്രകാശസാന്ദ്രത
hy6t	വ്യാകരണഒബ്ജക്റ്റ്
vyan	ഉച്ചരിക്കപ്പെട്ടിരുന്ന
sluf	singulativeനമ്പർ
dvit	അമിതമായദൈർഘ്യം
qyak	സിംഗിൾനടപടിക്രിയ
bzik	ഫിസിക്സ്
xlet	അർഥത്തിൽ
hqap	ഇന്നത്തെരൂപവും
qwat	സമ്പത്തുതുക
qyik	ബന്ധിതമായിരുന്നുകണം
sr6t	supercriticalദ്രാവകം
hfem	epentheticmorpheme
tl6t	നാമവിശേഷണവിദൂരഭാവിയിൽ
mrif	മൈക്രോഫോൺ
pcuk	postpositionalകേസ്
tfim	റാൻഡംഅക്സസ്മെമ്മറി
fwim	ethium
ly6t	allocutiveകരാർ
hvap	സ്ക്രോള്ബാര്
hfep	frequentativeവശം
bvan	വിതരണാത്മകമായസർവ്വനാമം
fyun	ഫ്ലോട്ടിങ്പോയിന്റ്നമ്പർ
xyas	മായ്ക്കുന്നു
hvif	ക്രിയമുദവയ്ക്കുക
xyis	കഴിഞ്ഞസ്വായത്തമാക്കാൻരൂപവും
tl6n	സെന്ട്രല്പ്രോസസ്സിംഗ്യൂണിറ്റ്
tfok	locativeദിശയിലുമുള്ളകേസ്
qwan	പതിവുചോദ്യങ്ങൾ
