hnit	infinitive
hnak	номинативхэрэг
hkak	ялгалхэрэг
htak	сэдэвхэрэг
hpap	аав
hmam	ээж
hyat	эцэг,эхбайх
hcan	Сайнуу
hwik	vocativeхэрэг
hsuc	өвөгдээдэс
htat	өвөө,эмээ
hcac	олон
hnik	genitiveхэрэг
hcit	тэмдэгнэр
hwan	болон
hman	би
hnan	Та
hwam	АНУ-ын
htit	энэнь
htac	очиххэрэг
htik	өгөхоршихынтийнялгалхэрэг
hyit	realisсэтгэлийнбайдал
htim	deonticсэтгэлийнбайдал
hcut	нөхцөлтсэтгэлийнбайдал
hsit	epistemicсэтгэлийнбайдал
hyak	багажийнхэрэг
htan	дотооднөхцөлбайдал
hpan	хүнтухайн
htin	биедаасанзаалт
hyan	хамааралтайзаалт
hfap	perfectiveасуудал
hkat	өнгөрсөнцаг
hnin	эрхүйсийн
hmak	comitativeхэрэг
hnat	Одооцаг
hpak	benefactiveхэрэг
swik	essiveхэрэг
htut	negatoryquantifier
hsan	гадаргуугийннөхцөл
hpin	adpositionalхэрэг
hwin	байршилхэрэг
hkan	зайнөхцөл
hnac	аргазамхэрэг
hyut	interrogativeсэтгэлийнбайдал
hnam	болонэсвэл
hkit	онцгой,эсвэл
hsuk	эхүүсвэрхэрэг
hpik	гуужуулахэмчилгээхэрэг
hcat	ойрхонбайх
hmat	demonstrative
hkuk	заалтсүүл
hlan	гэхдээ
hsut	бүх
hyin	нийтийнquantifier
hcin	эмэгтэйлэгхүйсийн
hpac	олонтоонытоо
hyik	нэг
htic	тэдний
hkik	хэн
tcat	ирээдүйцаг
hsin	нийгмийннөхцөл
hkac	үед
hmip	imperfectiveасуудал
klan	Тэнд
hlak	elativeхэрэг
hlik	illativeхэрэг
htam	удирдамжсэтгэлийнбайдал
hlat	сонгонquantifier
hkam	ямар
hwat	асуултүг
htap	copula
hpat	хүн
nyan	эр
hkas	болох
tcan	бусад
hnuc	тоо
twit	нааштайquantifier
hsak	цагхугацаанөхцөлбайдал
htuk	материаллагхэрэг
htun	зөвхөн
htum	hortativeсэтгэлийнбайдал
hyip	буцаанасуудал
hlit	volitiveсэтгэлийнбайдал
pcic	байхёстой
tyut	хоёр
hsat	харах
hkut	мэдэх
hcic	доошнь
hcap	дараа
hpam	эхний
hlac	alienableэзэмших
hkap	хэзээч
hnic	салшгүйэзэмших
tyat	хуучин
tcit	зөвлөлдөхсэтгэлийнбайдал
tcin	өдөр
hlam	ирж
hwak	эгшиг
hkin	явах
lwak	perlativeхэрэг
hpip	дэвшилтэттал
lyan	урт
hsac	гэжхэлэх
kyan	Хэрхэн
htas	дахин
hsic	энд
hcik	бодох
hcak	нөхцөлдор
hfan	олдлоо
hsun	гар
hyac	мөн
nwan	залуу
tyit	эсрэг
tlan	бурхан
twak	delativeхэрэг
hmin	юучбиш
hyas	нэгудаа
hlap	semelfactiveасуудал
kcac	зүүн
hyic	харсан
hcas	байшин
hwac	дэлхийн
tyin	гурван
hnun	нео
hcuk	анхааралхандуулах
pyan	хайртай
hsis	үргэлж
hyam	шөнийн
hyap	хаан
hkic	хооронд
hmas	оюунухаан
cyit	зүрх
pluc	paucalдугаар
kyik	учирнь
ksak	учиршалтгааныхэрэг
tcun	дууссаныхаа
hnim	нэр
tsan	зохихнэрүг
klac	улс
hpun	гэжасуув
cyat	харагдахуйцнотлох
pcac	илүүсайн
hmac	мөч
hnas	чадахгүй
hwic	ус
twim	desiderativeсэтгэлийнбайдал
kwan	гэрэл
tlat	үг
tyan	хаалганы
hsas	өглөө
syat	хүртэл
twik	terminativeхэрэг
hpit	цагаан
pcan	мөнгө
hyis	ядуу
mwan	үхэл
hfam	хэлбэр
nwik	inessiveхэрэг
kcat	хамт
tsac	ньихэвчлэн
pyat	найз
psan	хагас
hpim	чухалсэтгэлийнбайдал
hyuc	дугуй
hfat	илгээсэн
hcis	эхнэр
kcan	итгэжбайна
hsik	олоннийтийн
htus	төрийннөхцөлбайдал
hpas	хүү
clat	хүүхдүүд
tyak	ийн
cwan	гэдэгтнайдажбайна
syin	хонгорминь
hkuc	өндөр
tyac	уншсан
syit	хот
hlic	альхэдийн
hfit	factiveнотлох
tcac	охин
hcun	сонсох
ksan	наадзахнь
hyaf	магадгүй
kyat	үнэхээр
tcic	байгууллага
hwit	буцах
cwat	агаар
hfaf	хууль
hput	Туслаач
lyat	Захиа
ksas	дөрвөн
hpic	optativeсэтгэлийнбайдал
hfuk	гал
hcam	цаг
twat	дайн
kyak	хэдхэдэн
tlit	хоёрдахь
pcin	ард
hmut	алдсан
clan	мянган
hfac	гэрбүл
twan	сүнс
hwas	асуулт
syan	үнэн
htis	гаргах
tsat	боломжитсэтгэлийнбайдал
lwik	allativeхэрэг
nyin	anthropicхүйсийн
hfak	таван
tcak	ижилзүйлмаркер
htuc	өөрөөрзүйл
hnap	хариултнь
hmit	далайн
hcuc	айдас
pcat	ойлгох
syas	нэртомьёо
hcaf	сэжиг
twut	dubitativeсэтгэлийнбайдал
hkis	хар
tlak	авчирдаг
hyus	сайхан
nyit	төрөл
htip	арван
ksis	түүх
hpuk	ном
hlin	электрон
hkun	данс
lyas	хүү
lyit	бичих
pwat	ор
hnis	нас
hnut	эсрэгбаримтыгболзол
slas	урлаг
hwis	vialisхэрэг
pyak	ахдүү
lyin	шугам
tyas	хүснэгт
hyun	голын
kyac	нүд
tfan	гэнэт
kcin	гүн
hmuc	зорилго
cyac	цусны
hmap	өссөн
tlin	хүйтэн
hyif	урагш
tyam	орой
hnaf	бодох
hkip	бараг
myan	уурхай
tsin	мэдлэг
hkup	хуулбар
hsam	нөхөрнь
hlis	зургаан
cwit	амьдрах
cyan	амарамгалан
myat	санажбайна
tyic	байгалийн
hfut	унах
swas	үйлчилгээ
hsap	бусад
pcit	Зохиогчийнэрх
hyim	цэргийн
kyas	морь
plic	ирээдүй
pcak	баруун
hpis	төлөх
hyuk	улаан
hwun	алт
twin	хүсэл
plan	тоглох
hpus	оффис
syun	Засгийнгазар
kyic	сүм
htaf	хүч
hlun	уртнь
kyin	Тускомпани
kyis	цаасан
mlan	магадлал
hcim	ялангуяа
cyas	үүрэх
twac	цонх
nyat	гоосайхан
hcus	сүүлийнх
htup	үүрэг
htif	зайн
pyas	хөл
hlas	зэрлэг
ksin	ногоон
hmaf	гай
myac	инээмсэглэл
hsim	унтах
kyit	иштатсан
kwik	quotativeхэрэг
fwan	айлчлал
slan	дагах
psit	байгааэсэх
hmic	сайхан
hmuf	агшин
hfin	баян
tcam	дайсан
psuk	эвдэрсэн
kcap	хөлөгонгоц
pwan	хамааруулсанхүн
hfic	нөлөө
tcuc	гарчирэх
hkim	нууц
pyin	үү
pwit	precativeсэтгэлийнбайдал
pyit	эелдэгбүртгэл
cwak	муу
myak	жагсан
tcas	газрууд
hlaf	байх
psat	оронднь
nlan	хөх
psac	боломжгүй
kcuk	сургуулийн
kcit	гэрбүл
kcak	хоолхүнс
syis	хорин
tlac	намгүм
hcip	ирээдүйнасуудал
kwin	өгөх
tsit	зогслоо
pyac	хэл
hsus	долоохоногт
hcup	танхим
cyap	гайхдаг
tfin	төрөлхийн
fyat	шүүх
hnip	gnomicасуудал
tsak	хүндэтгэх
tlas	үнэцэнэ
syuc	мод
plat	ханын
cyak	тэнгэр
twip	inchoativeасуудал
mlat	тушаал
swit	jussiveсэтгэлийнбайдал
mwas	Сараар
hwaf	төгс
tyap	туршлага
ksac	нөхцөлбайдал
syac	шинэ
hnuk	гүн
kwak	хамрагдсан
tyuk	зүүн
pwac	чулуу
hkif	сайхан
nyac	чиглэл
cyis	дарга
tyuc	хүлээж
tsun	тосгон
tyik	хүлээнзөвшөөрчбайна
hnum	зөвшөөрсөнсэтгэлийнбайдал
slak	амжилт
tsic	оролдох
slat	уулархаг
hmik	дуухөгжим
hkus	хашхирах
hsip	Долоо
hpaf	хувийн
nwas	мэдээ
tfac	дүрзураг
fyan	бэлчээрийнмалажахуйн
cwas	Эхлэх
hfik	хуваарилалтынхэрэг
lyac	сурах
syik	улстөр
clin	Хенри
cyin	худал
tsas	хаягдах
cyik	эрхбүхийбайгууллага
tlap	шал
cyam	зуны
tcut	шашиншүтлэг
tcap	зугтахыг
hlut	зохиогч
pyun	бор
tcuk	өвдөлт
swan	хавар
hmun	зөөлөн
kyun	булан
nyak	бараанытэмдэг
tsis	шударгаёс
psas	үйлдвэрлэх
cyaf	инээд
hwut	мартах
hyup	Европ,АНУ-
hwap	найман
psak	авбал
kyap	аймшигтай
pyic	шаардлагатай
hmim	дунд
hsaf	амьсгал
hmis	мэргэн
hsum	possessiveмаркер
ksat	сайхан
ksit	хүнд
tsap	арал
kyam	бааз
tcum	барих
cyun	аз
psic	эрэг
tyun	домэйн
mwit	commissiveсэтгэлийнбайдал
tlut	зэрэг
myit	өвлийн
kfan	биеэавчявахбайдал
slac	ажиллажбайгаа
myin	минут
tyip	хүргэдэг
klas	шилэн
pfat	ТУЗ-ийн
cyic	хоосон
swam	хэрэг
syam	аюулгүй
tsut	эмч
hlip	completiveасуудал
kcas	харанхуй
nyun	дулаан
hpuc	ундаа
tlam	жишээнь
hfun	уурхилэн
tsik	хэдийч
tsam	шууд
hmup	малгай
klak	нохой
slin	мөнгөн
swac	зарц
kcam	бахархал
pyik	галттэрэгний
myut	ёссуртахууны
syak	оруулах
swat	илд
kyuk	халдлага
clac	эрүүлмэнд
tyaf	хэсэг
swic	нийгмийн
tfit	буцаанолголт
hkaf	албанёсны
pcas	харах
nyam	алдарсуу
tfat	арванхоёр
pcut	эрхэлжбайгаа
pwin	дарс
mwat	амт
fyac	төмөр
syap	тараах
myap	худалдаа
hyum	ашиглах
fwak	шүүгч
klat	ахмад
twap	cessativeасуудал
kcic	сониуч
kwic	гадаад
hnif	машнягт
myun	ачхолбогдол
tlic	эцэстнь
cyuk	хүзүү
syut	эрхчөлөө
pfan	тал
kyuc	хуурай
pcap	хажуутийш
tfak	нотлох
tcik	нотлоххэрэг
twun	алсхолын
tyis	ахицдэвшил
nyap	нарийн
plit	барилга
hpif	хуудас
pwic	барьж
syic	гунигтай
tsip	нүгэл
syim	өвчтэй
tcis	үнэнчшударга
pcun	банк
ksap	хүлээнавах
lyam	урсгал
tcaf	анхааралтай
kwac	чих
hpup	талх
kcut	сонгох
nwam	мал,амьтны
hsup	zoicхүйсийн
nwit	eventiveсэтгэлийнбайдал
tcim	ижилүйлявдалмаркер
tlik	multiplicativeхэрэг
kyus	хөндлөн
hmus	зузаан
kfat	зүрхлэх
nwat	ургадаг
myic	бороо
hpum	нүүр
swut	ариун
clis	долдугаарсарын
mwun	загвар
hfas	Файл
cwac	мор
kwat	тайтгарал
nwac	Хэрэвхэннэгэннь
tcip	хүссэн
kfac	өвс
hmuk	зурах
plin	нээх
kwun	онызургадугаарсарын
mlik	загас
klin	нийслэл
pfut	хөхний
twam	шаардлага
fyin	зардал
nlit	чинийх
mlin	сая
pyut	залбирч
hluk	ядарсан
ksut	алах
cyut	сүүдэр
psin	жин
kcis	саарал
pyam	зоригтой
mwac	сэтгэлхангалуун
klam	хэлж
ksam	үндэсний
hfip	сул
klik	хөндий
hkum	эрсдэлтэйсэтгэлийнбайдал
clas	шар
cyuc	дулаан
mlac	үлдэгдэл
syip	нэгэнадил
pwak	хайрцаг
tcif	үзүүртэй
psip	зарчим
ksik	үрдагавар
tsim	улиралнь
flan	шинжлэхухаан
pcam	бололтой
kcun	цооног
ksuk	авгаахнь
mlit	жагсаалт
pcik	аюултай
kwas	Наймдугаарсар
hluc	алдартай
klit	Үлмэдэгдэх
flak	танил
fyit	танилбүртгэл
lwat	уншигч
plun	алхах
twas	хоёрдахиних
pcis	тахилч
fyas	шархадсан
nlat	ордон
myuk	тэнэг
pfak	хайр
tcuf	ес
cwap	хайрэнэрэлийг
plac	галавалцуулах
pyap	оруулах
lyic	өмссөн
hcum	дуучимээ
lwit	уранзохиол
tsuk	цол
hfup	шуурга
kcik	халаасны
nwap	Арваннэгдүгээр
tyim	Арванхоёрдугаарсар
psaf	байхгүй
nlac	хүнам
kyaf	баярлалаа
slis	цуврал
pyaf	шувуу
mlak	эзэмшигч
kwut	хүрэм
hwuc	харилцаа
pyis	хурдан
twuc	утаа
nwak	онынэгдүгээрсарын
mlic	машин
tlis	шүд
ksun	шатаах
clam	ичгүүр
klaf	чанар
clit	бөгж
fyak	өгүүлбэр
fyam	өгүүлбэрмаркер
kwap	хавтгайдөрвөлжин
hwip	Нямгараг
psis	яруунайраг
pwut	preordained
kyim	худалданавах
clic	талбарууд
pyip	дөрөвдүгээрсар
kfap	Аравдугаарсар
psut	объект
kcuc	гашуун
nlap	боол
hsok	сул
htet	текст
hbat	хамгийн
hrit	зээлийн
hzit	онцлог
hpet	арвантаван
krac	хэрцгий
hduc	тоос
hrik	практик
hron	өнгө
hnus	хамар
hric	ээлтэй
srik	хангамж
hten	өчигдөр
tlet	hesternalцаг
slap	амжилтгүйболох
hban	хувцас
hdat	сохор
fran	нисэх
hdan	чөтгөр
htec	аажмаар
hmon	үүрэг
cran	золиослох
hran	мөсчанар
hmos	сайд
nrit	эрчимхүчний
hcet	үзэняддаг
hset	төв
hrin	оновчтойхүйсийн
hcot	эдэлнэ
hrip	товч
htep	мөргөл
hcif	арьс
hrat	дээвэр
kran	титэм
hkon	цайз
tran	цөхрөл
hmif	милийн
trin	тойрог
hgin	хорих
hkop	аяга
hcen	гишүүн
swin	иргэний
hrac	хаасайгүй
hris	өөрчлөн
hbin	болж
hmot	мах
hdut	сүү
hwen	vegetalхүйсийн
nran	ховор
hbac	үеэл
crut	гүүр
hsoc	хувьцаа
hsom	давс
nris	гэмзэмгүй
hbit	зайлсхийх
crin	гайхал
rwin	хатанхаан
hgut	тоо
hdas	бүжгийн
hnot	зочидбуудал
hdin	дүүргэх
hton	хоригдол
hdak	дэлгүүр
hlet	шат
hson	уучлал
hgek	гей
hras	элс
hsep	Есдүгээр
hbic	балгас
hlen	Тусгайзөвшөөрөл
hcon	хангалттай
hgit	гэрч
kfon	галтогооны
hbak	зарах
tlim	эмчилгээ
hsot	хурд
kyut	компьютер
hnen	мөнх
htek	номынсан
hzan	агуулсан
hbis	үндсэн
hbun	төөрөгдөл
kcus	тогооч
hgat	цөл
hwus	үнсэлт
hbif	мөс
hbot	бөмбөг
hrut	баталгаа
hdit	benedictiveсэтгэлийнбайдал
hdis	гэмбуруутай
hjan	шийтгэл
plis	цагдаа
hgan	нуух
hsen	экспедиц
nrin	мэдэхгүй
hyen	үүл
frif	хоёрдугаарсар
hdik	өвчин
hnek	санаачлагахэрэг
hbam	авгаэгч
hmen	даруу
hdip	хожимдолчухал
prat	мэдээлсэннотлох
hdet	шөнөдунд
hjit	хуруу
hmoc	хаанэггазар
pran	хэвлэлмэдээллийн
kcec	бүснутаг
hken	сүүлийнүед
hloc	ухаанбалартан
hrak	ажилтан
htes	ширтэж
rwan	шагнал
hdon	хандивлах
htot	магнай
hnet	тэнгэрэлч
hdun	ганц
croc	алдаа
hlon	үүр
hyec	хонь
hjin	тэвчээр
hrec	лавлагаа
mran	эрдэнэшиш
htos	ихэнхнь
hcos	аргахэмжээ
hkoc	хааяа
hlif	ашгийн
clak	элсэнчихэр
hjat	хүнтөрөлхтөн
tram	хүрээ
hdic	диск
hkok	ганцаардмал
srat	уранбүтээлч
crak	сэтгэлтатам
hmet	И-мэйл
hden	шийдвэр
gran	Засагдарга
crac	салбар
hjac	урамзориг
hdim	индуктивсэтгэлийнбайдал
hcok	яарах
hyet	газрынтос
pwap	хоолой
trat	хэвлэх
tcot	хатууасуудал
hdoc	өө
hren	ярианыагуулга
tcon	үд
krin	бүхээгийн
plam	дохиоллын
hnes	мэдрэлийн
tcen	ажиглалт
hsek	асуудал
plik	холбогдох
slik	торго
hfen	хувь
hgen	агент
hnon	үйлдвэрчнийэвлэлийн
crik	там
tcet	алдаатай
mrat	холимог
hdam	admonitiveсэтгэлийнбайдал
hgac	нэртөр
htoc	ямарнэгбайдлаар
hdac	зөвлөгөө
nwin	Үндсэнхууль
srit	аргахэрэгсэл
hret	хатуу
nlin	онлайн
hzat	хүнамыншилжилтхөдөлгөөн
klic	коллежийн
hkek	сүүл
nric	үе
hgic	хөлхөдөлгөөнихтэй
hgak	муур
trit	шууднотлох
tyot	гэрээ
hnok	агуулга
crit	орхигдсон
slen	арваннэгэн
srin	зан
hpok	овог
hyot	түргэнсэтгэдэгсэтгэлийнбайдал
cric	байр
hruc	бүдүүлэг
cwin	морь
hzak	сэгсэрнэ
dyit	ажүйлдвэрийн
hpec	мэргэжил
nras	сувилагч
hcec	заах
hbut	гутал
hmec	тодорхойбус
twot	үйлажиллагаа
crat	Бямба
hkot	хүчинчадал
hnec	нарны
hwuf	бэлэвсэнэхнэр
cren	урсгасан
nrat	од
hget	зочин
hbik	адислах
brin	дотоод
hpot	боломжтой
trac	эсэргүүцэл
prac	эдлэхгүй
hcoc	хөндий
hpon	аймгийн
hwim	Соёлиргэншил
dwan	зүүх
cwok	шок
hdok	жолооны
crun	эрдэнэсийн
hzik	үрийн
hrot	Сүүлийнөнгөрсөнцаг
hket	сэрүүн
hcek	тавилга
hrop	олс
mrac	адалявдаладалявдал
byit	найр
trak	жилбүрийн
hzin	өмнөд
sric	ёслол
clik	ан
trap	либерал
hrim	Христитгэл
hrus	гүнж
blat	тахилынширээ
cyon	жижигхэн
hwep	вэб
krat	хамба
tris	нилягаан
kcot	цуглуулах
hben	сонгууль
trik	согтуу
kfit	өргөх
tcec	валютын
nrik	тодорхойнийтлэл
grat	эзэнхаан
dran	удирдлага
hpen	өмнөнь
cluk	муухай
nrac	хоргүй
ryin	сургалт
hrun	өнхрөх
nwic	инч
slit	гөлөг
gzat	сонин
krot	огтлох
drit	сахал
hzis	нулимс
hdap	арваннайман
sris	түүхэн
mrut	нийт
nyik	шавар
bran	сүйтбүсгүй
drat	хамаарна
djan	аваргатом
glat	энгийн
hpoc	намар
pras	Хөшиг
hgot	цуглуулах
tret	театр
tras	харьцуулалт
rwit	өрсөлдөгч
hfon	бүрдүүлэх
klot	дасгалжуулагч
hmum	хошигнол
drac	өмч
rwas	уранзохиол
tset	өшөө
hdot	дисталdemonstrative
ryut	хартай
hwon	урилга
byat	шатаалт
flac	флэш
prot	хөрөгзураг
crek	саналболгожбайна
htok	зөрчилдөөн
htop	хараал
prit	imprecativeсэтгэлийнбайдал
hces	арчаагүй
klup	клуб
hnos	үер
dwin	ялгаагүйн
prin	давхрага
mrit	таамаглажсэтгэлийнбайдал
tcoc	эгц
hcom	эв
grit	аянга
tlot	өмнөх
hgik	өвдөгний
hwes	ухаангүй
hzac	харилцан
hsec	програмхангамж
tson	байгууллага
ryit	хүлээнавах
dlin	сахилга
slip	хуудас
klon	хувьсгал
hfim	фермер
hpom	тавцан
cyen	оюутан
hgec	агуй
hroc	уламжлал
srac	өгөх
ryat	эмгэнэлт
kcen	онгон
hbap	салахёсгүйцэтгэе
krik	шүүмжлэл
krap	хөвөн
fwat	эмнэлэг
kcet	түрээс
hgas	хий
pfin	гарцаагүй
dlit	хуудас
ryan	орчуулга
sran	оршуулгын
mrin	гурил
hram	романтик
dlan	долларын
hzas	jest
hsos	арванзургаа
klen	колони
gyin	жигүүр
hsif	арслан
cluc	зальтай
prip	бэлтгэл
hzut	манан
dwat	эм
krit	proofread
sras	үүр
hses	арвандөрвөн
brat	эсэргүүцэл
flat	хүчил
hjic	тухайлбал,
slic	зэвсэг
hbuc	хэрэглэгчийн
tron	жүрж
byan	халуун
hrif	командын
tlip	бийболгох
blan	сагс
kris	нарийнбичгийндарга
hyon	энэхооронд
tren	Өнөөдөр
dlat	hodiernalцаг
hzic	хор
tfic	буу
tlen	авъяас
hlim	уурамьсгалын
dyat	анд
kcon	илчлэлт
dlac	угаах
krak	улайх
hbas	утгагүй
hkec	нүүрсний
hrek	сэргээх
hkos	Сэлүүртзавь
hwif	дэд
tric	түрзуурын
hdep	delimitativeасуудал
mwak	овоо
ksot	ясны
hnoc	Даваа
nlas	Мягмар
brac	Лхагвагараг
frap	холбооны
pfit	төлөөлөгч
pcoc	ав
lyen	цагаанхэрэглэл
swak	угаалтуур
pcen	ерөнхийлөгч
brit	цуст
hwec	бүслэлтийг
hwet	гэдэс
hlos	Дээддавхарт
hbon	янзбүрийн
pcon	гуулин
hsem	дээдхэмжээнийуулзалт
lwac	хямд
tsos	уралдаан
kwen	онцгойхүн
trun	буух
trut	хөшөө
hrap	ихбууны
hgap	баривчлах
trot	температур
grin	хөрш
hjak	хүлээн
hpek	багц
hlus	буга
hwos	унтлагынөрөө
tsuc	бут
pcuc	урсах
cris	өвзалгамжлагч
clun	царс
hpes	таагүй
nlet	бүрэнбус
hrom	хөтөлбөр
pyon	төгөлдөрхуур
swet	ятгах
dric	үлүзэгдэх
tyen	сайнмэдэгдэжбайгаа
hruk	хэрцгий
frat	өгсөн
hyoc	уруутаталт
hlep	telicасуудал
nrot	Олонулсын
nret	хүчтэй
hfif	гүнухаантан
pfic	төлөөлөл
hmek	эмзэг
hfec	халамжийн
myik	загасбарих
truc	хулгайлж
tcop	уруул
rwic	явах
htom	эдийнзасаг
glan	галлерей
pren	Зэрэгцээ
hlek	atelicасуудал
nrak	тив
truk	тогших
hjim	ендерсэтгэлийнбайдал
rwat	зангиа
hcep	эсийн
dyan	өндөг
jrat	хиймэл
nren	урам
ksic	хямрал
tsoc	хайх
lwan	үдийнхоол
hpos	нарс
hcuf	түлхэх
tcus	Сью
pset	сунгах
hkep	зэс
swis	далайчин
prim	эзэнхааны
trip	ташуур
cras	цамц
swap	урсгал
syet	ноорог
htof	хулгайч
clen	суваг
kwit	хувийн
klok	илүүдэл
hrok	шинэчлэл
hguc	цангах
kcim	аюултай
hpem	далдуу
psik	чангаяригч
frit	босго
cret	улмөр
mrak	жад
syen	сесс
tcup	чийгтэй
hyek	зорчигч
trim	цагаантугалга
plak	гомдол
hyok	өнцөг
hgam	үнээ
hmok	тээрэм
jrac	газрынзураг
kloc	зах
gyit	санаатайгаар
hbip	шарайраг
mlet	хилэн
lyap	хүчирхийлэл
cwen	сүрэг
bwan	зээ
tses	арван
jrit	зөвтгөх
nlak	гарбичмэл
sron	дайчин
cruc	Баасан
broc	сойз
dlot	татажавах
krim	тос
pric	давирхай
prut	тангарагтан
hgon	хөлдүү
sram	үгчилбэл
pfot	шавар
hlot	төлөвлөсөн
djin	зоос
hlok	харайх
hpep	алим
hwot	эрчилсэн
dlak	хэлэлцэх
brik	бүртгүүлэх
nlis	хуулбарласан
hbet	бооцоо
pris	вирус
hjik	зочломтгой
blit	хүүхэдшиг
hjap	дээл
tfik	тусгах
hdaf	хүрч
hpop	дуурийн
kcaf	нуугдаж
kcoc	тохой
hrum	засвар
cyim	сэжигтэй
dyic	боловсролын
hgoc	уурхайн
drak	эмгэг
plas	алгаташилт
byin	хоёртын
hzap	Abbey
nlot	үнэнчбайдал
mrik	механик
hsop	амжилттай
crap	занга
kyek	бялуу
nrut	зугаацуулах
syes	эрхэмээ
hjet	арвандолоон
hjen	эмэгтэйлэг
hmom	зөгийнбал
hdec	харамсалтайнь
lwen	домог
slot	зуух
frac	босогчдын
gwan	товгор
mruk	сайжруулах
swot	намгийн
zlan	олох
hnem	хүүхэлдэйн
hdes	ороох
prak	номлож
frin	тайзнычимэглэл
hfet	эсэргүүцэж
cros	найралдууны
ryon	оновчтой
tcos	газартариалан
tsen	боловсруулах
hwek	чоно
nlik	татгалзах
klap	хивс
dras	үзэняддаг
prop	үржилшимтэй
slim	шүгэл
hgis	бяслаг
krut	хазах
srot	хамгаалах
bjan	төөрч
nwen	Тэнгисийнцэргийн
myas	маск
kwaf	боловсруулах
twis	Такси
pcip	харандаа
srap	хүнснийногоо,
sren	үзэсгэлэн
tlun	өмд
hrup	авлигын
nrip	Засгийнгазрын
srup	шөл
jran	мэсзаслынэмч
bjat	тэтгэмж
gyat	тагнуул
hlem	бодлогогүй
srak	хийсвэр
kson	өргөлт
cwis	Пүрэв
sret	чинсэтгэлээсээ
hraf	замынхөдөлгөөний
hres	архитектур
hsuf	хаях
rwak	анцав
twon	чимэглэл
hfus	нөхөнсэргээх
hkom	код
djat	анчин
nlut	сонин
hsef	могой
mris	ардчилал
bric	зай
mlam	лав
zran	хуваалцах
cron	дөг
hzen	усандсэлж
traf	зурвас
cwaf	дугтуй
srip	тамхи
mrot	моторт
swon	сайндурын
ryak	урвал
pfun	хэсэгчлэн
blac	ачаатээш
mret	Яам
hjon	бэлгийн
kcok	сүх
dram	алмазан
kren	өөр
tcek	цуурай
hdif	таних
tfas	элчинсайд
hfot	бүрдэнэ
lwas	залхуу
hmep	momentaneасуудал
kfin	кодчилол
mwin	зохиомол
hrem	рентген
pram	авирах
byac	зоорь
mren	дурсамжтай
swen	сенат
kras	авсыг
hgun	залгих
nlok	өөгшүүлж
ryic	хөдөөажахуйн
gwin	дүүжин
srut	нуга
hkes	нарийнтөвөгтэй
hfis	огцрох
frak	удаа
hnom	хуйвалдаан
hcop	паб
hlec	чинжүү
mlot	аялгуу
zrat	нэрдэвшигч
proc	ивээнтэтгэгч
flik	үнэг
cyet	харамссан
hgim	яндан
slet	хедж
tcok	үнэнзөвбайдал
bjit	хуучиннасбарсан
brot	цомирлог
bwat	хөнжил
hdus	гахайн
gwat	заанысоёогоорхийсэн
kret	ханд
nwet	ажиглагч
jwan	өргөнчөлөө
nwis	хадаас
mwic	зөгий
bzat	жүжигчин
gyan	хөлс
zyit	гүйцэтгэх
blic	хуурмаг
pcet	тодорхойгүйбайдал
tsot	дахин
bwit	хил
tres	стресс
hkof	хэрэглээ
nyen	еолох
hles	адилтөстэй
cyek	шуудай
hjis	зүү
gjan	үзэгдэл
prec	биеэавчявах
drot	хянагдаж
kcek	муруй
twic	тахианы
brak	баррель
zwat	байнга
clap	байнгаасуудал
tsec	шинжээч
bwin	сэтгэгдэлтөрүүлэх
cwet	хүрээлэгдсэн
hbek	талхчин
zlin	чидун
mron	ван
drin	зориулах
psap	ил
gjin	төрсөнөдөр
clut	алх
cwun	анхилуун
twaf	ердийн
pcot	гэрийнтэжээмэл
krok	гавал
dlik	хуультогтоохбайгууллага
cwic	азболоход
srun	ширүүнхарц
crec	устгах
jlan	маржин
kcip	аварга
blin	тэрбум
ryik	химийн
mlas	импульс
flit	туршилтын
hzet	зангилаа
cwik	Сүржавхлант
twet	юбка
mwik	долоохоног
tfis	техникийн
tlon	тээврийнхэрэгслийн
cram	зусардагч
grac	бэхжүүлэх
kraf	хэрээ
trup	шинжчанар
hduk	дэгээ
cruk	бар
nrap	гэрийнажилтай
crot	автозам
mlip	цагдаагийн
hfoc	зураг
nres	бүрэнбүтэнбайдал
plos	нэмэх
tfam	илтод,
nlic	арванесөн
hwok	мэргэшсэн
nlen	Эссэбичих
fyic	үрашиг
hwuk	өвөрмөц
hgok	органик
flic	теологи
flot	°в°гч
hboc	үүрэг
hwoc	шулам
syot	студи
cwip	оргилуундарс
hbes	сурталчилгаа
lwic	гэрбүлсалалтын
blot	боолт
cwot	олзлогдох
cwam	судлын
prik	идэвхгүй
hfum	Хөөс
grik	хайрга
zrin	хормогч
gren	гариг
hfuc	амилалт
claf	тавиур
flas	сэнс
hjot	халуунорны
hbim	дурзоргоороо
krek	мөнгөнус
hbec	элгэмсүү
tsaf	амиахорлох
pwas	зулгаах
plot	сурвалжлагч
kfak	зарцуулах
blak	тагтны
hdos	толбо
kwis	Сонгодог
kcos	буруутгах
psen	тэтгэврийн
kres	үйлүг
hzon	сармагчин
srim	гарынүсэг
glin	жигшил
mlut	зартай
myot	импортын
fwac	үүсгэнбайгуулагч
troc	бамбар
hgaf	дүрэм
hyop	дарвуултонгоц
ksip	устажүгүй
sres	аялал
hnup	бөмбөг
hzun	зөрүүд
mric	булчингийн
gjat	магнитудын
hros	цэвэрлэгч
zrac	аймхай
tros	шарсанталх
myus	хулгана
dwac	яриа
byak	ямааны
htef	захиалга
hfek	цэцэглэнхөгжиж
dzan	ногдуулах
nyon	нэрньүлмэдэгдэгч
zrit	албанёсныбүртгэл
pcos	спорт
hjec	хайлмал
dlas	устгах
mras	дээвэр
mram	ашигтмалтмалын
cwut	эвлэрэх
hbok	нугас
swun	саван
dwak	хүүхэлдэй
plif	Вилла
slon	оёдлын
tfut	баярхүргэе
djac	нэгтгэх
hjas	тасланзогсоох
kric	туулай
kwot	дамжуулагч
gzan	баталгаа
clot	тоглогч
ksek	шавьж
psam	маяг
mwut	шаршувуу
htem	байнга
clon	хийл
dzin	оршинсуугч
rwim	тустус
hyof	ашигтай
dron	луу
dwit	сонсголыннотлох
sroc	экспортлогч
hzot	дуусгаварболох
djik	хоргодон
kfik	таг
ryun	зохицуулалт
hmes	хотындарга
rwac	техникхангамж
sruk	циркийн
sros	цөөнх
bzan	бослого
kset	найралхөгжмийн
bjon	гахайн
hjut	хязгааргүй
tfen	хамгаалах
zwac	Султалнь
dyin	зөвшилцөл
myis	хөгжимчин
mlis	сэтгэцийн
pret	хангалтгүй
tsek	архитектор
hlom	Лимон
ksos	ханиалга
crok	толгойөвдөх
flin	төрөлтийн
mrun	мужаан
swec	Санамсаргүй
syuk	халбага
blun	Шаар
tcep	шохой
fric	сэргээш
rwik	босоо
rwen	урьдчилансэргийлэх
flet	inferentialнотлох
pfac	хэвлэлийнгазар
srek	цуу
tfun	туннель
pwet	эндүүрэл
gyik	математик
fwot	хатах
lwin	тэнцвэртэй
jwin	элэгний
bwik	sublativeхэрэг
hdup	дүрэх
hnop	монополь
bwic	шумбагчонгоц
ryen	үлхамааран
hcem	газархөдлөлт
hbos	лабораторийн
nrek	ажилтан
ryim	хэмнэл
nyic	тайлбарлах
dwas	Элчинсайдыняам
rwok	хурцдах
kram	чадваргүй
ksim	тунхагсэтгэлийнбайдал
clok	шоколад
pcec	эрх
nyis	аглагч
tyoc	тохиолдол
grak	зурлага
zlat	бээлий
hjuk	өвдөгсөгдөн
trif	газарзүй
djit	Системтэй
pson	дийлдэшгүй
mwis	хөрөнгөоруулалт
cwec	хэламаар
hdek	шашныбус
blik	бүргэд
sloc	сэтгэлзүйн
brap	хэрчим
jlat	дээрэмчин
dros	тунг
slam	хулд
pwun	курс
gwik	соронзон
pcop	насос
myen	адил
ksen	хүчилтөрөгч
mrap	мастеруудад
tfot	гэрчилгээ
ksus	бөөгнөрөл
trok	дэвэргэсэн
tloc	rung
zyan	сэлүүр
nlun	нэвтрэх
hlop	дуран
jlin	зөвбичгийндүрэм
lyut	үүлэрхэг
hsof	аялж
fyik	виски
klet	харьцангуй
hwof	бургас
hlum	тэмээний
myet	сонирхогчийн
klis	тусгаарлах
hbaf	намтар
gwac	илжиг
hwum	цууүг
pwik	хэтийнтөлөв
pron	дэмжсэн
myes	сарбүр
mwen	бодлыг
kfic	амралтын
klek	дарах
cwon	зууван
lyak	уянхатан
kwon	тольбичиг
hjam	сонирхогчийн
rwon	Солонгийнөнгийнхавтастай
crip	үүгээр
zwan	гарч
srok	редакцийн
craf	биемахбодийн
tlok	сав
brip	эрвээхэй
tfap	зураг
jwat	ихэр
pros	үйлажиллагааны
psun	Omen
clet	золгүй
hbus	хулсан
dyas	Дилер
klun	хуримтлал
jlit	саналнэгтэй
hdom	хардарсанзүүдшиг
kron	нүүрстөрөгчийн
hzam	саатал
cyot	сонсогч
hmem	музей
lwam	цагаантолгой
fras	тарсан
psoc	цоолтуурын
hgum	бохь
brek	тоормосны
glit	тогтвортойбайдал
frun	ялзрах
gris	түрэмгий
mroc	үрэлтийн
bzit	аалз
plut	төмс
glac	шунал
gzac	үржүүлэх
prun	эргэх
jlet	хуанлийн
nyim	нэрдэвшүүлэх
tlos	ихнаяд
slut	салат
fwit	нааштайсэтгэлийнбайдал
pyen	програмууд
nlon	нэрлэсэн
dren	харуулах
drun	сэтгэлханамжгүй
cyok	мөрөөхавчлаа
hfop	хөлбөмбөгийн
ryac	түншлэл
gzin	анхдагч
hgip	байцаа
tyet	Атлетик
hdof	ideophone
hwup	үнэлжбаршгүй
lwek	хөшүүрэг
syec	сенатор
jyak	зохицох
mlim	шоргоолж
fwic	үрдүнтэй
gzit	жирэмсэн
blas	хамааралтай
jrin	өдөртутмын
gwak	шагай
drik	хачин
prif	хувьсагч
jwit	олонянзбайдал
krip	ялгаварлангадуурхалт
ryot	awed
nwut	явганхүний​​зам
kcif	идэвхтэй
jrak	мэлхий
twek	exessiveхэрэг
psot	цагаатгал
pfon	хөвөн
sluk	хэрэм
nlim	irrealisсэтгэлийнбайдал
ksaf	хомсдол
glak	галтуул
plen	тэнцвэрт
kfaf	ороолт
kyon	ашиглах
jlik	геологийн
psop	гадаадпаспорт
kfis	оронтоо
fyon	уртхугацааныбонд
nram	ёссуртахуунгүй
hbuk	жигнэмэг
gras	транс
hyos	түргэнсэтгэдэг
flim	кино
plet	таблет
rwam	атомын
blis	ваниль
zlit	ДОХ-ын
fyut	нягтняхуурханддаг
crim	пирамид
hjif	хуульбус
crif	shyness
lwap	товшуур
tyon	одонорон
mrim	Maze
drut	тайлбар
nrim	тэтгэлэг
kruc	ястмэлхий
kwam	зөвлөх
jrik	крикет
dlut	илэрхийлэхэд
pyot	Тагтаа
dyon	дасанзохицох
prap	оператор
bzin	тэмдэг
tyek	гурвалжин
trec	нярав
nron	устөрөгчийн
pyet	хэвлэгч
tsok	багалзуурдажалах
zyin	архаг
slek	унадагдугуй
jyin	инженерийн
ryas	дамжуулах
zrak	тэнхрэх
nyas	бүжигчин
gric	шилжилтхөдөлгөөн
zlak	зөрчсөн
tces	теннисчин
hjun	салхитай
twen	нэхэх
kyet	цуглуулагч
gwit	нуруу
kyot	хөвч
fwin	давтамж
tfuc	Суурьмашин
dlet	сан
pfik	сэтгэгч
bjet	төсөв
trek	стратеги
kros	кварц
gjit	хайч
gwic	өөрчлөх
frik	онолын
tluc	алчуур
pruc	эргүүл
glic	мөсөнголын
krun	бүрэнбүтэн
bjin	таамаглал
tlaf	оролцох
tfet	үйлдвэрлэгч
bras	хажуугийн
dwik	шүүгдэгч
clec	яндангийн
cres	шатрын
tcef	интор
tcom	алдах
nyot	орчуулагч
tyok	ачаанымашин
cyip	давуу
grot	гичийн
bris	утасгүй
nlam	дуудлагахудалдааны
slif	шигшүүр
hgos	зэв
swoc	Тогтвортойбус
jyat	дампуурсан
slum	Ислам
hjes	хүнамынтооллого
dzat	tiptoe
slun	түдгэлзүүлэх
nwot	тасралтгүй
gyic	гитар
pfas	хэвийсэн
zyik	цайрын
blen	гялалзсан
hyem	хайлаас
hnep	тэмцэлдэх
nyut	сүлжмэл
ryam	төлөөнийнэртэмдэгт
clim	амтлагч
jret	хурц
tfon	элэглэх
jwac	жава
hrep	жор
dyac	франчайзын
myip	метр
rwis	арьсөнгө
hkem	сүүлтод
nwon	инновацийн
zwin	хориг
dyis	Дундадзууны
mrec	боршувуу
fyot	тайлбар
mlon	хэмжих
pfis	соёрхонбатлах
rwot	тойрогзамд
hfok	frugal
glof	гольфийн
zron	тэг
hzip	зип
hwom	оронгэргүй
bjic	бохь
pcim	биелүүлэх
hjip	чип
bwac	эвшээх
mlos	мэнгэ
mrip	ваар
bron	үрхөврөл
ksoc	хасалт
cyum	мөөгөнцрийн
jyan	Захиалгань
plim	харчавга
mwet	оршуулгынгазар
ryet	төгсөгч
glik	услалтын
plap	капиталист
tsif	мэдрэмж
gyak	акул
djon	анхдагч
nwun	цагаа
cles	бодитбайдал
dris	улам
hkef	кафе
blus	түргэнийтэрэг
blap	түрийвч
bjak	экстазын
klim	ярвайлт
gyac	эрдэмтэн
jyit	бусдадалагчлалгүйхандах
dzit	бодит
bwak	гадаа
dyot	радио
bwon	буурцагны
fris	албанбус
klut	бодох
tfek	Steak
nrok	азотын
zyat	сахлын
bram	mutter
ryis	танилцуулах
nlip	дүншинжилгээхийх
nros	ялгаатай
hcof	хувцастайлах
tfif	урамшууллын
kroc	суваг,шуудуутатах
hdum	еврэй
pses	хүлээнавагч
plok	бүрэлдэхүүн
lyet	линз
pwek	pegativeхэрэг
kfas	хортхавдар
pwen	ломбардны
nrun	сануулах
clek	урсгал
pcif	vindication
glas	нарийнтөвөгтэйбайдал
zwit	дуугардаггүй
kces	хүрэлцээ
crem	Жижиглэнхудалдаа
grap	шүүрэх
kwip	оролцох
dyut	хөнгөлөлт
crus	шатлан​​захирахёс
gyet	хаш
gram	snarl
kyip	гүрвэл
nyet	Бичигт
crop	хүрхрээ
glon	галлон
mrok	шумуул
fluc	чөлөөтэйярьдаг
dwic	хазайлт
slec	судлаач
srec	минутанд
blut	бооцоотавьжээ
myok	мозайк
tlek	залгуур
nruk	халдварт
nwoc	үүнээсхойш
bjut	суулт
hges	жирэмслэлт
twoc	хүнсний
kyos	коммунист
mrek	гайхуулах
clip	contrition
pwok	prosecutiveхэрэг
dwot	дарангуйлагч
zyac	preoccupation
jlic	хиймэлдагуулын
slop	гэрийншаахай
ryip	пропорциональ
psim	ойролцоо
byet	ажилгүй
cyop	хобби
rwun	шалгуур
blop	чийдэнгийн
syok	дэмжигч
klos	хлорын
lwot	хлорид
byic	бактер
lyik	наалттай
blok	биологийн
jlac	feign
bret	байтын
krif	шүүрлийг
blet	балет
nruc	шээс
tsus	сармис
dyak	дунданги
tcem	хавчаар
cyoc	хэцүү
trep	гүзээлзгэнэ
dlun	бохирдол
hlup	зургийнцомог
hbep	бейсболын
praf	зерчих
pwis	participle
grek	гаражийн
kruk	туслагч
hfof	фосфор
rwut	бүтцийн
myam	гимнази
krec	кран
jras	гүйцэтгэгч
zrik	мэдэгдэх
blam	латин
klip	бичил
hwef	цалингүй
zlac	банан
gret	генератор
lwuk	хавирга
nyek	никель
blos	автобус
sles	бичигзохиолыгхянагч
tlif	хавтан
kses	Хиам
mwot	улаанлоль
lyot	авто
tsom	калийн
brut	виртуал
djap	алгебр
hjok	ерөнхий
kfen	үзэлбаримтлал
pcok	оптик
bzut	budge
syek	ажилгүйдлийн
mruc	Катерпиллар
bwas	вэбхөтөч
klif	кальцийн
rwet	алсынөнгөрсөнцаг
srif	түүхэнцаг
hwem	спектр
syom	натрийн
tyos	итгэмжлэгдсэн
jyic	барьцаанд
hguk	хулуу
dwun	үрчлээний
swip	баяжуулалтын
tlec	Шалз
blaf	хүчингийн
tsem	Атейзм
mloc	хяналттавих
gyot	нөхцөлт
trop	шалгалт,илрүүлэлтийн
rwap	улирал
hjep	жендэрийн
pyim	цагаан
dlon	хосдугаар
pcep	уушигны
twuk	угаах
tyec	хаяг
syup	мундаг
trom	тэргэнцэр
nyip	ороннутгийн
glis	бензин
gjik	бөөрний
hjos	хараахяналтгүй
hjuc	өлгий
swek	хэтихачаалалтай
psek	хүнцэл
twok	статистикийн
tsep	царцаа
slos	социалист
nwim	мэдрэхүйннотлохсэтгэлийнбайдал
tlop	ширээнийбүтээлэг
trus	маргаантай
pwot	уяа
djot	хурдас
nloc	snub
mwon	Мандарин
hjek	Моринтойруулгын
crom	хамтранажиллах
myon	хатгаа
twec	situate
ryek	пуужин
dlic	ногдолашиг
kwet	Тэшүүр
bwen	хийүзэгдэл
plon	хувь
syon	хахуульдэлгэрсэн
djis	дижитал
byut	гичий
hyep	зовхи
dwon	диагональ
byis	ухамсарт
brec	хөмсөг
cyec	найтаах
hwop	ваттын
clus	инээдтэй
kfun	эзэмшлийн
nwum	хиндуйзм
fyim	дүрвэгч
cwos	явагч
tfoc	twinge
pwon	уураг
sraf	өөрөөсэтгэлхангалуун
hbom	бөөлжис
gyen	ген
drim	нэгдүгээркурсийнхээ
trem	үүсгэгч
tsup	хагалах
slok	социологи
kwoc	Сквош
bwam	Сонгогч
mlok	хөдөлгөөн
kyen	бүснутгийн
hmop	хөдөлгөөнөгсөх
rwek	буцаан
kfup	шоо
grok	лууван
drap	entrap
lwis	молекул
ksuc	нягтланбодогч
tsop	өмхийсамхай
kyok	Өргөстхэмх
nroc	гаарсан
jlot	уусгагч
psof	фосфатын
hgif	fascinate
kfim	шүлтлэг
psos	гимнастик
pfen	шалгах
kcom	эдийнзасагч
krom	таслалаар
tluk	wriggle
hyom	иод
nwuc	хөдөлгөөнуруугазар
gjac	зулбалт
pcom	хонхорцог
dzic	загварзохионбүтээгч
grun	bragging
dzot	хандивлагч
hzek	манганы
kfot	гар
jlas	найдваргүй
lyim	элит
jyen	иен
pcaf	хаалтанд
rwip	регбигийн
blip	библийн
kyoc	шалтгааны
lyon	шархлаа
flis	inflected
nrif	идэж,
kfam	квант
swes	цамц
lwon	хувьслын
drec	хуулрал
gjap	рашаан
lyec	шугаман
tyom	сурьма
pwuk	superessiveхэрэг
flaf	альфа
myim	дархлаа
pcek	хулгайлах
bjac	шарайрагныүйлдвэр
bzac	abridge
bzak	оймс
twes	телевизийн
dwut	баримтаткино
ksom	Космос
lyis	ойнажахуй
lwim	хөнгөнцагаан
ksok	зурхай
sruc	хурдасгах
dlif	далайнгахай
byik	алуурчин
tfec	бичгийнхэрэгсэл
hjaf	хөхтөн
ryok	протокол
dwis	давхарисэл
jlon	бүдүүн
brus	хүндсуртал
gjak	галактик
lyip	эмнэлзүйн
ryem	Radium
href	ховордсон
prok	хөргөгч
slep	satyr
dret	давталтын
kluk	археологийн
dlis	idiosyncrasy
kfip	хүлээнзөвшөөрөхболомжгүй
mlec	массаж
pfif	тодорхойлолт
nrec	мэдрэхүйн
pfet	танилцуулага
hzoc	үндэс
dlam	хамгийнтохиромжтой
nlec	антропологи
kluc	амттай
dyet	седан
tyif	transitive
krus	cower
nluc	наранцэцгийн
lyun	ионы
zrot	шилжүүлэнөгөхтухай
ksif	гажуудуулах
psif	ялгаралтын
crup	давхцал
fret	илрүүлэгч
grut	инвертийн
ksec	ангийнхан
jric	тэнэх
mrop	богинодолгионы
srus	суудлаасогцруулах
gyas	үсчин
floc	ардынаманзохиол
plek	хялгасан
nwop	өгзөг
nrom	хянагч
twos	терроризм
lwok	уриа
dwet	цагхугацааөнгөрөхтусам
slem	sublimate
grip	шарах
gwas	Хөөх
kwok	кобальт
gwon	овъёос
hdop	хөдөлгөөнupriver
glam	гургалдай
bwot	үхрийн
bren	гэдэсний
byot	видео
bjik	эсэргүүцэх
kwim	асуултхариултын
cwek	хоккей
grif	партизаны
hgem	магнийн
hyes	сурталчилгаа
fram	эмийнсан
nwos	unambitious
ryap	шинээрбайгуулах
cwim	найдвартайбайдал
klep	замаг
psec	нөхөнтөлөх
djic	дэлхийдаяар
kfut	Curfew
crep	гамбургер
frim	теорем
gjas	галавалцаж
hdef	дебит
ryum	ураны
pluk	үнэлэх
krop	зохицуулах
nraf	албантатвартөлөгч
tyes	нэгдсэн
plip	opine
hgom	гамма
hgus	коэффициент
cwuc	халаагч
zret	хасах
nles	шинжээч
trof	intransitive
hmof	Супермаркетын
hzim	висмут
dzac	хоолны
psok	илзахидал
blon	нийлэлт
djet	Digress
ksum	хувьцааэзэмшигч
mrup	нян
clif	Helix
cloc	морфологи
tfes	caterer
gjis	жинсэнөмд
jren	шугам
tlep	өгөгдлийнсан
kcup	купон
glot	хүчдэлийн
glut	тооны
srep	кибероронзайн
nwes	хөрөнгөоруулагч
ksef	рентген
bzis	виз
frut	дэдбүтцийн
nyuk	Firefly
dyik	илрүүлэгч
plec	гагнуурын
brom	бром
plop	палладин
zlik	цахиурын
flut	вольт
ksop	гоосайхны
gjun	үсзасалт
kfok	зогөсох
hpof	попкорн
hzuk	амьтны
nyoc	цаадутгаараа
jwak	йогийн
brim	бари
kles	толгойг
mwam	тиймээ
fwik	Firework
djas	жааз
dyim	дуу
tsum	гянтболд
drip	dribble
lyaf	хүүхдийнтэтгэмж
prom	програм
nrup	оруулах
hfes	reflexive
rwaf	удвал
dlen	бичигбаримт
byas	вакцин
fron	героин
dluk	таслах
dyun	оношлох
flap	хавтас
kfet	катодын
dlim	үзэлсуртал
prek	зогсоол
syoc	Хормынхувилбар
slus	хүртээмж
nlos	anticlimax
mlen	селен
pres	гадаргуу
hlof	хүхрийн
nlek	Одоогийнхамааралмаркер
gwot	нисэхонгоцныбуудал
mwip	imposter
klop	жоом
kwom	хромын
hl6t	литрийн
nwec	Гэсэнхэдийч
glip	мөчлөгт
nrop	цалингийн
crum	даавар
dlep	хөгжүүлэгч
frot	perforate
bwoc	хорлонсүйтгэх
fwis	феминист
djok	коньюгат
draf	шинэчлэх
trum	хэтдаврагсдын
graf	алгоритм
lwes	лазер
mlem	миллиметрийн
flen	уянхатан
zlot	анод
swok	snuggle
klec	ядарсаннохой
pwim	цагийн
htuf	туна
fyis	үйлдвэр
lwet	мэдрэмжийн
mrem	хост
jwic	залуужих
droc	жагсагч
clem	Гелийн
dzik	хэлний
psem	плазмын
hjom	хромосом
rwuc	дэс
tyus	бүхэлтоо
klom	км
hfos	факс
nwek	генетик
jrap	халив
zwas	appetizer
bwok	цэцэгтбайцаа
dwap	адаптер
syem	спам
blek	вектор
tlus	тактик
pyif	тодорхойгүй
cwoc	зүгээр
mrep	ампер
hbem	витамин
hxan	Хаалгач
hxut	татаас
hk6m	кадми
hxin	simultaneity
txin	титан
kxin	кг
klum	copulate
xlis	Hourglass
hqak	syntactic
hxat	бүтээлч
hxik	ином
hxas	ажлынбайрандахь
bxon	борын
dxin	ороомгийн
hxit	нисдэгтэрэг
tlum	теллур
txit	эцсийнхугацаа
kxat	исэлдүүлэн
hvik	уялдуулах
nluk	аналог
nyem	см
hm6t	молибдений
hl6m	лити
ht6t	мультимедиа
xlit	илчлэг
ryop	робот
pxas	эмзүйч
hxak	гэрийндаалгавар
lwif	locative
grim	логарифм
hqat	Mantis
qlit	экологи
xlik	боловсронгуй
mlep	загвар
hqit	цацрагидэвхит
kxim	килограмм
hxen	renter
hxot	overeat
kyif	Хувилагч
fwet	төлбөргүйпрограм
txet	дэдхэсэг
hs6n	дараалсан
hxet	сэмчагнах
xrat	үсзасах
hqan	хурааж
hr6t	Iridium
bxat	зурвасынөргөнийг
dxet	ширээний
hxis	экспоненциал
hxok	төвбайр
hxek	муухүндитгэх
srem	cerium
hp6t	partitive
pxik	partitiveхэрэг
kxet	хуурцаг
pruk	супермаркет
hvit	хүсэл
xlin	офлайн
frip	шифрлэлт
hvep	overpay
hxon	хамгийнсүүлийнхэлбэртаваачиж
kxit	нэмэгдүүлэх
hqin	семинар
tr6n	стерео
ht6n	тогтоогчийг
hvat	удахгүйболох
sl6s	цельсийн
hn6n	неон
ts6t	бодитцаг
hvin	оновчтой
pxat	Newsstand
myoc	модуль
ps6s	гоймон
bwek	еерсдийн
dlok	люкс
fraf	галтханань
hr6k	олдворуудыг
txat	үдийнхоолны
hqon	хахуунцэцгийн
pxun	плутони
ks6n	ажлынстанцашиглахгүйгээр
slef	шат
xrit	биехамгаалагчгэхмэтчилэн
hvut	overcrowd
xrim	иттри
hx6t	томруулсан
hqum	хэрэглэгчийннэр
hl6n	наймааэрхлэгчид
gron	аргон
pxan	сурталчилгаа
hvac	аягатавагугаагч
xlan	даяаршил
txon	долгионы
xrik	дахинболовсруулах
hxap	ажил
hxac	дахиначаалсны
xyat	гепатит
cwep	цалингаараа
hxos	torus
txif	typeface
qlat	үлхөдлөххөрөнгө
txot	дунднамар,
hxam	миллиграмм
pxis	пиксэл
pwif	Урьдчиланхарах
txam	тантал
myek	термодинамик
hbop	эвдэх
hqot	ууссан
xlic	тэргэнцэр
gxit	төрлөөрустгах
hvan	галтүймэртэйтэмцэх
glim	gallium
pfop	гарчирэх
hzum	циркон
xlon	утсаар
qlin	шугаманбус
kxam	сканди
blim	берилл
kxik	тохируулах
nr6n	мэдрэлийн
hpef	predicative
hruf	чиглүүлэгч
kxan	чинзйлийн
hxic	удирдамж
xlip	гарбөмбөг
dyek	дибагхийх
hxop	лазерын
qrot	нейтрон
nwip	ниобий
hs6t	ариунцэврийнөрөө
grem	германий
tles	metalloid
hp6k	prolativeхэрэг
qyin	биологийнолонянзбайдлын
txak	антибиотик
mlun	immobilization
txan	actinium
xran	сансрыннисгэгч
dres	шахсаныгзадлах
tr6t	харьгаригийн
hk6t	октет
hxus	нээлттэйэх
xlat	crackpot
mraf	марафон
ts6n	дундхавар
ht6s	Аутизм
nlif	ionize
txut	notability
hm6n	ялгаруулах
kxis	клипурлагийн
xrin	хийлгэж
xren	шилжүүлжбайна
bxak	Хавчуурга
pfos	дэмжсэнүгхэллэг
hvis	бохирын
hd6n	хуваарь
brum	удирдахзөвлөлийнхурлын
hqis	chauvinist
hk6n	эмхэтгэж
xyit	өөрчлөхтүлхүүр
xyin	хоёрхүнтутмыннэг
hxun	болговол
hvas	үүрэг
glok	блог
hvak	meandering
pxit	IPхаяг
hvet	хажуугийн
xram	гүргэмийн
hc6n	илэрхий
qran	Коран
zyen	ксенон
hqas	андгайлна
bzas	blase
hj6n	төрийнбусхүний
hnof	nonremittal
txas	боловсруулагчид
hbum	Буддыншашиннь
ts6s	маргалдсаныг
pxin	найрлага
hr6n	хүнс
hxim	дундзуны
dxit	дунд,өвлийн
hxaf	ухах
nlus	houseplant
txap	байдалбар
vrit	Ghostwriter
kxak	эргэнтойрондтэнэг
bxin	Хүнийбие
hqik	Борооныцув
hxes	Hertz
hxif	hypnothize
xras	цагийн
pl6k	paralegal
dxat	rashness
hxip	эсрэгбиеийн
vrat	шорт
hqek	дахинсэргээх
qrit	туйлшрал
pxot	шуудан
hxom	хэрэггүйзахидал
hqic	шүүмжлэгч
lwun	цэнхэрJean
hp6n	боловсролт
dxan	залгаж
xrak	жүжигчинүүрэг
dxak	осол
hven	сав
mwap	комикзурвас
qlan	өнгөсохор
xros	undressing
srom	танхим
hc6t	чатлаж
qrat	дээрээсньдоошхүртэл
hn6t	дарангуйлдаг
hqet	вэбсайт
fres	fundraise
froc	хуурамчаарүйлдэх
xlak	Холбоос
vlat	volubility
dvan	disembarking
gxin	Ялагдашгүй
ryes	хүлээнавагч
kxot	холболт
xyan	узэлбаримтлалынхурээнд
vlan	сурталчлагч
ryom	торийнатомын
hluf	настай
hquk	тарих
lyum	thuliumатомын
tyem	terbiumатомын
hp6m	praseodymium
txic	Нүүрхуудас
mros	автомашинч
dyam	сэтгэлатомын
pc6n	туршилтынтоо
nyos	ирсэнмэйл
pyek	проектор
kxon	krypton
hxuc	аврах
qrik	төвтэйхэрэг
xwin	туршлагагүй
kxic	галунтраах
hvot	схемд
dxot	тараг
hqut	гарах
pxen	хэлтсийн
drok	зорилгогох
flon	гарутас
txos	дунддуухоолой
hqok	ташуухэрэг
xwik	өвчтөнхэрэг
hx6n	prehodiernal
txik	долооворхуруу
hqen	илгээгч
mlap	үзүүлжчадахгүй
hvun	тулгуурлаж
hvon	Элэгдэх
vran	шууданзөөгч
pfes	профессор
pwip	яруунайрагч
hqam	гарчажиллах
gxat	хуульёсны
ks6t	нөлөөлөгч
vrin	элсүүлэгч
kxip	клипньТУЗ-ийн
sr6n	заслыгбуруу
vlit	үнэлгээний
tyup	хотынзахын
mrom	morpheme
xron	чихэвч
gxak	зардал
hrof	Трояныморь
xlas	саажилттай
dzet	redecorate
txac	бууж
xrot	ашиглагдаагүй
txis	цэгматриц
syif	Ришинэгж
xrac	гайхалтай
brif	хоёртынүнэцэнэ
dlos	терлийнхэрэг
txun	шинжчанарууд
dvat	ааштаймуу
psom	эхнийгар
gjek	өөруу
nlem	массыннэгж
qret	жижиглэнхудалдааныдэлгүүр
txip	гуравдахингазар
dlek	тустусдаа
lwut	урсгалынодоогийн
dxis	эрс
hs6m	цезийн
vlak	railcar
hn6m	netium
kxap	картон
bxan	явах
myem	Тавдугаарсар
gxik	иргэнийэрх
hxoc	нисэххүчин
xrok	хамтажиллагч
kr6t	дэлгэцийн
txok	автоматаар
hxep	тэшүүр
srop	ухаалаггарутас
pxak	тагтүгжих
hk6k	ардындуухөгжим
hl6k	eulersдугаар
pyom	Полонийнатомын
xyam	таллиатомын
hvic	довтолжээ
lyok	locativeхэрэг
xlot	үүссэн
txen	дахинтайлагнах
kxac	сөрөг
qrak	strikebreaker
hbup	усанбассейн
txuk	богинохолбоос
tsef	шовгор
bxit	вэбхост
ksem	зөвхөнунших
byim	rubidiumатомын
hvam	ванадийатомын
lw6n	лантан
frum	фторынатомын
nyom	Neodymium
mlom	multalдугаар
kxas	хувийн
xret	terabyte
hs6k	Хайлтынсистем
frus	corroding
gxan	галактикхүйсийн
vlas	хоолойндууавиа
glet	хийндөрөө
hvim	-ийнажиллахүеийн
bxip	зурган
qrin	одхүйсийн
bvak	abessiveхэрэг
pxon	боломжгүй
dvik	adessiveхэрэг
dvek	agentiveхэрэг
hlef	агентгох
kwek	хэргийн
kxen	нийтлэгхүйсийн
ht6m	ишлэлхэлбэр
tsuf	транстоонынэр
hf6n	зураглалыг
tc6t	шуудобъект
gvik	ergativeхэрэг
gxon	хуваагдал
ksep	хүлээнавагч
vyin	кинотеатр
pyos	идэвхгүйдуухоолой
hnef	хязгаарлагдмалүйлүг
xwit	үндсэнобъект
hqim	gnomicсэтгэлийнбайдал
jlak	нийтэдхэрэглэх
vrik	эцсийнхэсгүүд
qyan	зохиомолнэгж
kxaf	гэрлийнхурд
xyic	фишинг
qyit	чухалцэг
hvek	evitativeхэрэг
bvik	subessiveхэрэг
hzes	эзэмшижхэрэг
prus	компьютерийнвирус
ples	процессор
pxif	цагдаагийнофицер
dvak	lativeхэрэг
brun	хетчийн
tsi_k	antessiveхэрэг
tyum	rutheniumатомын
vyak	adverbialхэрэг
pxim	Ерөнхийсайд
syum	стронцийнатомын
sy6n	suspiciousness
hy6n	жендэрийнхөдөлгөөнд
pxac	ойлгож,мэдэрдэгбаярбаясгалан
vlin	Тээврийнхэрэгслийнжендэрийн
qwin	ашигтмалтмалынхүйсийн
hr6s	лавлагаа
tf6n	принтерийн
xris	Хэрэглэгчийнинтерфэйс
hw6n	тангарагөргөх
xlen	хэламаарнэрүг
pyec	хүснэгттэй
vlim	виртуалсанахойн
bres	үгпроцессор
hqip	үүлтооцоолох
vlic	виртуалмашин
pfam	спамчин
dyap	Хоёрдахьхэл
txek	nthэх
dxen	мэдээлэлуулуурхайн
byip	Бизнесийнхүн
hs6c	өөртөөитгэхитгэл
txim	иш
hb6t	үйлявдлынөөрчлөлт
hdem	домэйннэр
dxon	өөрөөрүйлявдал
lwaf	флэшдиск
sl6t	crastinalцаг
xyik	уяндиск
fyif	reflexiveдуухоолой
bvin	Орчлонертөнцхүйсийн
hm6p	эх
tfip	transitiveүйлүг
jlen	газарньхүйсийн
xrap	Судал
tc6n	судалгааныхүйсийн
sl6n	урансайхныхүйсийн
xrek	өвчтөнгох
xwan	хийсвэрхүйсийн
dxif	видеохурал
dyip	шуудбусяриа
zrek	exocentricхэрэг
hvuk	өдөөсөн
xwat	өнгөрсөнperfective
hr6m	rhenium
txaf	түргэссэн
hmef	шударгаүйлүг
tx6t	текстзасварлагч
txes	хамтыннэрүг
bvat	mistreating
bvuk	absolutiveхэрэг
ry6t	радиан
vlis	виртуалбодитбайдал
qren	гаригийнхүйсийн
gvak	дүрмийнхэрэг
bxok	халзан
mrum	компьютерийнпрограм
ps6t	үйлдлийнсистем
hfom	phoneme
tlem	Зөвхөнсанахойуншсан
pwam	суухаас
kfif	үндсэнbenefactive
qwit	бодитзүйл
nlaf	угсралт
nwok	ассоциативхэрэг
dzas	dissatisfy
swuk	тодотголыгхэрэг
syos	нэгтгэн
kr6n	цахилгаангүйдэл
dvin	амьгүйхүйсийн
pxom	propositiveсэтгэлийнбайдал
vris	харилцандуухоолой
rwos	аэрозол
dr6t	distractor
ht6k	харилцаахолбоо
slaf	олоннийтийнсүлжээ
lyuk	дараалсанзаалт
qras	албантушаалтнууд
ty6n	teminal
gwet	Удахгүйирээдүйцаг
hp6s	applicativeдуухоолой
tsof	antipassiveдуухоолой
ht6p	continutiveасуудал
hn6f	necessitativeсэтгэлийнбайдал
pfip	идэвхгүйparticiple
glap	самбарын
sy6k	existentialзаалт
qyat	гэрэлтэгчэрчим
hy6t	дүрмийнзорилго
vyan	зарлах
sluf	singulativeдугаар
dvit	хэтиххугацаа
qyak	Нэгаргахэмжээүйлүг
bzik	Физик
xlet	тодотголыгзэрэг
hqap	одоогийнparticiple
qwat	бодисынхэмжээ
qyik	холбоххэсгүүд
sr6t	даралтатшингэн
hfem	epentheticmorpheme
tl6t	алсынирээдүйцаг
mrif	микрофон
pcuk	postpositionalхэрэг
tfim	санамсаргүйхандалтсанахой
fwim	ethium
ly6t	allocutiveгэрээ
hvap	гүйлгэхбар
hfep	frequentativeасуудал
bvan	хуваарилалтынтөлөөнийнэр
fyun	бутархайтоо
xyas	арилгажбайна
hvif	үйлүгтамгалах
xyis	Өнгөрсөнидэвхгүйparticiple
tl6n	Төвболовсруулахнэгж
tfok	locativeчиглэлтэйхэрэг
qwan	Түгээмэласуултууд
