ni	पुरूषवचनानुसारनबदलणारेक्रियापदाचेटुयुक्तकिंवाटुविरहितरूप
na	कर्त्याचीकेस
ka	द्वितीयाकेस
ta	विषयकेस
ca	हॅलो
wu	संबोधनविभक्तीकेस
kcah	भुकेलेला
ti	षष्ठीविभक्तीकेस
ci	विशेषण
wa	आणि
mi	मला
sa	आपण
nyah	आम्हाला
ya	तो
ma	गंतव्यकेस
yi	चतुर्थीकेस
li	वास्तविकमूड
tu	deonticमूड
cu	सशर्तमूड
si	epistemicमूड
yu	कारणीभूतकेस
nu	आतीलसंदर्भ
pa	व्यक्तीसंदर्भ
tyah	स्वतंत्रखंड
la	अवलंबूनखंड
fa	perfectiveपैलू
ki	गेल्याताण
ne	मर्दानीलिंग
mwah	comitativeकेस
ra	उपस्थितताण
pwah	benefactiveकेस
swih	essiveकेस
no	negatoryक्वांटीफायर
pi	पृष्ठभागसंदर्भ
da	adpositionalकेस
te	स्थानकेस
to	जागासंदर्भ
ga	मार्गकेस
ri	प्रश्नार्थकमूड
ba	आणिकिंवा
ku	विशेषकिंवा
so	स्रोतकेस
pwih	अपादानकेस
ksah	शेजारी
tsah	भावनाव्यक्तकरणारा
ko	खंडशेपूट
pyah	परंतु
wi	सार्वत्रिकक्वांटीफायर
ji	नाजूकलिंग
pu	अनेकवचनसंख्या
bi	भविष्यातताण
co	सामाजिकसंदर्भ
me	imperfectiveपैलू
klah	तेथे
twah	नातेवाईककेस
twih	illativeकेस
di	दिशादाखवणारामूड
tlah	वैकल्पिकक्वांटीफायर
kyah	काय
tcah	प्रश्नशब्द
ja	दुवा
cyah	व्यक्ती
clah	इतर
do	संख्या
tlih	खंबीरक्वांटीफायर
se	वेळसंदर्भ
myah	ऐहिककेस
tyuh	फक्त
tcih	आग्रहकरणारामूड
tyih	पूर्वलक्ष्यीप्रभावानेपैलू
lo	volitiveमूड
cwah	नंतर
nlah	alienableताब्यात
nlih	inalienableताब्यात
cyih	चर्चामूड
lwah	perlativeकेस
pfih	पुरोगामीपैलू
tsih	येथे
ce	अंतर्गतसंदर्भ
pcah	देखील
lwih	delativeकेस
swah	semelfactiveपैलू
nyih	निओ
fu	लक्षकेंद्रित
plah	प्रेम
po	paucalसंख्या
kyih	कारण
ksih	कार्यकारणभावकेस
gi	नाव
tfah	योग्यनाम
crih	दृश्यमानसाक्षीसंबधी
kceh	चांगले
dwih	desiderativeमूड
wo	शब्द
srah	पर्यंत
tweh	terminativeकेस
nwih	inessiveकेस
pcih	अत्यावश्यकमूड
crah	विश्वास
ro	राज्यसंदर्भ
cwih	आशा
kwih	factiveसाक्षीसंबधी
fi	परत
psih	निवडमूड
tseh	संभाव्यमूड
lweh	allativeकेस
nrih	anthropicलिंग
tceh	त्याचविषयमार्कर
re	विविधविषय
croh	भीती
mrah	समजून
cyuh	यातकाहीशंका
twuh	संशयास्पदमूड
myih	सुंदर
lyih	व्याज
flah	counterfactualसशर्त
we	vialisकेस
clih	थंड
pyih	शांतता
su	वगळता
kwah	इच्छा
le	लांबी
bo	शक्यता
mlah	समस्या
syah	स्मित
slih	झोप
zi	उद्धृत
twoh	quotativeकेस
mo	समावेशकव्यक्ती
kcih	कृपया
rwih	precativeमूड
mrih	विनयशीलनोंदणी
rwah	संभाव्यपैलू
cyeh	आश्चर्य
go	म्हणीसंबंधीपैलू
tsoh	आदर
za	inchoativeपैलू
jwih	jussiveमूड
mwih	परवानगीमूड
sloh	यश
prih	खाजगी
de	व्यक्तीदर्शककेस
tcoh	वेदना
ryah	हास्य
mlih	ज्ञानी
ye	मालकीचेमार्कर
ke	commissiveमूड
creh	व्यर्थ
mweh	completiveपैलू
nrah	उबदार
nroh	राग
bwah	असूनही
trah	गर्व
mroh	नैतिक
slah	आरोग्य
syih	सामाजिक
pe	समाप्तीपैलू
krih	जिज्ञासू
tfih	intensifier
fe	शेवटी
prah	बाजूला
trih	साक्षीसंबधी
nwah	साक्षीसंबधीकेस
srih	दु:खी
zo	प्राणीजीवनासंबधीचेलिंग
nweh	eventiveमूड
cwoh	त्याचकार्यक्रममार्कर
plih	गुणाकारात्मककेस
dwah	इच्छित
kcoh	थकलेले
drah	समाधानी
lu	सट्टेबाजीचामूड
frih	परिचितनोंदणी
frah	जखमी
mruh	विदूषक
djih	सहानुभूती
krah	आभार
cruh	लाज
fyah	वाक्यांशमार्कर
ryih	preordained
kruh	कडू
tyeh	मजकूर
kreh	क्रूर
tleh	hesternalताण
kfah	यज्ञ
dyih	द्वेष
cloh	कारणाचालिंग
nloh	आनंद
psah	निराशा
sleh	vegetalलिंग
nruh	निष्पाप
drih	वाहवा
sroh	क्षमा
brih	बेस
kluh	गोंधळ
bwih	आशीर्वादमूड
klih	अपराधी
grih	अज्ञान
nyeh	पुढाकारकेस
nleh	नम्र
dlih	विलंबअत्यावश्यक
proh	अहवालसाक्षीसंबधी
mloh	विषाद
du	असामान्य
jrih	संयम
freh	referential
kloh	एकाकी
kroh	मोहिनी
tcuh	उत्साह
kcuh	अनुमानाचामूड
xa	प्रवचनसंदर्भ
nreh	चिंताग्रस्त
pseh	पैलू
ge	एजंट
mu	सूचनामूड
byah	महत्वाकांक्षा
pcoh	गर्दीच्या
treh	थेटसाक्षीसंबधी
yo	धास्तावलेलामूड
cwuh	धक्का
tloh	अलीकडीलगेल्याताण
dlah	निश्चितलेख
cluh	कुरुप
myuh	विनोद
dyah	शरिराच्यामध्यापासूनकिंवाउगमस्थानापासूनदूरएदूरस्थभावनाव्यक्तकरणारा
rwuh	अत्यंतदक्ष
troh	imprecatoryमूड
dzih	दुर्लक्ष
swuh	assumptiveमूड
bzah	थट्टाकरणे
gwih	म्हणजे
dloh	hodiernalताण
dweh	delimitativeपैलू
kweh	विशेषव्यक्ती
truh	तापमान
tfeh	telicपैलू
lyeh	atelicपैलू
ru	प्रतिबंधकमूड
kfih	बालिश
cyoh	संशयास्पद
nluh	निष्ठा
cweh	सापळा
nwoh	सजीव
sruh	आनंद
ksoh	लैंगिक
lyah	आळशी
mreh	momentaneपैलू
pceh	फारवाईटवाटले
bjih	माजीमृत
pcuh	अनिश्चितता
xi	नेहमीचापैलू
blih	आम्हीकटिबद्ध
tsuh	क्षुल्लक
fwih	भव्य
grah	खुशामत
brah	अनियंत्रित
cleh	परोपकार
sreh	औपचारिकनोंदणी
pfah	फायदेशीर
droh	श्रवणसाक्षीसंबधी
flih	inferentialसाक्षीसंबधी
sweh	sublativeकेस
ksuh	घोषणात्मकमूड
pleh	वंचित
psoh	अजिंक्य
be	शाब्दिक
mwoh	तंद्री
kleh	म्हणणेखरेकरुनदाखवीन
glah	लोभ
kseh	होकारार्थीमूड
zrah	असंतोष
dyoh	idiophone
syoh	awed
gwah	जास्तकेस
zlih	irrealisमूड
zrih	माहत
byih	जूळवूनघेण्याचीप्रक्रियाकिंवात्याचापरिणाम
ryeh	सर्वनाममार्कर
fwah	साधा
bjah	हर्षभरीत
kxah	मनाचीशांती
gvih	pegativeकेस
pxih	सर्मथन
xrah	कालबाह्यहोत
tfoh	सदैव
kxih	पश्चाताप
ryoh	prosecutiveकेस
qyah	एकाग्रतेचाविषय
r6	कृदंत
txah	दूरस्थगेल्याताण
xrih	ऐतिहासिकताण
dxah	दुहेरीसंख्या
syuh	सुपर
vweh	overworked
n6	ज्ञानेंद्रियांचासाक्षीसंबधीमूड
bweh	व्यापणे
xlih	खूपआनंदी
txih	टोचणी
sluh	स्वत:चीसमाधान
txoh	गतीचढावर
xe	पूर्वलक्ष्यीप्रभावाने
pxah	अडचणीतघालणे
vwah	गतीउतारावर
xyih	एलिट
fleh	inflected
psuh	superessiveकेस
syeh	तीव्रकामवासनाअसणारामनुष्य
qi	सकर्मक
xruh	अंगचोरूनबसणे
zwah	व्वा
tr6h	गतीupriver
qwah	unambitious
xlah	जगभरातील
tyoh	अकर्मक
tluh	प्रतिसारालंकार
qa	चालूसमर्पकतामार्कर
kxoh	थकलेलेकुत्रा
rwoh	क्रमवाचक
ve	वेक्टर
kyoh	हजार
swoh	घडणारा
pxeh	वस्तूचाकेस
txeh	augmentative
dxih	विधेय
pxoh	prolativeकेस
pfoh	प्रोवाक्यांश
blah	कंटाळलेला
fyih	नॉनमानवी
xo	अभिनेताभूमिका
pc6h	चाचणीसंख्या
greh	पर्यावरणकेस
groh	ध्येयट्रिगर
dxoh	मध्यमआवाज
rweh	आडवाकेस
xwah	रुग्णकेस
xu	पूर्वhodiernal
xroh	बोलताबाहेर
ks6h	प्रयोजक
vi	बायनरीमूल्य
dleh	मॉडेलकेस
gjeh	आणखीतर
xreh	सहकारी
lwoh	ठिकाणकेस
ml6h	multalसंख्या
gjih	आकाशगंगालिंग
qlah	तारालिंग
bvih	abessiveकेस
dvah	adessiveकेस
je	agentiveकेस
t6	एजंटट्रिगर
kxeh	तेकेस
gxih	सामान्यलिंग
tc6h	उताराफॉर्म
ts6h	पलीकडेआकडा
ryuh	थेटऑब्जेक्ट
gveh	ergativeकेस
pyoh	निष्क्रीयआवाज
qe	मर्यादितक्रियापद
xwih	प्राथमिकऑब्जेक्ट
myoh	म्हणीसंबंधीमूड
vrih	अंतिमकण
va	evitativeकेस
bveh	subessiveकेस
dxeh	ताब्यातकेस
dvih	lativeकेस
tsa7h	antessiveकेस
dyeh	क्रियाविशेषणकेस
mleh	जिवंतलिंग
pfeh	संवेदनशीलआनंद
xleh	वाहनलिंग
qlih	खनिजलिंग
xloh	शाब्दिकनाम
dreh	दुसराभाषा
bvah	स्वत:चीआत्मविश्वास
qrah	बदलच्याकार्यक्रम
fo	विविधकार्यक्रम
sl6h	crastinalताण
fyoh	सर्वनामआवाज
bxih	विश्वलिंग
jlih	सकर्मकक्रियापद
kyeh	परिसरलिंग
txuh	संशोधनलिंग
s6	कलात्मकलिंग
preh	रुग्णट्रिगर
sr6h	गोषवारालिंग
nyoh	अप्रत्यक्षभाषण
zreh	exocentricकेस
kfeh	गेल्याperfective
jo	वस्तुनिष्ठ,क्रियापद
kxuh	सामूहिकनाम
bu	absolutiveकेस
qrih	ग्रहांच्यालिंग
kfoh	कोरbenefactive
kwoh	associativeकेस
pluh	उत्कृष्टदर्जाचाकेस
jrah	विद्युतचालू
glih	मृतलिंग
p6	propositiveमूड
vrah	परस्परांचाआवाज
lyuh	सलगखंड
gleh	लवकरचभविष्यातताण
lyoh	applicativeआवाज
ps6h	antipassiveआवाज
tfuh	continuativeपैलू
nr6h	necessitativeमूड
pr6h	निष्क्रीयकृदंत
sy6h	अनुभवजन्यखंड
qyih	अर्थतीव्रता
gluh	singulativeसंख्या
kwuh	जास्तकालावधी
xyah	एकचकारवाईक्रियापद
vlih	उत्कृष्टदर्जाचापदवी
djah	उपस्थितकृदंत
m6	रक्कमच्यापदार्थ
ti7	संबंधितकण
f6	epentheticशब्दाचालहानातलहानअर्थपूर्णअवयव
tli7h	दूरस्थभविष्यातताण
si_	postpositionalकेस
l6	allocutionकरार
k6	frequentativeपैलू
bzih	व्यक्तीदर्शकसर्वनाम
tu7	फ्लोटिंगबिंदूसंख्या
vo	क्रियापदलावणे
ki7	गेल्यानिष्क्रीयकृदंत
ta_	ठिकाणनिदेशककेस
