hnit	infinitive
hnak	निस्क्रियगर्नुहोस्मामला
hkak	कर्ताकारकमामला
htak	विषयमामला
hpap	पिताजी
hmam	आमा
hyat	अभिभावकको
hcan	नमस्ते
hwik	सक्रियपार्नुहोस्मामला
hsuc	पुर्खा
htat	Grandparent
hcac	भोक
hnik	genitiveमामला
hcit	विशेषण
hwan	र
hman	मलाई
hnan	तपाईं
hwam	हामीलाई
htit	यसलाई
htac	गन्तव्यमामला
htik	समयजनाउनेब्याकरणिकशब्दमामला
hyit	realisमुड
htim	deonticमुड
hcut	ससर्तमुड
hsit	epistemicमुड
hyak	सहायकमामला
htan	भित्रीसन्दर्भ
hpan	व्यक्तिसन्दर्भ
htin	स्वतन्त्रखण्ड
hyan	निर्भरखण्ड
hfap	perfectiveपक्ष
hkat	भुतकाल
hnin	पुरुषलिङ्ग
hmak	comitativeमामला
hnat	बर्तमानकाल
hpak	benefactiveमामला
swik	essiveमामला
htut	negatoryपरिमाणक
hsan	सतहसन्दर्भ
hpin	adpositionalमामला
hwin	स्थानमामला
hkan	ठाउँसन्दर्भ
hnac	बाटोमामला
hyut	interrogativeमुड
hnam	रवा
hkit	विशेषवा
hsuk	स्रोतमामला
hpik	ablativeमामला
hcat	निकटता
hmat	demonstrative
hkuk	दफापुच्छर
hlan	तर
hsut	सबै
hyin	विश्वव्यापीपरिमाणक
hcin	स्त्रीलिङ्ग
hpac	बहुसंख्यकनम्बर
hyik	एक
htic	उनीहरुको
hkik	को
tcat	भविष्यमाकाल
hsin	सामाजिकसन्दर्भ
hkac	जब
hmip	imperfectiveपक्ष
klan	त्यहाँ
hlak	elativeमामला
hlik	illativeमामला
htam	निर्देशनमुड
hlat	ऐच्छिकपरिमाणक
hkam	के
hwat	प्रश्नशब्द
htap	copula
hpat	व्यक्ति
nyan	पुरुष
hkas	सकेजति
tcan	अन्य
hnuc	नम्बर
twit	दाबीपरिमाणक
hsak	समयसन्दर्भ
htuk	अस्थायीमामला
htun	मात्र
htum	hortativeमुड
hyip	पूर्वव्यापीपक्ष
hlit	volitiveमुड
pcic	पर्छ
tyut	दुई
hsat	हेर्न
hkut	चिन्छु
hcic	तल
hcap	पछि
hpam	पहिलो
hlac	alienableसम्पत्ति
hkap	कहिल्यै
hnic	inalienableसम्पत्ति
tyat	पुरानो
tcit	deliberativeमुड
tcin	दिन
hlam	आउन
hwak	स्वर
hkin	जाने
lwak	perlativeमामला
hpip	प्रगतिशीलपक्ष
lyan	लामो
hsac	भन्न
kyan	कसरी
htas	फेरि
hsic	यहाँ
hcik	लाग्छ
hcak	सन्दर्भअन्तर्गत
hfan	फेला
hsun	हात
hyac	पनि
nwan	जवान
tyit	विरुद्ध
tlan	भगवान
twak	delativeमामला
hmin	केही
hyas	एकपटक
hlap	semelfactiveपक्ष
kcac	बाँकी
hyic	देख्यो
hcas	घर
hwac	विश्व
tyin	तीन
hnun	नव
hcuk	ध्यान
pyan	प्रेम
hsis	सधैं
hyam	रात
hyap	राजा
hkic	बीच
hmas	मन
cyit	मुटु
pluc	paucalनम्बर
kyik	किनभने
ksak	causalमामला
tcun	सम्पन्न
hnim	नाम
tsan	उचितसंज्ञा
klac	देश
hpun	सोधे
cyat	देखिनेप्रमाणिक
pcac	राम्रो
hmac	क्षण
hnas	सकदिन
hwic	पानी
twim	चाहतभरामुड
kwan	प्रकाश
tlat	शब्द
tyan	ढोका
hsas	बिहान
syat	सम्म
twik	terminativeमामला
hpit	सेतो
pcan	पैसा
hyis	गरिब
mwan	मृत्यु
hfam	फारम
nwik	inessiveमामला
kcat	सँगै
tsac	अक्सर
pyat	मित्र
psan	आधा
hpim	जरूरीमुड
hyuc	गोलो
hfat	पठाइयो
hcis	पत्नी
kcan	विश्वास
hsik	सार्वजनिक
htus	राज्यसन्दर्भ
hpas	छोरा
clat	बच्चाहरु
tyak	यसरी
cwan	आशा
syin	प्रिय
hkuc	उच्च
tyac	पढ्न
syit	शहर
hlic	पहिलेनै
hfit	factiveप्रमाणिक
tcac	केटी
hcun	सुन
ksan	कमसेकम
hyaf	सायद
kyat	साँच्चै
tcic	जीउ
hwit	फर्किनु
cwat	हावा
hfaf	कानुन
hput	मदत
lyat	पत्र
ksas	चार
hpic	optativeमुड
hfuk	आगो
hcam	घण्टा
twat	युद्ध
kyak	धेरै
tlit	दोस्रो
pcin	पछि
hmut	हराएको
clan	हजार
hfac	परिवार
twan	प्राण
hwas	प्रश्न
syan	सत्य
htis	बनाउने
tsat	सम्भावितमुड
lwik	allativeमामला
nyin	anthropicलिङ्ग
hfak	पाँच
tcak	एउटैविषयमार्कर
htuc	विभिन्नविषय
hnap	जवाफ
hmit	समुद्र
hcuc	डर
pcat	बुझ्न
syas	सर्तहरू
hcaf	पक्कै
twut	dubitativeमुड
hkis	कालो
tlak	ल्याउन
hyus	सुन्दर
nyit	क्रमबद्ध
htip	दस
ksis	कथा
hpuk	पुस्तक
hlin	इलेक्ट्रोनिक
hkun	खाता
lyas	चासो
lyit	लेख्न
pwat	ओछ्यानमा
hnis	उमेर
hnut	counterfactualससर्त
slas	कला
hwis	vialisमामला
pyak	भाइ
lyin	लाइन
tyas	तालिका
hyun	नदी
kyac	आँखा
tfan	अचानक
kcin	गहिरो
hmuc	उद्देश्य
cyac	रगत
hmap	गुलाफ
tlin	चिसो
hyif	अगाडि
tyam	लेट
hnaf	ठान्नु
hkip	लगभग
myan	मेरो
tsin	ज्ञान
hkup	कापी
hsam	पति
hlis	छ
cwit	जीवित
cyan	शान्ति
myat	सम्झनु
tyic	प्राकृतिक
hfut	गिर
swas	सेवा
hsap	बाहेक
pcit	प्रतिलिपिअधिकार
hyim	सेना
kyas	घोडा
plic	भविष्यमा
pcak	पश्चिम
hpis	भुक्तानी
hyuk	रातो
hwun	सुन
twin	इच्छा
plan	खेल्नु
hpus	कार्यालय
syun	सरकार
kyic	चर्च
htaf	बल
hlun	लम्बाइ
kyin	कम्पनी
kyis	कागज
mlan	सम्भावना
hcim	विशेषगरी
cyas	सहन
twac	विन्डो
nyat	सौन्दर्य
hcus	उत्तरार्द्ध
htup	कर्तव्य
htif	दूरी
pyas	खुट्टा
hlas	जंगली
ksin	हरियो
hmaf	समस्या
myac	मुस्कान
hsim	निद्रामा
kyit	उद्धृत
kwik	quotativeमामला
fwan	यात्रा
slan	पालना
psit	उपस्थिति
hmic	मीठो
hmuf	मुख
hfin	धनी
tcam	शत्रु
psuk	भाँचिएको
kcap	जहाज
pwan	समावेशीव्यक्ति
hfic	प्रभाव
tcuc	देखा
hkim	गोप्य
pyin	कृपया
pwit	precativeमुड
pyit	भद्ररजिस्टर
cwak	खराब
myak	मार्च
tcas	स्थानहरू
hlaf	रहन
psat	सट्टा
nlan	नीलो
psac	असम्भव
kcuk	विद्यालय
kcit	विवाह
kcak	खाना
syis	बीस
tlac	शान्त
hcip	सम्भावितपक्ष
kwin	दिने
tsit	रोकियो
pyac	भाषा
hsus	हप्ता
hcup	हल
cyap	आश्चर्य
tfin	स्वाभाविकगण
fyat	अदालत
hnip	gnomicपक्ष
tsak	आदर
tlas	मूल्य
syuc	रूख
plat	पर्खाल
cyak	स्वर्ग
twip	inchoativeपक्ष
mlat	आदेश
swit	jussiveमुड
mwas	महिना
hwaf	सिद्ध
tyap	अनुभव
ksac	परिस्थिति
syac	ताजा
hnuk	ड्यूक
kwak	ढाकिएको
tyuk	पूर्व
pwac	पत्थर
hkif	महान
nyac	निर्देशन
cyis	कुर्सी
tyuc	प्रतीक्षा
tsun	गाउँमा
tyik	सहमत
hnum	अनुमोदकमुड
slak	सफलता
tsic	प्रयास
slat	पर्वत
hmik	संगीत
hkus	कराउँदै
hsip	सात
hpaf	निजी
nwas	समाचार
tfac	दृश्य
fyan	बगैचा
cwas	सुरु
hfik	distributiveमामला
lyac	सिक्न
syik	राजनीतिक
clin	हेनरी
cyin	झूट
tsas	जात
cyik	अख्तियार
tlap	तल्ला
cyam	गर्मी
tcut	धर्म
tcap	भाग्ने
hlut	लेखक
pyun	खैरो
tcuk	दुखाइ
swan	वसन्त
hmun	नरम
kyun	कुना
nyak	ट्रेडमार्क
tsis	न्याय
psas	उत्पादनगर्न
cyaf	हाँस
hwut	भूल
hyup	युरोप
hwap	आठ
psak	बित्दैजाँदा
kyap	भयानक
pyic	आवश्यक
hmim	मध्यम
hsaf	सास
hmis	बुद्धिमानी
hsum	possessiveमार्कर
ksat	सुखद
ksit	गम्भीर
tsap	द्वीप
kyam	शिविरमा
tcum	स्पर्श
cyun	भाग्य
psic	किनारमा
tyun	डोमेन
mwit	commissiveमुड
tlut	डिग्री
myit	जाडो
kfan	आचरण
slac	चालु
myin	मिनेट
tyip	नेतृत्व
klas	ग्लास
pfat	बोर्ड
cyic	व्यर्थमा
swam	मामिलामा
syam	सुरक्षित
tsut	डाक्टर
hlip	completiveपक्ष
kcas	अन्धकार
nyun	न्यानो
hpuc	पेय
tlam	उदाहरणका
hfun	क्रोध
tsik	बावजूद
tsam	सीधा
hmup	टोपी
klak	कुकुर
slin	चाँदी
swac	दास
kcam	गर्व
pyik	रेल
myut	नैतिक
syak	प्रविष्ट
swat	तरवार
kyuk	आक्रमण
clac	स्वास्थ्य
tyaf	अनुच्छेद
swic	सामाजिक
tfit	रकमफिर्ता
hkaf	सरकारी
pcas	नजर
nyam	महिमा
tfat	बाह्र
pcut	संलग्न
pwin	रक्सी
mwat	स्वाद
fyac	फलाम
syap	वितरण
myap	व्यापार
hyum	प्रयोग
fwak	न्यायाधीश
klat	कप्तान
twap	cessativeपक्ष
kcic	उत्सुक
kwic	विदेशी
hnif	intensifier
myun	महत्त्व
tlic	अन्तमा
cyuk	घाँटी
syut	स्वतन्त्रता
pfan	पक्ष
kyuc	सुक्खा
pcap	अलग
tfak	प्रमाणिक
tcik	प्रमाणिकमामला
twun	टाढा
tyis	प्रगति
nyap	साँघुरो
plit	भवन
hpif	पृष्ठ
pwic	पकड
syic	दुःखी
tsip	पाप
syim	बिरामी
tcis	इमानदार
pcun	बैंक
ksap	स्वीकार
lyam	धारा
tcaf	ध्यानदिएर
kwac	कान
hpup	रोटी
kcut	छनौट
nwam	पशु
hsup	zoicलिङ्ग
nwit	eventiveमुड
tcim	एउटैघटनामार्कर
tlik	multiplicativeमामला
kyus	पार
hmus	बाक्लो
kfat	हिम्मत
nwat	बढ्न
myic	वर्षा
hpum	सतह
swut	पवित्र
clis	जुलाई
mwun	फैशन
hfas	फाइल
cwac	काँध
kwat	सान्त्वना
nwac	कसैले
tcip	इच्छित
kfac	घाँस
hmuk	आकर्षित
plin	उद्घाटन
kwun	जुन
mlik	माछा
klin	राजधानी
pfut	स्तन
twam	दावी
fyin	खर्च
nlit	तपाइँको
mlin	लाख
pyut	प्रार्थना
hluk	थकित
ksut	मार्न
cyut	छाया
psin	वजन
kcis	खैरो
pyam	साहसी
mwac	सन्तुष्ट
klam	बताइरहेका
ksam	राष्ट्रिय
hfip	कमजोर
klik	उपत्यका
hkum	speculativeमुड
clas	पहेंलो
cyuc	गर्मी
mlac	रहलपहल
syip	बराबरी
pwak	बक्स
tcif	चुच्चा
psip	सिद्धान्त
ksik	नतिजा
tsim	सिजन
flan	विज्ञान
pcam	स्पष्टतः
kcun	खन्नु
ksuk	मामा
mlit	सूची
pcik	खतरनाक
kwas	अगस्ट
hluc	लोकप्रिय
klit	अज्ञात
flak	परिचित
fyit	परिचितरजिस्टर
lwat	पाठक
plun	हिड्ने
twas	दुईपटक
pcis	पुजारी
fyas	घाइते
nlat	दरबार
myuk	मूर्ख
pfak	अनुग्रह
tcuf	नौ
cwap	सहानुभूति
plac	फट
pyap	राख्नुको
lyic	लुगा
hcum	हल्ला
lwit	साहित्य
tsuk	दर्जा
hfup	आँधी
kcik	खल्तीमा
nwap	नोभेम्बर
tyim	डिसेम्बर
psaf	अभाव
nlac	जनसंख्या
kyaf	धन्यवाद
slis	श्रृंखला
pyaf	बर्ड
mlak	मालिक
kwut	कोट
hwuc	सम्बन्ध
pyis	तीव्रगतिमा
twuc	धुवाँ
nwak	जनवरी
mlic	मिसिन
tlis	दाँत
ksun	जल
clam	लाज
klaf	गुणस्तर
clit	घन्टी
fyak	वाक्यांश
fyam	वाक्यांशमार्कर
kwap	वर्ग
hwip	आइतबार
psis	कविता
pwut	preordained
kyim	किन्न
clic	क्षेत्रहरू
pyip	अप्रिल
kfap	अक्टोबर
psut	वस्तुहरु
kcuc	तीतो
nlap	दास
hsok	छाडा
htet	पाठ
hbat	खराब
hrit	ऋण
hzit	विशेषताहरु
hpet	पन्ध्र
krac	क्रूर
hduc	धूलो
hrik	व्यावहारिक
hron	रंग
hnus	नाक
hric	अनुकूल
srik	आपूर्ति
hten	हिजो
tlet	hesternalकाल
slap	असफल
hban	लगाउने
hdat	अन्धा
fran	उड
hdan	राक्षस
htec	बिस्तारै
hmon	मिसन
cran	बलिदान
hran	अन्तस्करण
hmos	मंत्री
nrit	ऊर्जा
hcet	घृणा
hset	केन्द्र
hrin	तर्कसंगतलिङ्ग
hcot	आनन्द
hrip	संक्षिप्त
htep	उपासनाको
hcif	छाला
hrat	छत
kran	मुकुट
hkon	महल
tran	निराश
hmif	माइल
trin	गोलाकार
hgin	जेल
hkop	कप
hcen	सदस्य
swin	नागरिक
hrac	जताततै
hris	अनुकूलन
hbin	बन्ने
hmot	मासु
hdut	दूध
hwen	vegetalलिङ्ग
nran	दुर्लभ
hbac	भान्जा
crut	पुल
hsoc	शेयर
hsom	नुन
nris	निर्दोष
hbit	जोगिन
crin	प्रशंसा
rwin	रानी
hgut	गणना
hdas	नृत्य
hnot	होटल
hdin	भर्न
hton	कैदी
hdak	दोकान
hlet	सिढी
hson	माफी
hgek	समलिङ्गी
hras	बालुवा
hsep	सेप्टेम्बर
hbic	नष्ट
hlen	लाइसेन्स
hcon	पर्याप्त
hgit	साक्षी
kfon	भान्सा
hbak	बेच्न
tlim	उपचार
hsot	गति
kyut	कम्प्युटर
hnen	अनन्त
htek	पुस्तकालय
hzan	समावेश
hbis	आधार
hbun	भ्रम
kcus	कुक
hgat	मरुभूमि
hwus	चुम्बनले
hbif	बरफ
hbot	बल
hrut	तर्क
hdit	benedictiveमुड
hdis	दोषी
hjan	सजाय
plis	प्रहरी
hgan	लुकाउन
hsen	यात्रा
nrin	नजान्ने
hyen	बादल
frif	फेब्रुअरी
hdik	रोग
hnek	पहलमामला
hbam	चाची
hmen	नम्र
hdip	ढिलाइजरूरी
prat	रिपोर्टप्रमाणिक
hdet	मध्यरातमा
hjit	औंला
hmoc	कहीं
pran	प्रेस
kcec	क्षेत्र
hken	हाल
hloc	melancholy
hrak	कर्मचारी
htes	हेर्न
rwan	इनाम
hdon	दान
htot	निधारमा
hnet	स्वर्गदूतले
hdun	Singular
croc	त्रुटि
hlon	किरण
hyec	भेडा
hjin	धैर्य
hrec	referential
mran	मकै
htos	बहुमत
hcos	उपाय
hkoc	कहिलेकाँही
hlif	मुनाफा
clak	चीनी
hjat	मानवता
tram	फ्रेम
hdic	डिस्क
hkok	एक्लो
srat	कलाकार
crak	आकर्षण
hmet	इमेल
hden	निर्णय
gran	राज्यपाल
crac	साखा
hjac	उत्साह
hdim	आगमनात्मकमुड
hcok	हतार
hyet	तेल
pwap	पाइप
trat	मुद्रण
tcot	ठोसकुरा
hdoc	ओह
hren	भाषणलेसन्दर्भ
tcon	दिउँसो
krin	सानोघर
plam	अलार्म
hnes	स्नायु
tcen	अवलोकन
hsek	पक्ष
plik	लागू
slik	रेशम
hfen	प्रतिशत
hgen	एजेन्ट
hnon	संघ
crik	नरक
tcet	बिग्रेको
mrat	मिश्रित
hdam	admonitiveमुड
hgac	महत्त्वाकाङ्क्षालाई
htoc	तरिका
hdac	सल्लाह
nwin	संविधान
srit	साधन
hret	दृढ
nlin	अनलाइन
hzat	ज्वारभाटा
klic	कलेज
hkek	पुच्छर
nric	पुस्ता
hgic	भीड
hgak	बिरालो
trit	प्रत्यक्षप्रमाणिक
tyot	सन्धि
hnok	सामग्रीहरू
crit	त्यागेर
slen	एघार
srin	अन्त
hpok	कुल
hyot	चिन्तितमुड
cric	आश्रय
hruc	अशिष्ट
cwin	सवारी
hzak	हल्लाउनु
dyit	उद्योग
hpec	पेशामा
nras	नर्स
hcec	शिक्षा
hbut	जूता
hmec	अस्पष्ट
twot	गतिविधि
crat	शनिबार
hkot	क्षमता
hnec	घाम
hwuf	विधवा
cren	बगाएको
nrat	तारा
hget	अतिथि
hbik	आशीर्वाद
brin	भित्री
hpot	उपलब्ध
trac	प्रतिरोध
prac	उठाउन
hcoc	खोक्रो
hpon	प्रान्त
hwim	सभ्यता
dwan	टास्नु
cwok	आघात
hdok	ड्राइभिङ
crun	धन
hzik	बीउ
hrot	हालभूतकाल
hket	जागा
hcek	फर्नीचर
hrop	डोरी
mrac	साहसिक
byit	भोजमा
trak	वार्षिक
hzin	दक्षिणी
sric	समारोह
clik	शिकार
trap	उदार
hrim	मसीहीधर्म
hrus	राजकुमारी
blat	वेदी
cyon	साना
hwep	वेब
krat	प्रधान
tris	बैजनी
kcot	भेला
hben	चुनाव
trik	पिएको
kfit	लिफ्ट
tcec	विनिमय
nrik	निश्चितलेख
grat	सम्राट
dran	प्रशासन
hpen	पहिले
cluk	कुरूप
nrac	अहानिकारक
ryin	प्रशिक्षण
hrun	रोल
nwic	इन्च
slit	गोली
gzat	अखबार
krot	काटन
drit	दारी
hzis	आंसू
hdap	अठार
sris	ऐतिहासिक
mrut	कुल
nyik	माटोको
bran	दुलही
drat	निर्भर
djan	विशाल
glat	सादगी
hpoc	शरदऋतु
pras	पर्दा
hgot	सभा
tret	थिएटर
tras	तुलना
rwit	प्रतिद्वन्द्वी
hfon	गठन
klot	कोच
hmum	हास्य
drac	भाषणले
rwas	उपन्यास
tset	बदला
hdot	distaldemonstrative
ryut	डाह
hwon	निमन्त्रणा
byat	जलेको
flac	फ्लैश
prot	चित्र
crek	सुझाव
htok	द्वन्द्व
htop	श्राप
prit	imprecativeमुड
hces	असहाय
klup	क्लब
hnos	बाढी
dwin	भावशून्यता
prin	क्षितिज
mrit	assumptiveमुड
tcoc	ठाडो
hcom	सद्भाव
grit	गर्जन
tlot	बाल्यकाल
hgik	गोडा
hwes	अचेत
hzac	आपसी
hsec	सफ्टवेयर
tson	संस्थाका
ryit	रसिद
dlin	अनुशासन
slip	पर्ची
klon	क्रान्ति
hfim	किसानले
hpom	मंच
cyen	विद्यार्थी
hgec	गुफा
hroc	परम्परा
srac	पेश
ryat	शोकमा
kcen	कुमारी
hbap	विदाई
krik	आलोचना
krap	कपास
fwat	अस्पताल
kcet	भाडामा
hgas	ग्याँस
pfin	अपरिहार्य
dlit	पात
ryan	अनुवाद
sran	अन्त्येष्टि
mrin	पीठो
hram	रोमान्टिक
dlan	डलर
hzas	हंसी
hsos	सोह्र
klen	बस्ती
gyin	पखेटा
hsif	सिंह
cluc	चतुर
prip	तयारी
hzut	तुवालो
dwat	चिकित्सा
krit	proofread
sras	गुँड
hses	चौध
brat	आपत्ति
flat	एसिड
hjic	अर्थात्
slic	हतियार
hbuc	प्रयोगकर्ता
tron	सुन्तला
byan	स्नान
hrif	आदिम
tlip	स्थापना
blan	टोकरी
kris	सचिव
hyon	त्यतिन्जेल
tren	आज
dlat	hodiernalकाल
hzic	विष
tfic	राइफल
tlen	प्रतिभा
hlim	जलवायु
dyat	जीवनसाथी
kcon	प्रकाश
dlac	धुनु
krak	स्वीकार
hbas	अर्थहीन
hkec	कोइला
hrek	पुनर्स्थापना
hkos	हल्काडुङगा
hwif	उपाध्यक्ष
tric	अस्थायी
hdep	delimitativeपक्ष
mwak	थुप्रो
ksot	हड्डी
hnoc	सोमवार
nlas	मंगलबार
brac	बुधवार
frap	संघीय
pfit	प्रतिनिधि
pcoc	पोल
lyen	सनी
swak	डुब्नु
pcen	अध्यक्ष
brit	रक्तपातपूर्ण
hwec	कब्जाको
hwet	पेट
hlos	माथिल्लोतलाको
hbon	वैविध्यपूर्ण
pcon	पीतल
hsem	शिखर
lwac	सस्तो
tsos	प्रतियोगिता
kwen	विशेषव्यक्ति
trun	अवतरण
trut	मुर्ति
hrap	तोप
hgap	पक्राउ
trot	तापमान
grin	छिमेकी
hjak	अंगालोहाल्नु
hpek	पैक
hlus	मृग
hwos	बेडरूम
tsuc	झाडी
pcuc	छुट्टी
cris	वारिस
clun	ओक
hpes	अप्रिय
nlet	अपूर्ण
hrom	कार्यक्रम
pyon	पियानो
swet	राजी
dric	अदृश्य
tyen	राम्रोज्ञात
hruk	क्रूरताको
frat	तोकिएको
hyoc	प्रलोभनको
hlep	telicपक्ष
nrot	अन्तर्राष्ट्रिय
nret	हिंसापुर्वक
hfif	दार्शनिक
pfic	प्रतिनिधित्व
hmek	संवेदनशील
hfec	कल्याण
myik	माछामार्ने
truc	चोरी
tcop	ओठ
rwic	रिटायर
htom	अर्थव्यवस्था
glan	ग्यालरी
pren	समानता
hlek	atelicपक्ष
nrak	महादेशमा
truk	दस्तक
hjim	prohibitiveमुड
rwat	टाई
hcep	सेल
dyan	अन्डा
jrat	कृत्रिम
nren	प्रेरणा
ksic	संकट
tsoc	खोजी
lwan	भोजन
hpos	पाइन
hcuf	पुस
tcus	अदालतमानालिसगर्नु
pset	विस्तार
hkep	तामा
swis	जलसैनिक
prim	शाही
trip	सचेतक
cras	शर्ट
swap	कूचोलगाउनु
syet	स्केच
htof	चोर
clen	च्यानल
kwit	व्यक्तित्व
klok	अतिरिक्त
hrok	सुधार
hguc	तिर्खा
kcim	धम्कयाउने
hpem	पाम
psik	वक्ता
frit	सीमा
cret	निशान
mrak	भाला
syen	सत्र
tcup	नम
hyek	यात्री
trim	टिन
plak	उजुरी
hyok	कोण
hgam	गाई
hmok	मिल
jrac	नक्सा
kloc	कलर
gyit	जानाजानी
hbip	बियर
mlet	मखमली
lyap	दुरुपयोग
cwen	बगालका
bwan	भान्जी
tses	तेह्र
jrit	सफाइ
nlak	पांडुलिपि
sron	योद्धा
cruc	शुक्रबार
broc	ब्रश
dlot	डाउनलोड
krim	तर
pric	पिच
prut	न्यायपीठ
hgon	स्थिर
sram	शाब्दिक
pfot	पट
hlot	योजना
djin	सिक्का
hlok	फड्को
hpep	स्याऊ
hwot	मुड
dlak	छलफल
brik	सदस्यता
nlis	लेखन
hbet	शर्त
pris	भाइरस
hjik	अतिथिसत्कार
blit	बालकजस्तो
hjap	ओढ्ने
tfik	प्रतिबिम्बित
hdaf	प्राप्त
hpop	ओपेरा
kcaf	लुकाउने
kcoc	कुहिनो
hrum	मरम्मत
cyim	शंकास्पद
dyic	शैक्षिक
hgoc	पिट
drak	विकार
plas	ताली
byin	बाइनरी
hzap	अभय
nlot	लोयल्टी
mrik	यांत्रिक
hsop	सफलतापूर्वक
crap	पासोमा
kyek	केक
nrut	रम्न
syes	सर
hjet	सत्र
hjen	स्त्री
hmom	मह
hdec	दुर्भाग्य
lwen	पौराणिककथा
slot	चुलो
frac	विद्रोही
gwan	सुनिनु
mruk	सुधार
swot	दलदल
zlan	कमाउन
hnem	एनिमेसन
hdes	लाउने
prak	प्रचार
frin	दृश्यहरु
hfet	विरोध
cros	chorus
ryon	तर्कसंगत
tcos	बाली
tsen	प्रशोधन
hwek	ब्वाँसो
nlik	नगर्दा
klap	गलैँचा
dras	तुच्छसम्भ्कनु
prop	उर्वर
slim	सीटी
hgis	पनीर
krut	दु:ख
srot	साथी
bjan	घूमछन
nwen	नौसेना
myas	मुकुट
kwaf	विकास
twis	ट्याक्सी
pcip	पेन्सिल
srap	तरकारी
sren	प्रदर्शनी
tlun	ट्राउजर
hrup	भ्रष्टाचार
nrip	कैबिनेट
srup	सूप
jran	सर्जन
bjat	भत्ता
gyat	जासूस
hlem	लापरवाही
srak	सार
kson	उच्चारण
cwis	बिहीबार
sret	भवदीय
hraf	यातायात
hres	वास्तुकला
hsuf	निपटान
rwak	दरार
twon	आभूषण
hfus	रिकभरी
hkom	कोड
djat	शिकारी
nlut	समाचारपत्र
hsef	सर्प
mris	लोकतन्त्र
bric	ब्याट्री
mlam	मोम
zran	बाढ्नु
cron	thrill
hzen	पौडनु
traf	पट्टी
cwaf	खाम
srip	चुरोट
mrot	मोटर
swon	स्वयंसेवक
ryak	प्रतिक्रिया
pfun	आंशिक
blac	सामान
mret	सेवाको
hjon	यौन
kcok	बन्चरो
dram	हीरा
kren	वैकल्पिक
tcek	प्रतिध्वनि
hdif	पहिचान
tfas	राजदूत
hfot	समावेश
lwas	अल्छी
hmep	momentaneपक्ष
kfin	सङ्केतन
mwin	काल्पनिक
hrem	रे
pram	चढाई
byac	तहखाने
mren	स्मरणीय
swen	सीनेट
kras	लाशराख्नेबाकस
hgun	निल्छ
nlok	Indulge
ryic	कृषि
gwin	स्विंग
srut	चउर
hkes	जटिल
hfis	राजीनामा
frak	पटक-पटक
hnom	षडयंत्र
hcop	पब
hlec	मरिच
mlot	माधुर्य
zrat	उम्मेदवार
proc	संरक्षक
flik	स्यालले
cyet	खेद
hgim	चिम्नी
slet	भ्काडी
tcok	शुद्धता
bjit	पूर्वमृतक
brot	कली
bwat	कम्बल
hdus	सुँगुर
gwat	हात्तीदाँतको
kret	निकाल्ने
nwet	पर्यवेक्षक
jwan	बाटो
nwis	नङ
mwic	मौरी
bzat	अभिनेता
gyan	पसिना
zyit	कार्यकारी
blic	भ्रम
pcet	अनिश्चितता
tsot	गुना
bwit	सीमा
tres	तनाव
hkof	खपत
nyen	इन्कारकोआवाज
hles	जस्तै
cyek	बोरा
hjis	सुई
gjan	घटना
prec	व्यवहार
drot	नियंत्रित
kcek	वक्र
twic	चिकन
brak	बैरल
zwat	बानी
clap	बानीपक्ष
tsec	विशेषज्ञ
bwin	प्रभावित
cwet	यसद्वारासीमाबद्ध
hbek	रोटी
zlin	जैतून
mron	वैन
drin	समर्पित
psap	पर्दाफास
gjin	जन्मदिन
clut	हथौडा
cwun	सुगन्धित
twaf	तुच्छ
pcot	pet
krok	खोपडी
dlik	विधान
cwic	भाग्यवस
srun	भ्रूभंग
crec	नष्ट
jlan	मार्जिन
kcip	च्याम्पियन
blin	अरब
ryik	रासायनिक
mlas	नाडी
flit	पायलट
hzet	गाँठ
cwik	राजसी
twet	स्कर्ट
mwik	साप्ताहिक
tfis	प्राविधिक
tlon	वाहन
cram	चापलूसी
grac	बलियो
kraf	काग
trup	विशेषता
hduk	हुक
cruk	बाघ
nrap	हाउसकिपरको
crot	राजमार्ग
mlip	मिलिशिया
hfoc	तस्वीर
nres	निष्ठा
plos	प्लस
tfam	पारदर्शी
nlic	उन्नाइस
hwok	योग्य
nlen	निबन्ध
fyic	दक्षता
hwuk	अद्वितीय
hgok	जैविक
flic	धर्मशास्त्र
flot	फ्लोट
hboc	oblige
hwoc	चुडैल
syot	स्टूडियो
cwip	स्याम्पेन
hbes	ब्यानर
lwic	छोडपत्र
blot	बोल्ट
cwot	कैद
cwam	नस
prik	निष्क्रिय
hfum	फिंज
grik	रोडा
zrin	एप्रन
gren	ग्रह
hfuc	पुनरुत्थानको
claf	तखता
flas	प्रशंसक
hjot	ट्रपिकल
hbim	मनपरी
krek	पारा
hbec	benevolent
tsaf	आत्महत्या
pwas	टिप्नु
plot	रिपोर्टर
kfak	expend
blak	बालकनी
hdos	दाग
kwis	क्लासिक
kcos	आरोप
psen	पेन्सन
kres	क्रिया
hzon	बाँदर
srim	हस्ताक्षर
glin	नचाहनु
mlut	कुख्यात
myot	आयात
fwac	संस्थापक
troc	टर्च
hgaf	व्याकरण
hyop	नौका
ksip	लोप
sres	भ्रमण
hnup	घरकोछानो
hzun	हठी
mric	मासु
gjat	परिमाण
hros	दल्नु
zrac	कायर
tros	तताएकोपाउरोटी
myus	माउस
dwac	संवाद
byak	बाख्रा
htef	दर्जी
hfek	फलिफाप
dzan	आयातित
nyon	अज्ञात
zrit	औपचारिकरजिस्टर
pcos	खेल
hjec	पिघल
dlas	मेटाउन
mras	छाता
mram	खनिज
cwut	समझौता
hbok	धुनमा
swun	साबुन
dwak	पुतली
plif	विला
slon	सिलाई
tfut	बधाई
djac	reconcile
hjas	दबा
kric	खरायो
kwot	सञ्चालकको
gzan	ग्यारेन्टी
clot	खेलाडी
ksek	कीराहरूको
psam	मुद्रा
mwut	उल्लू
htem	स्थायी
clon	भाइलिन
dzin	निवासी
rwim	क्रमशः
hyof	लाभदायी
dron	ड्रागन
dwit	श्रवणप्रमाणिक
sroc	निर्यात
hzot	समापन
djik	Linger
kfik	ढक्कन
ryun	विनियमन
hmes	मेयर
rwac	हार्डवेयर
sruk	सर्कस
sros	अल्पसंख्यक
bzan	दङ्गा
kset	अर्केस्ट्रा
bjon	सुंगूरकोमासु
hjut	असीमित
tfen	रक्षा
zwac	बेफाइदा
dyin	deliberation
myis	संगीतकार
mlis	मानसिक
pret	अयोग्य
tsek	नक्शावारुपरेखातयारपार्नेव्यक्ति
hlom	कागति
ksos	खोकी
crok	टाउकोदुखाइ
flin	प्रजनन
mrun	सिकर्मी
swec	अनियमित
syuk	चम्चा
blun	बेलुन
tcep	चक
fric	स्फूर्ति
rwik	ठाडो
rwen	रोकेको
flet	inferentialप्रमाणिक
pfac	प्रकाशक
srek	सिरका
tfun	टनेल
pwet	पहेली
gyik	गणित
fwot	विलोप
lwin	सन्तुलित
jwin	कलेजो
bwik	sublativeमामला
hdup	स्नान
hnop	एकाधिकार
bwic	पनडुब्बी
ryen	बिना
hcem	भूकम्प
hbos	प्रयोगशाला
nrek	कामदार
ryim	ताल
nyic	व्याख्या
dwas	दूतावास
rwok	प्रकुपित
kram	नसक्नुको
ksim	declarativeमुड
clok	चकलेट
pcec	सुअवसरपाउनुभएको
nyis	एकान्तवासी
tyoc	संयोग
grak	स्क्राच
zlat	पन्जा
hjuk	घुडाटेक्नु
trif	भूगोल
djit	व्यवस्थित
pson	अजेय
mwis	लगानी
cwec	मौखिक
hdek	सांसारिक
blik	बाज
sloc	मनोविज्ञान
brap	स्क्रैप
jlat	समुद्रीडाकू
dros	खुराक
slam	सामन
pwun	हलुआ
gwik	चुम्बकीय
pcop	पंप
myen	त्यस्तै
ksen	अक्सिजन
mrap	फोरमैन
tfot	प्रमाणपत्र
ksus	क्लस्टर
trok	लफ्फाजी
tloc	बजाइएको
zyan	डांडी
nlun	लग-इन
hlop	दूरबिन
jlin	हिज्जे
lyut	बादल
hsof	सर्फ
fyik	व्हिस्की
klet	अपेक्षाकृत
hwof	Willow
hlum	उँट
myet	अवैतनिक
klis	अलग
hbaf	जीवनी
gwac	गधा
hwum	अफवाह
pwik	दृष्टिकोण
pron	समर्थक
myes	मासिक
mwen	reverie
kfic	छुट्टी
klek	क्लिक
cwon	गोलो
lyak	लोचदार
kwon	शब्दकोश
hjam	छम
rwon	इन्द्रेणी
crip	एतद्द्वारा
zwan	निरन्तर
srok	सम्पादकीय
craf	फैाजी
tlok	ट्यांक
brip	पुतली
tfap	चार्ट
jwat	दुई
pros	सञ्चालन
psun	Omen
clet	wretchedness
hbus	बांस
dyas	बिक्रेता
klun	जम्मा
jlit	एकमत
hdom	डरलाग्दोसपना
kron	कार्बन
hzam	जाम
cyot	श्रोता
hmem	संग्रहालय
lwam	वर्णमाला
fras	स्क्याटर
psoc	मुक्का
hgum	गम
brek	ब्रेक
glit	स्थिरता
frun	क्षयहुनु
gris	आक्रामक
mroc	घर्षण
bzit	माकुरा
plut	आलु
glac	लोभ
gzac	गुणन
prun	स्पिन
jlet	पात्रो
nyim	नामांकन
tlos	ट्रिलियन
slut	सलाद
fwit	सकारात्मकमुड
pyen	आवेदन
nlon	नाममात्र
dren	देखाउन
drun	dissatisfaction
cyok	shrug
hfop	फुटबल
ryac	साझेदारी
gzin	अग्रगामी
hgip	बन्दागोभी
tyet	पुष्ट
hdof	ideophone
hwup	अमूल्य
lwek	लीवर
syec	सीनेटर
jyak	समायोजित
mlim	कमिला
fwic	प्रभावकारी
gzit	गर्भवती
blas	रिलायन्स
jrin	दैनिक
gwak	टखने
drik	oddly
prif	चर
jwit	विविधता
krip	भेदभावको
ryot	awed
nwut	पेटी
kcif	सक्रिय
jrak	भ्यागुतो
twek	exessiveमामला
psot	प्रायश्चित्त
pfon	स्पन्जले
sluk	लोखर्के
nlim	irrealisमुड
ksaf	scarcity
glak	ज्वालामुखी
plen	संतुलन
kfaf	रूमाल
kyon	शोषण
jlik	भूवैज्ञानिक
psop	राहदानी
kfis	रिक्ति
fyon	affinity
nram	अनैतिक
hbuk	बिस्कुट
gras	ट्रान्स
hyos	चिन्तित
flim	फिलिम
plet	ट्याब्लेट
rwam	परमाणु
blis	भनिलाको
zlit	एड्स
fyut	fastidious
crim	पिरामिड
hjif	गैरकानुनी
crif	लजाउने
lwap	lute
tyon	खगोलविज्ञान
mrim	Maze
drut	वर्णनात्मक
nrim	छात्रवृत्ति
kruc	कछुवा
kwam	adviser
jrik	क्रिकेट
dlut	जनाउँछ
pyot	परेवा
dyon	मिलाइएको
prap	अपरेटर
bzin	ब्याज
tyek	त्रिकोण
trec	कोषाध्यक्ष
nron	हाइड्रोजन
pyet	मुद्रक
tsok	दमा
zyin	पुरानो
slek	साइकल
jyin	ईन्जिनियरिङ्
ryas	प्रसारण
zrak	ताजा
nyas	नर्तक
gric	प्रवास
zlak	उल्लङ्घन
tces	टेनिस
hjun	हावाको
twen	बुनाई
kyet	कलेक्टर
gwit	मेरुदण्ड
kyot	कर्ड
fwin	आवृत्ति
tfuc	करघा
dlet	निर्देशिका
pfik	विचारक
bjet	बजेट
trek	रणनीति
kros	क्वार्ट्ज
gjit	कैंची
gwic	स्विच
frik	सैद्धान्तिक
tluc	तौलिया
pruc	गस्ती
glic	हिमनदी
krun	पूर्णता
bjin	भविष्यवाणी
tlaf	भाग
tfet	निर्माता
bras	पार्श्व
dwik	प्रतिवादी
clec	निकास
cres	चेस
tcef	चेरी
tcom	ठक्करनखाओस्
nyot	अनुवादक
tyok	ट्रक
cyip	उच्चकोटीको
grot	तोरी
bris	वायरलेस
nlam	लिलामी
slif	छनौट
hgos	खियाले
swoc	अस्थिर
jyat	दिवालिया
slum	इस्लाम
hjes	जनगणना
dzat	tiptoe
slun	निलम्बन
nwot	निरन्तरता
gyic	गिटार
pfas	पूर्वाग्रह
zyik	जस्ता
blen	चमकदार
hyem	एल्म
hnep	हाथापाई
nyut	बुना
ryam	सर्वनाममार्कर
clim	मसला
jret	तीव्रता
tfon	जिस्काउनु
jwac	Java
hrep	नुस्खा
dyac	मताधिकार
myip	मीटर
rwis	जातीय
hkem	पुच्छ्रेतारा
nwon	नवीनता
zwin	प्रतिबन्ध
dyis	मध्ययुगीन
mrec	भँगेरा
fyot	पादटिप्पणी
mlon	मापन
pfis	ratification
rwot	कक्षा
hfok	frugal
glof	गल्फ
zron	शून्य
hzip	जिप
hwom	बेघर
bjic	चबाने
pcim	पूरा
hjip	चिप
bwac	हाईगर्नु
mlos	तिल
mrip	बर्तन
bron	भ्रूण
ksoc	कटौती
cyum	खमीर
jyan	शब्दजाल
plim	आलुबखडा
mwet	मुर्दागाड्नेठांउ
ryet	स्नातक
glik	सिंचाई
plap	पूंजीपति
tsif	लोच
gyak	सार्क
djon	पूर्वनिर्धारित
nwun	समयनिष्ठ
cles	यथार्थवाद
dris	झन्
hkef	क्याफे
blus	यम्बुलेन्स
blap	वालेट
bjak	खुश
klim	मुखबिगराइ
gyac	वैज्ञानिक
jyit	equanimity
dzit	व्यावहारिक
bwak	आउटडोर
dyot	रेडियो
bwon	सेम
fris	अनौपचारिक
klut	अन्दाजलगाउनु
tfek	स्टेक
nrok	नाइट्रोजन
zyat	छुरा
bram	mutter
ryis	परिचयात्मक
nlip	विश्लेषण
nros	contrasting
hcof	पोशाकउतारलेना
tfif	उत्प्रेरणा
kroc	खातिका
hdum	यहूदी
pses	प्राप्तकर्ता
plok	पूरक
lyet	लेन्स
pwek	pegativeमामला
kfas	क्यान्सर
pwen	मोहरा
nrun	रिमाइन्डर
clek	लिक
pcif	vindication
glas	जटिलता
zwit	talkative
kces	sufficiency
crem	खुद्रा
grap	लिनु
kwip	हस्तक्षेप
dyut	छुट
crus	तहगतप्रणाली
gyet	जेड
gram	snarl
kyip	छेपारो
nyet	प्याड
crop	झरना
glon	गैलन
mrok	लामखुट्टे
fluc	धाराप्रवाह
dwic	बिचलन
slec	अन्वेषक
srec	समाप्तहुँदैछ
blut	कुस्ती
myok	मोशाको
tlek	प्लग
nruk	संक्रामक
nwoc	henceforward
bjut	उठबस
hges	गर्भावस्था
twoc	किराना
kyos	कम्युनिस्ट
mrek	विस्मित
clip	contrition
pwok	prosecutiveमामला
dwot	तानाशाह
zyac	preoccupation
jlic	उपग्रह
slop	जूता
ryip	समानुपातिक
psim	अनुमानित
byet	बेरोजगार
cyop	शौक
rwun	मापदण्ड
blop	बल्ब
syok	समर्थक
klos	क्लोरीन
lwot	क्लोराइड
byic	ब्याक्टेरिया
lyik	टाँसिएको
blok	जैविक
jlac	feign
bret	बाइट
krif	secretion
blet	ब्यालेट
nruc	मूत्र
tsus	लसुन
dyak	मध्यमवर्ग
tcem	संडसी
cyoc	चुनौतीपूर्ण
trep	स्ट्रबेरी
dlun	प्रदूषण
hlup	एल्बम
hbep	बेसबल
praf	चोरी
pwis	participle
grek	ग्यारेज
kruk	बैसाखी
hfof	फस्फोरस
rwut	संरचनात्मक
myam	जिम
krec	सारस
jras	ठेकेदार
zrik	सूचित
blam	नृत्यहल
klip	कालिगढ
hwef	सम्मकोबेतलबी
zlac	केरा
gret	बिजुली
lwuk	रिब
nyek	निकल
blos	बस
sles	सेन्सर
tlif	टाइल
kses	ससेज
mwot	टमाटर
lyot	स्वतः
tsom	पोटासियम
brut	भर्चुअल
djap	बीजगणित
hjok	सामान्य
kfen	अवधारणाहरु
pcok	अप्टिकल
bzut	budge
syek	बेरोजगारी
mruc	झिसिलिकीरा
bwas	ब्राउजर
klif	क्यालसियम
rwet	रिमोटभूतकाल
srif	ऐतिहासिककाल
hwem	स्पेक्ट्रम
syom	सोडियम
tyos	उत्तराधिकारी
jyic	अस्थाइबन्दि
hguk	gourd
dwun	शिकन
swip	स्पाइक
tlec	निशान
blaf	बलात्कार
tsem	नास्तिकता
mloc	मनिटर
gyot	ससर्त
trop	जांच
rwap	त्रैमासिक
hjep	लिङ्ग
pyim	प्लेटिनम
dlon	दोहोरोनम्बर
pcep	फोक्सो
twuk	scouring
tyec	ट्याग
syup	सुपर
trom	ट्रली
nyip	स्थानीय
glis	पेट्रोल
gjik	मृगौला
hjos	उपेक्षित
hjuc	loot
swek	overworked
psek	आर्सेनिक
twok	तथ्याङ्क
tsep	फट्याड़ग्रो
slos	समाजवादी
nwim	संवेदीप्रमाणिकमुड
tlop	tablecloth
trus	विवादास्पद
pwot	पट्टा
djot	तलछट
nloc	snub
mwon	चीनी
hjek	जकी
crom	सहयोग
myon	निमोनिया
twec	बैठाना
ryek	रकेट
dlic	लाभांश
kwet	स्केट
bwen	obsession
plon	बाड
syon	पन्त
djis	डिजिटल
byut	कुतिया
hyep	पटल
dwon	विकर्ण
byis	अवचेतन
brec	भौं
cyec	हाच्छिउंगर्नु
hwop	वाट
clus	उल्लसित
kfun	कब्जा
nwum	हिन्दुधर्म
fyim	शरणार्थी
cwos	शटल
tfoc	twinge
pwon	प्रोटिन
sraf	आत्मसन्तुष्ट
hbom	उल्टी
gyen	जीन
drim	freshman
trem	accoutrements
tsup	चकनाचूरहुनु
slok	समाजशास्त्र
kwoc	स्क्वास
bwam	मतदाता
mlok	गतिशीलता
kyen	क्षेत्रीय
hmop	गतिउकालो
rwek	पूर्वव्यापी
kfup	घन
grok	गाजर
drap	entrap
lwis	आणविक
ksuc	लेखापाल
tsop	झगडा
kyok	ककडी
nroc	Orgy
jlot	विलायक
psof	फस्फेट
hgif	Fascinate
kfim	alkaline
psos	व्यायाम
pfen	प्रमाणिकरण
kcom	अर्थशास्त्री
krom	अल्पविराम
tluk	wriggle
hyom	आयोडिन
nwuc	गतिओरालो
gjac	गर्भपात
pcom	फली
dzic	डिजाइनर
grun	ब्रेगिङ्ग
dzot	दाता
hzek	मैंगनीज
kfot	किबोर्ड
jlas	अविश्वसनीय
lyim	कुलीन
jyen	येन
pcaf	कोष्ठक
rwip	रग्बी
blip	बाइबल
kyoc	causation
lyon	अल्सर
flis	विभक्ति
nrif	nibble
kfam	क्वांटम
swes	स्वेटर
lwon	विकासवादी
drec	dissection
gjap	स्पा
lyec	रैखिक
tyom	एन्टिमोनी
pwuk	superessiveमामला
flaf	अल्फा
myim	प्रतिरक्षा
pcek	अपहरण
bjac	भठ्ठी
bzac	abridge
bzak	sock
twes	टेलिभिजन
dwut	वृत्तचित्र
ksom	ब्रह्माण्ड
lyis	वानिकी
lwim	एल्यूमीनियम
ksok	Horoscope
sruc	शीघ्र
dlif	डल्फिन
byik	हत्यारा
tfec	स्टेशनरी
hjaf	स्तनपायीले
ryok	प्रोटोकल
dwis	डाइअक्साइड
jlon	पेट
brus	प्रशाशनिकतन्त्र
gjak	ग्यालेक्सी
lyip	चिकित्सीय
ryem	रेडियम
href	rarefied
prok	फ्रिज
slep	satyr
dret	पुनरावृत्ति
kluk	पुरातात्त्विक
dlis	idiosyncrasy
kfip	अस्वीकार्य
mlec	मालिश
pfif	विशिष्टीकरण
nrec	संवेदी
pfet	leaflet
hzoc	underlie
dlam	आदर्श
nlec	शास्त्र
kluc	स्वादिष्ट
dyet	पालकी
tyif	transitive
krus	cower
nluc	सूर्यमुखी
lyun	आयन
zrot	extradition
ksif	मिथ्यासिद्ध
psif	उत्सर्जन
crup	मिल्दाजुल्दा
fret	अन्वेषक
grut	इन्भर्ट
ksec	classmate
jric	यात्रा
mrop	माइक्रोवेव
srus	oust
gyas	hairdresser
floc	लोकगीत
plek	केशिका
nwop	चाक
nrom	नियन्त्रक
twos	आतंकवाद
lwok	नारा
dwet	समयकोक्रमसँगै
slem	अग्लो
grip	ग्रिल
gwas	वाह
kwok	कोबाल्ट
gwon	जई
hdop	गतिupriver
glam	गुदा
bwot	bovine
bren	आंत्र
byot	भिडियो
bjik	boycott
kwim	प्रतियोगिता
cwek	हकी
grif	छापामार
hgem	म्याग्नेसियम
hyes	जागरूकता
fram	औशधिपसल
nwos	unambitious
ryap	पुनःव्यवस्थित
cwim	विश्वसनीयता
klep	सिवार
psec	दिनु
djic	विश्वव्यापी
kfut	curfew
crep	ह्यामबर्गर
frim	प्रमेय
gjas	सल्काउनुभयो
hdef	डेबिट
ryum	युरेनियम
pluk	आकलन
krop	समन्वय
nraf	करदाता
tyes	एकीकृत
plip	opine
hgom	गामा
hgus	गुणक
cwuc	हीटर
zret	घटाउनुहोस्
nles	विश्लेषक
trof	intransitive
hmof	मल
hzim	विस्मुट
dzac	Diner
psok	पोस्टकार्ड
blon	convergence
djet	digress
ksum	हिस्सेदार
mrup	microbe
clif	हेलिक्स
cloc	morphological
tfes	क्याटेरर
gjis	जिन्स
jren	पङ्क्तिबद्ध
tlep	डेटाबेस
kcup	कुपन
glot	भोल्टेज
glut	क्याल्कुलेटरको
srep	साइबरस्पेस
nwes	निवेशक
ksef	एक्सरे
bzis	भिसा
frut	पूर्वाधार
nyuk	firefly
dyik	डिटेक्टर
plec	splice
brom	बर्नर
plop	पैलेडियम
zlik	सिलिकन
flut	भोल्ट
ksop	कस्मेटिक
gjun	सौन्दर्य
kfok	बाडुली
hpof	पपकर्न
hzuk	चिडियाघर
nyoc	connotation
jwak	योग
brim	बारियम
kles	behead
mwam	हाँ
fwik	पटका
djas	ज्याज
dyim	अडियो
tsum	टंगस्टन
drip	dribble
lyaf	छुटानामभएपछिपतिलेपत्नीलाईदिनेपैसा
prom	प्रोग्रामर
nrup	इनपुट
hfes	reflexive
rwaf	ओपेराकार्टूनअक्षर
dlen	दस्तावेज
byas	टीका
fron	लागुपदार्थ
dluk	जडानविच्छेद
dyun	निदान
flap	फोल्डर
kfet	कैथोड
dlim	विचारधारा
prek	पार्किङ
syoc	स्न्यापसट
slus	पहुँच
nlos	anticlimax
mlen	सेलेनियम
pres	Cortex
hlof	सल्फर
nlek	वर्तमानसान्दर्भिकतामार्कर
gwot	विमानस्थल
mwip	imposter
klop	ककरोच
kwom	क्रोमियम
hl6t	लीटर
nwec	तैपनि
glip	चक्रीय
nrop	पेरोल
crum	हर्मोन
dlep	विकासकर्ता
frot	perforate
bwoc	तोडफोड
fwis	नारीवादी
djok	संयुग्मी
draf	आधुनिकबनाउनु
trum	extremist
graf	तर्कको
lwes	लेजर
mlem	मिलिमिटर
flen	फ्लेक्स
zlot	Anode
swok	snuggle
klec	कुकुरथकित
pwim	आंशिकसमय
htuf	टूना
fyis	रिफाइनरी
lwet	संवेदनशीलता
mrem	mainframe
jwic	कायाकल्प
droc	demonstrator
clem	मध्यम
dzik	दोभाषे
psem	प्लाज्मा
hjom	क्रोमोजोम
rwuc	ordinal
tyus	पूर्णांक
klom	किलोमिटर
hfos	फ्याक्स
nwek	जेनेटिक्स
jrap	पेचकस
zwas	appetizer
bwok	ब्रोकोली
dwap	एडप्टर
syem	स्पाम
blek	सदिश
tlus	चाल
pyif	नतोकिएको
cwoc	ठिकैछ
mrep	ampere
hbem	भिटामिन
hxan	doorman
hxut	आर्थिकसहायता
hk6m	मध्यम
hxin	simultaneity
txin	टाइटेनियम
kxin	किलो
klum	copulate
xlis	घडी
hqak	syntactic
hxat	रचनात्मकता
hxik	ईपुस्तक
hxas	कार्यस्थल
bxon	बोरोनकोअर्थ
dxin	अनुगम
hxit	हेलिकप्टर
tlum	टेलुरियम
txit	म्याद
kxat	oxidize
hvik	align
nluk	एनालग
nyem	सेन्टिमिटरले
hm6t	मोलाइबडेनियम
hl6m	लिथियम
ht6t	मल्टिमिडिया
xlit	क्यालोरी
ryop	रोबोट
pxas	फार्मासिस्ट
hxak	गृहकार्य
lwif	locative
grim	लोगारिदम
hqat	म्यान्टिस्
qlit	पारिस्थितिकी
xlik	sophisticate
mlep	टेम्पलेट
hqit	radioactivity
kxim	किलोग्राम
hxen	भाडादार
hxot	overeat
kyif	कापियर
fwet	फ्रीवेयर
txet	उपसमूह
hs6n	क्रमिक
hxet	eavesdrop
xrat	सैलुन
hqan	छल
hr6t	मध्यम
bxat	ब्यान्डविथ
dxet	डेस्कटप
hxis	घाताङ्कीय
hxok	मुख्यालय
hxek	गलतठाउमाराख्नु
srem	मध्यम
hp6t	partitive
pxik	partitiveमामला
kxet	क्यासेट
pruk	सुपरमार्केट
hvit	willpower
xlin	अफलाइन
frip	गुप्तिकरण
hvep	overpay
hxon	समक्रमण
kxit	विस्तार
hqin	संगोष्ठी
tr6n	स्टेरियो
ht6n	बांधनेवाला
hvat	आगामी
sl6s	सेल्सियस
hn6n	नियन
ts6t	वास्तविकसमय
hvin	स्ट्रीमलाइन
pxat	पत्रिका
myoc	मोड्युल
ps6s	पास्ता
bwek	ब्रिफकेस
dlok	डिलक्स
fraf	फायरवाल
hr6k	शिल्पकृति
txat	खाजासमय
hqon	अजवायन
pxun	Plutonium
ks6n	कार्यकेन्द्र
slef	एस्केलेटर
xrit	Lifeguard
hvut	overcrowd
xrim	यट्रियम
hx6t	augmentative
hqum	प्रयोगकर्तानाम
hl6n	salespeople
gron	Argon
pxan	प्रचार
hvac	रेडियोबिना
xlan	वैश्वीकरण
txon	तरङलम्बाइ
xrik	फेरिप्रयोगमाल्याउनु
hxap	झोला
hxac	फेरिशुरुगर्नु
xyat	hepatitis
cwep	पे
hxos	टोरस
txif	टाइपफेस
qlat	रियाल्टार
txot	मध्यशरदऋतु
hxam	milligram
pxis	पिक्सेल
pwif	पूर्वावलोकन
txam	तन्तालम
myek	thermodynamic
hbop	मातोड
hqot	solute
xlic	व्हीलचेयर
gxit	नरसंहार
hvan	Firefighting
glim	गैलियम
pfop	पपअप
hzum	Zirconium
xlon	हटलाइन
qlin	nonlinear
kxam	scandium
blim	Beryllium
kxik	कन्फिगर
nr6n	neuron
hpef	predicative
hruf	राउटर
kxan	क्रमगुणित
hxic	निर्देशिका
xlip	भलिबल
dyek	डिबग
hxop	wristwatch
qrot	न्यूट्रोन
nwip	निओबियम
hs6t	ट्वाइलेट
grem	जर्मेनियम
tles	मेटालोइड
hp6k	prolativeमामला
qyin	जैविकविविधता
txak	एंटीबायोटिक
mlun	स्थिरीकरण
txan	एक्टिनियम
xran	अन्तरिक्षयात्री
dres	decompress
tr6t	पृथ्वीबाहिरअन्यग्रहहरूमा
hk6t	octet
hxus	खुलास्रोत
xlat	crackpot
mraf	म्याराथन
ts6n	मध्यवसन्त
ht6s	Autism
nlif	ionize
txut	notability
hm6n	उत्सर्जन
kxis	क्लिपआर्ट
xrin	भइरहेको
xren	मापुन:निर्देशित
bxak	बुकमार्क
pfos	समर्थकवाक्यांश
hvis	मलको
hd6n	डिनोमिनेटर
brum	बोर्डरूम
hqis	chauvinist
hk6n	कम्पाइल
xyit	पारीप्रमुख
xyin	एकदोस्रो
hxun	subsisting
hvas	भूमिका
glok	ब्लग
hvak	meandering
pxit	आईपी​​ठेगाना
hvet	अर्को
xram	safflower
hc6n	obviousness
qran	कुरान
zyen	क्सीनन
hqas	माकसम
bzas	blase
hj6n	गैरमानव
hnof	nonremittal
txas	निर्माता
hbum	बौद्ध
ts6s	quarreling
pxin	सामाग्री
hr6n	रासन
hxim	मध्यगर्मी
dxit	मध्यजाडो
hxaf	खन्नु
nlus	houseplant
txap	स्थितिबार
vrit	Ghostwriter
kxak	वरिपरिमूर्ख
bxin	मानवशरीर
hqik	रेनकोट
hxes	hertz
hxif	hypnothize
xras	प्रतिघण्टा
pl6k	Paralegal
dxat	rashness
hxip	एंटीबडी
vrat	छोटकरीमा
hqek	देगी
qrit	ध्रुवीयता
pxot	हुलाककार्यालय
hxom	रद्दीमेल
hqic	समीक्षक
lwun	निलो
hp6n	परिपक्वता
dxan	संलग्न
xrak	अभिनेताभूमिका
dxak	दुर्घटना
hven	कन्टेनर
mwap	हास्यपट्टी
qlan	रंगअन्धो
xros	undressing
srom	शोरूम
hc6t	कुराकानी
qrat	तलकोमाथि
hn6t	निषेध
hqet	वेबसाइट
fres	fundraise
froc	Forging
xlak	हाइपरलिङ्क
vlat	volubility
dvan	disembarking
gxin	विजयी
ryes	पाहुनालाइस्वागतगर्नेव्यक्ति
kxot	कनेक्टरों
xyan	delimitation
vlan	विज्ञापनदाता
ryom	परमाणुथोरियम
hluf	बुढ्यौली
hquk	इंजेक्षन
lyum	थुलियमअणु
tyem	मध्यमअणु
hp6m	प्रासेओडाइमियम
txic	गृहपृष्ठ
mros	मोटरहाक्नेव्यक्ति
dyam	मध्यमअणु
pc6n	परीक्षणनम्बर
nyos	इनबक्स
pyek	प्रोजेक्टर
kxon	क्रिप्टन
hxuc	बचाव
qrik	केंद्रितमामला
xwin	inexperience
kxic	निभाउने
hvot	फ्लोचार्ट
dxot	दही
hqut	बाहिरनिस्कनु
pxen	विभागीय
drok	लक्ष्यट्रिगर
flon	मोबाइलफोन
txos	मध्यआवाज
hqok	अप्रत्यक्षमामला
xwik	रोगीमामला
hx6n	prehodiernal
txik	चोरऔला
hqen	प्रेषक
mlap	मालवेयर
hvun	suasion
hvon	थाक्नु
vran	हुलाकी
pfes	प्राध्यापक
pwip	कवि
hqam	कसरत
gxat	वैधता
ks6t	causative
vrin	भर्तीकर्ता
kxip	क्लिपबोर्ड
sr6n	अस्वीकृति
vlit	evaluative
tyup	छेउछाउको
mrom	morpheme
xron	हेडफोन
gxak	महँगो
hrof	ट्रोजनघोडा
xlas	पक्षाघात
dzet	redecorate
txac	surrendering
xrot	प्रयोगनगरिएको
txis	डटम्याट्रिक्स
syif	सीएकाइहरु
xrac	अचम्मकोकुरा
brif	बाइनरीमूल्य
dlos	मोडेलमामला
txun	विशेषताहरु
dvat	खराबस्वभावका
psom	पहिलोहात
gjek	अरूभने
nlem	ठूलोकोएकाइ
qret	खुद्रापसल
txip	तीनबिन्दु
dlek	व्यक्तिगत
lwut	प्रवाहवर्तमान
dxis	नाटकीय
hs6m	सीजियम
vlak	railcar
hn6m	netium
kxap	गत्ता
bxan	प्रस्थान
myem	मईकोमहिना
gxik	नागरिकअधिकार
hxoc	वायुसेना
xrok	सहकर्मी
kr6t	स्क्रिनसट
txok	स्वतः
hxep	स्केटबोर्ड
srop	स्मार्टफोन
pxak	क्यापस्लक
hk6k	लोकसंगीत
hl6k	eulersनम्बर
pyom	परमाणुपोलोनियम
xyam	परमाणुथालियम
hvic	अतिक्रमण
lyok	locativeमामला
xlot	फ्लैट्स
txen	restatement
kxac	जवाबीहमला
qrak	strikebreaker
hbup	स्विमिंगपूल
txuk	छोटोसर्किट
tsef	tapered
bxit	वेबहोस्ट
ksem	पढ्नमात्रमिल्ने
byim	परमाणुरूबिडियम
hvam	Vanadiumअणु
lw6n	लान्थानम
frum	परमाणुफ्लोरिन
nyom	मध्यम
mlom	multalनम्बर
kxas	व्यक्तिगत
xret	terabyte
hs6k	खोजइन्जिन
frus	corroding
gxan	ग्यालेक्सीलिङ्ग
vlas	vocalizations
glet	ग्याँसपेडल
hvim	रनटाइम
bxip	बिटमैप
qrin	तारालिङ्ग
bvak	abessiveमामला
pxon	उपलब्ध
dvik	adessiveमामला
dvek	agentiveमामला
hlef	एजेन्टट्रिगर
kwek	मामलागर्न
kxen	साधारणलिङ्ग
ht6m	दृष्टान्तफारम
tsuf	ट्रान्सअंक
hf6n	fining
tc6t	प्रत्यक्षवस्तु
gvik	ergativeमामला
gxon	खण्डीकरणकोक्रमलाई
ksep	रिसेप्टर
vyin	सिनेमाहल
pyos	सुस्तआवाज
hnef	परिमितक्रिया
xwit	प्राथमिकवस्तु
hqim	gnomicमुड
jlak	सामान्यकरण
vrik	अन्तिमकण
qyan	काल्पनिकएकाइ
kxaf	प्रकाशकोगति
xyic	फिसिङ
qyit	महत्वपूर्णबिन्दु
hvek	evitativeमामला
bvik	subessiveमामला
hzes	नजिकैमामला
prus	कम्प्युटरभाइरस
ples	प्रोसेसर
pxif	प्रहरीअधिकृत
dvak	lativeमामला
brun	दौरा
tsi_k	antessiveमामला
tyum	परमाणुरूथेनियम
vyak	adverbialमामला
pxim	प्रधानमन्त्री
syum	परमाणुस्ट्रोनटियम
sy6n	suspiciousness
hy6n	लिङ्गचेतन
pxac	समानुभूतिशीलआनन्द
vlin	वाहनलिङ्ग
qwin	खनिजलिङ्ग
hr6s	सान्दर्भिक
tf6n	टोनर
xris	प्रयोगकर्ताइन्टरफेस
hw6n	शपथग्रहण
xlen	मौखिकसंज्ञा
pyec	स्प्रिेडसिट
vlim	भर्चुअलस्मृति
bres	शब्दप्रोसेसर
hqip	क्लाउडकम्प्युटिङ
vlic	भर्चुअलमिसिन
pfam	स्पैमर
dyap	दोस्रोभाषा
txek	nthमूल
dxen	डाटाखनन
byip	व्यापारव्यक्ति
hs6c	आत्मविश्वास
txim	संकेत
hb6t	घटनाकोपरिवर्तन
hdem	डोमेननाम
dxon	विभिन्नघटना
lwaf	फ्लैशड्राइव
sl6t	crastinalकाल
xyik	फ्लपीडिस्क
fyif	reflexiveआवाज
bvin	ब्रह्माण्डकोलिङ्ग
hm6p	Motherboard
tfip	transitiveक्रिया
jlen	ईलाकालिङ्ग
xrap	धारिलो
tc6n	अनुसन्धानलिङ्ग
sl6n	कलात्मकलिङ्ग
xrek	रोगीट्रिगर
xwan	सारलिङ्ग
dxif	भिडियोसम्मेलन
dyip	अप्रत्यक्षबोली
zrek	exocentricमामला
hvuk	evoking
xwat	विगतकाperfective
hr6m	मध्यम
txaf	ट्रिगर
hmef	आवेकहिनक्रिया
tx6t	पाठसम्पादक
txes	सामूहिकसंज्ञा
bvat	दुर्व्यवहार
bvuk	absolutiveमामला
ry6t	रेडियन
vlis	भर्चुअलवास्तविकता
qren	ग्रहलिङ्ग
gvak	व्याकरणमामला
bxok	गंजा
mrum	कम्प्यूटरकार्यक्रम
ps6t	अपरेटिङसिस्टम
hfom	phoneme
tlem	मात्रस्मृतिपढ्न
pwam	स्पाइवेयर
kfif	कोरbenefactive
qwit	rationality
nlaf	स्थापना
nwok	associativeमामला
dzas	dissatisfy
swuk	सर्वोत्कृष्टमामला
syos	सारांश
kr6n	बिजुलीवर्तमान
dvin	inanimateलिङ्ग
pxom	propositiveमुड
vris	पारस्परिकआवाज
rwos	aerosol
dr6t	distractor
ht6k	दूरसंचार
slaf	सामाजिकसंजाल
lyuk	क्रमिकखण्ड
qras	superiors
ty6n	teminal
gwet	चाँडैभविष्यमाकाल
hp6s	applicativeआवाज
tsof	antipassiveआवाज
ht6p	continutiveपक्ष
hn6f	necessitativeमुड
pfip	निष्क्रियparticiple
glap	उपकरणपट्टी
sy6k	अस्तित्वखण्ड
qyat	चमकीलेतीव्रता
hy6t	व्याकरणवस्तु
vyan	घोषणा
sluf	singulativeनम्बर
dvit	अत्यधिकअवधि
qyak	एकलकार्यक्रिया
bzik	भौतिकशास्त्र
xlet	सर्वोत्कृष्टडिग्री
hqap	वर्तमानparticiple
qwat	पदार्थकोमात्रा
qyik	संयोजीकण
sr6t	supercriticalतरलपदार्थ
hfem	epentheticmorpheme
tl6t	रिमोटभविष्यकाल
mrif	माइक्रोफोन
pcuk	postpositionalमामला
tfim	अनियमितपहुँचस्मृति
fwim	ethium
ly6t	allocutiveसम्झौता
hvap	पुस्तकपट्टी
hfep	frequentativeपक्ष
bvan	distributiveसर्वनाम
fyun	उत्प्लवानबिन्दुनम्बर
xyas	मेटाउँदै
hvif	क्रियालगाउनु
xyis	विगतमानिष्क्रियparticiple
tl6n	केन्द्रीयप्रशोधनएकाइ
tfok	locativeदिशात्मकमामला
qwan	बारम्बारसोधिनेप्रश्नहरू
