hnit	infinitive
hnak	chonchonominative
hkak	chonchoaccusative
htak	tsankhani
hpap	bambo
hmam	mayi
hyat	makolo
hcan	Moni
hwik	chonchogramalawosonya
hsuc	makolo
htat	agogo
hcac	njala
hnik	chonchogenitive
hcit	adjective
hwan	ndi
hman	ine
hnan	inu
hwam	ife
htit	izo
htac	kopitankhani
htik	chonchodative
hyit	maganizorealis
htim	maganizodeontic
hcut	maganizomakonzedwe
hsit	maganizoepistemic
hyak	chonchozoimbidwa
htan	mkatinkhani
hpan	munthunkhani
htin	mzerapalokha
hyan	mzerayozungulira
hfap	perfectivembali
hkat	kale
hnin	wamphongojenda
hmak	chonchocomitative
hnat	pakalipano
hpak	chonchobenefactive
swik	chonchoessive
htut	negatoryquantifier
hsan	pamwambankhani
hpin	chonchoadpositional
hwin	locationnkhani
hkan	dangankhani
hnac	njirankhani
hyut	maganizointerrogative
hnam	ndipokapena
hkit	yekhakapena
hsuk	chonchogwero
hpik	chonchoablative
hcat	moyandikana
hmat	woonekeratu
hkuk	mzeramchira
hlan	koma
hsut	onse
hyin	quantifierchilengedwe
hcin	zachikazijenda
hpac	mochulukitsanumber
hyik	chimodzi
htic	awo
hkik	amene
tcat	tsogoloyomangika
hsin	nkhanichikhalidwe
hkac	liti
hmip	imperfectivembali
klan	Apo
hlak	chonchoelative
hlik	chonchoillative
htam	maganizolangizo
hlat	kusankidwaquantifier
hkam	chani
hwat	mawufunso
htap	copula
hpat	munthu
nyan	mwamuna
hkas	ndikanathera
tcan	ena
hnuc	number
twit	quantifierochangamuka
hsak	nthawinkhani
htuk	nkhanizosatha
htun	okha
htum	maganizohortative
hyip	retrospectivembali
hlit	maganizovolitive
pcic	ayenela
tyut	awiri
hsat	onani
hkut	mukudziwa
hcic	pansi
hcap	pambuyo
hpam	choyamba
hlac	alienablechuma
hkap	konse
hnic	kwachikhalirechuma
tyat	akale
tcit	maganizodeliberative
tcin	tsiku
hlam	kubwera
hwak	vowel
hkin	kupita
lwak	chonchoperlative
hpip	mwapang&#39;onopang&#39;onombali
lyan	yaitali
hsac	kunena
kyan	Bwanji
htas	kachiwiri
hsic	Pano
hcik	ndikuganiza
hcak	pansipankhani
hfan	anapeza
hsun	dzanja
hyac	komanso
nwan	achinyamata
tyit	motsutsana
tlan	mulungu
twak	chonchodelative
hmin	kanthu
hyas	kamodzi
hlap	semelfactivembali
kcac	anasiya
hyic	anaona
hcas	nyumba
hwac	dziko
tyin	atatu
hnun	Wachiwiri
hcuk	cholinga
pyan	kukonda
hsis	nthawizonse
hyam	usiku
hyap	mfumu
hkic	pakati
hmas	malingaliro
cyit	mtima
pluc	numberpaucal
kyik	chifukwa
ksak	chonchocausal
tcun	tamaliza
hnim	dzina
tsan	moyeneranauni
klac	dziko
hpun	anafunsa
cyat	loonekawosonyezakutin&#39;zoona
pcac	bwino
hmac	mphindi
hnas	sindingakhoze
hwic	madzi
twim	maganizodesiderative
kwan	kuwala
tlat	mawu
tyan	chitseko
hsas	m&#39;mawa
syat	mpaka
twik	chonchoterminative
hpit	woyera
pcan	ndalama
hyis	wosauka
mwan	imfa
hfam	mawonekedwe
nwik	chonchoinessive
kcat	pamodzi
tsac	zambiri
pyat	bwenzi
psan	theka
hpim	maganizoMotelo
hyuc	kuzungulira
hfat	anatumiza
hcis	mkazi
kcan	ndikukhulupirira
hsik	boma
htus	bomankhani
hpas	mwana
clat	ana
tyak	Motero
cwan	ndikuyembekeza
syin	wokondedwa
hkuc	mkulu
tyac	werengani
syit	mzinda
hlic	kale
hfit	factivewosonyezakutin&#39;zoona
tcac	msungwana
hcun	akumva
ksan	osachepera
hyaf	mwina
kyat	poyeneradi
tcic	thupi
hwit	obwereza
cwat	mpweya
hfaf	chilamulo
hput	Thandizeni
lyat	kalata
ksas	zinayi
hpic	maganizooptative
hfuk	moto
hcam	ora
twat	nkhondo
kyak	zingapo
tlit	lachiwiri
pcin	kuseri
hmut	anataya
clan	zikwi
hfac	banja
twan	moyo
hwas	funso
syan	choonadi
htis	kupanga
tsat	maganizokuthekera
lwik	chonchoallative
nyin	Anthropicjenda
hfak	zisanu
tcak	phunzirolomwelopentopeni
htuc	nkhanizosiyanasiyana
hnap	yankho
hmit	nyanja
hcuc	mantha
pcat	kumvetsa
syas	mawu
hcaf	kukayika
twut	maganizodubitative
hkis	chakuda
tlak	kubweretsa
hyus	kukongola
nyit	mtundu
htip	khumi
ksis	nkhani
hpuk	buku
hlin	pakompyuta
hkun	nkhani
lyas	chidwi
lyit	kulemba
pwat	bedi
hnis	m&#39;badwo
hnut	counterfactualmakonzedwe
slas	art
hwis	vialisnkhani
pyak	m&#39;bale
lyin	mzere
tyas	gome
hyun	mtsinje
kyac	diso
tfan	mwadzidzidzi
kcin	kwambiri
hmuc	cholinga
cyac	magazi
hmap	ananyamuka
tlin	kuzizira
hyif	patsogolo
tyam	kumapeto
hnaf	ndikuganiza
hkip	pafupifupi
myan	zanga
tsin	chidziwitso
hkup	munditumizire
hsam	mwamuna
hlis	zisanundichimodzi
cwit	moyo
cyan	mtendere
myat	kumbukirani
tyic	achilengedwe
hfut	kugwa
swas	utumiki
hsap	kupatula
pcit	kukopera
hyim	asilikali
kyas	kavalo
plic	tsogolo
pcak	kumadzulo
hpis	kulipira
hyuk	wofiira
hwun	golidi
twin	chilakolako
plan	kusewera
hpus	ofesi
syun	boma
kyic	mpingo
htaf	mphamvu
hlun	kutalika
kyin	kampani
kyis	pepala
mlan	Mwina
hcim	makamaka
cyas	kudzachitira
twac	window
nyat	kukongola
hcus	yotsirizira
htup	ntchito
htif	mtunda
pyas	phazi
hlas	zakutchire
ksin	wobiriwira
hmaf	vuto
myac	kumwetulira
hsim	tulo
kyit	undefined
kwik	chonchoquotative
fwan	ulendo
slan	kutsatira
psit	kukhalapo
hmic	sweet
hmuf	m&#39;kamwa
hfin	wachuma
tcam	mdani
psuk	osweka
kcap	m&#39;chombo
pwan	munthuPonena
hfic	chikoka
tcuc	kuoneka
hkim	chinsinsi
pyin	Chonde
pwit	maganizoprecative
pyit	aulemum&#39;kaundula
cwak	zoipa
myak	march
tcas	malo
hlaf	kukhala
psat	m&#39;malo
nlan	buluu
psac	zosatheka
kcuk	sukulu
kcit	anakwatira
kcak	chakudya
syis	makumiawiri
tlac	chete
hcip	mbalioyembekezera
kwin	kupereka
tsit	anasiya
pyac	chilankhulo
hsus	sabata
hcup	holo
cyap	ndikudabwa
tfin	Anabadwa
fyat	khoti
hnip	gnomicmbali
tsak	kulemekeza
tlas	ofunika
syuc	mtengo
plat	wall
cyak	kumwamba
twip	inchoativembali
mlat	lamulo
swit	maganizojussive
mwas	mwezi
hwaf	wangwiro
tyap	zinachitikira
ksac	zinthu
syac	mwatsopano
hnuk	wolamulira
kwak	yokutidwa
tyuk	kum&#39;mawa
pwac	mwala
hkif	wolemekezeka
nyac	malangizo
cyis	mpando
tyuc	akuyembekezera
tsun	mudzi
tyik	kugwirizana
hnum	maganizoazilera
slak	bwino
tsic	akuyesera
slat	phiri
hmik	nyimbo
hkus	kulira
hsip	Zisanundiziwiri
hpaf	paokha
nwas	uthenga
tfac	powonekera
fyan	m&#39;munda
cwas	yamba
hfik	chonchodistributive
lyac	kuphunzira
syik	zandale
clin	Henry
cyin	bodza
tsas	adaponya
cyik	ulamuliro
tlap	pansi
cyam	chilimwe
tcut	chipembedzo
tcap	kuthawa
hlut	wolemba
pyun	bulauni
tcuk	kupweteka
swan	masika
hmun	yofewa
kyun	ngodya
nyak	chizindikiro
tsis	chilungamo
psas	panga
cyaf	Anaseka
hwut	angaiwale
hyup	Ulaya
hwap	zisanundizitatu
psak	m&#39;kupita
kyap	lowopsya
pyic	chofunika
hmim	sing&#39;anga
hsaf	mpweya
hmis	wanzeru
hsum	odzikundikirapentopeni
ksat	osangalatsa
ksit	manda
tsap	chilumba
kyam	mumsasa
tcum	kukhudza
cyun	olosera
psic	pagombe
tyun	ankalamulira
mwit	maganizocommissive
tlut	digiri
myit	yozizira
kfan	khalidwe
slac	athamanga
myin	miniti
tyip	kutsogolera
klas	galasi
pfat	bolodi
cyic	pachabe
swam	zochitika
syam	otetezeka
tsut	dokotala
hlip	completivembali
kcas	mdima
nyun	ofunda
hpuc	kumwa
tlam	Mwachitsanzo
hfun	mkwiyo
tsik	ngakhale
tsam	mwachindunji
hmup	chipewa
klak	galu
slin	zasiliva
swac	wantchito
kcam	kunyada
pyik	sitima
myut	makhalidwe
syak	kulowa
swat	lupanga
kyuk	kuukira
clac	umoyo
tyaf	ndime
swic	chikhalidwe
tfit	obwezeredwa
hkaf	boma
pcas	Mwachidule
nyam	ulemerero
tfat	thwelofu
pcut	zikugwira
pwin	vinyo
mwat	kukoma
fyac	chitsulo
syap	kugawira
myap	malonda
hyum	ntchito
fwak	woweruza
klat	kapitawo
twap	cessativembali
kcic	chidwi
kwic	lachilendo
hnif	intensifier
myun	kufunika
tlic	potsiriza
cyuk	pakhosi
syut	ufulu
pfan	mbali
kyuc	youma
pcap	pambali
tfak	wosonyezakutin&#39;zoona
tcik	chonchowosonyezakutin&#39;zoona
twun	lakutali
tyis	patsogolo
nyap	yopapatiza
plit	nyumba
hpif	tsamba
pwic	atagwira
syic	zachisoni
tsip	tchimo
syim	odwala
tcis	woonamtima
pcun	banki
ksap	kulandira
lyam	mtsinje
tcaf	mosamala
kwac	khutu
hpup	mkate
kcut	kusankha
nwam	chinyama
hsup	zoicjenda
nwit	eventivemaganizo
tcim	chomwechochochitikapentopeni
tlik	chonchomultiplicative
kyus	kuwoloka
hmus	wandiweyani
kfat	angayerekeze
nwat	kukula
myic	mvula
hpum	pamwamba
swut	woyera
clis	July
mwun	mafashoni
hfas	file
cwac	phewa
kwat	chitonthozo
nwac	aliyense
tcip	anakhumba
kfac	udzu
hmuk	kudzatunga
plin	kutsegula
kwun	June
mlik	nsomba
klin	likulu
pfut	m&#39;mawere
twam	Funsani
fyin	ndalama
nlit	zanu
mlin	miliyoni
pyut	pempherani
hluk	wotopa
ksut	kupha
cyut	mthunzi
psin	kulemera
kcis	imvi
pyam	olimbamtima
mwac	kukhuta
klam	ndikukuuzani
ksam	national
hfip	ofooka
klik	chigwa
hkum	maganizozongopeka
clas	yellow
cyuc	kutentha
mlac	zotsalira
syip	mofanana
pwak	bokosi
tcif	zisonga
psip	mfundo
ksik	zotsatira
tsim	nyengo
flan	sayansi
pcam	Zikuoneka
kcun	inabala
ksuk	amalume
mlit	mndandanda
pcik	owopsa
kwas	August
hluc	wotchuka
klit	osadziwika
flak	bwino
fyit	bwinom&#39;kaundula
lwat	owerenga
plun	akuyenda
twas	kawiri
pcis	wansembe
fyas	anavulazidwa
nlat	yachifumu
myuk	kupusitsa
pfak	mtima
tcuf	zisanundizinayi
cwap	chifundo
plac	mkangano
pyap	kuika
lyic	wovala
hcum	phokoso
lwit	mabuku
tsuk	udindo
hfup	mkuntho
kcik	mthumba
nwap	novembala
tyim	December
psaf	kulibe
nlac	anthu
kyaf	tikukuthokozani
slis	mndandanda
pyaf	mbalame
mlak	mwini
kwut	odula
hwuc	kugona
pyis	mofulumira
twuc	utsi
nwak	January
mlic	makina
tlis	mano
ksun	choyaka
clam	manyazi
klaf	khalidwe
clit	mphete
fyak	akuti
fyam	akutipentopeni
kwap	khwalala
hwip	pasabata
psis	ndakatulo
pwut	undefined
kyim	kugula
clic	m&#39;minda
pyip	April
kfap	October
psut	zinthu
kcuc	zowawa
nlap	kapolo
hsok	lotayirira
htet	lemba
hbat	zikachitika
hrit	ngongole
hzit	Mawonekedwe
hpet	fifitini
krac	wankhanza
hduc	fumbi
hrik	othandiza
hron	mtundu
hnus	mphuno
hric	wochezeka
srik	kotunga
hten	dzulo
tlet	hesternalyomangika
slap	kulephera
hban	azivala
hdat	akhungu
fran	kuuluka
hdan	mdierekezi
htec	pang&#39;onopang&#39;ono
hmon	ntchito
cran	nsembe
hran	chikumbumtima
hmos	mtumiki
nrit	mphamvu
hcet	kudana
hset	likulu
hrin	zomvekajenda
hcot	kusangalala
hrip	mwachidule
htep	kulambira
hcif	khungu
hrat	denga
kran	korona
hkon	Nyumbayi
tran	kusimidwa
hmif	kilomita
trin	bwalo
hgin	m&#39;ndende
hkop	chikho
hcen	membala
swin	yapachiweniweni
hrac	kulikonse
hris	mwambo
hbin	kukhala
hmot	nyama
hdut	mkaka
hwen	vegetaljenda
nran	chosowa
hbac	msuweni
crut	mlatho
hsoc	katundu
hsom	mchere
nris	wosalakwa
hbit	kupewa
crin	kuzizwa
rwin	mfumukazi
hgut	awerenge
hdas	gule
hnot	hotel
hdin	mudzaze
hton	mkaidi
hdak	shopu
hlet	masitepe
hson	chikhululukiro
hgek	gaymu
hras	mchenga
hsep	September
hbic	chitayiko
hlen	laisensi
hcon	mokwanira
hgit	umboni
kfon	khitchini
hbak	kugulitsa
tlim	mankhwala
hsot	liwiro
kyut	kompyuta
hnen	wosatha
htek	laibulale
hzan	okhala
hbis	m&#39;munsi
hbun	chisokonezo
kcus	wophika
hgat	chipululu
hwus	chipsompsono
hbif	ayezi
hbot	mpira
hrut	mtsutso
hdit	maganizobenedictive
hdis	wolakwa
hjan	chilango
plis	police
hgan	kubisa
hsen	Ulendowu
nrin	mbuli
hyen	mtambo
frif	February
hdik	matenda
hnek	kanthunkhani
hbam	azakhali
hmen	wodzichepetsa
hdip	mochedwaMotelo
prat	inanenawosonyezakutin&#39;zoona
hdet	usiku
hjit	chala
hmoc	kwinakwake
pran	atolankhani
kcec	dera
hken	posachedwapa
hloc	wozingwa
hrak	ogwira
htes	ankayang&#39;ana
rwan	mphotho
hdon	aperekepo
htot	mphumi
hnet	mngelo
hdun	mmodzi
croc	cholakwa
hlon	m&#39;bandakucha
hyec	nkhosa
hjin	chipiriro
hrec	referential
mran	chimanga
htos	ambiri
hcos	miyeso
hkoc	zina
hlif	phindu
clak	shuga
hjat	anthu
tram	chimango
hdic	litayamba
hkok	kopanda
srat	wojambula
crak	chithumwa
hmet	imelo
hden	chisankho
gran	bwanamkubwa
crac	nthambi
hjac	changu
hdim	maganizoinductive
hcok	fulumirani
hyet	mafuta
pwap	chitoliro
trat	kusindikiza
tcot	nkhaniolimba
hdoc	o
hren	nkhaninkhani
tcon	usana
krin	kanyumba
plam	Alamu
hnes	wamanjenje
tcen	Ataona
hsek	mbali
plik	applicable
slik	silika
hfen	cent
hgen	wothandizila
hnon	ogwirizana
crik	gehena
tcet	zosalongosoka
mrat	wosakaniza
hdam	maganizoadmonitive
hgac	kutchuka
htoc	mwanjiraina
hdac	malangizo
nwin	constitution
srit	chida
hret	mwamphamvu
nlin	Intaneti
hzat	mafunde
klic	koleji
hkek	mchira
nric	m&#39;badwo
hgic	yodzaza
hgak	mphaka
trit	wosonyezakutin&#39;zoonamwachindunji
tyot	Mgwirizanowu
hnok	nkhani
crit	anasiya
slen	khumindichimodzi
srin	Mwachibadwa
hpok	fuko
hyot	maganizoamantha
cric	pogona
hruc	wamwano
cwin	kukwera
hzak	kugwirana
dyit	makampani
hpec	chivomerezo
nras	namwino
hcec	chiphunzitso
hbut	nsapato
hmec	yosokoneza
twot	ntchito
crat	Loweruka
hkot	mphamvu
hnec	dzuwa
hwuf	wamasiye
cren	anakhetsa
nrat	nyenyezi
hget	mlendo
hbik	akudalitseni
brin	lamkati
hpot	lilipo
trac	kukaniza
prac	amapeza
hcoc	dzenje
hpon	m&#39;chigawo
hwim	chitukuko
dwan	Yembekezerani
cwok	mantha
hdok	galimoto
crun	chuma
hzik	mbewu
hrot	posachedwapakale
hket	Galamukani
hcek	mipando
hrop	Mangani
mrac	ulendo
byit	phwando
trak	pachaka
hzin	kum&#39;mwera
sric	mwambo
clik	kusaka
trap	owolowamanja
hrim	chikristo
hrus	wolemekezeka
blat	guwa
cyon	ting&#39;onoting&#39;ono
hwep	intaneti
krat	kadinala
tris	wofiirira
kcot	kusonkhanitsa
hben	chisankho
trik	ataledzera
kfit	Nyamulani
tcec	kuwombola
nrik	Mfotokozi
grat	mfumu
dran	Dongosolo
hpen	poyamba
cluk	wonyansa
nrac	zabwinobwino
ryin	maphunziro
hrun	mpukutu
nwic	inchi
slit	kuwombera
gzat	nyuzipepala
krot	kudula
drit	ndevu
hzis	kugwetsera
hdap	khumindizisanundizitatu
sris	m&#39;mbiri
mrut	choipitsitsa
nyik	m&#39;matope
bran	mkwatibwi
drat	zimadalira
djan	chimphona
glat	kuphweka
hpoc	m&#39;dzinja
pras	chophimba
hgot	kusonkhana
tret	zisudzo
tras	poyerekeza
rwit	mnzake
hfon	kupanga
klot	kochi
hmum	nthabwala
drac	nkhani
rwas	buku
tset	kubwezera
hdot	wapotalikirawoonekeratu
ryut	nsanje
hwon	pempho
byat	kuwotchedwa
flac	kung&#39;anima
prot	chithunzi
crek	amati
htok	nkhondo
htop	temberero
prit	maganizoimprecative
hces	pogwira
klup	club
hnos	chigumula
dwin	mphwayi
prin	m&#39;chizimezime
mrit	maganizoassumptive
tcoc	phompho
hcom	mogwirizana
grit	bingu
tlot	ubwana
hgik	bondo
hwes	atakomoka
hzac	mwagwirizana
hsec	software
tson	mabungwe
ryit	chiphaso
dlin	chilango
slip	Pepala
klon	Kukwera
hfim	mlimi
hpom	nsanja
cyen	wophunzira
hgec	phanga
hroc	miyambo
srac	kugonjera
ryat	tsoka
kcen	namwali
hbap	kutsanzikana
krik	podzudzula
krap	thonje
fwat	chipatala
kcet	lendi
hgas	gasi
pfin	mosalephera
dlit	tsamba
ryan	kumasulira
sran	maliro
mrin	ufa
hram	chikondi
dlan	dollar
hzas	ananyodola
hsos	sikisitini
klen	njuchi
gyin	phiko
hsif	mkango
cluc	kuchenjerera
prip	kukonzekera
hzut	nkhungu
dwat	mankhwala
krit	proofread
sras	chisa
hses	khumindizinayi
brat	chokana
flat	asidi
hjic	ndicho
slic	chida
hbuc	wosuta
tron	lalanje
byan	osamba
hrif	wosazindikira
tlip	kukhazikitsa
blan	dengu
kris	mlembi
hyon	Panthawiyi
tren	lero
dlat	hodiernalyomangika
hzic	chiphe
tfic	mfuti
tlen	talente
hlim	nyengo
dyat	mwamuna
kcon	Chivumbulutso
dlac	wosambitsa
krak	chivomerezo
hbas	zamkhutu
hkec	malasha
hrek	kubwezeretsa
hkos	bwato
hwif	wachiwiri
tric	zosakhalitsa
hdep	delimitativembali
mwak	mulu
ksot	bone
hnoc	lolemba
nlas	Lachiwiri
brac	Lachitatu
frap	feduro
pfit	woimira
pcoc	mzati
lyen	bafuta
swak	lakuya
pcen	pulezidenti
brit	wamagazi
hwec	kuzinga
hwet	mmimba
hlos	capamwamba
hbon	zosiyanasiyana
pcon	mkuwa
hsem	udachitikira
lwac	wotchipa
tsos	Mpikisanowo
kwen	munthuyekha
trun	ankafika
trut	fano
hrap	zidazankhondo
hgap	mmangeni
trot	kutentha
grin	Mdera
hjak	akukumbatirana
hpek	paketi
hlus	nswala
hwos	kuchipinda
tsuc	chitsamba
pcuc	kumaliseche
cris	wolowa
clun	thundu
hpes	zosasangalatsa
nlet	chosakwanira
hrom	pulogalamu
pyon	limba
swet	kukopa
dric	wosaoneka
tyen	chodziwika
hruk	nkhanza
frat	anatumizidwa
hyoc	mayesero
hlep	telicmbali
nrot	mayiko
nret	chiwawa
hfif	nzeruzapamwamba
pfic	chifaniziro
hmek	tcheru
hfec	moyo
myik	nsomba
truc	kuba
tcop	mlomo
rwic	kupuma
htom	chuma
glan	gallery
pren	kufanana
hlek	atelicmbali
nrak	Africa
truk	kugogoda
hjim	maganizoprohibitive
rwat	tayi
hcep	cell
dyan	dzira
jrat	yokumba
nren	kudzoza
ksic	mavuto
tsoc	akufufuza
lwan	nkhomaliro
hpos	paini
hcuf	Kankhani
tcus	Sue
pset	kuwonjezera
hkep	zamkuwa
swis	yapamadzi
prim	lachifumu
trip	chikwapu
cras	shati
swap	zikulilima
syet	sewero
htof	mbala
clen	njira
kwit	umunthu
klok	owonjezera
hrok	kusintha
hguc	ludzu
kcim	pachiswe
hpem	kanjedza
psik	wokamba
frit	pakhomo
cret	kuda
mrak	mkondo
syen	gawo
tcup	achinyezi
hyek	wapaulendo
trim	tini
plak	dandaulo
hyok	njingayo
hgam	ng&#39;ombe
hmok	chigayo
jrac	mapa
kloc	kolala
gyit	dala
hbip	mowa
mlet	veleveti
lyap	nkhanza
cwen	nkhosa
bwan	mwana
tses	khumindizitatu
jrit	kulungamitsa
nlak	pamanja
sron	wankhondo
cruc	Lachisanu
broc	burashi
dlot	Download
krim	kirimu
pric	phula
prut	loweruza
hgon	achisanu
sram	kwenikweni
pfot	mphika
hlot	anakonza
djin	ndalama
hlok	adzatumpha
hpep	apulosi
hwot	zopotoka
dlak	kambiranani
brik	amamvera
nlis	transcribe
hbet	uliwonse
pris	virus
hjik	kuchereza
blit	zachibwana
hjap	mkanjo
tfik	kuonetsa
hdaf	afikire
hpop	kuimba
kcaf	kubisala
kcoc	chigongono
hrum	kukonza
cyim	Muzisamala
dyic	yophunzitsa
hgoc	dzenje
drak	matenda
plas	chimwemwe
byin	bayinare
hzap	Abbey
nlot	wokhulupirika
mrik	mawotchi
hsop	bwinobwino
crap	msampha
kyek	keke
nrut	kuchereza
syes	bwana
hjet	seventini
hjen	zachikazi
hmom	uchi
hdec	mwatsoka
lwen	nthano
slot	mbaula
frac	kupanduka
gwan	kufufuma
mruk	patsogolo
swot	dambo
zlan	kupeza
hnem	mosangalatsa
hdes	kuvala
prak	lalikira
frin	zokongola
hfet	amatsutsa
cros	makolasi
ryon	zomveka
tcos	mbewu
tsen	processing
hwek	nkhandwe
nlik	chokana
klap	muofesiyo
dras	nadzapeputsa
prop	chonde
slim	wenzulo
hgis	cheese
krut	kuluma
srot	kuperekezedwa
bjan	kuyendayenda
nwen	bulu
myas	amabisa
kwaf	kukhala
twis	zashuga
pcip	pensulo
srap	masamba
sren	chionetsero
tlun	Buluku
hrup	chivundi
nrip	nduna
srup	msuzi
jran	dokotala
bjat	gawo
gyat	kazitape
hlem	wosasamala
srak	umboni
kson	ka
cwis	Lachinayi
sret	modzipereka
hraf	magalimoto
hres	zomangamanga
hsuf	akanagwiritsa
rwak	mng&#39;alu
twon	yokongoletsera
hfus	kuchira
hkom	kachidindo
djat	msaki
nlut	Kalatayi
hsef	njoka
mris	demokalase
bric	batire
mlam	sera
zran	kuuza
cron	kukayikitsanso
hzen	kusambira
traf	Mzere
cwaf	envelopu
srip	ndudu
mrot	galimoto
swon	mongodzipereka
ryak	zimene
pfun	pang&#39;ono
blac	Katundu
mret	utumiki
hjon	kugonana
kcok	nkhwangwa
dram	diamondi
kren	taphunzira
tcek	Echo
hdif	adzadziwire
tfas	kazembe
hfot	zigwirizana
lwas	aulesi
hmep	momentanembali
kfin	kabisidwe
mwin	kungoganiza
hrem	ray
pram	kukwera
byac	m&#39;chipindachapansi
mren	losaiwalika
swen	Senate
kras	bokosi
hgun	kumeza
nlok	azimukonda
ryic	zaulimi
gwin	kugwedezeka
srut	dambo
hkes	zovuta
hfis	yosiya
frak	mobwerezabwereza
hnom	chiwembu
hcop	maloomwera
hlec	tsabola
mlot	Nyimbo
zrat	phungu
proc	woyang&#39;anira
flik	nkhandwe
cyet	undefined
hgim	m&#39;chumunicho
slet	tchinga
tcok	lolondola
bjit	kalewomwalirayo
brot	Mphukira
bwat	bulangete
hdus	nkhumba
gwat	minyanga
kret	Tingafinye
nwet	amatsata
jwan	Njira
nwis	misomali
mwic	njuchi
bzat	wosewera
gyan	m&#39;thukuta
zyit	pakampani
blic	nkhambakamwa
pcet	njakata
tsot	pindani
bwit	malire
tres	kupanikizika
hkof	mowa
nyen	kulilira
hles	amafanana
cyek	thumba
hjis	singano
gjan	chodabwitsa
prec	zinthu
drot	ankalamulira
kcek	pamapindikira
twic	nkhuku
brak	mbiya
zwat	kabwerebwere
clap	kabwerebwerembali
tsec	katswiri
bwin	tisangalatse
cwet	njanjira
hbek	wophika
zlin	maolivi
mron	galimoto
drin	zimathera
psap	poyera
gjin	tsikulobadwa
clut	nyundo
cwun	onunkhira
twaf	zazing&#39;ono
pcot	kusisita
krok	chigaza
dlik	aphungu
cwic	mwamwayi
srun	kukokatsinya
crec	kuwononga
jlan	mphepete
kcip	ngwazi
blin	biliyoni
ryik	mankhwala
mlas	Kugunda
flit	woyendetsa
hzet	mfundo
cwik	otchuka
twet	siketi
mwik	mlunguuliwonse
tfis	luso
tlon	galimoto
cram	undefined
grac	kulimbikitsa
kraf	khwangwala
trup	chikhumbo
hduk	mbedza
cruk	kambuku
nrap	wantchito
crot	khwalala
mlip	asilikali
hfoc	chithunzi
nres	umphumphu
plos	kuphatikiza
tfam	mandala
nlic	naintini
hwok	oyenerera
nlen	nkhani
fyic	Mwachangu
hwuk	lapadera
hgok	organic
flic	zamulungu
flot	zimatengedwa
hboc	zinzawozo
hwoc	mfiti
syot	situdiyo
cwip	Shampeni
hbes	mbendera
lwic	chilekano
blot	bawuti
cwot	ukapolo
cwam	mtsempha
prik	chabe
hfum	thovu
grik	miyala
zrin	thewera
gren	dziko
hfuc	kuuka
claf	alumali
flas	zimakupiza
hjot	otentha
hbim	umasinthasintha
krek	Mercury
hbec	undefined
tsaf	kudzipha
pwas	kubudula
plot	mtolankhani
kfak	amaika
blak	khonde
hdos	banga
kwis	tingachipezepowerenga
kcos	kunditsutsa
psen	penshioni
kres	mneni
hzon	nyani
srim	siginecha
glin	tikupereka
mlut	wowopsa
myot	nji
fwac	woyambitsa
troc	muuni
hgaf	galamala
hyop	yatchi
ksip	zinatha
sres	ulendowu
hnup	mzikiti
hzun	aliuma
mric	minofu
gjat	zinkachitikira
hros	pakani
zrac	wamantha
tros	Tilandire
myus	mbewa
dwac	Kukambiranako
byak	mbuzi
htef	telala
hfek	anachuluka
dzan	amalowerera
nyon	anonymous
zrit	m&#39;kaundulaofunda
pcos	masewera
hjec	Sungunulani
dlas	kuchotsa
mras	ambulera
mram	mchere
cwut	osayanjanitsika
hbok	bakha
swun	sopo
dwak	chidole
plif	Villa
slon	kusoka
tfut	kudzamuthokoza
djac	kuyanjanitsa
hjas	kupondereza
kric	Kalulu
kwot	kondakitala
gzan	chitsimikizo
clot	player
ksek	tizilombo
psam	kaimidwe
mwut	kadzidzi
htem	sadzadwalanso
clon	zeze
dzin	wokhala
rwim	motero
hyof	opindulitsa
dron	chinjoka
dwit	Makutuwosonyezakutin&#39;zoona
sroc	exporting
hzot	kuchotsa
djik	pompo
kfik	chivindikiro
ryun	lamulo
hmes	meya
rwac	hardware
sruk	ochitirazionetsero
sros	ochepa
bzan	chipolowe
kset	oimba
bjon	Nyambayankhumba
hjut	malire
tfen	kuteteza
zwac	sangathe
dyin	kuganizira
myis	woimba
mlis	mwamaganizo
pret	zoperewera
tsek	wamanga
hlom	mandimu
ksos	chifuwa
crok	mutu
flin	chonde
mrun	kalipentala
swec	mwachisawawa
syuk	supuni
blun	zibaluni
tcep	choko
fric	chitsitsimutso
rwik	ofukula
rwen	popewa
flet	inferentialwosonyezakutin&#39;zoona
pfac	wofalitsa
srek	vinegar
tfun	mumphangayo
pwet	chithunzi
gyik	masamu
fwot	zimasuluka
lwin	moyenera
jwin	chiwindi
bwik	chonchosublative
hdup	kuviika
hnop	okhawo
bwic	sitimazapamadzi
ryen	mosasamala
hcem	chivomezi
hbos	zasayansi
nrek	wantchito
ryim	mungoli
nyic	kutanthauzira
dwas	ofesiyo
rwok	zoyambitsa
kram	kulephera
ksim	maganizodeclarative
clok	chokoleti
pcec	mwayi
nyis	hermit
tyoc	mwangozi
grak	zikande
zlat	mogwirizana
hjuk	tigwade
trif	madera
djit	mwadongosolo
pson	undefined
mwis	Msungidwe
cwec	wapakamwa
hdek	boma
blik	Mphamba
sloc	zamaganizo
brap	zidutswa
jlat	Wakuba
dros	kumwamankhwala
slam	salimoni
pwun	pudding
gwik	maginito
pcop	mpope
myen	Mofananamo
ksen	mpweya
mrap	kapitawo
tfot	kalata
ksus	m&#39;bulu
trok	apamwamba
tloc	rung
zyan	nkhafi
nlun	Lowanimuakaunti
hlop	zakutali
jlin	kalembedwe
lyut	mitambo
hsof	mafunde
fyik	kachasu
klet	ndi
hwof	msondodzi
hlum	ngamila
myet	zofufuzafufuza
klis	kudzipatula
hbaf	yonena
gwac	bulu
hwum	mphekesera
pwik	kaonedwe
pron	ovomereza
myes	pamwezi
mwen	undefined
kfic	kutchuthi
klek	pitani
cwon	chowulungika
lyak	zotanuka
kwon	dictionary
hjam	nkhosa
rwon	utawaleza
crip	ukakhale
zwan	zikuchitika
srok	mkonzi
craf	logwirika
tlok	thanki
brip	gulugufe
tfap	tchati
jwat	amapasa
pros	opaleshoni
psun	malodza
clet	undefined
hbus	nsungwi
dyas	wogulitsa
klun	kudzikundikira
jlit	chimodzi
hdom	kutulo
kron	mpweya
hzam	kupanikizana
cyot	kumvetsera
hmem	Museum
lwam	alifabeti
fras	kuwanditsa
psoc	nkhonya
hgum	chingamu
brek	ananyema
glit	kukhazikika
frun	zowola
gris	aukali
mroc	mikangano
bzit	kangaude
plut	mbatata
glac	umbombo
gzac	kuchulukitsa
prun	sapota
jlet	kalendala
nyim	nomination
tlos	zankhaninkhani
slut	saladi
fwit	maganizoinde
pyen	ofunsira
nlon	mwadzina
dren	amasonyeza
drun	kusakhutira
cyok	kugwedeza
hfop	mpira
ryac	mgwirizano
gzin	mpainiya
hgip	kabichi
tyet	othamanga
hdof	ideophone
hwup	kwambiri
lwek	ndalezo
syec	aphungu
jyak	akomere
mlim	nyerere
fwic	mogwira
gzit	pakati
blas	kudalira
jrin	tsikulililonse
gwak	kumwendo
drik	oddly
prif	variable
jwit	zosiyanasiyana
krip	tsankho
ryot	undefined
nwut	msewu
kcif	mwachangu
jrak	chule
twek	chonchoexessive
psot	chitetezero
pfon	chinkhupule
sluk	gologolo
nlim	maganizoirrealis
ksaf	wosaperewera
glak	chamoto
plen	mgwirizano
kfaf	mpango
kyon	amapezerapo
jlik	Geological
psop	pasipoti
kfis	Kusoweka
fyon	kuyandikana
nram	wachiwerewere
hbuk	biscuit
gras	chizimbwizimbwi
hyos	amantha
flim	filimu
plet	piritsi
rwam	atomu
blis	vanila
zlit	zothandizira
fyut	fastidious
crim	piramidi
hjif	n&#39;kosaloleka
crif	manyazi
lwap	lute
tyon	zakuthambo
mrim	ndikuyenda
drut	ofotokoza
nrim	akatswiri
kruc	kamba
kwam	mlangizi
jrik	Cricket
dlut	potanthauza
pyot	nkhunda
dyon	anatengera
prap	Woyankha
bzin	baji
tyek	kansalu
trec	msungichuma
nron	haidrojeni
pyet	chosindikizira
tsok	kutsamwa
zyin	aakulu
slek	njinga
jyin	zomangamanga
ryas	HIV
zrak	kulunzanitsa
nyas	wovina
gric	kusamuka
zlak	zimaipitsa
tces	tennis
hjun	mphepo
twen	yokhotakhota
kyet	wokhometsa
gwit	msana
kyot	poyambira
fwin	pafupipafupi
tfuc	nsalu
dlet	Directory
pfik	woganiza
bjet	bajeti
trek	strategy
kros	khwatsi
gjit	lumo
gwic	magetsi
frik	ongolankhula
tluc	chopukutira
pruc	kulondera
glic	glacier
krun	kukwanira
bjin	kuneneratu
tlaf	nawo
tfet	wopanga
bras	lateral
dwik	wozengedwa
clec	utsi
cres	Chess
tcef	tcheri
tcom	timapunthwa
nyot	womasulira
tyok	galimoto
cyip	yopambana
grot	mpiru
bris	mafoni
nlam	yobetcherana
slif	sieve
hgos	dzimbiri
swoc	wosakhazikika
jyat	zinatha
slum	Chisilamu
hjes	kalembera
dzat	tiptoe
slun	suspend
nwot	Landilani
gyic	gitala
pfas	kukondera
zyik	nthaka
blen	chonyezimira
hyem	Elm
hnep	scramble
nyut	osokedwa
ryam	puronaunipentopeni
clim	zonunkhira
jret	sharpness
tfon	kunyoza
jwac	Java
hrep	Chinsinsi
dyac	chilolezo
myip	mita
rwis	mitundu
hkem	nyenyezi
nwon	luso
zwin	chiletso
dyis	akale
mrec	mpheta
fyot	am&#39;munsi
mlon	kayesedwe
pfis	ratification
rwot	kumayendapamtundawoyenerapozungulira
hfok	mosamala
glof	gofu
zron	zero
hzip	zipi
hwom	pokhala
bjic	kutafuna
pcim	akwaniritse
hjip	Chip
bwac	yawn
mlos	Mole
mrip	mbiya
bron	Ndisanaumbidwe
ksoc	deduction
cyum	yisiti
jyan	jargon
plim	maula
mwet	manda
ryet	womalizamaphunziro
glik	ulimiwothirira
plap	capitalist
tsif	elasticity
gyak	Shaki
djon	kusakhulupirika
nwun	kusungira
cles	Kuzindikira
dris	kwambiri
hkef	cafe
blus	ambulansi
blap	chikwama
bjak	undefined
klim	grimace
gyac	wasayansi
jyit	equanimity
dzit	amawaganizira
bwak	panja
dyot	wailesi
bwon	nyemba
fris	mwamwayi
klut	amanena
tfek	nyamayang&#39;ombe
nrok	asafe
zyat	lumo
bram	mutter
ryis	yoyambirira
nlip	kambiranani
nros	zosiyana
hcof	kudzivula
tfif	woyandikana
kroc	mzere
hdum	Chiyuda
pses	wolandira
plok	womuyenerera
lyet	disolo
pwek	chonchopegative
kfas	khansa
pwen	chuma
nrun	chikumbutso
clek	kutayikira
pcif	kutsimikizira
glas	Kuvuta
zwit	kulankhulalankhula
kces	kukwanira
crem	ritelo
grap	katengedwe
kwip	adzalowerera
dyut	kuchotsera
crus	wolowezana
gyet	yade
gram	ukali
kyip	buluzi
nyet	timizere
crop	mathithi
glon	galoni
mrok	udzudzu
fluc	bwino
dwic	kupatuka
slec	wofufuza
srec	undefined
blut	tiyanganire
myok	zithunzi
tlek	pulagi
nruk	opatsirana
nwoc	undefined
bjut	squat
hges	pregnancy
twoc	golosale
kyos	chikominisi
mrek	Timasangalalanso
clip	contrition
pwok	chonchoprosecutive
dwot	wolamulira
zyac	kumangoganizira
jlic	Kanema
slop	slipper
ryip	njila
psim	oyerekeza
byet	ulova
cyop	chizolowezi
rwun	muyeso
blop	babu
syok	wochirikiza
klos	chlorine
lwot	mankhwalaenaake
byic	mabakiteriya
lyik	yomata
blok	tizilombo
jlac	feign
bret	mamvekedwe
krif	katulutsidwe
blet	kuvina
nruc	mkodzo
tsus	adyo
dyak	opeza
tcem	mbano
cyoc	yesa
trep	sitiroberi
dlun	kuipitsidwa
hlup	Album
hbep	mpira
praf	kuberanakwazaluso
pwis	participle
grek	garaja
kruk	Bwino
hfof	phosphorous
rwut	structural
myam	maseweraolimbitsathupi
krec	Kireni
jras	womanga
zrik	awadziwitse
blam	ndinkakonda
klip	mmisiri
hwef	zaulere
zlac	nthochi
gret	jenereta
lwuk	nthiti
nyek	faifitambala
blos	basi
sles	othana
tlif	matailosi
kses	soseji
mwot	tomato
lyot	magalimoto
tsom	potaziyamu
brut	pafupifupi
djap	ajebura
hjok	generic
kfen	Zikhulupiriro
pcok	kuwala
bzut	kuwasuntha
syek	ulova
mruc	mbozi
bwas	osatsegula
klif	kashiamu
rwet	kutalikale
srif	mbiriyomangika
hwem	sipekitiramu
syom	sodiumwochuluka
tyos	trasti
jyic	zigaŵenga
hguk	mphonda
dwun	khwinya
swip	kukwera
tlec	MafunsoChongani
blaf	kugwiriridwa
tsem	kulibeMulungu
mloc	polojekiti
gyot	makonzedwe
trop	kafukufuku
rwap	miyeziitatuiliyonse
hjep	jenda
pyim	Platinum
dlon	numberwapawiri
pcep	m&#39;mapapo
twuk	otsukirandikupha
tyec	opatsidwa
syup	wapamwamba
trom	trolley
nyip	kwanuko
glis	mafuta
gjik	impso
hjos	sizikugwiridwa
hjuc	abe
swek	undefined
psek	Arsenic
twok	zowerengera
tsep	chiwala
slos	zokomera
nwim	imalandirawosonyezakutin&#39;zoonamaganizo
tlop	tablecloth
trus	yovutayi
pwot	mumalo-zanachala
djot	chitayiko
nloc	snub
mwon	m&#39;Chimandarini
hjek	Wokwerayuadapambanapo
crom	kugwirizana
myon	chibayo
twec	situate
ryek	roketi
dlic	lopeza
kwet	yendamomyata
bwen	akamakonda
plon	gawo
syon	Pant
djis	digito
byut	hule
hyep	chikope
dwon	opendekera
byis	chikumbumtima
brec	eyebrow
cyec	kuyetsemula
hwop	Watt
clus	oseketsa
kfun	kukhalamo
nwum	Chihindu
fyim	othawakwawo
cwos	yolumikiza
tfoc	undefined
pwon	mapuloteni
sraf	undefined
hbom	masanzi
gyen	jini
drim	oyambakumene
trem	accoutrements
tsup	limaphwanya
slok	Sociology
kwoc	sikwashi
bwam	oponyamavoti
mlok	sayenda
kyen	dera
hmop	zoyendaphiri
rwek	retrospective
kfup	kyubu
grok	karoti
drap	undefined
lwis	maselo
ksuc	yowerengera
tsop	kununkha
kyok	mkhaka
nroc	chisembwere
jlot	zosungunulira
psof	mankwala
hgif	amakopeka
kfim	zamchere
psos	olimbitsa
pfen	yachinsinsi
kcom	zachuma
krom	koma
tluk	wriggle
hyom	ayodini
nwuc	zoyendakutsikatsika
gjac	padera
pcom	ngolo
dzic	mlengi
grun	kudzitama
dzot	mwiniwake
hzek	manganese
kfot	kiyibodi
jlas	wosadalirika
lyim	osankhika
jyen	yen
pcaf	zolemba
rwip	kusewera
blip	Baibulo
kyoc	causation
lyon	chilonda
flis	inflected
nrif	chikudya
kfam	kwantamu
swes	juzi
lwon	zamoyozinachita
drec	kung&#39;ambika
gjap	spa
lyec	liniya
tyom	antimony
pwuk	chonchosuperessive
flaf	alpha
myim	m&#39;thupi
pcek	kusowetsa
bjac	moŵa
bzac	abridge
bzak	sock
twes	TV
dwut	zopelekedwa
ksom	chilengedwe
lyis	zankhalango
lwim	zotayidwa
ksok	horoscope
sruc	igwirikemofulumira
dlif	dolphin
byik	wakupha
tfec	malo
hjaf	nyama
ryok	protocol
dwis	woipa
jlon	m&#39;matumbo
brus	malamulo
gjak	Way
lyip	yachipatala
ryem	Analandira
href	rarefied
prok	firiji
slep	undefined
dret	iteration
kluk	m&#39;mabwinja
dlis	mbaliyapadera
kfip	zosavomerezeka
mlec	kutikita
pfif	mfundo
nrec	imalandira
pfet	leaflet
hzoc	chimayambitsa
dlam	Choncho
nlec	Anthropology
kluc	chokoma
dyet	sedani
tyif	transitive
krus	mantha
nluc	mpendadzuwa
lyun	pakulewa
zrot	extradition
ksif	tisalembe
psif	umuna
crup	zimalowana
fret	opeza
grut	invert
ksec	Mnzanga
jric	ulendo
mrop	mayikirowevu
srus	adzawathamangitsa
gyas	hairdresser
floc	folklore
plek	capillary
nwop	matako
nrom	Mtsogoleri
twos	uchigawenga
lwok	chiphiphiritso
dwet	popitanthawi
slem	sublimate
grip	Grill
gwas	Oo
kwok	cobalt
gwon	oat
hdop	zoyendapamtsinjepa
glam	anus
bwot	Bovine
bren	matumbo
byot	kanema
bjik	kunyanyala
kwim	mafunsookhudza
cwek	umodzi
grif	zigawenga
hgem	magnesium
hyes	kuzindikira
fram	mankhwala
nwos	undefined
ryap	musanjenso
cwim	kudalirika
klep	kelp
psec	reimburse
djic	padzikolonse
kfut	Nthawiyofikira
crep	Hamburger
frim	LingaliroLovomerezeka
gjas	azinyadira
hdef	madebiti
ryum	ureniamu
pluk	ganizilani
krop	amayang&#39;anira
nraf	wokhoma
tyes	Integrated
plip	opine
hgom	gamma
hgus	koyefishienti
cwuc	chotenthetsera
zret	kuchotsera
nles	katswiri
trof	intransitive
hmof	msikawo
hzim	bismuth
dzac	odyera
psok	kalata
blon	mgwirizano
djet	digress
ksum	shareholder
mrup	tizilombotoyambitsamatenda
clif	helix
cloc	morphological
tfes	caterer
gjis	jinzi
jren	mayikidwe
tlep	Nawonsoachichepere
kcup	coupon
glot	Voteji
glut	Chiwerengero
srep	Intaneti
nwes	Investor
ksef	×ray
bzis	chitupachavisachikapezeka
frut	zomangamanga
nyuk	Firefly
dyik	chowunikira
plec	splice
brom	bromine
plop	palladium
zlik	Kunsonga
flut	Volt
ksop	zodzikongoletsera
gjun	kudzikongoletsa
kfok	hiccup
hpof	Mbuliwuli
hzuk	Zoo
nyoc	wokhala
jwak	maseŵeraayoga
brim	barium
kles	akutulutsan&#39;kukudulamutu
mwam	eya
fwik	firework
djas	jazi
dyim	zomvetsera
tsum	tungsten
drip	dribble
lyaf	alimony
prom	mapulogalamu
nrup	Muzifunsa
hfes	reflexive
rwaf	chrysanthemum
dlen	zolembedwa
byas	katemera
fron	heroin
dluk	kusagwirizana
dyun	ama
flap	foda
kfet	cathode
dlim	maganizo
prek	magalimoto
syoc	chithunzithunzi
slus	screen
nlos	anticlimax
mlen	selenium
pres	kotekisi
hlof	sulufule
nlek	panopazoyenererapentopeni
gwot	ndege
mwip	wabodzayo
klop	cockroach
kwom	chromium
hl6t	lita
nwec	Komabe
glip	ozungulira
nrop	kopelekamalipiro
crum	timadzi
dlep	mapulogalamu
frot	perforate
bwoc	zonyozazimayenda
fwis	lotetezaufuluwaakazi
djok	conjugate
draf	modernize
trum	monyanyira
graf	aligorivimu
lwes	laser
mlem	millimeter
flen	Flex
zlot	anode
swok	snuggle
klec	undefined
pwim	mwakanthawi
htuf	nsomba
fyis	fakitale
lwet	tilinazo
mrem	mainframe
jwic	rejuvenation
droc	demonstrator
clem	helium
dzik	nzeru
psem	plasma
hjom	khromozomu
rwuc	ordinal
tyus	inteja
klom	kilometre
hfos	fax
nwek	chibadwa
jrap	screwdriver
zwas	Appetizer
bwok	burokoli
dwap	adaputala
syem	sipamu
blek	vekitala
tlus	Msampha
pyif	mosadziwika
cwoc	chabwino
mrep	ampere
hbem	vitamini
hxan	pakhomo
hxut	subsidize
hk6m	Cadmium
hxin	simultaneity
txin	titaniyamu
kxin	undefined
klum	copulate
xlis	hourglass
hqak	syntactic
hxat	zilandiridwenso
hxik	Em&#39;buku
hxas	kuntchito
bxon	boron
dxin	undefined
hxit	ndege
tlum	tellurium
txit	tsikulomalizira
kxat	oxidize
hvik	agwirizane
nluk	analogi
nyem	centimeter
hm6t	molybdenum
hl6m	lifiyamu
ht6t	matumizidweophatikizikaamawu,nyimbondizithunzi
xlit	calorie
ryop	loboti
pxas	pharmacist
hxak	ntchitoyakunyumba
lwif	locative
grim	logarithm
hqat	mantis
qlit	zachilengedwe
xlik	sophisticate
mlep	Chinsinsi
hqit	mpweyawapoizoni
kxim	kilogalamu
hxen	renter
hxot	unadyamopitiriza
kyif	copier
fwet	Freeware
txet	kagawo
hs6n	yotsatana
hxet	eavesdrop
xrat	tsitsi
hqan	impound
hr6t	iridium
bxat	bandiwifi
dxet	kompyuta
hxis	kwakukulukwambiri
hxok	headquarter
hxek	misplace
srem	cerium
hp6t	partitive
pxik	chonchopartitive
kxet	makaseti
pruk	supamaketi
hvit	maganizo
xlin	olumikizidwakumakina
frip	kubisa
hvep	overpay
hxon	synchronize
kxit	azipeza
hqin	unakonzedwa
tr6n	sitiriyo
ht6n	fastener
hvat	adziwitse
sl6s	Celsius
hn6n	Neon
ts6t	pompopompo
hvin	streamline
pxat	manyuzipepala
myoc	gawo
ps6s	pasitala
bwek	chikwama
dlok	dilakisi
fraf	makhomaoteteza
hr6k	bokosilo
txat	nthawiyankhomaliro
hqon	oregano
pxun	nyukiliyazobasi
ks6n	kaphatikizidwekamakompyuta
slef	escalator
xrit	Oyang&#39;anirapamadzi
hvut	kusowapoponda
xrim	yttrium
hx6t	augmentative
hqum	lolowera
hl6n	antchito
gron	argon
pxan	zotsatsira
hvac	chotsukirambale
xlan	kudalirana
txon	timaganiza
xrik	akonzanso
hxap	chikwama
hxac	yambitsaninso
xyat	chiwindi
cwep	malipiro
hxos	torus
txif	typeface
qlat	malonda
txot	m&#39;mam&#39;dzinja
hxam	milligram
pxis	mapikiselo
pwif	chithunzithunzi
txam	tantalum
myek	thermodynamic
hbop	thyolandikulowa
hqot	solute
xlic	chikuku
gxit	kupululutsa
hvan	yozimitsamoto
glim	gallium
pfop	tumphuka
hzum	zirconium
xlon	hotline
qlin	osalunjika
kxam	scandium
blim	beryllium
kxik	sintha
nr6n	minyewa
hpef	predicative
hruf	rauta
kxan	factorial
hxic	Chinthu
xlip	volebo
dyek	yesa
hxop	wotchi
qrot	nyutironi
nwip	niobium
hs6t	chimbuzi
grem	germanium
tles	metalloid
hp6k	chonchoprolative
qyin	pakuleka
txak	maantibayotiki
mlun	immobilization
txan	actinium
xran	wasayansiyazakuthambo
dres	decompress
tr6t	zakuthambo
hk6t	octet
hxus	lotsegukagwero
xlat	chianimphikawosweka
mraf	mpikisano
ts6n	m&#39;makasupe
ht6s	sathakulankhulabwinobwino
nlif	ionize
txut	notability
hm6n	emitting
kxis	zithunzi
xrin	likufa
xren	womweukulozera
bxak	Bookmark
pfos	ovomerezaakuti
hvis	ndowe
hd6n	chimenechachititsa
brum	boardroom
hqis	chauvinist
hk6n	kulemba
xyit	kosangalatsachinsinsi
xyin	chachiwiri
hxun	tisapezeke
hvas	maudindo
glok	Blog
hvak	meandering
pxit	ipadiresi
hvet	pafupindi
xram	safflower
hc6n	obviousness
qran	Koran
zyen	xenon
hqas	kulumbirapa
bzas	blase
hj6n	simunthu
hnof	nonremittal
txas	opanga
hbum	Chibuda
ts6s	mkangano
pxin	zosakaniza
hr6n	loonetsa
hxim	m&#39;machilimwe
dxit	m&#39;mayozizira
hxaf	zimakumba
nlus	houseplant
txap	udindokapamwamba
vrit	ghostwriter
kxak	powabweretsa
bxin	thupi
hqik	raincoat
hxes	hedzi
hxif	hypnothize
xras	paola
pl6k	paralegal
dxat	rashness
hxip	oteteza
vrat	akabudula
hqek	reshaping
qrit	polarity
pxot	positiofesi
hxom	chosamangamakalata
hqic	ndemanga
lwun	buluuJean
hp6n	kusasitsa
dxan	yodalira
xrak	ntchitowosewera
dxak	ngozi
hven	muli
mwap	azithunzithunziMzere
qlan	mtunduakhungu
xros	undressing
srom	ChipindaCowonetsera
hc6t	kumacheza
qrat	mozondoka
hn6t	chopinga
hqet	webusaiti
fres	fundraise
froc	forging
xlak	hyperlink
vlat	volubility
dvan	Atatuluka
gxin	akugonjetsa
ryes	wolandiraalendo
kxot	zolumikizira
xyan	KudulidwaKwamalile
vlan	wotsatsa
ryom	thoriumatomu
hluf	ukalamba
hquk	bayani
lyum	thuliumatomu
tyem	terbiumatomu
hp6m	praseodymium
txic	tsambakunyumba
mros	pagalimoto
dyam	rhodiumatomu
pc6n	numbermayesero
nyos	MakalataObwera
pyek	pulojekita
kxon	krypton
hxuc	posunga
qrik	chonchocentric
xwin	osadziwa
kxic	chida
hvot	flowchart
dxot	yogurt
hqut	fufuzanikuchokera
pxen	departmental
drok	cholingachoyambitsa
flon	foniyam&#39;manja
txos	mawupakati
hqok	chonchooblique
xwik	chonchowodwala
hx6n	prehodiernal
txik	cholozerachala
hqen	sender
mlap	yaumbanda
hvun	suasion
hvon	zisathe
vran	makalatachonyamulira
pfes	pulofesa
pwip	ndakatulo
hqam	kulimbitsathupi
gxat	kumbali
ks6t	causative
vrin	recruiter
kxip	kopanirabolodi
sr6n	disapproving
vlit	evaluative
tyup	mzinda
mrom	morpheme
xron	headphone
gxak	wapatali
hrof	trojankavalo
xlas	analumala
dzet	redecorate
txac	Pololera
xrot	makuponi
txis	donthomasanjidwewo
syif	mayunitsisi
xrac	N&#39;zosadabwitsa
brif	mtengobayinare
dlos	modalnkhani
txun	zikhumbo
dvat	zoipamtima
psom	dzanjayoyamba
gjek	chirichonsengati
nlem	botololamisa
qret	sitoloritelo
txip	mfundopatatu
dlek	payekha
lwut	otayapanopa
dxis	kwambiri
hs6m	cesium
vlak	railcar
hn6m	netium
kxap	makatoni
bxan	chichokereni
myem	mweziwaMay
gxik	ufulu
hxoc	mphamvumpweya
xrok	kuntchito
kr6t	chithunzi
txok	basi
hxep	skateboard
srop	yamakono
pxak	zilembozazikulu
hk6k	wowerengekanyimbo
hl6k	eulersnumber
pyom	poloniumatomu
xyam	thalliumatomu
hvic	achilendo
lyok	choncholocative
xlot	zatchatchatcha
txen	restatement
kxac	counterattack
qrak	strikebreaker
hbup	dziwelosambirira
txuk	derayochepa
tsef	tapered
bxit	ukondekhamu
ksem	Ndikuwerengako
byim	rubidiumatomu
hvam	vanadiumatomu
lw6n	lanthanum
frum	fluorineatomu
nyom	neodymium
mlom	numbermultal
kxas	Makonda
xret	terabyte
hs6k	kundimulaigal
frus	corroding
gxan	Wayjenda
vlas	vocalizations
glet	mpweyango
hvim	pulogalamuyowongolera
bxip	bitmap
qrin	nyenyezijenda
bvak	chonchoabessive
pxon	ajambule
dvik	chonchoadessive
dvek	chonchoagentive
hlef	wothandizilachoyambitsa
kwek	mlandu
kxen	wambajenda
ht6m	mawonekedwetikalemba
tsuf	transnumeral
hf6n	fining
tc6t	chinthumwachindunji
gvik	chonchoergative
gxon	kugawikana
ksep	cholandilira
vyin	filimuzisudzo
pyos	mawuchabe
hnef	amaliremneni
xwit	chinthuchachikulu
hqim	maganizognomic
jlak	generalization
vrik	tinthuyomaliza
qyan	kungoganizagulu
kxaf	kuwalakumayendera
xyic	njirayofuna
qyit	mfundoyovuta
hvek	chonchoevitative
bvik	chonchosubessive
hzes	chonchowogwidwa
prus	kompyutavirus
ples	purosesa
pxif	wapolisi
dvak	choncholative
brun	woyendera
tsi_k	chonchoantessive
tyum	rutheniumatomu
vyak	chonchoadverbial
pxim	ndunayayikulu
syum	strontiumatomu
sy6n	suspiciousness
hy6n	zamoyojenda
pxac	chimwemwemowaganizira
vlin	galimotojenda
qwin	jendamchere
hr6s	kutumiza
tf6n	tona
xris	wosutamawonekedwe
hw6n	kutukwana
xlen	wapakamwanauni
pyec	spreadsheet
vlim	kukumbukirapafupifupi
bres	mawupurosesa
hqip	mtambokompyuta
vlic	makinapafupifupi
pfam	spammer
dyap	chilankhuloyachiwiri
txek	nthmuzu
dxen	migodideta
byip	ntchitomunthu
hs6c	chikhulupirirokudzikonda
txim	kunena
hb6t	kusinthachochitika
hdem	dzinaankalamulira
dxon	chochitikamosiyana
lwaf	kung&#39;animagalimoto
sl6t	crastinalyomangika
xyik	floppylitayamba
fyif	mawureflexive
bvin	chilengedwejenda
hm6p	mavabodi
tfip	transitivemneni
jlen	m&#39;derajenda
xrap	wovulidwa
tc6n	kafukufukujenda
sl6n	lusojenda
xrek	choyambitsawodwala
xwan	umbonijenda
dxif	videoconference
dyip	mawuzotsalira
zrek	chonchoexocentric
hvuk	zingakumbutsewakufayo
xwat	perfectivekale
hr6m	rhenium
txaf	zinayambitsa
hmef	chabemneni
tx6t	mkonzilemba
txes	gulunauni
bvat	kuzunza
bvuk	chonchoabsolutive
ry6t	radian
vlis	chenichenipafupifupi
qren	mapulanetijenda
gvak	chonchokalembedwe
bxok	dazi
mrum	computer
ps6t	opareting&#39;isisitimu
hfom	phoneme
tlem	kuwerengakukumbukirakokha
pwam	mapulogalamuaukazitape
kfif	pakatibenefactive
qwit	rationality
nlaf	khazikitsa
nwok	chonchoassociative
dzas	dissatisfy
swuk	nkhaniyokomakwambiri
syos	mwachidule
kr6n	magetsiinawadutsa
dvin	zopandamoyojenda
pxom	maganizopropositive
vris	mawureciprocal
rwos	aerosol
dr6t	distractor
ht6k	telefoni
slaf	ochezera
lyuk	mzeramotsatizana
qras	mabwana
ty6n	teminal
gwet	posachedwam&#39;tsogoloyomangika
hp6s	mawuapplicative
tsof	mawuantipassive
ht6p	continutivembali
hn6f	maganizonecessitative
pfip	chabeparticiple
glap	Toolbar
sy6k	mzeraexistential
qyat	wowalakwambiri
hy6t	kalembedwechinthu
vyan	Popereka
sluf	numbersingulative
dvit	Kutalikakwambiri
qyak	singlekanthumneni
bzik	sayansi
xlet	digirichapamwamba
hqap	panopaparticiple
qwat	kuchulukakwamankhwala
qyik	connectivetinthu
sr6t	madzimadzisupercritical
hfem	epentheticmorpheme
tl6t	tsogolokutaliyomangika
mrif	maikolofoni
pcuk	chonchopostpositional
tfim	kupezamwachisawawakukumbukira
fwim	ethium
ly6t	mgwirizanoallocutive
hvap	mpukutukapamwamba
hfep	frequentativembali
bvan	distributivepuronauni
fyun	akuyandamanumbermfundo
xyas	erasing
hvif	mnenimwamatapo
xyis	Kalechabeparticiple
tl6n	chapakatiprocessinggulu
tfok	locativechonchombali
qwan	wokondakufunsamafunso
