hnit	infinitivo
hnak	nominativocaso
hkak	acusativocaso
htak	temacaso
hpap	pai
hmam	mamãe
hyat	parental
hcan	Olá
hwik	vocativocaso
hsuc	antepassado
htat	avó
hcac	faminto
hnik	genitivocaso
hcit	adjetivo
hwan	e
hman	amim
hnan	vocês
hwam	nos
htit	isto
htac	destinocaso
htik	dativocaso
hyit	realishumor
htim	deontichumor
hcut	condicionalhumor
hsit	epistêmicahumor
hyak	instrumentalcaso
htan	interiorcontexto
hpan	pessoacontexto
htin	cláusulaindependente
hyan	dependentecláusula
hfap	perfectivoaspecto
hkat	passadotenso
hnin	masculinogênero
hmak	comitativecaso
hnat	presentetenso
hpak	benefactivocaso
swik	essivecaso
htut	negatórioquantificador
hsan	superfíciecontexto
hpin	adpositionalcaso
hwin	localizaçãocaso
hkan	espaçocontexto
hnac	caminhocaso
hyut	interrogativohumor
hnam	eou
hkit	exclusivoou
hsuk	fontecaso
hpik	ablativocaso
hcat	proximidade
hmat	demonstrativo
hkuk	cláusula-tail
hlan	mas
hsut	todos
hyin	universalquantificador
hcin	femininogênero
hpac	pluralnúmero
hyik	um
htic	deles
hkik	quem
tcat	futurotenso
hsin	socialcontexto
hkac	quando
hmip	imperfeitoaspecto
klan	há
hlak	relativocaso
hlik	ilativocaso
htam	directivahumor
hlat	eletivoquantificador
hkam	qual
hwat	questãopalavra
htap	cópula
hpat	pessoa
nyan	macho
hkas	poderia
tcan	deoutros
hnuc	número
twit	assertivoquantificador
hsak	Tempocontexto
htuk	temporalcaso
htun	só
htum	exortativohumor
hyip	retrospectivoaspecto
hlit	volitivohumor
pcic	devo
tyut	dois
hsat	Vejo
hkut	conhecer
hcic	baixa
hcap	após
hpam	primeiro
hlac	alienávelposse
hkap	Nunca
hnic	inalienávelposse
tyat	velho
tcit	deliberativohumor
tcin	dia
hlam	vir
hwak	vogal
hkin	ir
lwak	perlativecaso
hpip	progressivoaspecto
lyan	grandes
hsac	dizer
kyan	como
htas	maisumavez
hsic	Aqui
hcik	acho
hcak	debaixocontexto
hfan	encontrado
hsun	mão
hyac	também
nwan	jovem
tyit	contra
tlan	Deus
twak	delativecaso
hmin	nenhumacoisa
hyas	umavez
hlap	semelfactiveaspecto
kcac	deixou
hyic	viu
hcas	casa
hwac	mundo
tyin	três
hnun	neo
hcuk	foco
pyan	AME
hsis	sempre
hyam	noite
hyap	rei
hkic	entre
hmas	mente
cyit	coração
pluc	paucalnúmero
kyik	Porque
ksak	causalcaso
tcun	feito
hnim	nome
tsan	adequadosubstantivo
klac	país
hpun	perguntei
cyat	visívelcomprobatório
pcac	melhor
hmac	momento
hnas	nãopodes
hwic	água
twim	desiderativahumor
kwan	claro
tlat	palavra
tyan	porta
hsas	manhã
syat	até
twik	terminativocaso
hpit	branco
pcan	dinheiro
hyis	pobre
mwan	morte
hfam	Formato
nwik	inessivecaso
kcat	junto
tsac	frequentemente
pyat	amigos
psan	metade
hpim	imperativohumor
hyuc	volta
hfat	enviei
hcis	esposa
kcan	acreditar
hsik	público
htus	Estadocontexto
hpas	filho
clat	crianças
tyak	assim
cwan	esperança
syin	Prezada
hkuc	alto
tyac	ler
syit	cidade
hlic	já
hfit	factivecomprobatório
tcac	menina
hcun	ouvir
ksan	mínimo
hyaf	possivelmente
kyat	defato
tcic	corpo
hwit	Retorna
cwat	ar
hfaf	lei
hput	Socorro
lyat	carta
ksas	quatro
hpic	optativohumor
hfuk	fogo
hcam	hora
twat	guerra
kyak	devárias
tlit	segundo
pcin	atrás
hmut	perdido
clan	mil
hfac	família
twan	alma
hwas	questão
syan	verdade
htis	fazer
tsat	potencialhumor
lwik	alativocaso
nyin	antrópicogênero
hfak	cinco
tcak	mesmosujeitomarcador
htuc	diferentesujeito
hnap	responda
hmit	mar
hcuc	medo
pcat	compreender
syas	condições
hcaf	dúvida
twut	dubitativohumor
hkis	preto
tlak	trazer
hyus	bela
nyit	ordenar
htip	dez
ksis	história
hpuk	reservar
hlin	eletrônico
hkun	conta
lyas	interesse
lyit	Escreva
pwat	cama
hnis	idade
hnut	contrafactualcondicional
slas	arte
hwis	Vialiscaso
pyak	irmão
lyin	linha
tyas	mesa
hyun	rio
kyac	olho
tfan	derepente
kcin	profundo
hmuc	propósito
cyac	sangue
hmap	rosa
tlin	frio
hyif	paraafrente
tyam	atrasado
hnaf	supor
hkip	quase
myan	meu
tsin	conhecimento
hkup	cópia
hsam	marido
hlis	seis
cwit	vivo
cyan	Paz
myat	lembrar
tyic	natural
hfut	cair
swas	serviço
hsap	exceto
pcit	direitosautorais
hyim	exército
kyas	cavalo
plic	futuro
pcak	oeste
hpis	pagamento
hyuk	vermelho
hwun	ouro
twin	desejo
plan	Toque
hpus	escritório
syun	governo
kyic	Igreja
htaf	força
hlun	comprimento
kyin	companhia
kyis	papel
mlan	probabilidade
hcim	especialmente
cyas	Urso
twac	janela
nyat	beleza
hcus	último
htup	dever
htif	distância
pyas	pé
hlas	selvagem
ksin	verde
hmaf	problema
myac	sorrir
hsim	dorme
kyit	citado
kwik	quotativecaso
fwan	visita
slan	Segue
psit	presença
hmic	doce
hmuf	boca
hfin	rico
tcam	inimigo
psuk	quebrado
kcap	navio
pwan	inclusivopessoa
hfic	influência
tcuc	aparecer
hkim	segredo
pyin	porfavor
pwit	precativehumor
pyit	educadoregistrar
cwak	mal
myak	Março
tcas	locais
hlaf	fique
psat	aoinvés
nlan	azul
psac	impossível
kcuk	escola
kcit	casado
kcak	Comida
syis	vinte
tlac	quieto
hcip	emperspectivaaspecto
kwin	dando
tsit	parado
pyac	idioma
hsus	semana
hcup	corredor
cyap	maravilha
tfin	nascermos
fyat	quadra
hnip	sentenciosoaspecto
tsak	respeito
tlas	quevaleapena
syuc	árvore
plat	parede
cyak	céu
twip	incoativoaspecto
mlat	comando
swit	jussivohumor
mwas	mês
hwaf	perfeito
tyap	experiência
ksac	circunstâncias
syac	fresco
hnuk	duque
kwak	coberto
tyuk	leste
pwac	pedra
hkif	nobre
nyac	direção
cyis	cadeira
tyuc	esperando
tsun	aldeia
tyik	concordar
hnum	permissivohumor
slak	sucesso
tsic	tentando
slat	monte
hmik	música
hkus	chora
hsip	Sete
hpaf	particular
nwas	notícia
tfac	cena
fyan	jardim
cwas	início
hfik	distributivocaso
lyac	aprender
syik	político
clin	henry
cyin	mentira
tsas	elenco
cyik	autoridade
tlap	andar
cyam	verão
tcut	religião
tcap	escapar
hlut	autor
pyun	Castanho
tcuk	dor
swan	Primavera
hmun	suave
kyun	canto
nyak	marcacomercial
tsis	justiça
psas	produzir
cyaf	rir
hwut	esqueço
hyup	Europa
hwap	oito
psak	passagem
kyap	terrível
pyic	requeridos
hmim	médio
hsaf	respiração
hmis	sábio
hsum	possessivomarcador
ksat	agradável
ksit	grave
tsap	ilha
kyam	acampar
tcum	tocar
cyun	fortuna
psic	costa
tyun	domínio
mwit	comissivahumor
tlut	grau
myit	inverno
kfan	conduta
slac	correndo
myin	minuto
tyip	conduzir
klas	vidro
pfat	borda
cyic	vão
swam	romances
syam	seguro
tsut	médico
hlip	completivoaspecto
kcas	escuridão
nyun	caloroso
hpuc	bebe
tlam	exemplo
hfun	raiva
tsik	despeito
tsam	diretamente
hmup	chapéu
klak	cão
slin	prata
swac	servo
kcam	orgulho
pyik	trem
myut	moral
syak	entrar
swat	espada
kyuk	ataque
clac	saúde
tyaf	parágrafo
swic	social
tfit	restituição
hkaf	oficial
pcas	relance
nyam	glória
tfat	doze
pcut	contratado
pwin	vinho
mwat	gosto
fyac	ferro
syap	distribuir
myap	comércio
hyum	utilização
fwak	juiz
klat	capitão
twap	cessaçãoaspecto
kcic	curioso
kwic	estrangeiro
hnif	intensificador
myun	importância
tlic	finalmente
cyuk	pescoço
syut	liberdade
pfan	lados
kyuc	seco
pcap	delado
tfak	comprobatório
tcik	comprobatóriocaso
twun	distante
tyis	progresso
nyap	limitar
plit	construção
hpif	página
pwic	segurando
syic	triste
tsip	pecado
syim	doente
tcis	honesto
pcun	banco
ksap	aceitar
lyam	corrente
tcaf	cuidadosamente
kwac	orelha
hpup	pão
kcut	escolher
nwam	animal
hsup	zóicogênero
nwit	Eventivehumor
tcim	mesmoeventomarcador
tlik	multiplicativocaso
kyus	atravessar
hmus	espesso
kfat	ousar
nwat	crescer
myic	chuva
hpum	superfície
swut	piedosos
clis	julho
mwun	moda
hfas	arquivo
cwac	ombro
kwat	conforto
nwac	alguém
tcip	desejado
kfac	grama
hmuk	desenhar
plin	abertura
kwun	junho
mlik	peixe
klin	capital
pfut	mama
twam	reivindicação
fyin	despesa
nlit	Sua
mlin	milhão
pyut	orar
hluk	cansado
ksut	matar
cyut	sombra
psin	peso
kcis	cinzento
pyam	bravo
mwac	satisfeito
klam	dizendo
ksam	nacional
hfip	fraco
klik	vale
hkum	especulativohumor
clas	amarelo
cyuc	calor
mlac	permanece
syip	igualmente
pwak	caixa
tcif	pontiagudo
psip	princípio
ksik	consequência
tsim	estação
flan	ciência
pcam	aparentemente
kcun	perfuração
ksuk	tio
mlit	Lista
pcik	perigoso
kwas	agosto
hluc	popular
klit	desconhecido
flak	familiar
fyit	familiarregistrar
lwat	leitor
plun	caminhada
twas	duasvezes
pcis	sacerdote
fyas	feridos
nlat	palácio
myuk	enganar
pfak	favor
tcuf	nove
cwap	simpatia
plac	explosão
pyap	colocando
lyic	vestido
hcum	barulho
lwit	literatura
tsuk	categoria
hfup	tempestade
kcik	bolso
nwap	novembro
tyim	dezembro
psaf	ausência
nlac	população
kyaf	obrigado
slis	série
pyaf	pássaro
mlak	proprietário
kwut	casaco
hwuc	relações
pyis	rapidamente
twuc	fumaça
nwak	janeiro
mlic	máquina
tlis	dentes
ksun	ardente
clam	vergonha
klaf	qualidade
clit	anel
fyak	frase
fyam	frasemarcador
kwap	Praça
hwip	domingo
psis	poesia
pwut	preordained
kyim	comprar
clic	Campos
pyip	abril
kfap	outubro
psut	objetos
kcuc	amargo
nlap	escravo
hsok	solto
htet	texto
hbat	opior
hrit	crédito
hzit	características
hpet	quinze
krac	cruel
hduc	poeira
hrik	prático
hron	cor
hnus	nariz
hric	amigáveis
srik	fornecem
hten	ontem
tlet	hesternaltenso
slap	falhou
hban	usar
hdat	cego
fran	mosca
hdan	diabo
htec	gradualmente
hmon	missão
cran	sacrifício
hran	consciência
hmos	ministro
nrit	energia
hcet	ódio
hset	centro
hrin	racionalgênero
hcot	apreciar
hrip	breve
htep	adoração
hcif	pele
hrat	cobertura
kran	coroa
hkon	castelo
tran	desespero
hmif	milha
trin	círculo
hgin	prisão
hkop	copo
hcen	membro
swin	civil
hrac	emtodaparte
hris	personalizadas
hbin	tornando-se
hmot	euno
hdut	leite
hwen	vegetalgênero
nran	raro
hbac	prima
crut	ponte
hsoc	ações
hsom	sal
nris	inocente
hbit	evitar
crin	admiração
rwin	rainha
hgut	contagem
hdas	dança
hnot	hotel
hdin	preencher
hton	prisioneiro
hdak	loja
hlet	escada
hson	perdão
hgek	homossexual
hras	areia
hsep	setembro
hbic	ruína
hlen	licença
hcon	suficientemente
hgit	testemunha
kfon	cozinha
hbak	vender
tlim	tratamento
hsot	velocidade
kyut	computador
hnen	eterno
htek	biblioteca
hzan	contendo
hbis	base
hbun	confusão
kcus	cozinhar
hgat	deserto
hwus	beijo
hbif	gelo
hbot	bola
hrut	argumento
hdit	bênçãohumor
hdis	culpado
hjan	punição
plis	polícia
hgan	esconder
hsen	expedição
nrin	ignorante
hyen	nuvem
frif	fevereiro
hdik	doença
hnek	iniciativacaso
hbam	tia
hmen	humilde
hdip	atrasadoimperativo
prat	relatadocomprobatório
hdet	meia-noite
hjit	dedo
hmoc	emalgumlugar
pran	pressione
kcec	região
hken	recentemente
hloc	melancólico
hrak	funcionários
htes	olharfixo
rwan	recompensa
hdon	doar
htot	testa
hnet	anjo
hdun	singular
croc	erro
hlon	alvorecer
hyec	ovelha
hjin	paciência
hrec	referencial
mran	milho
htos	maioria
hcos	medidas
hkoc	ocasionalmente
hlif	lucro
clak	açúcar
hjat	humanidade
tram	quadro
hdic	disco
hkok	solitário
srat	artista
crak	charme
hmet	oemail
hden	decisão
gran	governador
crac	filial
hjac	entusiasmo
hdim	indutivohumor
hcok	pressa
hyet	óleo
pwap	cachimbo
trat	imprimir
tcot	matériasólida
hdoc	ó
hren	discursocontexto
tcon	meio-dia
krin	cabine
plam	alarme
hnes	nervoso
tcen	observação
hsek	aspecto
plik	aplicável
slik	seda
hfen	centavo
hgen	agente
hnon	união
crik	inferno
tcet	defeituoso
mrat	misturado
hdam	admoestaçãohumor
hgac	ambição
htoc	dealgumamaneira
hdac	conselho
nwin	constituição
srit	instrumento
hret	firmemente
nlin	conectados
hzat	maré
klic	escolaSuperior
hkek	cauda
nric	geração
hgic	lotado
hgak	gato
trit	diretocomprobatório
tyot	tratado
hnok	conteúdo
crit	abandonado
slen	onze
srin	instinto
hpok	tribo
hyot	apreensivohumor
cric	abrigo
hruc	grosseiro
cwin	equitação
hzak	agitar
dyit	indústria
hpec	profissão
nras	enfermeira
hcec	ensino
hbut	sapatos
hmec	vago
twot	atividade
crat	sábado
hkot	capacidade
hnec	luzdosol
hwuf	viúva
cren	verter
nrat	estrela
hget	hóspede
hbik	abençoar
brin	interior
hpot	disponível
trac	resistência
prac	derivar
hcoc	oco
hpon	província
hwim	civilização
dwan	aguentar
cwok	choque
hdok	dirigindo
crun	tesouro
hzik	semente
hrot	recentepassadotenso
hket	acordado
hcek	mobiliário
hrop	corda
mrac	aventura
byit	festa
trak	anual
hzin	dosul
sric	cerimônia
clik	caça
trap	liberal
hrim	cristandade
hrus	Princesa
blat	altar
cyon	minúsculo
hwep	rede
krat	cardeal
tris	roxo
kcot	reunir
hben	eleição
trik	bêbado
kfit	elevador
tcec	intercâmbio
nrik	definidoartigo
grat	imperador
dran	administração
hpen	anteriormente
cluk	feio
nrac	inofensivo
ryin	Treinamento
hrun	rolo
nwic	polegada
slit	atirar
gzat	jornal
krot	corte
drit	barba
hzis	lágrima
hdap	dezoito
sris	histórico
mrut	bruto
nyik	lama
bran	noiva
drat	depender
djan	gigante
glat	simplicidade
hpoc	outono
pras	véu
hgot	ajuntamento
tret	teatro
tras	comparação
rwit	rival
hfon	formando
klot	treinador
hmum	humor
drac	discurso
rwas	romance
tset	vingança
hdot	distaldemonstrativo
ryut	ciumento
hwon	convite
byat	queimado
flac	Flash
prot	retrato
crek	sugerir
htok	conflito
htop	maldição
prit	imprecatóriohumor
hces	desamparado
klup	clube
hnos	inundar
dwin	indiferença
prin	horizonte
mrit	pretensiosohumor
tcoc	íngreme
hcom	harmonia
grit	trovão
tlot	infância
hgik	joelho
hwes	inconsciente
hzac	mútuo
hsec	Programas
tson	instituições
ryit	recibo
dlin	disciplina
slip	deslize
klon	revolução
hfim	agricultor
hpom	plataforma
cyen	aluna
hgec	caverna
hroc	tradição
srac	enviar
ryat	tragédia
kcen	virgem
hbap	despedida
krik	crítica
krap	algodão
fwat	hospital
kcet	arrendar
hgas	gás
pfin	inevitável
dlit	folha
ryan	tradução
sran	funeral
mrin	farinha
hram	romântico
dlan	dólar
hzas	brincadeira
hsos	dezesseis
klen	colônia
gyin	asa
hsif	leão
cluc	destreza
prip	preparação
hzut	névoa
dwat	medicamento
krit	corrigirprovas
sras	ninho
hses	catorze
brat	objeção
flat	ácido
hjic	nomeadamente
slic	arma
hbuc	doutilizador
tron	laranja
byan	banho
hrif	primitivo
tlip	estabelecer
blan	cesta
kris	secretário
hyon	entretanto
tren	hoje
dlat	hodiernotenso
hzic	veneno
tfic	rifle
tlen	talento
hlim	clima
dyat	companheiro
kcon	revelação
dlac	lavagem
krak	confissão
hbas	absurdo
hkec	carvão
hrek	restaurar
hkos	canoa
hwif	vício
tric	temporário
hdep	delimitativeaspecto
mwak	pilha
ksot	osso
hnoc	Segunda-feira
nlas	terça-feira
brac	quarta-feira
frap	federal
pfit	representante
pcoc	pólo
lyen	linho
swak	lavatório
pcen	presidente
brit	sangrento
hwec	cerco
hwet	estômago
hlos	emcima
hbon	variado
pcon	bronze
hsem	cimeira
lwac	barato
tsos	contestar
kwen	exclusivopessoa
trun	aterrissagem
trut	estátua
hrap	artilharia
hgap	prender
trot	temperatura
grin	Vizinhança
hjak	abraço
hpek	pacote
hlus	cervo
hwos	quarto
tsuc	arbusto
pcuc	descarga
cris	herdeiro
clun	carvalho
hpes	desagradável
nlet	incompleto
hrom	programa
pyon	piano
swet	persuadir
dric	invisível
tyen	bemconhecido
hruk	crueldade
frat	atribuído
hyoc	tentação
hlep	telicaspecto
nrot	internacional
nret	violentamente
hfif	filósofo
pfic	representação
hmek	sensível
hfec	bem-estar
myik	pescaria
truc	roubar
tcop	lábio
rwic	aposentar
htom	economia
glan	galeria
pren	paralelo
hlek	atelicaspecto
nrak	continente
truk	batida
hjim	proibitivohumor
rwat	gravata
hcep	célula
dyan	ovo
jrat	artificial
nren	inspiração
ksic	crise
tsoc	procurando
lwan	almoço
hpos	pinho
hcuf	empurrar
tcus	processar
pset	ampliar
hkep	cobre
swis	marinheiro
prim	imperial
trip	chicote
cras	camisa
swap	varrer
syet	esboço
htof	ladrao
clen	canal
kwit	personalidade
klok	excesso
hrok	reforma
hguc	sede
kcim	ameaçador
hpem	palma
psik	alto-falante
frit	limiar
cret	vestígios
mrak	lança
syen	sessão
tcup	úmido
hyek	viajante
trim	lata
plak	queixa
hyok	ângulo
hgam	vaca
hmok	moinho
jrac	mapa
kloc	colarinho
gyit	deliberadamente
hbip	cerveja
mlet	veludo
lyap	Abuso
cwen	rebanho
bwan	sobrinha
tses	treze
jrit	justificar
nlak	manuscrito
sron	Guerreiro
cruc	Sexta-feira
broc	escova
dlot	baixar
krim	creme
pric	breu
prut	júri
hgon	congeladas
sram	literalmente
pfot	pote
hlot	planejado
djin	moeda
hlok	salto
hpep	maçã
hwot	retorcido
dlak	discutir
brik	seinscrever
nlis	transcrever
hbet	aposta
pris	vírus
hjik	hospitalidade
blit	infantil
hjap	robe
tfik	refletir
hdaf	atingir
hpop	ópera
kcaf	seescondendo
kcoc	cotovelo
hrum	reparar
cyim	suspeito
dyic	educacional
hgoc	cova
drak	desordem
plas	aplauso
byin	binário
hzap	abadia
nlot	fidelidade
mrik	mecânico
hsop	comsucesso
crap	armadilha
kyek	bolo
nrut	entreter
syes	senhor
hjet	dezessete
hjen	feminino
hmom	mel
hdec	infelizmente
lwen	lenda
slot	fogão
frac	rebelde
gwan	inchar
mruk	melhorar
swot	pântano
zlan	ganhar
hnem	animado
hdes	curativo
prak	pregar
frin	cenário
hfet	opor
cros	coro
ryon	racional
tcos	cortar
tsen	emprocessamento
hwek	lobo
nlik	recusa
klap	tapete
dras	desprezar
prop	fértil
slim	apito
hgis	queijo
krut	mordida
srot	escolta
bjan	vaguear
nwen	marinha
myas	máscara
kwaf	desenvolver
twis	táxi
pcip	lápis
srap	vegetal
sren	exposição
tlun	calças
hrup	corrupção
nrip	armário
srup	sopa
jran	cirurgião
bjat	abono
gyat	espião
hlem	imprudente
srak	abstrato
kson	acentuar
cwis	quinta-feira
sret	sinceramente
hraf	tráfego
hres	arquitetura
hsuf	disposição
rwak	fenda
twon	ornamento
hfus	recuperação
hkom	código
djat	caçador
nlut	BoletimdeNotícias
hsef	serpente
mris	democracia
bric	bateria
mlam	cera
zran	compartilhando
cron	emoção
hzen	nadar
traf	faixa
cwaf	envelope
srip	cigarro
mrot	motor
swon	voluntário
ryak	reação
pfun	parcialmente
blac	Bagagem
mret	ministério
hjon	sexual
kcok	machado
dram	diamante
kren	alternar
tcek	eco
hdif	identidade
tfas	embaixador
hfot	consistir
lwas	preguiçoso
hmep	momentanéaspecto
kfin	codificação
mwin	imaginário
hrem	raio
pram	escalada
byac	adega
mren	memorável
swen	senado
kras	caixão
hgun	andorinha
nlok	saciar
ryic	agrícola
gwin	balanço
srut	prado
hkes	complexo
hfis	renúncia
frak	repetidamente
hnom	conspiração
hcop	bar
hlec	Pimenta
mlot	melodia
zrat	candidato
proc	patrono
flik	Raposa
cyet	lamentou
hgim	chaminé
slet	cercaviva
tcok	precisão
bjit	antigofalecido
brot	broto
bwat	cobertor
hdus	porco
gwat	marfim
kret	extrair
nwet	observador
jwan	avenida
nwis	unhas
mwic	abelha
bzat	ator
gyan	suor
zyit	executivo
blic	ilusão
pcet	incerteza
tsot	dobra
bwit	fronteira
tres	estresse
hkof	consumo
nyen	gemido
hles	assemelhar
cyek	saco
hjis	agulha
gjan	fenômeno
prec	comportar-se
drot	controlada
kcek	curva
twic	frango
brak	barril
zwat	habitual
clap	habitualaspecto
tsec	especialista
bwin	impressionar
cwet	delimitada
hbek	padeiro
zlin	azeitona
mron	van
drin	dedicar
psap	expor
gjin	aniversário
clut	martelo
cwun	perfumado
twaf	trivial
pcot	animaldeestimação
krok	crânio
dlik	legislatura
cwic	Felizmente
srun	carranca
crec	destruidor
jlan	margem
kcip	campeão
blin	bilhão
ryik	químico
mlas	pulso
flit	piloto
hzet	nó
cwik	majestoso
twet	saia
mwik	semanal
tfis	técnico
tlon	veículo
cram	lisonjeiro
grac	fortalecer
kraf	Corvo
trup	atributo
hduk	gancho
cruk	tigre
nrap	empregada
crot	autoestrada
mlip	milícia
hfoc	fotografia
nres	integridade
plos	mais
tfam	transparente
nlic	dezenove
hwok	qualificado
nlen	ensaio
fyic	eficiência
hwuk	único
hgok	orgânico
flic	teologia
flot	flutuador
hboc	obrigar
hwoc	bruxa
syot	estúdio
cwip	champanhe
hbes	bandeira
lwic	divórcio
blot	parafuso
cwot	cativeiro
cwam	veia
prik	passiva
hfum	espuma
grik	cascalho
zrin	avental
gren	planeta
hfuc	ressurreição
claf	prateleira
flas	ventilador
hjot	tropical
hbim	arbitrário
krek	mercúrio
hbec	benevolente
tsaf	suicídio
pwas	coragem
plot	repórter
kfak	gastar
blak	varanda
hdos	mancha
kwis	clássico
kcos	acusar
psen	pensão
kres	verbo
hzon	macaco
srim	assinatura
glin	relutância
mlut	notório
myot	importar
fwac	fundador
troc	tocha
hgaf	gramática
hyop	iate
ksip	extinto
sres	excursão
hnup	cúpula
hzun	teimoso
mric	músculo
gjat	magnitude
hros	esfregar
zrac	covardemente
tros	torrada
myus	rato
dwac	diálogo
byak	cabra
htef	alfaiate
hfek	florescer
dzan	impor
nyon	anônimo
zrit	formalregistrar
pcos	Esportes
hjec	fundição
dlas	excluir
mras	guarda-chuva
mram	mineral
cwut	trégua
hbok	Pato
swun	sabão
dwak	boneca
plif	vila
slon	decostura
tfut	felicitar
djac	conciliar
hjas	suprimir
kric	Coelho
kwot	condutor
gzan	garantia
clot	jogador
ksek	inseto
psam	postura
mwut	coruja
htem	permanentemente
clon	violino
dzin	residente
rwim	respectivamente
hyof	benéfico
dron	Dragão
dwit	auditivocomprobatório
sroc	exportador
hzot	terminação
djik	demorar
kfik	tampa
ryun	regulamento
hmes	prefeito
rwac	ferragens
sruk	circo
sros	minoria
bzan	revolta
kset	orquestra
bjon	bacon
hjut	ilimitado
tfen	defender
zwac	desvantagem
dyin	deliberação
myis	músico
mlis	mentalmente
pret	insuficiente
tsek	arquiteto
hlom	limão
ksos	tosse
crok	dordecabeça
flin	fertilidade
mrun	carpinteiro
swec	acaso
syuk	colher
blun	balão
tcep	giz
fric	refresco
rwik	vertical
rwen	prevenção
flet	inferencialcomprobatório
pfac	editor
srek	vinagre
tfun	túnel
pwet	quebracabeça
gyik	matemática
fwot	desvanecer
lwin	equilibrado
jwin	fígado
bwik	Sublativecaso
hdup	mergulho
hnop	monopólio
bwic	submarino
ryen	independentemente
hcem	terremoto
hbos	laboratório
nrek	trabalhador
ryim	ritmo
nyic	interpretar
dwas	embaixada
rwok	provocar
kram	incapacidade
ksim	declarativohumor
clok	chocolate
pcec	privilegiado
nyis	eremita
tyoc	coincidência
grak	arranhar
zlat	luva
hjuk	ajoelhar
trif	geografia
djit	sistemático
pson	invencível
mwis	investimento
cwec	verbal
hdek	secular
blik	falcão
sloc	psicologia
brap	fragmento
jlat	pirata
dros	dose
slam	salmão
pwun	pudim
gwik	magnético
pcop	bomba
myen	similarmente
ksen	oxigênio
mrap	capataz
tfot	certificado
ksus	grupo
trok	retórica
tloc	degrau
zyan	remo
nlun	entrar
hlop	telescópio
jlin	soletração
lyut	nublado
hsof	ressaca
fyik	uísque
klet	relativamente
hwof	salgueiro
hlum	camelo
myet	amador
klis	isolamento
hbaf	biografia
gwac	asno
hwum	rumor
pwik	perspectiva
pron	pró
myes	mensal
mwen	devaneio
kfic	férias
klek	clique
cwon	oval
lyak	elástico
kwon	dicionário
hjam	presunto
rwon	arcoIris
crip	porestemeio
zwan	ocorrendo
srok	editorial
craf	corporal
tlok	tanque
brip	borboleta
tfap	gráfico
jwat	gêmeo
pros	operativo
psun	presságio
clet	miséria
hbus	bambu
dyas	negociante
klun	acumulação
jlit	unânime
hdom	pesadelo
kron	carbono
hzam	geléia
cyot	ouvinte
hmem	museu
lwam	alfabeto
fras	espalhar
psoc	soco
hgum	Chiclete
brek	freio
glit	estabilidade
frun	podridão
gris	agressivo
mroc	atrito
bzit	aranha
plut	batata
glac	ganância
gzac	multiplicar
prun	girar
jlet	calendário
nyim	nomeação
tlos	trilhão
slut	salada
fwit	afirmativohumor
pyen	aplicações
nlon	nominal
dren	demonstrar
drun	descontentamento
cyok	encolherdeombros
hfop	futebol
ryac	parceria
gzin	pioneiro
hgip	repolho
tyet	atlético
hdof	idiophone
hwup	inestimável
lwek	alavanca
syec	senador
jyak	acomodar
mlim	formiga
fwic	eficazmente
gzit	grávida
blas	confiança
jrin	tododia
gwak	tornozelo
drik	estranhamente
prif	variável
jwit	diversidade
krip	discriminação
ryot	awed
nwut	calçada
kcif	ativamente
jrak	rã
twek	excessivocaso
psot	expiação
pfon	esponja
sluk	esquilo
nlim	irrealishumor
ksaf	escassez
glak	vulcão
plen	equilíbrio
kfaf	cachecol
kyon	explorar
jlik	geológico
psop	passaporte
kfis	vaga
fyon	afinidade
nram	imoral
hbuk	bolacha
gras	transe
hyos	apreensivo
flim	filme
plet	comprimido
rwam	átomo
blis	baunilha
zlit	Auxilia
fyut	fastidioso
crim	pirâmide
hjif	ilegal
crif	acanhamento
lwap	alaúde
tyon	astronomia
mrim	labirinto
drut	descritivo
nrim	bolsadeestudo
kruc	tartaruga
kwam	conselheiro
jrik	grilo
dlut	denotar
pyot	Pombo
dyon	adaptação
prap	operador
bzin	crachá
tyek	triângulo
trec	tesoureiro
nron	hidrogênio
pyet	impressora
tsok	estrangulamento
zyin	crônico
slek	bicicleta
jyin	engenharia
ryas	transmissão
zrak	refrescar
nyas	dançarino
gric	migração
zlak	violar
tces	tênis
hjun	ventoso
twen	tecer
kyet	coletor
gwit	espinha
kyot	acorde
fwin	freqüência
tfuc	tear
dlet	diretório
pfik	pensador
bjet	orçamento
trek	estratégia
kros	quartzo
gjit	tesoura
gwic	interruptor
frik	teórico
tluc	toalha
pruc	patrulha
glic	geleira
krun	plenitude
bjin	predição
tlaf	participar
tfet	fabricante
bras	lateral
dwik	réu
clec	escape
cres	xadrez
tcef	cereja
tcom	tropeçar
nyot	tradutor
tyok	caminhão
cyip	insuperável
grot	mostarda
bris	semfio
nlam	leilão
slif	peneira
hgos	ferrugem
swoc	instável
jyat	falido
slum	islamismo
hjes	censo
dzat	napontadospés
slun	suspender
nwot	continuidade
gyic	violão
pfas	viés
zyik	zinco
blen	brilhante
hyem	olmo
hnep	passeio
nyut	tricotado
ryam	pronomemarcador
clim	especiaria
jret	nitidez
tfon	provocação
jwac	Java
hrep	receita
dyac	franquia
myip	metro
rwis	racial
hkem	cometa
nwon	inovação
zwin	banimento
dyis	medieval
mrec	pardal
fyot	notaderodapé
mlon	medição
pfis	ratificação
rwot	órbita
hfok	frugal
glof	golfe
zron	zero
hzip	fechoeclair
hwom	semcasa
bjic	mastigação
pcim	Preencha
hjip	lasca
bwac	bocejar
mlos	toupeira
mrip	cerâmica
bron	embrião
ksoc	dedução
cyum	fermento
jyan	jargão
plim	ameixa
mwet	cemitério
ryet	graduado
glik	irrigação
plap	capitalista
tsif	elasticidade
gyak	Tubarão
djon	padrão
nwun	pontual
cles	realismo
dris	cadavezmais
hkef	café
blus	ambulância
blap	carteira
bjak	extático
klim	careta
gyac	cientista
jyit	equanimidade
dzit	realista
bwak	aoarlivre
dyot	rádio
bwon	feijão
fris	informal
klut	especular
tfek	bife
nrok	azoto
zyat	navalha
bram	murmurar
ryis	introdutório
nlip	analisar
nros	contrastando
hcof	despir
tfif	incentivo
kroc	sulco
hdum	judaísmo
pses	beneficiário
plok	complemento
lyet	lente
pwek	pegativecaso
kfas	Câncer
pwen	penhor
nrun	lembrete
clek	vazamento
pcif	vindicação
glas	complexidade
zwit	falador
kces	suficiência
crem	varejo
grap	agarrar
kwip	intervir
dyut	desconto
crus	hierarquia
gyet	jade
gram	rosnar
kyip	lagarto
nyet	almofada
crop	Cachoeira
glon	galão
mrok	mosquito
fluc	fluente
dwic	desvio
slec	explorador
srec	expirando
blut	lutar
myok	mosaico
tlek	plugue
nruk	infeccioso
nwoc	daquiemdiante
bjut	agachamento
hges	gravidez
twoc	mercearia
kyos	comunista
mrek	surpreender
clip	contrição
pwok	prosecutivecaso
dwot	ditador
zyac	preocupação
jlic	satélite
slop	chinelo
ryip	proporcional
psim	aproximado
byet	desempregado
cyop	passatempo
rwun	critério
blop	bulbo
syok	suporte
klos	cloro
lwot	cloreto
byic	bactérias
lyik	pegajoso
blok	biológico
jlac	fingir
bret	byte
krif	secreção
blet	balé
nruc	urina
tsus	alho
dyak	classemédia
tcem	tenaz
cyoc	desafiador
trep	morango
dlun	poluição
hlup	álbum
hbep	beisebol
praf	pirataria
pwis	particípio
grek	garagem
kruk	muleta
hfof	fósforo
rwut	estrutural
myam	ginásio
krec	guindaste
jras	contratante
zrik	notificar
blam	salãodebaile
klip	artesão
hwef	nãoremunerado
zlac	banana
gret	gerador
lwuk	costela
nyek	níquel
blos	autocarro
sles	censurar
tlif	telha
kses	linguiça
mwot	tomate
lyot	auto
tsom	potássio
brut	virtual
djap	álgebra
hjok	genérico
kfen	conceitos
pcok	ótico
bzut	mover
syek	desemprego
mruc	lagarta
bwas	navegador
klif	cálcio
rwet	controloremotopassadotenso
srif	históricotenso
hwem	espectro
syom	sódio
tyos	administrador
jyic	refém
hguk	cabaça
dwun	ruga
swip	espigão
tlec	carrapato
blaf	estupro
tsem	ateísmo
mloc	monitor
gyot	condicional
trop	sonda
rwap	trimestral
hjep	gênero
pyim	platina
dlon	dualnúmero
pcep	pulmão
twuk	vasculhando
tyec	etiqueta
syup	super
trom	carrinho
nyip	localmente
glis	gasolina
gjik	rim
hjos	desacompanhado
hjuc	pilhagem
swek	Excessodetrabalho
psek	arsênico
twok	estatístico
tsep	gafanhoto
slos	socialista
nwim	sensorialcomprobatóriohumor
tlop	toalhademesa
trus	controverso
pwot	trela
djot	sedimento
nloc	arrebitado
mwon	tangerina
hjek	jóquei
crom	colaborar
myon	pneumonia
twec	situar
ryek	foguete
dlic	dividendo
kwet	patim
bwen	obsessão
plon	atribuição
syon	arfar
djis	digital
byut	cadela
hyep	pálpebra
dwon	diagonal
byis	subconsciente
brec	sobrancelha
cyec	espirrar
hwop	watt
clus	divertido
kfun	ocupação
nwum	hinduismo
fyim	refugiado
cwos	transporte
tfoc	pontada
pwon	proteína
sraf	autosatisfeito
hbom	vomitar
gyen	gene
drim	calouro
trem	atavios
tsup	despedaçar
slok	sociologia
kwoc	abóbora
bwam	eleitor
mlok	mobilidade
kyen	regional
hmop	movimentoladeiraacima
rwek	retrospectivo
kfup	cubo
grok	cenoura
drap	apanharemarmadilha
lwis	molecular
ksuc	contador
tsop	fedor
kyok	pepino
nroc	orgia
jlot	solvente
psof	fosfato
hgif	fascinar
kfim	alcalino
psos	ginástica
pfen	verificação
kcom	economista
krom	vírgula
tluk	meneio
hyom	iodo
nwuc	movimentodeclive
gjac	abortoespontâneo
pcom	vagem
dzic	desenhista
grun	segabar
dzot	doador
hzek	manganês
kfot	teclado
jlas	nãoconfiável
lyim	elite
jyen	yen
pcaf	parêntese
rwip	rúgbi
blip	Bíblia
kyoc	causação
lyon	úlcera
flis	flexionada
nrif	mordidela
kfam	quantidade
swes	suéter
lwon	evolutivo
drec	dissecação
gjap	estânciatermal
lyec	linear
tyom	antimônio
pwuk	superessivecaso
flaf	alfa
myim	imune
pcek	rapto
bjac	cervejaria
bzac	abreviar
bzak	meia
twes	televisão
dwut	documentário
ksom	cosmos
lyis	silvicultura
lwim	alumínio
ksok	horóscopo
sruc	acelerar
dlif	golfinho
byik	assassino
tfec	papelaria
hjaf	mamífero
ryok	protocolo
dwis	dióxido
jlon	cólon
brus	burocracia
gjak	galáxia
lyip	clínico
ryem	rádio
href	rarefeito
prok	frigorífico
slep	sátiro
dret	iteração
kluk	arqueológico
dlis	idiossincrasia
kfip	inaceitável
mlec	massagem
pfif	especificação
nrec	sensorial
pfet	folheto
hzoc	subjacentes
dlam	idealmente
nlec	antropologia
kluc	saboroso
dyet	sedan
tyif	transitivo
krus	encolher-se
nluc	girassol
lyun	íon
zrot	extradição
ksif	falsificar
psif	emissão
crup	sobreposição
fret	inventor
grut	invertido
ksec	colegadeclasse
jric	itinerário
mrop	microondas
srus	expulsar
gyas	cabeleireiro
floc	folclore
plek	capilar
nwop	nádegas
nrom	controlador
twos	terrorismo
lwok	slogan
dwet	aolongodotempo
slem	sublimado
grip	grade
gwas	Uau
kwok	cobalto
gwon	aveia
hdop	movimentoupriver
glam	ânus
bwot	bovino
bren	intestino
byot	vídeo
bjik	boicote
kwim	questionário
cwek	hóquei
grif	guerrilha
hgem	magnésio
hyes	consciência
fram	farmacia
nwos	unambitious
ryap	rearranjar
cwim	confiabilidade
klep	kelp
psec	reembolsar
djic	nomundotodo
kfut	toquederecolher
crep	hambúrguer
frim	teorema
gjas	inflamar
hdef	débito
ryum	urânio
pluk	avaliar
krop	coordenada
nraf	contribuinte
tyes	integrado
plip	opinou
hgom	gama
hgus	coeficiente
cwuc	aquecedor
zret	subtrair
nles	analista
trof	intransitivo
hmof	shopping
hzim	bismuto
dzac	ojantar
psok	cartãopostal
blon	convergência
djet	divagar
ksum	acionista
mrup	micróbio
clif	hélice
cloc	morfológica
tfes	fornecedor
gjis	calçajeans
jren	alinhamento
tlep	bancodedados
kcup	cupom
glot	Voltagem
glut	calculadora
srep	ciberespaço
nwes	investidor
ksef	raioX
bzis	Visa
frut	ainfraestrutura
nyuk	vaga-lume
dyik	detetor
plec	emendar
brom	bromo
plop	paládio
zlik	silício
flut	volt
ksop	cosmético
gjun	aliciamento
kfok	soluço
hpof	Pipoca
hzuk	jardimzoológico
nyoc	conotação
jwak	ioga
brim	bário
kles	decapitar
mwam	sim
fwik	fogodeartifício
djas	jazz
dyim	auditivo
tsum	tungstênio
drip	driblar
lyaf	pensãoalimentícia
prom	programador
nrup	entrada
hfes	reflexivo
rwaf	crisântemo
dlen	documentação
byas	vacina
fron	heroína
dluk	desligar
dyun	diagnosticar
flap	pasta
kfet	cátodo
dlim	ideologia
prek	estacionamento
syoc	instantâneo
slus	acessibilidade
nlos	anticlímax
mlen	selênio
pres	córtex
hlof	enxofre
nlek	atualrelevânciamarcador
gwot	aeroporto
mwip	impostor
klop	barata
kwom	crômio
hl6t	litro
nwec	noentanto,
glip	cíclico
nrop	folhadepagamento
crum	hormônio
dlep	desenvolvedor
frot	perfurar
bwoc	sabotar
fwis	feminista
djok	conjugado
draf	modernizar
trum	extremista
graf	algoritmo
lwes	laser
mlem	milímetro
flen	flexionar
zlot	ânodo
swok	aconchegar
klec	cãocansado
pwim	meioperíodo
htuf	atum
fyis	refinaria
lwet	sensibilidade
mrem	estruturaprincipal
jwic	rejuvenescimento
droc	demonstrador
clem	hélio
dzik	bilíngüe
psem	plasma
hjom	cromossoma
rwuc	ordinal
tyus	númerointeiro
klom	quilômetro
hfos	fax
nwek	genética
jrap	chavedefenda
zwas	aperitivo
bwok	brócolis
dwap	adaptador
syem	Spam
blek	vetor
tlus	tática
pyif	indeterminado
cwoc	bem
mrep	ampére
hbem	vitamina
hxan	porteiro
hxut	subsidiar
hk6m	cádmio
hxin	simultaneidade
txin	titânio
kxin	quilo
klum	copular
xlis	ampulheta
hqak	sintático
hxat	criatividade
hxik	elivro
hxas	ambientedetrabalho
bxon	boro
dxin	indutância
hxit	helicóptero
tlum	telúrio
txit	datalimite
kxat	oxidar
hvik	alinhar
nluk	análogo
nyem	centímetro
hm6t	molibdênio
hl6m	lítio
ht6t	multimídia
xlit	caloria
ryop	robô
pxas	farmacêutico
hxak	deverdecasa
lwif	locativo
grim	logaritmo
hqat	mantis
qlit	ecologia
xlik	sofisticar
mlep	modelo
hqit	radioatividade
kxim	quilograma
hxen	inquilino
hxot	comerdemasiado
kyif	copiadora
fwet	gratuito
txet	subconjunto
hs6n	seqüente
hxet	bisbilhotar
xrat	cortedecabelo
hqan	represar
hr6t	irídio
bxat	larguradebanda
dxet	ÁreadeTrabalho
hxis	exponencial
hxok	sede
hxek	misplace
srem	cério
hp6t	partitivo
pxik	partitivocaso
kxet	cassete
pruk	supermercado
hvit	forçadevontade
xlin	off-line
frip	criptografia
hvep	pagarexcessivamente
hxon	sincronizar
kxit	maximizar
hqin	seminário
tr6n	estéreo
ht6n	prendedor
hvat	próximos
sl6s	Celsius
hn6n	néon
ts6t	realTempo
hvin	simplificar
pxat	bancadejornais
myoc	módulo
ps6s	massa
bwek	pasta
dlok	deluxo
fraf	firewall
hr6k	artefato
txat	horadoalmoço
hqon	orégano
pxun	plutônio
ks6n	postodetrabalho
slef	escadarolante
xrit	Salva-vidas
hvut	sobrecarregar
xrim	ítrio
hx6t	aumentativo
hqum	nomedeusuário
hl6n	vendedores
gron	argão
pxan	promocional
hvac	lava-louças
xlan	globalização
txon	Comprimentodeonda
xrik	reciclar
hxap	mochila
hxac	reiniciar
xyat	hepatite
cwep	salário
hxos	toro
txif	tipodeletra
qlat	corretordeimóveis
txot	meiodooutono
hxam	miligrama
pxis	pixels
pwif	visualização
txam	tântalo
myek	termodinâmico
hbop	amansar
hqot	soluto
xlic	cadeiraderodas
gxit	genocídio
hvan	decombateaincêndios
glim	gálio
pfop	estouroacima
hzum	zircônio
xlon	hotline
qlin	não-linear
kxam	escândio
blim	berílio
kxik	configure
nr6n	neurônio
hpef	predicativo
hruf	roteador
kxan	fatorial
hxic	diretriz
xlip	voleibol
dyek	depurar
hxop	relógiodepulso
qrot	nêutron
nwip	nióbio
hs6t	Banheiro
grem	germânio
tles	metalóide
hp6k	prolativecaso
qyin	biodiversidade
txak	antibiótico
mlun	imobilização
txan	actínio
xran	astronauta
dres	descomprimir
tr6t	extraterrestre
hk6t	octeto
hxus	abertofonte
xlat	crackpot
mraf	maratona
ts6n	meadosdaprimavera
ht6s	autismo
nlif	ionizar
txut	notabilidade
hm6n	emitindo
kxis	grampoarte
xrin	passandopor
xren	redirecionando
bxak	marcapáginas
pfos	prófrase
hvis	fezes
hd6n	denominador
brum	saladereuniões
hqis	chauvinista
hk6n	compilar
xyit	mudançachave
xyin	umsegundo
hxun	subsistindo
hvas	papéis
glok	blogue
hvak	Meandros
pxit	ipendereço
hvet	-Aolado
xram	cártamo
hc6n	evidência
qran	Alcorão
zyen	xênon
hqas	Juro-in
bzas	saciado
hj6n	nãohumano
hnof	noncommittal
txas	makers
hbum	budismo
ts6s	brigas
pxin	ingredientes
hr6n	ração
hxim	meadosdoverão
dxit	meadosdeinverno
hxaf	escavar
nlus	plantadacasa
txap	estadoBarra
vrit	Escritorfantasma
kxak	enganá-around
bxin	corpohumano
hqik	capadechuva
hxes	hertz
hxif	hipnotizar
xras	dehoraemhora
pl6k	paralegal
dxat	temeridade
hxip	anticorpo
vrat	Bermudas
hqek	remodelando
qrit	polaridade
pxot	AgênciadosCorreios
hxom	lixoenviar
hqic	crítico
lwun	jeansazul
hp6n	maturação
dxan	anexando
xrak	atorFunção
dxak	acidente
hven	containers
mwap	tirinha
qlan	daltônico
xros	tirandoaroupa
srom	saladeexposição
hc6t	conversando
qrat	decabeçaparabaixo
hn6t	inibição
hqet	site
fres	captarrecursos
froc	forjamento
xlak	hyperlink
vlat	volubilidade
dvan	desembarcando
gxin	conquistando
ryes	recepcionista
kxot	conectores
xyan	delimitação
vlan	anunciante
ryom	tórioátomo
hluf	develhice
hquk	injetar
lyum	túlioátomo
tyem	térbioátomo
hp6m	praseodímio
txic	casapágina
mros	motorista
dyam	ródioátomo
pc6n	tentativasnúmero
nyos	caixadeentrada
pyek	projetor
kxon	criptônio
hxuc	resgatando
qrik	centralcaso
xwin	inexperiência
kxic	extintor
hvot	fluxograma
dxot	iogurte
hqut	registroFora
pxen	departamental
drok	objetivogatilho
flon	celular
txos	meiovoz
hqok	oblíquocaso
xwik	pacientecaso
hx6n	préhodierna
txik	dedoindicador
hqen	remetente
mlap	malwares
hvun	persuasão
hvon	desgastar
vran	correio-carrier
pfes	professor
pwip	poeta
hqam	exercite-se
gxat	legalidade
ks6t	causativo
vrin	recrutador
kxip	grampoborda
sr6n	desaprovação
vlit	avaliativo
tyup	subúrbio
mrom	morfema
xron	fonedeouvido
gxak	dispendioso
hrof	troianocavalo
xlas	paralisado
dzet	redecorar
txac	rendição
xrot	nãousado
txis	pontomatriz
syif	siunidades
xrac	surpreendentemente
brif	-valorbinário
dlos	modalcaso
txun	atributos
dvat	mal-humorado
psom	emprimeiramão
gjek	else-if
nlem	unidadedemassa
qret	varejoloja
txip	triple-ponto
dlek	individualmente
lwut	fluxocirculante
dxis	dramaticamente
hs6m	césio
vlak	vagãoferroviário
hn6m	nerium
kxap	cartão
bxan	partida
myem	mêsdemaio
gxik	direitoscivis
hxoc	forçaAérea
xrok	colegadetrabalho
kr6t	imagemdetela
txok	automaticamente
hxep	skate
srop	Smartphone
pxak	tampastrancar
hk6k	músicafolclórica
hl6k	Euler-number
pyom	polônioátomo
xyam	tálioátomo
hvic	invasora
lyok	locativocaso
xlot	apartamentos
txen	correção
kxac	contraataque
qrak	fura-greve
hbup	piscina
txuk	circuitocurto
tsef	cônico
bxit	redeanfitrião
ksem	lersó
byim	rubídioátomo
hvam	vanádioátomo
lw6n	lantânio
frum	flúorátomo
nyom	neodímio
mlom	multalnúmero
kxas	personalizar
xret	terabyte
hs6k	pesquisamotor
frus	corroendo
gxan	galáxiagênero
vlas	vocalizações
glet	acelerador
hvim	tempodeexecução
bxip	bitmap
qrin	estrelagênero
bvak	abessivecaso
pxon	indisponível
dvik	adessivecaso
dvek	agentivecaso
hlef	agentegatilho
kwek	paracaso
kxen	comumgênero
ht6m	citaçãoFormato
tsuf	transnumeral
hf6n	refinação
tc6t	diretoobjeto
gvik	ergativecaso
gxon	fragmentação
ksep	receptor
vyin	cinema
pyos	passivavoz
hnef	finitoverbo
xwit	primárioobjeto
hqim	sentenciosohumor
jlak	generalização
vrik	finalpartícula
qyan	imaginário-unidade
kxaf	velocidadedaluz
xyic	phishing
qyit	pontocrítico
hvek	evitativecaso
bvik	subessivecaso
hzes	possessocaso
prus	computador-vírus
ples	processador
pxif	políciaoficial
dvak	lativocaso
brun	turismo
tsi_k	antessivecaso
tyum	rutênioátomo
vyak	adverbialcaso
pxim	primeiroministro
syum	estrôncioátomo
sy6n	suspiciousness
hy6n	animargênero
pxac	empáticaalegria
vlin	veículogênero
qwin	mineralgênero
hr6s	referência
tf6n	toner
xris	doutilizadorinterface
hw6n	juramento
xlen	verbalsubstantivo
pyec	planilha
vlim	virtualmemória
bres	palavraprocessador
hqip	nuvemInformática
vlic	virtualmáquina
pfam	spammer
dyap	segundolíngua
txek	nth-raiz
dxen	dadosmineração
byip	onegóciopessoa
hs6c	autoconfiança
txim	referindo
hb6t	alterardoevento
hdem	domínionome
dxon	diferenteevento
lwaf	Flashdirigir
sl6t	crastinaltenso
xyik	frouxodisco
fyif	reflexivovoz
bvin	universogênero
hm6p	motherboard
tfip	transitivoverbo
jlen	localidadegênero
xrap	listrado
tc6n	pesquisagênero
sl6n	artísticogênero
xrek	pacientegatilho
xwan	abstratogênero
dxif	vídeoconferência
dyip	indiretodiscurso
zrek	excêntricacaso
hvuk	evocando
xwat	passadoperfectivo
hr6m	rênio
txaf	desencadeado
hmef	impessoalverbo
tx6t	textoeditor
txes	coletivosubstantivo
bvat	mautratamento
bvuk	absolutivocaso
ry6t	radiano
vlis	virtualrealidade
qren	planetáriogênero
gvak	gramaticalcaso
bxok	calvo
mrum	computadorprograma
ps6t	operativosistema
hfom	fonema
tlem	lersómemória
pwam	spyware
kfif	testemunhobenefactivo
qwit	racionalidade
nlaf	instalação
nwok	associativocaso
dzas	desagradar
swuk	superlativocaso
syos	resumindo
kr6n	elétricoatual
dvin	inanimadogênero
pxom	propositivahumor
vris	recíprocavoz
rwos	aerossol
dr6t	distracção
ht6k	telecomunicação
slaf	socialnetworking
lyuk	sucessivocláusula
qras	superiores
ty6n	terminal
gwet	embrevefuturotenso
hp6s	aplicativavoz
tsof	antipasivavoz
ht6p	continuativoaspecto
hn6f	necessitativehumor
pfip	passivaparticípio
glap	barradeferramentas
sy6k	existencialcláusula
qyat	luminosointensidade
hy6t	gramatical-objeto
vyan	pronúncia
sluf	singulativenúmero
dvit	excessivoduração
qyak	solteiroaçaoverbo
bzik	física
xlet	superlativograu
hqap	presenteparticípio
qwat	quantidadedosubstância
qyik	conectivopartícula
sr6t	fluidosupercrítico-
hfem	epentéticomorfema
tl6t	controloremotofuturotenso
mrif	microfone
pcuk	postpositionalcaso
tfim	aleatóriaAcessomemória
fwim	etídio
ly6t	alocuçãoacordo
hvap	rolagemBarra
hfep	freqüentativoaspecto
bvan	distributivopronome
fyun	pontoflutuantenúmero-
xyas	apagamento
hvif	sufixoverbo-
xyis	passadopassivaparticípio
tl6n	centralemprocessamentounidade
tfok	locativodirecionalcaso
qwan	freqüentementepergunteiquestões
