hnit	infinitiv
hnak	cazulnominativ
hkak	acuzativ
htak	cazsubiect
hpap	tata
hmam	mama
hyat	părintesc
hcan	buna
hwik	cazvocativ
hsuc	strămoş
htat	bunic
hcac	flămând
hnik	cazulgenitiv
hcit	adjectiv
hwan	și
hman	pemine
hnan	tu
hwam	ne
htit	aceasta
htac	cazdedestinație
htik	cazdativ
hyit	stareadespiritREALIS
htim	stareadespiritdeontică
hcut	stareadespiritcondiționată
hsit	stareadespiritepistemică
hyak	cazinstrumental
htan	contextulinterior
hpan	context,persoana
htin	clauzaindependenta
hyan	propozițiesubordonată
hfap	aspectperfectiv
hkat	timpultrecut
hnin	genmasculin
hmak	cazcomitative
hnat	timpulprezent
hpak	cazbenefactive
swik	cazessive
htut	cuantificatornegatoare
hsan	contextdesuprafață
hpin	cazadpositional
hwin	cazdelocație
hkan	contextulspațiu
hnac	cazînmod
hyut	stareadespiritinterogativ
hnam	șisau
hkit	exclusivesau
hsuk	cazsursă
hpik	cazablativ
hcat	proximitate
hmat	demonstrativ
hkuk	clauzadecoadă
hlan	dar
hsut	toate
hyin	cuantificatoruniversal
hcin	genfeminin
hpac	numărdeplural
hyik	unu
htic	allor
hkik	care
tcat	timpulviitor
hsin	contextsocial
hkac	cand
hmip	aspectimperfective
klan	Acolo
hlak	cazelative
hlik	cazillative
htam	stareadespiritdedirectivă
hlat	cuantificatorelective
hkam	ce
hwat	întrebarecuvânt
htap	copula
hpat	persoană
nyan	masculin
hkas	arputea
tcan	alte
hnuc	număr
twit	cuantificatorasertiv
hsak	contextuldetimp
htuk	caztemporal
htun	numai
htum	stareadespiritîndemn
hyip	aspectretrospectiv
hlit	stareadespiritvolitivă
pcic	trebuiesa
tyut	Două
hsat	vedea
hkut	ști
hcic	jos
hcap	după
hpam	primul
hlac	posesiaalienabil
hkap	nu
hnic	cuoposesieinalienabilă
tyat	vechi
tcit	stareadespiritdeliberativ
tcin	zi
hlam	veni
hwak	vocală
hkin	merge
lwak	cazperlative
hpip	aspectprogresiv
lyan	lung
hsac	Spune
kyan	Cum
htas	dinnou
hsic	aici
hcik	gândi
hcak	înconformitatecucontextul
hfan	găsite
hsun	mana
hyac	deasemenea
nwan	tineri
tyit	împotriva
tlan	dumnezeu
twak	cazdelative
hmin	nimic
hyas	osinguradata
hlap	aspectsemelfactive
kcac	stânga
hyic	avăzut
hcas	casă
hwac	lume
tyin	Trei
hnun	neo
hcuk	concentra
pyan	dragoste
hsis	mereu
hyam	noapte
hyap	rege
hkic	între
hmas	minte
cyit	inimă
pluc	Numărulpaucal
kyik	deoarece
ksak	cazdecauzalitate
tcun	Terminat
hnim	Nume
tsan	substantivpropriu
klac	țară
hpun	întrebă
cyat	evidentialvizibile
pcac	maibine
hmac	moment
hnas	nupoti
hwic	apă
twim	stareadespiritcareexprimăundeziderat
kwan	ușoară
tlat	cuvânt
tyan	uşă
hsas	dimineaţă
syat	panacand
twik	cazterminative
hpit	alb
pcan	bani
hyis	sărac
mwan	moarte
hfam	formă
nwik	cazinessive
kcat	împreună
tsac	demulteori
pyat	prieten
psan	jumătate
hpim	stareadespiritimperativ
hyuc	rundă
hfat	trimis
hcis	soție
kcan	crede
hsik	public
htus	contextuldestat
hpas	fiu
clat	copii
tyak	prinurmare
cwan	speranţă
syin	dragă
hkuc	înalt
tyac	citit
syit	oraș
hlic	deja
hfit	evidentialFactive
tcac	fată
hcun	auzi
ksan	celmaipuţin
hyaf	poate
kyat	intr-adevar
tcic	corp
hwit	întoarcere
cwat	aer
hfaf	lege
hput	Ajutor
lyat	scrisoare
ksas	patru
hpic	stareadespiritoptativ
hfuk	foc
hcam	ora
twat	război
kyak	maimulți
tlit	aldoilea
pcin	inspate
hmut	pierdut
clan	mie
hfac	familie
twan	suflet
hwas	întrebare
syan	adevăr
htis	luare
tsat	stareadespiritpotențial
lwik	cazallative
nyin	genantropică
hfak	cinci
tcak	marcatoracelașisubiect
htuc	altsubiect
hnap	Răspuns
hmit	mare
hcuc	frică
pcat	aintelege
syas	termeni
hcaf	îndoială
twut	stareadespiritdubitativ
hkis	negru
tlak	aduce
hyus	frumoasa
nyit	fel
htip	zece
ksis	poveste
hpuk	carte
hlin	electronic
hkun	cont
lyas	interes
lyit	scrie
pwat	pat
hnis	vârstă
hnut	contrafactualăcondiționată
slas	artă
hwis	cazvialis
pyak	frate
lyin	linia
tyas	masa
hyun	râu
kyac	ochi
tfan	brusc
kcin	profund
hmuc	scop
cyac	sânge
hmap	Trandafir
tlin	rece
hyif	redirecţiona
tyam	târziu
hnaf	presupune
hkip	aproape
myan	amea
tsin	cunoştinţe
hkup	copie
hsam	soț
hlis	şase
cwit	viaţă
cyan	pace
myat	tineminte
tyic	natural
hfut	cădea
swas	serviciu
hsap	cuexceptia
pcit	drepturideautor
hyim	armată
kyas	cal
plic	viitor
pcak	vest
hpis	aplati
hyuk	roșu
hwun	aur
twin	dorință
plan	Joaca
hpus	birou
syun	Guvern
kyic	biserică
htaf	putere
hlun	lungime
kyin	companie
kyis	hârtie
mlan	probabilitate
hcim	inmoddeosebit
cyas	urs
twac	fereastră
nyat	frumuseţe
hcus	dinurmă
htup	datorie
htif	distanţă
pyas	picior
hlas	sălbatic
ksin	verde
hmaf	necaz
myac	zâmbet
hsim	dormi
kyit	citat
kwik	cazînclinatsprecitate
fwan	vizita
slan	urma
psit	prezenţă
hmic	dulce
hmuf	gură
hfin	bogat
tcam	dusman
psuk	spart
kcap	navă
pwan	persoanăinclusive
hfic	influență
tcuc	apărea
hkim	secret
pyin	Vărog
pwit	stareadespiritprecative
pyit	registrudepoliticos
cwak	rău
myak	Martie
tcas	locuri
hlaf	stau
psat	inschimb
nlan	albastru
psac	imposibil
kcuk	şcoală
kcit	căsătorit
kcak	alimente
syis	douăzeci
tlac	Liniște
hcip	aspectulprospectiv
kwin	dând
tsit	oprit
pyac	limba
hsus	săptămână
hcup	hol
cyap	mirare
tfin	născut
fyat	curte
hnip	aspectaforistic
tsak	respect
tlas	invaloarede
syuc	copac
plat	perete
cyak	cer
twip	aspectincoativ
mlat	comanda
swit	stareadespiritjussive
mwas	lună
hwaf	perfect
tyap	experienţă
ksac	circumstanțe
syac	proaspăt
hnuk	duce
kwak	acoperit
tyuk	Orientul
pwac	piatră
hkif	nobil
nyac	direcţie
cyis	scaun
tyuc	aşteptare
tsun	sat
tyik	deacord
hnum	stareadespiritpermisiv
slak	succes
tsic	încercat
slat	deal
hmik	muzică
hkus	strigăt
hsip	Șapte
hpaf	privat
nwas	știri
tfac	scenă
fyan	grădină
cwas	ÎNCEPE
hfik	cazdeîmpărțire
lyac	învăța
syik	politic
clin	henry
cyin	minciună
tsas	arunca
cyik	autoritate
tlap	podea
cyam	vară
tcut	religie
tcap	evadare
hlut	autor
pyun	maro
tcuk	durere
swan	arc
hmun	moale
kyun	colţ
nyak	marcă
tsis	justiţie
psas	legumeşifructe
cyaf	râde
hwut	auita
hyup	Europa
hwap	opt
psak	trecere
kyap	teribil
pyic	necesar
hmim	mediu
hsaf	suflare
hmis	înţelept
hsum	marcatorposesiv
ksat	placut
ksit	mormânt
tsap	insulă
kyam	tabara
tcum	atingere
cyun	avere
psic	ţărm
tyun	domeniu
mwit	stareadespiritcomisiv
tlut	grad
myit	iarnă
kfan	conduce
slac	alergare
myin	minut
tyip	conduce
klas	sticlă
pfat	bord
cyic	zadar
swam	afaceri
syam	Sigur
tsut	doctor
hlip	aspectcompletive
kcas	întuneric
nyun	cald
hpuc	băutură
tlam	exemplu
hfun	furie
tsik	ciudă
tsam	direct
hmup	pălărie
klak	câine
slin	argint
swac	servitor
kcam	mândrie
pyik	tren
myut	morală
syak	introduce
swat	sabie
kyuk	atac
clac	sănătate
tyaf	paragraf
swic	social
tfit	restituire
hkaf	oficial
pcas	privire
nyam	glorie
tfat	doisprezece
pcut	angajat
pwin	vin
mwat	gust
fyac	fier
syap	distribui
myap	comerț
hyum	folosind
fwak	judecător
klat	căpitan
twap	aspectcessative
kcic	curios
kwic	străin
hnif	intensificator
myun	importanţă
tlic	insfarsit
cyuk	gât
syut	libertate
pfan	fete
kyuc	uscat
pcap	deoparte
tfak	doveditor
tcik	cazevidential
twun	îndepărtat
tyis	progres
nyap	îngust
plit	clădire
hpif	pagină
pwic	deținere
syic	trist
tsip	păcat
syim	bolnav
tcis	sincer
pcun	bancă
ksap	Accept
lyam	curent
tcaf	cugrija
kwac	ureche
hpup	pâine
kcut	alege
nwam	animal
hsup	zoicdegen
nwit	stareadespiritEventive
tcim	marcatoracelașieveniment
tlik	cazmultiplicativ
kyus	cruce
hmus	gros
kfat	aindrazni
nwat	crește
myic	ploaie
hpum	suprafaţă
swut	sfânt
clis	iulie
mwun	Modă
hfas	fişier
cwac	umăr
kwat	confort
nwac	oricine
tcip	dorit
kfac	iarbă
hmuk	adesena
plin	deschidere
kwun	iunie
mlik	peşte
klin	capital
pfut	sân
twam	cerere
fyin	cheltuială
nlit	ata
mlin	milion
pyut	ruga
hluk	obosit
ksut	ucide
cyut	umbră
psin	greutate
kcis	gri
pyam	curajos
mwac	satisfăcut
klam	spune
ksam	naţional
hfip	slab
klik	vale
hkum	stareadespiritspeculativ
clas	galben
cyuc	căldură
mlac	rămășițe
syip	inaceeasimasura
pwak	cutie
tcif	ascuţit
psip	principiu
ksik	consecinţă
tsim	sezon
flan	ştiinţă
pcam	aparent
kcun	plictiseală
ksuk	unchi
mlit	listă
pcik	periculos
kwas	August
hluc	popular
klit	necunoscut
flak	familiar
fyit	registrudefamiliar
lwat	cititor
plun	mers
twas	dedouăori
pcis	preot
fyas	răniți
nlat	palat
myuk	prost
pfak	favoare
tcuf	nouă
cwap	simpatie
plac	izbucni
pyap	punând
lyic	tăbăcit
hcum	zgomot
lwit	literatură
tsuk	rang
hfup	furtună
kcik	buzunar
nwap	noiembrie
tyim	decembrie
psaf	absență
nlac	populație
kyaf	mulțumire
slis	serie
pyaf	pasăre
mlak	proprietar
kwut	haină
hwuc	relaţii
pyis	rapid
twuc	fum
nwak	ianuarie
mlic	maşină
tlis	dantură
ksun	ardere
clam	rușine
klaf	calitate
clit	inel
fyak	fraza
fyam	markerdeexpresie
kwap	pătrat
hwip	duminică
psis	poezie
pwut	predeterminata
kyim	acumpara
clic	câmpuri
pyip	Aprilie
kfap	octombrie
psut	obiecte
kcuc	amar
nlap	sclav
hsok	liber
htet	text
hbat	celmairău
hrit	credit
hzit	caracteristici
hpet	cincisprezece
krac	crud
hduc	praf
hrik	practic
hron	culoare
hnus	nas
hric	prietenos
srik	livra
hten	ieri
tlet	hesternaltensionată
slap	eșua
hban	purta
hdat	ORB
fran	azbura
hdan	diavol
htec	treptat
hmon	misiune
cran	sacrificiu
hran	conştiinţă
hmos	ministru
nrit	energie
hcet	ură
hset	centru
hrin	genrațional
hcot	sebucura
hrip	scurt
htep	cult
hcif	piele
hrat	acoperiş
kran	coroană
hkon	castel
tran	disperare
hmif	milă
trin	cerc
hgin	închisoare
hkop	ceașcă
hcen	membru
swin	civil
hrac	pretutindeni
hris	personalizat
hbin	devenire
hmot	carne
hdut	lapte
hwen	genvegetal
nran	rar
hbac	văr
crut	pod
hsoc	stoc
hsom	sare
nris	nevinovat
hbit	evita
crin	admirație
rwin	regină
hgut	Numarati
hdas	dans
hnot	hotel
hdin	completati
hton	prizonier
hdak	magazin
hlet	scară
hson	Pardon
hgek	homosexual
hras	nisip
hsep	Septembrie
hbic	ruina
hlen	licență
hcon	suficient
hgit	martor
kfon	bucătărie
hbak	vinde
tlim	tratament
hsot	viteză
kyut	computer
hnen	etern
htek	bibliotecă
hzan	conținând
hbis	baza
hbun	confuzie
kcus	bucătar
hgat	deşert
hwus	pup
hbif	gheaţă
hbot	minge
hrut	ceartă
hdit	stareadespiritbenedictive
hdis	vinovat
hjan	pedeapsă
plis	politie
hgan	ascunde
hsen	expediție
nrin	ignorant
hyen	nor
frif	februarie
hdik	boală
hnek	cazinițiativă
hbam	mătuşă
hmen	umil
hdip	imperativîntârziat
prat	probantăaraportat
hdet	miezulnopţii
hjit	deget
hmoc	undeva
pran	presa
kcec	regiune
hken	înultimultimp
hloc	melancolie
hrak	personal
htes	privi
rwan	recompensă
hdon	dona
htot	frunte
hnet	înger
hdun	singular
croc	eroare
hlon	zoridezi
hyec	oaie
hjin	răbdare
hrec	referențial
mran	porumb
htos	majoritate
hcos	măsuri
hkoc	dincandincand
hlif	profit
clak	zahăr
hjat	umanitate
tram	cadru
hdic	disc
hkok	singuratic
srat	artist
crak	farmec
hmet	e-mail
hden	decizie
gran	guvernator
crac	ramură
hjac	entuziasm
hdim	stareadespiritinductiv
hcok	grabă
hyet	ulei
pwap	țeavă
trat	imprimare
tcot	Materiesolidă
hdoc	Oh
hren	contextuldiscursului
tcon	amiază
krin	cabină
plam	alarma
hnes	agitat
tcen	observare
hsek	aspect
plik	aplicabil
slik	mătase
hfen	cent
hgen	agent
hnon	uniune
crik	iad
tcet	defect
mrat	amestecat
hdam	stareadespiritadmonitive
hgac	ambiţie
htoc	oarecum
hdac	sfat
nwin	constituţie
srit	instrument
hret	cufermitate
nlin	penet
hzat	maree
klic	colegiu
hkek	coadă
nric	generaţie
hgic	aglomerat
hgak	pisica
trit	evidentialdirectă
tyot	tratat
hnok	cuprins
crit	abandonat
slen	unsprezece
srin	instinct
hpok	trib
hyot	stareadespiritreceptiv
cric	adapost
hruc	nepoliticos
cwin	călărie
hzak	scutura
dyit	industrie
hpec	profesie
nras	asistentmedical
hcec	învățătură
hbut	pantofi
hmec	vag
twot	activitate
crat	sâmbătă
hkot	capacitate
hnec	razadesoare
hwuf	văduvă
cren	vărsa
nrat	stea
hget	oaspete
hbik	binecuvânta
brin	interior
hpot	disponibil
trac	rezistenţă
prac	deriva
hcoc	gol
hpon	provincie
hwim	civilizaţie
dwan	atârna
cwok	şoc
hdok	conducere
crun	comoară
hzik	sămânță
hrot	recenttimpultrecut
hket	treaz
hcek	mobila
hrop	frânghie
mrac	aventură
byit	sărbătoare
trak	anual
hzin	dinsud
sric	ceremonie
clik	vânătoare
trap	liberal
hrim	creştinism
hrus	prinţesă
blat	altar
cyon	minuscul
hwep	web
krat	cardinal
tris	Violet
kcot	aduna
hben	alegere
trik	beat
kfit	lift
tcec	schimbvalutar
nrik	articolhotărât
grat	împărat
dran	administrare
hpen	înprealabil
cluk	urât
nrac	inofensiv
ryin	pregătire
hrun	rulou
nwic	inch
slit	trage
gzat	ziar
krot	tăiere
drit	barbă
hzis	rupere
hdap	optsprezece
sris	istoric
mrut	brut
nyik	noroi
bran	mireasă
drat	depinde
djan	gigant
glat	simplitate
hpoc	toamnă
pras	voal
hgot	adunare
tret	teatru
tras	comparaţie
rwit	rival
hfon	formare
klot	antrenor
hmum	umor
drac	discuție
rwas	roman
tset	răzbunare
hdot	distaldemonstrativ
ryut	gelos
hwon	invitație
byat	ars
flac	bliț
prot	portret
crek	sugera
htok	conflict
htop	blestem
prit	stareadespiritimprecative
hces	neajutorat
klup	club
hnos	potop
dwin	indiferenţă
prin	orizont
mrit	stareadespiritarogant
tcoc	abrupt
hcom	armonie
grit	tunet
tlot	copilărie
hgik	genunchi
hwes	inconştient
hzac	reciproc
hsec	software-ul
tson	instituții
ryit	primire
dlin	disciplina
slip	alunecare
klon	revoluţie
hfim	agricultor
hpom	platformă
cyen	student
hgec	peşteră
hroc	tradiţie
srac	adepune
ryat	tragedie
kcen	virgin
hbap	ramasbun
krik	critică
krap	bumbac
fwat	spital
kcet	chirie
hgas	gaz
pfin	inevitabil
dlit	frunze
ryan	traducere
sran	înmormântare
mrin	făină
hram	romantic
dlan	dolar
hzas	glumă
hsos	şaisprezece
klen	colonie
gyin	aripă
hsif	leu
cluc	viclean
prip	preparare
hzut	aburi
dwat	medicament
krit	recitești
sras	cuib
hses	paisprezece
brat	obiecţie
flat	acid
hjic	șianume
slic	armă
hbuc	utilizator
tron	portocale
byan	baie
hrif	primitiv
tlip	astabili
blan	coş
kris	secretar
hyon	întretimp
tren	astăzi
dlat	hodiernaltensionată
hzic	otravă
tfic	puşcă
tlen	talent
hlim	climat
dyat	pereche
kcon	revelatie
dlac	spalare
krak	mărturisire
hbas	Prostii
hkec	cărbune
hrek	restabili
hkos	canoe
hwif	viciu
tric	temporar
hdep	aspectdelimitative
mwak	morman
ksot	os
hnoc	luni
nlas	marţi
brac	miercuri
frap	federal
pfit	reprezentant
pcoc	pol
lyen	lenjerie
swak	chiuvetă
pcen	președinte
brit	sângeros
hwec	asediu
hwet	stomac
hlos	laetaj
hbon	variat
pcon	alamă
hsem	vârf
lwac	ieftin
tsos	concurs
kwen	persoanăexclusivă
trun	aterizare
trut	statuie
hrap	artilerie
hgap	arestare
trot	temperatura
grin	Cartier
hjak	îmbrăţişare
hpek	ambalaj
hlus	cerb
hwos	dormitor
tsuc	tufiș
pcuc	descărcare
cris	moştenitor
clun	stejar
hpes	neplăcut
nlet	incomplet
hrom	program
pyon	pian
swet	convinge
dric	invizibil
tyen	binecunoscute
hruk	cruzime
frat	alocate
hyoc	ispită
hlep	aspectTelic
nrot	internaţional
nret	violent
hfif	filozof
pfic	reprezentare
hmek	sensibil
hfec	bunăstare
myik	pescuit
truc	fura
tcop	buze
rwic	retrage
htom	economie
glan	Galerie
pren	paralel
hlek	aspectatelic
nrak	continent
truk	cioc
hjim	stareadespiritprohibitive
rwat	cravată
hcep	celulă
dyan	ou
jrat	artificial
nren	inspirație
ksic	criză
tsoc	incautarea
lwan	masadepranz
hpos	pin
hcuf	Apăsaţi
tcus	adainjudecata
pset	extinde
hkep	cupru
swis	marinar
prim	imperial
trip	bici
cras	cămaşă
swap	sterge
syet	schiță
htof	hoţ
clen	canal
kwit	personalitate
klok	exces
hrok	reforma
hguc	sete
kcim	amenințător
hpem	palma
psik	vorbitor
frit	prag
cret	urme
mrak	suliţă
syen	sesiune
tcup	umed
hyek	călător
trim	staniu
plak	plângere
hyok	unghi
hgam	vacă
hmok	moară
jrac	Hartă
kloc	guler
gyit	intenționat
hbip	bere
mlet	catifea
lyap	abuz
cwen	turmă
bwan	nepoată
tses	treisprezece
jrit	justifica
nlak	manuscris
sron	războinic
cruc	vineri
broc	perie
dlot	Descarca
krim	cremă
pric	pas
prut	juriu
hgon	îngheţat
sram	literalmente
pfot	oală
hlot	planificat
djin	monedă
hlok	salt
hpep	măr
hwot	răsucit
dlak	discuta
brik	subscrie
nlis	transcrie
hbet	pariu
pris	virus
hjik	ospitalitate
blit	copilăresc
hjap	halat
tfik	Reflectați
hdaf	atinge
hpop	operă
kcaf	ascunzătoare
kcoc	cot
hrum	reparație
cyim	suspicios
dyic	educational
hgoc	groapă
drak	tulburare
plas	aplauze
byin	binar
hzap	abaţie
nlot	loialitate
mrik	mecanic
hsop	cusucces
crap	capcană
kyek	tort
nrut	distra
syes	domn
hjet	şaptesprezece
hjen	feminin
hmom	Miere
hdec	dinpacate
lwen	legendă
slot	cuptor
frac	rebel
gwan	umfla
mruk	îmbunătăţi
swot	mlaştină
zlan	câştiga
hnem	animat
hdes	pansament
prak	predica
frin	decor
hfet	opune
cros	cor
ryon	raţional
tcos	adecupa
tsen	prelucrare
hwek	lup
nlik	refuz
klap	covor
dras	dispreţui
prop	fertil
slim	fluier
hgis	brânză
krut	mușca
srot	escorta
bjan	umbla
nwen	bleumarin
myas	masca
kwaf	dezvolta
twis	taxi
pcip	creion
srap	vegetal
sren	expoziţie
tlun	pantaloni
hrup	corupţie
nrip	cabinet
srup	supă
jran	chirurg
bjat	alocație
gyat	spion
hlem	nesăbuit
srak	abstract
kson	accent
cwis	joi
sret	Cusinceritate
hraf	trafic
hres	arhitectură
hsuf	dispoziție
rwak	sparge
twon	ornament
hfus	recuperare
hkom	cod
djat	vânător
nlut	buletininformativ
hsef	şarpe
mris	democraţie
bric	baterie
mlam	ceară
zran	partajarea
cron	fior
hzen	înot
traf	bandă
cwaf	plic
srip	ţigară
mrot	motor
swon	voluntar
ryak	reacţie
pfun	parţial
blac	Bagaj
mret	minister
hjon	sexual
kcok	topor
dram	diamant
kren	alterna
tcek	ecou
hdif	identitate
tfas	ambasador
hfot	consta
lwas	leneş
hmep	aspectmomentane
kfin	codificare
mwin	imaginar
hrem	rază
pram	alpinism
byac	pivniţă
mren	memorabil
swen	senat
kras	sicriu
hgun	ainghiti
nlok	răsfăța
ryic	agricol
gwin	leagăn
srut	luncă
hkes	complex
hfis	resemnare
frak	repetat
hnom	conspiraţie
hcop	cârciumă
hlec	piper
mlot	melodie
zrat	candidat
proc	patron
flik	vulpe
cyet	regretat
hgim	șemineu
slet	gardviu
tcok	precizie
bjit	fostuldecedat
brot	mugur
bwat	pătură
hdus	porc
gwat	fildeş
kret	extrage
nwet	observator
jwan	bulevard
nwis	cuie
mwic	albină
bzat	actor
gyan	sudoare
zyit	executiv
blic	amăgire
pcet	incertitudine
tsot	plia
bwit	limite
tres	stres
hkof	consum
nyen	geme
hles	semăna
cyek	sac
hjis	ac
gjan	fenomen
prec	comporta
drot	dirijat
kcek	curba
twic	pui
brak	butoi
zwat	obișnuit
clap	aspectobișnuit
tsec	expert
bwin	impresiona
cwet	delimitate
hbek	brutar
zlin	oliv
mron	dubă
drin	dedica
psap	expune
gjin	zidenastere
clut	ciocan
cwun	aromat
twaf	banal
pcot	animaldecompanie
krok	craniu
dlik	legislatură
cwic	dinfericire
srun	seîncrunta
crec	distruge
jlan	margine
kcip	campion
blin	miliard
ryik	chimic
mlas	puls
flit	pilot
hzet	nod
cwik	maiestuos
twet	fustă
mwik	săptămânal
tfis	tehnic
tlon	vehicul
cram	măgulitor
grac	aintari
kraf	cioară
trup	atribut
hduk	cârlig
cruk	tigru
nrap	menajeră
crot	șosea
mlip	miliţie
hfoc	fotografie
nres	integritate
plos	lacareseadauga
tfam	transparent
nlic	nouăsprezece
hwok	calificat
nlen	eseu
fyic	eficienţă
hwuk	unic
hgok	organic
flic	teologie
flot	pluti
hboc	obliga
hwoc	vrăjitoare
syot	studio
cwip	Șampanie
hbes	steag
lwic	divorț
blot	bolț
cwot	captivitate
cwam	venă
prik	pasiv
hfum	spumă
grik	pietriş
zrin	şorţ
gren	planetă
hfuc	Înviere
claf	raft
flas	ventilator
hjot	tropical
hbim	arbitrar
krek	Mercur
hbec	binevoitor
tsaf	sinucidere
pwas	potroace
plot	reporter
kfak	cheltui
blak	balcon
hdos	pată
kwis	clasic
kcos	acuza
psen	pensiune
kres	verb
hzon	maimuţă
srim	semnătură
glin	repulsie
mlut	notoriu
myot	import
fwac	fondator
troc	lanternă
hgaf	gramatică
hyop	iaht
ksip	dispărut
sres	excursie
hnup	Fă-mi
hzun	încăpăţânat
mric	muşchi
gjat	mărime
hros	freca
zrac	fricos
tros	paineprajita
myus	mouse
dwac	dialog
byak	capră
htef	croitor
hfek	înflori
dzan	aimpune
nyon	anonim
zrit	registrudeformale
pcos	sport
hjec	topi
dlas	șterge
mras	umbrelă
mram	mineral
cwut	armistiţiu
hbok	rață
swun	săpun
dwak	păpuşă
plif	vilă
slon	cusut
tfut	vafelicit
djac	reconcilia
hjas	suprima
kric	iepure
kwot	conductor
gzan	garanție
clot	jucător
ksek	insectă
psam	postură
mwut	bufniţă
htem	inpermanenta
clon	vioară
dzin	rezident
rwim	respectiv
hyof	benefică
dron	balaur
dwit	evidentialauditiv
sroc	exportator
hzot	terminare
djik	persista
kfik	capac
ryun	regulament
hmes	primar
rwac	hardware-ul
sruk	circ
sros	minoritate
bzan	tărăboi
kset	orchestră
bjon	slănină
hjut	nelimitat
tfen	apărarea
zwac	dezavantaj
dyin	deliberare
myis	muzician
mlis	mintal
pret	neadecvat
tsek	arhitect
hlom	lămâie
ksos	tuse
crok	dureredecap
flin	fertilitate
mrun	dulgher
swec	întâmplător
syuk	linguriţă
blun	balon
tcep	cretă
fric	gustare
rwik	vertical
rwen	prevenirea
flet	evidentialinferențială
pfac	editor
srek	oţet
tfun	tunel
pwet	puzzle
gyik	matematică
fwot	decolorare
lwin	echilibrat
jwin	ficat
bwik	cazsublative
hdup	cufundare
hnop	monopol
bwic	submarin
ryen	fărădeosebire
hcem	cutremur
hbos	laborator
nrek	muncitor
ryim	ritm
nyic	interpreta
dwas	ambasadă
rwok	provoca
kram	incapacitate
ksim	stareadespiritdeclarativ
clok	ciocolată
pcec	privilegiat
nyis	pustnic
tyoc	coincidenta
grak	zgârietură
zlat	mănușă
hjuk	îngenunchea
trif	geografie
djit	sistematic
pson	deneinvins
mwis	investiție
cwec	verbal
hdek	laic
blik	şoim
sloc	psihologie
brap	resturi
jlat	pirat
dros	doza
slam	somon
pwun	budincă
gwik	magnetic
pcop	pompa
myen	asemănător
ksen	oxigen
mrap	maistru
tfot	certificat
ksus	mănunchi
trok	retorică
tloc	treaptă
zyan	vâslă
nlun	Logare
hlop	telescop
jlin	ortografie
lyut	noros
hsof	surf
fyik	whisky
klet	relativ
hwof	salcie
hlum	cămilă
myet	amator
klis	izolare
hbaf	biografie
gwac	măgar
hwum	zvon
pwik	perspectivă
pron	pro
myes	lunar
mwen	reverie
kfic	concediudeodihna
klek	clic
cwon	oval
lyak	elastic
kwon	dicţionar
hjam	șuncă
rwon	curcubeu
crip	Prinprezenta
zwan	careapar
srok	editorial
craf	caporal
tlok	rezervor
brip	fluture
tfap	diagramă
jwat	geamăn
pros	operare
psun	augur
clet	nemernicie
hbus	bambus
dyas	comerciant
klun	acumulare
jlit	unanim
hdom	coșmar
kron	carbon
hzam	gem
cyot	ascultător
hmem	muzeu
lwam	alfabet
fras	împrăștia
psoc	lovicupumnul
hgum	gumă
brek	frână
glit	stabilitate
frun	putrezi
gris	agresiv
mroc	frecare
bzit	păianjen
plut	cartof
glac	lăcomie
gzac	multiplica
prun	ainvarti
jlet	calendar
nyim	numire
tlos	trilion
slut	salată
fwit	stareadespiritpozitivă
pyen	aplicatii
nlon	nominal
dren	demonstra
drun	nemulţumire
cyok	umeri
hfop	fotbal
ryac	asociere
gzin	pionier
hgip	varză
tyet	atletic
hdof	ideophone
hwup	nepreţuit
lwek	pârghie
syec	senator
jyak	găzdui
mlim	furnică
fwic	înmodeficient
gzit	gravidă
blas	încredere
jrin	infiecarezi
gwak	gleznă
drik	ciudat
prif	variabil
jwit	diversitate
krip	discriminare
ryot	awed
nwut	trotuar
kcif	activ
jrak	broască
twek	cazexessive
psot	ispăşire
pfon	burete
sluk	veveriţă
nlim	stareadespiritirrealis
ksaf	raritate
glak	vulcan
plen	echilibru
kfaf	eșarfă
kyon	exploata
jlik	geologic
psop	pașaport
kfis	postvacant
fyon	afinitate
nram	imoral
hbuk	biscuit
gras	transă
hyos	receptiv
flim	film
plet	comprimat
rwam	atom
blis	vanilie
zlit	ajutoare
fyut	pretențios
crim	piramidă
hjif	ilegal
crif	timiditate
lwap	lăută
tyon	astronomie
mrim	labirint
drut	descriptiv
nrim	Bursadestudiu
kruc	broascatestoasa
kwam	consilier
jrik	crichet
dlut	denota
pyot	porumbel
dyon	adaptare
prap	operator
bzin	insignă
tyek	triunghi
trec	trezorier
nron	hidrogen
pyet	imprimantă
tsok	sufoca
zyin	cronic
slek	bicicletă
jyin	Inginerie
ryas	transmisie
zrak	reîmprospăta
nyas	dansator
gric	migrațiune
zlak	viola
tces	tenis
hjun	bătutdevânturi
twen	ţese
kyet	colector
gwit	coloanăvertebrală
kyot	coardă
fwin	frecvență
tfuc	războideţesut
dlet	director
pfik	gânditor
bjet	buget
trek	strategie
kros	cuarţ
gjit	foarfecă
gwic	intrerupator
frik	teoretic
tluc	prosop
pruc	patrulare
glic	gheţar
krun	caractercomplet
bjin	prezicere
tlaf	participa
tfet	producător
bras	lateral
dwik	pârât
clec	epuiza
cres	şah
tcef	cireașă
tcom	poticnire
nyot	traducător
tyok	camion
cyip	depășind
grot	muştar
bris	fărăfir
nlam	licitaţie
slif	sită
hgos	rugini
swoc	inconstant
jyat	falimentar
slum	islam
hjes	recensământ
dzat	mergeînvârfulpicioarelor
slun	suspenda
nwot	continuitate
gyic	chitară
pfas	părtinire
zyik	zinc
blen	lucios
hyem	ulm
hnep	încăierare
nyut	tricotat
ryam	marcatorpronume
clim	condiment
jret	acuitate
tfon	şicana
jwac	java
hrep	reţetă
dyac	vot
myip	metru
rwis	rasial
hkem	cometă
nwon	inovaţie
zwin	interzice
dyis	medieval
mrec	vrabie
fyot	notădesubsol
mlon	măsurare
pfis	ratificare
rwot	orbită
hfok	frugal
glof	golf
zron	zero
hzip	zip
hwom	fărăadăpost
bjic	demestecat
pcim	îndeplini
hjip	cip
bwac	căscat
mlos	cârtiță
mrip	ceramică
bron	embrion
ksoc	deducere
cyum	drojdie
jyan	jargon
plim	prună
mwet	cimitir
ryet	absolvent
glik	irigare
plap	capitalist
tsif	elasticitate
gyak	rechin
djon	Modimplicit
nwun	punctual
cles	realism
dris	totmaimult
hkef	cafenea
blus	ambulanță
blap	portofel
bjak	extatic
klim	grimasă
gyac	omdestiinta
jyit	calm
dzit	realist
bwak	înaerliber
dyot	radio
bwon	fasole
fris	neoficial
klut	specula
tfek	friptură
nrok	azot
zyat	aparatderas
bram	murmura
ryis	introductiv
nlip	aanaliza
nros	contrastante
hcof	debandaja
tfif	stimulent
kroc	brazdă
hdum	iudaismul
pses	destinatar
plok	completa
lyet	obiectiv
pwek	cazpegative
kfas	cancer
pwen	pion
nrun	aducereaminte
clek	spărtură
pcif	justificare
glas	complexitate
zwit	sfătos
kces	suficienta
crem	cuamănuntul
grap	apuca
kwip	interveni
dyut	reducere
crus	ierarhie
gyet	jad
gram	mârâit
kyip	şopârlă
nyet	tampon
crop	cascadă
glon	galon
mrok	ţânţar
fluc	fluent
dwic	deviere
slec	explorator
srec	expiră
blut	trântă
myok	mozaic
tlek	dop
nruk	infecțios
nwoc	deaziînainte
bjut	ghemuit
hges	sarcină
twoc	băcănie
kyos	comunist
mrek	uimi
clip	căinţă
pwok	cazprosecutive
dwot	dictator
zyac	preocupare
jlic	satelit
slop	papuc
ryip	proporţional
psim	aproximativ
byet	şomerii
cyop	pasiune
rwun	criteriu
blop	bec
syok	suporter
klos	clor
lwot	clorură
byic	bacterii
lyik	lipicios
blok	biologic
jlac	preface
bret	octet
krif	secreţie
blet	balet
nruc	urină
tsus	usturoi
dyak	clasamijlocie
tcem	clește
cyoc	provocator
trep	căpșună
dlun	poluare
hlup	album
hbep	baseball
praf	piraterie
pwis	participiu
grek	garaj
kruk	cârjă
hfof	fosfor
rwut	structural
myam	gimnazial
krec	macara
jras	contractant
zrik	notifica
blam	salădedans
klip	artizan
hwef	neplătit
zlac	banană
gret	generator
lwuk	coastă
nyek	nichel
blos	autobuz
sles	cenzura
tlif	ţiglă
kses	cârnat
mwot	roșie
lyot	auto
tsom	potasiu
brut	virtual
djap	algebră
hjok	generic
kfen	concepte
pcok	optic
bzut	clinti
syek	şomaj
mruc	omidă
bwas	browser-
klif	calciu
rwet	timpultrecutdeladistanță
srif	istoricătensionată
hwem	spectru
syom	sodiu
tyos	administrator
jyic	ostatic
hguk	tărtăcuţă
dwun	rid
swip	vârfascuțit
tlec	căpușă
blaf	viol
tsem	ateism
mloc	monitor
gyot	condiţional
trop	sondă
rwap	trimestrial
hjep	gen
pyim	platină
dlon	numărdublu
pcep	plămân
twuk	degresare
tyec	etichetă
syup	super
trom	cărucior
nyip	lanivellocal
glis	benzină
gjik	rinichi
hjos	nesupravegheat
hjuc	pradă
swek	suprasolicitat
psek	arsenic
twok	statistic
tsep	lăcustă
slos	socialist
nwim	stareadespiritevidentialsenzoriale
tlop	fațădemasă
trus	controversat
pwot	zgardă
djot	sediment
nloc	cârn
mwon	mandarin
hjek	jocheu
crom	coopera
myon	pneumonie
twec	situa
ryek	rachetă
dlic	dividend
kwet	patine
bwen	obsesie
plon	alocare
syon	gâfâi
djis	digital
byut	căţea
hyep	pleoapă
dwon	diagonală
byis	subconştient
brec	sprânceană
cyec	strănut
hwop	watt
clus	vesel
kfun	ocupare
nwum	hinduism
fyim	refugiat
cwos	navetă
tfoc	junghi
pwon	proteină
sraf	mulțumitdesine
hbom	vărsătură
gyen	genă
drim	studentînanulîntâi
trem	accoutrements
tsup	sfărâma
slok	sociologie
kwoc	sucdefructe
bwam	alegător
mlok	mobilitate
kyen	regional
hmop	mișcareînsus
rwek	retrospectiv
kfup	cub
grok	morcov
drap	prindeîncapcană
lwis	molecular
ksuc	contabil
tsop	putoare
kyok	castravete
nroc	orgie
jlot	solvent
psof	fosfat
hgif	fascina
kfim	alcalin
psos	gimnastică
pfen	verificare
kcom	economist
krom	virgulă
tluk	bâțâi
hyom	iod
nwuc	mișcareînjos
gjac	avort
pcom	păstaie
dzic	proiectant
grun	fanfaronadă
dzot	donator
hzek	mangan
kfot	tastatură
jlas	nedemndeîncredere
lyim	elită
jyen	yen
pcaf	paranteze
rwip	rugbi
blip	Biblie
kyoc	legăturadecauzalitate
lyon	ulcer
flis	încovoiat
nrif	ciuguli
kfam	cuantic
swes	pulover
lwon	evolutivă
drec	disecţie
gjap	spa
lyec	liniar
tyom	antimoniu
pwuk	cazsuperessive
flaf	alfa
myim	imun
pcek	răpire
bjac	fabricădebere
bzac	prescurta
bzak	ciorap
twes	televiziune
dwut	filmdocumentar
ksom	cosmos
lyis	silvicultură
lwim	aluminiu
ksok	horoscop
sruc	accelera
dlif	delfin
byik	ucigaş
tfec	papetărie
hjaf	mamifer
ryok	protocol
dwis	bioxid
jlon	colon
brus	birocraţie
gjak	galaxie
lyip	clinic
ryem	radiu
href	rarefiată
prok	frigider
slep	satir
dret	repetare
kluk	arheologic
dlis	idiosincrasie
kfip	inacceptabil
mlec	masaj
pfif	specificație
nrec	senzorial
pfet	foaievolantă
hzoc	fundamenta
dlam	ideal
nlec	antropologie
kluc	gustos
dyet	limuzină
tyif	tranzitiv
krus	seînjosi
nluc	floarea-soarelui
lyun	ion
zrot	extrădare
ksif	falsifica
psif	emisie
crup	suprapune
fret	căutător
grut	inversa
ksec	colegadeclasa
jric	Calculitinerar
mrop	cuptorcumicrounde
srus	daafară
gyas	coafeză
floc	folclor
plek	capilar
nwop	fund
nrom	controlor
twos	terorism
lwok	slogan
dwet	pesteorar
slem	sublimat
grip	grătar
gwas	Wow
kwok	cobalt
gwon	ovăz
hdop	mișcareînsusulrâului
glam	anus
bwot	bovin
bren	intestin
byot	video
bjik	boicota
kwim	chestionare
cwek	hochei
grif	gherila
hgem	magneziu
hyes	conștientizare
fram	farmacie
nwos	timide
ryap	rearanja
cwim	fiabilitate
klep	varec
psec	rambursa
djic	lanivelmondial
kfut	staredeasediu
crep	hamburger
frim	teoremă
gjas	aprinde
hdef	debit
ryum	uraniu
pluk	evalua
krop	coordona
nraf	contribuabil
tyes	integrat
plip	opina
hgom	gamma
hgus	coeficient
cwuc	încălzitor
zret	scădea
nles	analist
trof	intranzitiv
hmof	centrucomercial
hzim	bismut
dzac	cantină
psok	cartepoştală
blon	convergenţă
djet	faceodigresiune
ksum	acționar
mrup	microb
clif	spirală
cloc	morfologic
tfes	furnizor
gjis	blugi
jren	aliniere
tlep	Bazădedate
kcup	cupon
glot	Voltaj
glut	calculator
srep	spațiulcibernetic
nwes	investitor
ksef	razeX
bzis	Visa
frut	infrastructură
nyuk	Licurici
dyik	detector
plec	lipitură
brom	brom
plop	paladiu
zlik	siliciu
flut	volt
ksop	cosmetic
gjun	îngrijire
kfok	sughiţ
hpof	floriceledeporumb
hzuk	grădinăzoologică
nyoc	conotație
jwak	yoga
brim	bariu
kles	decapita
mwam	da
fwik	artificii
djas	jazz
dyim	audio
tsum	tungsten
drip	dribla
lyaf	pensiaalimentară
prom	programator
nrup	intrare
hfes	reflexiv
rwaf	crizantemă
dlen	documentație
byas	vaccin
fron	heroină
dluk	deconecta
dyun	diagnostica
flap	pliant
kfet	catod
dlim	ideologie
prek	parcare
syoc	instantaneu
slus	accesibilitate
nlos	anticlimax
mlen	seleniu
pres	cortexul
hlof	sulf
nlek	marcatorderelevanțăactuală
gwot	aeroport
mwip	impostor
klop	gândacdebucătărie
kwom	crom
hl6t	litru
nwec	cutoateacestea
glip	ciclic
nrop	statdeplată
crum	hormonde
dlep	dezvoltator
frot	perfora
bwoc	sabotaj
fwis	feministă
djok	conjuga
draf	moderniza
trum	extremist
graf	algoritmul
lwes	culaser
mlem	milimetru
flen	flex
zlot	anod
swok	seghemui
klec	câineobosit
pwim	cujumătatedenormă
htuf	ton
fyis	rafinărie
lwet	sensibilitate
mrem	mainframe
jwic	întinerire
droc	demonstrant
clem	heliu
dzik	bilingv
psem	cuplasmă
hjom	cromozom
rwuc	ordinal
tyus	întreg
klom	kilometru
hfos	fax
nwek	genetică
jrap	şurubelniţă
zwas	aperitiv
bwok	brocoli
dwap	adaptor
syem	spam
blek	vector
tlus	tactică
pyif	nespecificat
cwoc	bine
mrep	amper
hbem	vitamină
hxan	portar
hxut	subvenţiona
hk6m	cadmiu
hxin	simultaneitate
txin	titan
kxin	kilogram
klum	seîmperechea
xlis	clepsidră
hqak	sintactic
hxat	creativitate
hxik	cartee
hxas	laloculdemuncă
bxon	bor
dxin	inductanţă
hxit	elicopter
tlum	-tellur
txit	termenlimita
kxat	oxida
hvik	alinia
nluk	analog
nyem	centimetru
hm6t	molibden
hl6m	litiu
ht6t	multimedia
xlit	calorie
ryop	robot
pxas	farmacist
hxak	temepentruacasă
lwif	locativă
grim	logaritm
hqat	mantis
qlit	ecologie
xlik	perverti
mlep	șablon
hqit	radioactivitate
kxim	kilogram
hxen	moșier
hxot	mâncapreamult
kyif	copiator
fwet	freeware
txet	subgrup
hs6n	secvențială
hxet	tragecuurechea
xrat	tunsoare
hqan	sechestra
hr6t	iridiu
bxat	lățimedebandă
dxet	desktop-ul
hxis	exponențială
hxok	sediulcentral
hxek	punegreșit
srem	ceriu
hp6t	partitiv
pxik	cazpartitive
kxet	casetă
pruk	supermarket
hvit	vointa
xlin	deconectat
frip	criptare
hvep	plătimaimultdecât
hxon	sincroniza
kxit	maximaliza
hqin	seminar
tr6n	stereo
ht6n	elementdefixare
hvat	viitoare
sl6s	celsius
hn6n	neon
ts6t	timpreal
hvin	raționaliza
pxat	chioşcdeziare
myoc	modul
ps6s	Paste
bwek	servietă
dlok	Deluxe
fraf	firewall
hr6k	artefact
txat	oraprânzului
hqon	oregano
pxun	plutoniu
ks6n	stațiedelucru
slef	scarărulantă
xrit	Salvamar
hvut	supraaglomera
xrim	ytriu
hx6t	augmentativ
hqum	numedeutilizator
hl6n	agențiidevânzări
gron	argon
pxan	promoționale
hvac	spalatordevase
xlan	globalizarea
txon	lungimedeundă
xrik	reciclați
hxap	rucsac
hxac	repornire
xyat	hepatită
cwep	salariu
hxos	torusului
txif	tipdecaractere
qlat	agentimobiliar
txot	mijlocultoamnei
hxam	miligram
pxis	pixel
pwif	previzualizare
txam	tantal
myek	termodinamică
hbop	spargere
hqot	solut
xlic	scauncurotile
gxit	genocid
hvan	stingereaincendiilor
glim	galiu
pfop	pop-up
hzum	zirconiu
xlon	liniideasistențătelefonică
qlin	neliniare
kxam	scandiu
blim	beriliu
kxik	configurați
nr6n	neuron
hpef	predicativ
hruf	router
kxan	factorial
hxic	Ghid
xlip	volei
dyek	depanare
hxop	ceasdemână
qrot	neutron
nwip	niobiu
hs6t	toaletă
grem	germaniu
tles	metaloid
hp6k	cazprolative
qyin	biodiversitatea
txak	antibiotic
mlun	imobilizare
txan	actiniului
xran	astronaut
dres	decomprima
tr6t	extraterestru
hk6t	octetul
hxus	sursadeschisa
xlat	trăsnit
mraf	maraton
ts6n	primăvarălamijlocul
ht6s	autism
nlif	ioniza
txut	notabilitate
hm6n	electroluminiscente
kxis	clipart
xrin	încurs
xren	redirecționează
bxak	semndecarte
pfos	Expresiepro
hvis	fecale
hd6n	numitor
brum	saladeconsiliu
hqis	şovinist
hk6n	compila
xyit	cheiededeplasare
xyin	osecundă
hxun	subzistente
hvas	rolurile
glok	blogul
hvak	şerpuit
pxit	adresaIP
hvet	lângă
xram	șofrănel
hc6n	evidenţă
qran	Coran
zyen	xenon
hqas	jurîn
bzas	blazat
hj6n	nonumane
hnof	nonremittal
txas	factoriidedecizie
hbum	budism
ts6s	certurile
pxin	ingrediente
hr6n	raţie
hxim	lamijloculverii
dxit	lamijloculiernii
hxaf	excava
nlus	plantădecasă
txap	baradestare
vrit	persoanăcarescriepentrualtcineva
kxak	pierdevremea
bxin	corpuluman
hqik	pelerinadeploaie
hxes	hertzi
hxif	hypnothize
xras	peoră
pl6k	parajurist
dxat	nechibzuinţă
hxip	anticorp
vrat	pantaloniscurti
hqek	reprofilare
qrit	polaritate
pxot	Oficiulpostal
hxom	corespondentănesolicitată
hqic	referent
lwun	Jeanalbastru
hp6n	maturizare
dxan	atașare
xrak	rolulactor
dxak	accident
hven	containere
mwap	benzidesenate
qlan	culoareorb
xros	dezechipare
srom	showroom
hc6t	chat
qrat	Cususulînjos
hn6t	inhibitie
hqet	site-ulweb
fres	strângereadefonduri
froc	forjare
xlak	hyperlink
vlat	volubilitate
dvan	debarcă
gxin	cuceritor
ryes	recepţioner
kxot	conectori
xyan	delimitare
vlan	agentdepublicitate
ryom	atomdetoriu
hluf	invarsta
hquk	injecta
lyum	thuliumatom
tyem	atomdeterbiu
hp6m	praseodim
txic	paginaprincipala
mros	automobilist
dyam	unatomderodiu
pc6n	numărdeîncercare
nyos	Inbox
pyek	proiector
kxon	krypton
hxuc	salvare
qrik	cazcentrice
xwin	lipsădeexperiență
kxic	stingător
hvot	organigrame
dxot	iaurt
hqut	logout
pxen	departamental
drok	dedeclanșaregol
flon	telefonmobil
txos	vocedemijloc
hqok	cazoblic
xwik	cazpacient
hx6n	prehodiernal
txik	degetularatator
hqen	expeditor
mlap	malware
hvun	suasion
hvon	seuza
vran	operatordetransporte-mail
pfes	Profesor
pwip	poet
hqam	afaceexerciţiifizice
gxat	legalitate
ks6t	cauzal
vrin	recrutor
kxip	planșetăcuclamă
sr6n	dezaprobator
vlit	evaluativ
tyup	suburbie
mrom	morfem
xron	cască
gxak	costisitor
hrof	Caltroian
xlas	paralizat
dzet	redecoreze
txac	capitulant
xrot	nefolosit
txis	matricedepuncte
syif	unitățiSI
xrac	înmodsurprinzător
brif	valoarebinară
dlos	cazmodal
txun	atribute
dvat	răutemperată
psom	primamana
gjek	altfel,dacă
nlem	unitatedemasă
qret	magazindevânzarecuamănuntul
txip	punctultriplu
dlek	individual
lwut	curentdecurgere
dxis	dramatic
hs6m	cesiu
vlak	automotor
hn6m	netium
kxap	carton
bxan	cuplecare
myem	lunamai
gxik	drepturicivile
hxoc	forțaaeriană
xrok	colegdemunca
kr6t	capturădeecran
txok	automat
hxep	skateboard
srop	smartphone
pxak	majuscule
hk6k	muzicafolk
hl6k	eulersnumăr
pyom	atomdepoloniu
xyam	atomdetaliu
hvic	invadator
lyok	cazlocativă
xlot	apartamente
txen	retratare
kxac	contra-atac
qrak	strikebreaker
hbup	piscina
txuk	scurtcircuit
tsef	conic
bxit	webgazdă
ksem	numaiîncitire
byim	atomderubidiu
hvam	atomdevanadiu
lw6n	lantan
frum	atomdefluor
nyom	neodimiu
mlom	Numărulmultal
kxas	personaliza
xret	terabyte
hs6k	motordecăutare
frus	coroda
gxan	galaxiedegen
vlas	vocalize
glet	pedalădeaccelerație
hvim	larulare
bxip	bitmap
qrin	genstele
bvak	cazabessive
pxon	indisponibil
dvik	cazadessive
dvek	cazagentive
hlef	agentdedeclanșare
kwek	lacaz
kxen	gencomună
ht6m	formularuldecitare
tsuf	număruldereferințătrans
hf6n	cleire
tc6t	complementdirect
gvik	cazergative
gxon	fragmentare
ksep	receptorului
vyin	Cinema
pyos	vocepasivă
hnef	verbfinit
xwit	obiectprincipal
hqim	stareadespiritaforistic
jlak	generalizare
vrik	particulăfinală
qyan	unitatedeimaginar
kxaf	vitezaluminii
xyic	phishing
qyit	punctcritic
hvek	cazevitative
bvik	cazsubessive
hzes	cazposedat
prus	virusdecalculator
ples	procesor
pxif	politist
dvak	cazjuridico
brun	turism
tsi_k	cazantessive
tyum	atomderuteniu
vyak	cazadverbial
pxim	primministru
syum	atomdestronțiu
sy6n	suspiciozitate
hy6n	animatedegen
pxac	bucuriaempatica
vlin	gendevehicul
qwin	mineraledegen
hr6s	trimitere
tf6n	toner
xris	interfațacuutilizatorul
hw6n	înjurăturile
xlen	substantivverbal
pyec	foaiedecalcul
vlim	memorievirtuala
bres	procesordecuvinte
hqip	cloudcomputing
vlic	mașinăvirtuală
pfam	spammer
dyap	adoualimba
txek	rădăcinănth
dxen	extragereadatelor
byip	omdeafaceri
hs6c	încredereînsine
txim	referire
hb6t	schimbareadeeveniment
hdem	numeledomeniului
dxon	evenimentdiferit
lwaf	unitateflash
sl6t	crastinaltensionată
xyik	floppydisk
fyif	vocereflexiv
bvin	universdegen
hm6p	placadebaza
tfip	verbtranzitiv
jlen	localitategen
xrap	indungi
tc6n	gendecercetare
sl6n	artisticedegen
xrek	declanșarepacient
xwan	genabstract
dxif	conferințevideo
dyip	vorbireindirectă
zrek	cazexocentric
hvuk	evocând
xwat	perfectiverămassingur
hr6m	reniu
txaf	adeclanșat
hmef	verbimpersonal
tx6t	editordetext
txes	substantivcolectiv
bvat	trateazarau
bvuk	cazabsolutive
ry6t	radian
vlis	realitatevirtuala
qren	genplanetar
gvak	cazgramatical
bxok	chel
mrum	programdecalculator
ps6t	sistemdeoperare
hfom	fonem
tlem	citeștenumaimemorie
pwam	spyware
kfif	benefactivecore
qwit	rațiune
nlaf	instalare
nwok	cazasociativ
dzas	nemulțumi
swuk	cazsuperlativ
syos	rezumând
kr6n	curentelectric
dvin	genneînsuflețit
pxom	stareadespiritpropositive
vris	vocereciprocă
rwos	aerosoli
dr6t	distractorului
ht6k	telecomunicaţie
slaf	rețelesociale
lyuk	clauzasuccesivă
qras	superiorii
ty6n	teminal
gwet	încurândtimpulviitor
hp6s	voceaplicativă
tsof	voceantipassive
ht6p	aspectcontinutive
hn6f	stareadespiritnecessitative
pfip	participiupasiv
glap	Baradeinstrumente
sy6k	clauzaexistențială
qyat	intensitateluminoasă
hy6t	obiectgramatical
vyan	pronuntarea
sluf	Numărulsingulative
dvit	durataexcesivă
qyak	verbdeacțiuneunică
bzik	fizică
xlet	gradulsuperlativ
hqap	participiuprezent
qwat	cantitatedesubstanță
qyik	particulăconjunctiv
sr6t	fluidulsupercritic
hfem	morfemepenthetic
tl6t	viitorladistanțătensionată
mrif	microfon
pcuk	cazpostpositional
tfim	memoriecuaccesaleator
fwim	ethium
ly6t	acordlocutive
hvap	barădedefilare
hfep	aspectfrecventativ
bvan	pronumedistributiv
fyun	plutitoarenumărlitera
xyas	radierii
hvif	verbafix
xyis	participiupasivfisalvat
tl6n	unitățicentraledeprocesare
tfok	cazdirecționallocativă
qwan	întrebărifrecvente
