hnit	infinitive
hnak	nominativeصورت
hkak	accusativeصورت
htak	موضوعصورت
hpap	داد
hmam	مام
hyat	والدين
hcan	هيلو
hwik	vocativeصورت
hsuc	جد
htat	grandparent
hcac	بکايل
hnik	genitiveصورت
hcit	صفت
hwan	۽
hman	مونکي
hnan	توهان
hwam	اسان
htit	ان
htac	منزلصورت
htik	dativeصورت
hyit	realisمزاج
htim	deonticمزاج
hcut	conditionalمزاج
hsit	epistemicمزاج
hyak	instrumentalصورت
htan	گهروسلسلي
hpan	ماڻهوسلسلي
htin	آزادشق
hyan	منحصرشق
hfap	perfectiveپاسو
hkat	گذريلزمان
hnin	مذڪرجنس
hmak	comitativeصورت
hnat	زمانحال
hpak	benefactiveصورت
swik	essiveصورت
htut	negatoryquantifier
hsan	مٿاڇريسلسلي
hpin	adpositionalصورت
hwin	هنڌصورت
hkan	تارنجيسلسلي
hnac	واٽصورت
hyut	interrogativeمزاج
hnam	۽يا
hkit	سچايا
hsuk	مصدرصورت
hpik	ablativeصورت
hcat	قرب
hmat	demonstrative
hkuk	شقدم
hlan	پر
hsut	سڀ
hyin	آفاقيquantifier
hcin	مؤنثجنس
hpac	جمعجوتعداد
hyik	هڪ
htic	سندن
hkik	جو
tcat	زمانمستقبل
hsin	سماجيسلسلي
hkac	جڏهن
hmip	imperfectiveپاسو
klan	نه
hlak	elativeصورت
hlik	illativeصورت
htam	هدايتمزاج
hlat	چونڊquantifier
hkam	ڇا
hwat	سواللفظ
htap	copula
hpat	ماڻهو
nyan	مرد
hkas	ٿيسگهي
tcan	ٻئي
hnuc	تعداد
twit	assertivequantifier
hsak	وقتراقم
htuk	عارضيصورت
htun	صرف
htum	hortativeمزاج
hyip	retrospectiveپاسو
hlit	volitiveمزاج
pcic	هجي
tyut	ٻه
hsat	ڏسڻ
hkut	خبر
hcic	نازل
hcap	پوء
hpam	پهريون
hlac	alienableقبضو
hkap	ڪڏهنبه
hnic	سڀاويڪقبضو
tyat	پراڻي
tcit	deliberativeمزاج
tcin	ڏينهن
hlam	اچي
hwak	اسمن
hkin	وڃو
lwak	perlativeصورت
hpip	ترقيپسندپاسو
lyan	ايتري
hsac	چونٿا
kyan	ڪيئن
htas	ٻيهر
hsic	هتي
hcik	خيال
hcak	راقمهيٺ
hfan	مليو
hsun	هٿ
hyac	به
nwan	جوان
tyit	خلاف
tlan	خدا
twak	delativeصورت
hmin	ڪجھبهنه
hyas	هڪدفعو
hlap	semelfactiveپاسو
kcac	کاٻو
hyic	کين
hcas	گھر
hwac	دنيا
tyin	ٽي
hnun	جيneo
hcuk	وڌائڻ
pyan	عشق
hsis	هميشه
hyam	رات
hyap	بادشاهه
hkic	جيوچ۾
hmas	من
cyit	دل
pluc	paucalتعداد
kyik	ڇاڪاڻته
ksak	causalصورت
tcun	مڪملٿيو
hnim	نالو
tsan	مناسباچار
klac	ملڪ
hpun	چيو
cyat	نظرevidential
pcac	ڀلي
hmac	پلپل
hnas	نهڪريسگهي
hwic	پاڻي
twim	desiderativeمزاج
kwan	نور
tlat	لفظ
tyan	در
hsas	صبح
syat	ايتريقدر
twik	terminativeصورت
hpit	اڇو
pcan	رقم
hyis	غريب
mwan	موت
hfam	فارم
nwik	inessiveصورت
kcat	گڏ
tsac	اڪثر
pyat	دوست
psan	اڌ
hpim	لکندڙنمزاج
hyuc	لکين
hfat	موڪليو
hcis	زال
kcan	ايمان
hsik	عوامي
htus	رياستجيسلسلي
hpas	پُٽ
clat	ٻارن
tyak	اهڙيءطرح
cwan	اميد
syin	پيارا
hkuc	تيز
tyac	پڙهڻ
syit	شهر
hlic	اڳ۾ئي
hfit	factiveevidential
tcac	ڇوڪري
hcun	ٻڌي
ksan	گهٽ
hyaf	مان
kyat	بيشڪ
tcic	جسم
hwit	موٽڻ
cwat	هوائي
hfaf	قانون
hput	مدد
lyat	خط
ksas	چار
hpic	optativeمزاج
hfuk	باهه
hcam	ڪلاڪ
twat	جنگ
kyak	ڪيترنئي
tlit	ٻيون
pcin	پويان
hmut	گم
clan	هزار
hfac	خاندان
twan	جان
hwas	سوال
syan	سچ
htis	ميڪنگ
tsat	امڪانيمزاج
lwik	allativeصورت
nyin	anthropicجنس
hfak	پنج
tcak	ساڳئيموضوعنشانن
htuc	مختلفموضوع
hnap	جواب
hmit	سمنڊ
hcuc	خوف
pcat	سمجهڻ
syas	اصطلاح
hcaf	شڪ
twut	dubitativeمزاج
hkis	ڪارو
tlak	آڻيو
hyus	خوبصورت
nyit	جيحسابسان
htip	ڏهه
ksis	ڪهاڻي
hpuk	ڪتاب
hlin	اليڪٽرانڪ
hkun	حساب
lyas	فائدي
lyit	لکڻ
pwat	پلنگ
hnis	عمر
hnut	counterfactualconditional
slas	فن
hwis	vialisصورت
pyak	ڀاءُ
lyin	ليڪ
tyas	ميز
hyun	سنڌوء
kyac	اک
tfan	اوچتو
kcin	رڙيون
hmuc	مقصد
cyac	رت
hmap	گلاب
tlin	ڀڌ
hyif	اڳتي
tyam	شهيد
hnaf	ڀانئيان
hkip	سمجهي
myan	منهنجو
tsin	علم
hkup	ڪاپي
hsam	مڙس
hlis	ڇهه
cwit	جيئري
cyan	سلام
myat	ياد
tyic	قدرتي
hfut	گر
swas	خدمت
hsap	کانسواء
pcit	ڪاپيرائيٽ
hyim	فوج
kyas	گهوڙي
plic	مستقبل
pcak	اولهه
hpis	ادا
hyuk	ڳاڙهو
hwun	هونءبه
twin	اميدون
plan	راند
hpus	آفيس
syun	حڪومت
kyic	گرجاگھر
htaf	زور
hlun	ڊيگهه
kyin	ڪمپني
kyis	پيپر
mlan	ممڪن
hcim	خاصطورتي
cyas	کڻندو
twac	دري
nyat	حسن
hcus	جنهنڪري
htup	فرض
htif	فاصلي
pyas	دامن
hlas	جهنگلي
ksin	سائو
hmaf	ڏکي
myac	مرڪ
hsim	ننڊ
kyit	undefined
kwik	quotativeصورت
fwan	دوري
slan	جيتابعداريڪريو
psit	موجودگي
hmic	مٺي
hmuf	وات
hfin	امير
tcam	دشمن
psuk	ٽٽل
kcap	ٻيڙي
pwan	جنهنجيشخص
hfic	اثر
tcuc	ظاهر
hkim	خفيه
pyin	مهربانيڪري
pwit	precativeمزاج
pyit	politeتيگهڻن
cwak	ڏک
myak	مارچ
tcas	جايون
hlaf	رهو
psat	بدران
nlan	نيرو
psac	ناممڪن
kcuk	اسڪول
kcit	سانشادي
kcak	کاڌو
syis	ويهه
tlac	پهر
hcip	prospectiveپاسو
kwin	ڪاري
tsit	رک
pyac	ٻولي
hsus	هفتو
hcup	هال
cyap	عجب
tfin	ڄائو
fyat	سپريمڪورٽ
hnip	gnomicپاسو
tsak	عزت
tlas	لڳي
syuc	وڻ
plat	ڀت
cyak	آسمان
twip	inchoativeپاسو
mlat	حڪم
swit	jussiveمزاج
mwas	مهينو
hwaf	ڀرپور
tyap	تجربو
ksac	حالتن
syac	تازو
hnuk	رولو
kwak	ٻ
tyuk	اوڀر
pwac	پٿر
hkif	سڳوري
nyac	رخ
cyis	شخصيتن
tyuc	انتظار
tsun	ڳوٺ
tyik	متفق
hnum	permissiveمزاج
slak	ڪاميابي
tsic	ڪوشش
slat	ٽڪريء
hmik	موسيقي
hkus	رڙ
hsip	ست
hpaf	نجي
nwas	خبر
tfac	منظر
fyan	باغ
cwas	شروع
hfik	distributiveصورت
lyac	معلومٿئيٿو
syik	سياسي
clin	هينري
cyin	ڪوڙ
tsas	وڌائين
cyik	دليل
tlap	منزل
cyam	اونهاري
tcut	مذهب
tcap	فرار
hlut	ليکڪ
pyun	ناسي
tcuk	درد
swan	بهارجي
hmun	نرم
kyun	ڪنڊ
nyak	ٽريڊمارڪ
tsis	جسٽس
psas	پيدا
cyaf	کلڻ
hwut	وسارڻ
hyup	يورپ
hwap	اٺ
psak	بيتن
kyap	سخت
pyic	گهري
hmim	وچولي
hsaf	دم
hmis	حڪمتوارو
hsum	possessiveنشانن
ksat	وڻندڙ
ksit	قبر
tsap	ٻيٽ
kyam	ڪيمپ
tcum	رابطو
cyun	نصيب
psic	اڇليوسون
tyun	ڊومين
mwit	commissiveمزاج
tlut	وڏا
myit	سياري۾
kfan	ٺاهيندا
slac	ڊوڙندو
myin	منٽ
tyip	ڏس
klas	گلاس
pfat	بورڊ
cyic	چٽ
swam	ڪمن
syam	محفوظ
tsut	ڊاڪٽر
hlip	completiveپاسو
kcas	اونداھين
nyun	گرم
hpuc	پيو
tlam	مثال
hfun	ڪاوڙ
tsik	چوندارھيا
tsam	سڌوسنئون
hmup	ٽوپي
klak	ڪتو
slin	چاندي
swac	خادم
kcam	ناز
pyik	سکيا
myut	اخلاقي
syak	داخل
swat	تلوار
kyuk	حملو
clac	صحت
tyaf	پيراگراف
swic	سماجي
tfit	واپسي
hkaf	سرڪاري
pcas	چتائي
nyam	جلال
tfat	ٻارهن
pcut	مصروف
pwin	شراب
mwat	مزو
fyac	لوھ
syap	کيورهائڻ
myap	واپار
hyum	استعمالڪرڻ
fwak	جج
klat	ڪئپٽن
twap	cessativeپاسو
kcic	عجيب
kwic	پرڏيهي
hnif	intensifier
myun	اهميت
tlic	آخر۾
cyuk	ڳچيء۾
syut	آزادي
pfan	پاسن
kyuc	سڪي
pcap	منھن
tfak	evidential
tcik	evidentialصورت
twun	جيفاصليتي
tyis	جاريآهي
nyap	سوڙهو
plit	عمارت
hpif	صفحو
pwic	جوت
syic	اداس
tsip	گناہ
syim	بيمار
tcis	ايماندار
pcun	ڪناريتي
ksap	قبول
lyam	وهڪرو
tcaf	هوشياريسان
kwac	ڪن
hpup	ماني
kcut	چونڊي
nwam	حيوان
hsup	zoicجنس
nwit	eventiveمزاج
tcim	ساڳئيواقعينشانن
tlik	multiplicativeصورت
kyus	صليب
hmus	دلدار
kfat	مجال
nwat	سٺا
myic	مينهن
hpum	مٿاڇري
swut	پاڪ
clis	جولاءِ
mwun	فيشن
hfas	فائيل
cwac	ڪلهي
kwat	آرام
nwac	ڪنهن
tcip	جوارادوڪيو
kfac	گاهه
hmuk	ڪڍو
plin	کلڻ
kwun	جون
mlik	مڇي
klin	گاديءجو
pfut	سينو
twam	دعوي
fyin	خرچ
nlit	اوھان
mlin	لک
pyut	دعائون
hluk	ٿڪل
ksut	قتل
cyut	پاڇو
psin	وزن
kcis	ڀورو
pyam	بهادر
mwac	مطمئن
klam	ٻڌايان
ksam	قومي
hfip	ڪمزور
klik	واديء
hkum	نينمزاج
clas	پيلو
cyuc	گرمي
mlac	رهيٿو
syip	ڪتب
pwak	باڪس
tcif	نشاندهي
psip	اصول
ksik	پڇاڙي
tsim	موسم
flan	سائنس
pcam	apparently
kcun	هليرهيو
ksuk	چاچو
mlit	فهرست
pcik	خطرناڪ
kwas	آگسٽ
hluc	مشهور
klit	نامعلوم
flak	واقف
fyit	واقفتيگهڻن
lwat	پڙهندڙ
plun	پنڌ
twas	ٻيهر
pcis	پادريء
fyas	زخمي
nlat	محلات
myuk	گهڙيل
pfak	احسان
tcuf	نو
cwap	همدردي
plac	پٿرن
pyap	اسي
lyic	تيارٿي
hcum	شور
lwit	ادب
tsuk	سپههسالار
hfup	طوفان
kcik	کيسو
nwap	نومبر
tyim	ڊسمبر
psaf	غيرموجودگيء
nlac	آبادي
kyaf	آنو
slis	سيريز
pyaf	پکي
mlak	مالڪ
kwut	ڪوٽ
hwuc	لاڳاپا
pyis	وهن
twuc	دونھون
nwak	جنوري
mlic	مشين
tlis	ڏند
ksun	ٻرندڙ
clam	شرم
klaf	معيار
clit	منڊي
fyak	جملي
fyam	جملينشانن
kwap	چورس
hwip	آچر
psis	شاعري
pwut	undefined
kyim	خريد
clic	پوک
pyip	اپريل
kfap	آڪٽوبر
psut	شيون
kcuc	ڪڙو
nlap	غلام
hsok	ڳالھائيندا
htet	متن
hbat	البت
hrit	ڪريڊٽ
hzit	خاصيتون
hpet	پندرهن
krac	ظالم
hduc	مٽي
hrik	عملي
hron	رنگ
hnus	نڪ
hric	دوست
srik	جيسامانجو
hten	ڪالهه
tlet	hesternalزمان
slap	لکان
hban	پائڻ
hdat	انڌا
fran	مک
hdan	شيطان
htec	جتان
hmon	مشن
cran	قرباني
hran	ضمير
hmos	وزير
nrit	توانائي
hcet	نفرت
hset	مرڪز
hrin	ناليماترجنس
hcot	لطفاندوز
hrip	ٿوريء
htep	عبادت
hcif	جلدئي
hrat	ڇت
kran	تاج
hkon	محل
tran	نااميد
hmif	ميل
trin	جودائرو
hgin	جيل
hkop	ڪپ
hcen	رڪن
swin	ديوان
hrac	هر
hris	رواج
hbin	واه
hmot	گوشت
hdut	کير
hwen	vegetalجنس
nran	نادر
hbac	سوٽ
crut	پل
hsoc	اسٽاڪ
hsom	لوڻ
nris	معصوم
hbit	پاسو
crin	سندستعريف
rwin	راڻي
hgut	شمار
hdas	ناچ
hnot	هوٽل
hdin	ڀريندا
hton	قيدي
hdak	جودڪان
hlet	جوانڪارڪندا
hson	معافي
hgek	ڇوڪرو
hras	واريء
hsep	سيپٽمبر
hbic	بيشڪ
hlen	لائسنس
hcon	ڪجيٿو
hgit	شاھدي
kfon	بورچيخاني
hbak	وڪرو
tlim	علاج
hsot	رفتار
kyut	ڪمپيوٽر
hnen	دائمي
htek	لائبريري
hzan	هجن
hbis	بنياديطور
hbun	مونجهاري
kcus	پچائڻ
hgat	ٿر
hwus	چمي
hbif	برف
hbot	طالبالمولي
hrut	دليل
hdit	benedictiveمزاج
hdis	ڏوهاري
hjan	سزا
plis	پوليس
hgan	لڪايو
hsen	لڳن
nrin	اڻڄاڻ
hyen	ڪڪر
frif	فيبروري
hdik	بيماري
hnek	شروعاتصورت
hbam	چاچي
hmen	عاجز
hdip	لکندڙندير
prat	ٻڌايوevidential
hdet	آڌيرات
hjit	آڱر
hmoc	اوڏانهن
pran	پريس
kcec	علائقي
hken	تازوتوانوهوندو
hloc	دردن
hrak	عملي
htes	اگھڙنکي
rwan	انعام
hdon	موڪليندڙ
htot	پيشاني
hnet	ملائڪ
hdun	مانسمجھان
croc	غلطي
hlon	صبح
hyec	رڍ
hjin	صبر
hrec	referential
mran	کارن
htos	اڪثريت
hcos	اپاء
hkoc	ڪڏهنڪڏهن
hlif	نفعي
clak	کنڊ
hjat	انسانيت
tram	طئه
hdic	ڊسڪ
hkok	اڪيلو
srat	فنڪار
crak	چارم
hmet	ايميل
hden	فيصلو
gran	گورنر
crac	شاخ
hjac	جوش
hdim	inductiveمزاج
hcok	جلدي
hyet	تيل
pwap	چلم
trat	پرنٽ
tcot	بيڪارڪم
hdoc	آه
hren	وڪيپيڊياسلسلي
tcon	منجھند
krin	ڪئبن
plam	الارم
hnes	نروس
tcen	مشاهدي
hsek	پاسو
plik	اطلاق
slik	ريشمي
hfen	سيڪڙو
hgen	ايجنٽ
hnon	يونين
crik	دوزخ
tcet	عيب
mrat	ملايو
hdam	admonitiveمزاج
hgac	لوڀ
htoc	اهڙو
hdac	صلاح
nwin	آئين
srit	آلي
hret	محڪم
nlin	آنلائن
hzat	tide
klic	ڪاليج
hkek	پڇ
nric	جڳ
hgic	ڀريل
hgak	بلي
trit	سڌيevidential
tyot	انجام
hnok	مواد
crit	لاوارث
slen	يارنهن
srin	ورتي
hpok	قبيلو
hyot	apprehensiveمزاج
cric	پناهه
hruc	بدتميز
cwin	سوار
hzak	لکن
dyit	صنعت
hpec	پيشو
nras	نرس
hcec	درس
hbut	بوٽ
hmec	منجھيل
twot	سرگرمي
crat	ڇنڇر
hkot	گنجائش
hnec	آس
hwuf	بيوه
cren	وسري
nrat	تارو
hget	مهمان
hbik	رحمت
brin	ڪهڙا
hpot	موجود
trac	مزاحمت
prac	حاصل
hcoc	رهان
hpon	صوبي
hwim	سڀيتا
dwan	اونڌا
cwok	صدمو
hdok	ڊرائيونگ
crun	خزانو
hzik	ٻج
hrot	زمانماضيحال
hket	ستل
hcek	فرنيچر
hrop	رسي
mrac	مهم
byit	جيدعوت
trak	سالياني
hzin	ڏکڻ
sric	تقريب
clik	شڪار
trap	لبرل
hrim	عيسائيت
hrus	اڄڪلهه
blat	مذبح
cyon	ٺهي
hwep	ويب
krat	نو
tris	واڱڻائي
kcot	گڏ
hben	اليڪشن
trik	پيتل
kfit	لفٽ
tcec	بدلي
nrik	قطعيمضمون
grat	شهنشاهه
dran	انتظاميه
hpen	عربن
cluk	بدصورت
nrac	ضرر
ryin	تربيت
hrun	رول
nwic	انچ
slit	گولين
gzat	اخبار
krot	واڍي
drit	کيڏاڙھيءکان
hzis	آنسو
hdap	ارڙهن
sris	تاريخي
mrut	مجموعي
nyik	گاري
bran	گھوٽ
drat	ڀاڙي
djan	ديو
glat	سادگي
hpoc	سرء
pras	قضا
hgot	گڏجاڻي
tret	ٿيٽر
tras	مقابلو
rwit	رقيب
hfon	نظرايندا
klot	coach
hmum	مزاح
drac	وڪيپيڊيا
rwas	ناول
tset	انتقام
hdot	distaldemonstrative
ryut	حاسد
hwon	دعوت
byat	سڙي
flac	فليش
prot	تصوير
crek	صلاح
htok	هيء
htop	لعنت
prit	imprecativeمزاج
hces	لاچار
klup	ڪلب
hnos	ٻوڏ
dwin	بيحسي
prin	افق
mrit	assumptiveمزاج
tcoc	لڪ
hcom	همآهنگي
grit	کنوڻ
tlot	ننڍپڻ
hgik	knee
hwes	غيرشعوري
hzac	پاڻ
hsec	سافٽويئر
tson	ادارن
ryit	پنهنجيمرضي
dlin	نظموضبط
slip	پرچي
klon	انقلاب
hfim	هاريء
hpom	پليٽفارم
cyen	شاگرد
hgec	غار
hroc	روايت
srac	جميع
ryat	الميو
kcen	ڪنواري
hbap	الوداعي
krik	تنقيد
krap	ڪپهه
fwat	اسپتال
kcet	ڪرايو
hgas	گئس
pfin	ناگزير
dlit	پتي
ryan	ترجمو
sran	جنازي
mrin	اٽو
hram	رومانوي
dlan	ڊالر
hzas	ڪريوٺندو
hsos	سورهن
klen	ڪالوني
gyin	ونگ
hsif	شعر
cluc	مڪر
prip	تياري
hzut	mist
dwat	دوا
krit	proofread
sras	بسيرو
hses	چوڏهن
brat	اعتراض
flat	امل
hjic	ڇهن
slic	اسر
hbuc	يوزر
tron	نارنگي
byan	غسل
hrif	مديخارج
tlip	قائم
blan	ٽوڪري
kris	سيڪريٽري
hyon	انهيسانگڏگڏ
tren	اڄ
dlat	hodiernalزمان
hzic	زهر
tfic	پڇاڳاڇا
tlen	ڏات
hlim	آبهوا
dyat	سنگتي
kcon	لاھڻ
dlac	ڌوئڻ
krak	اقرار
hbas	ڪوڙين
hkec	ڪوئلي
hrek	بحال
hkos	ٻيڙين
hwif	وائيس
tric	ٿوريوقت
hdep	delimitativeپاسو
mwak	انبار
ksot	بون
hnoc	سومر
nlas	اڱارو
brac	اربع
frap	وفاقي
pfit	نمائندو
pcoc	قطب
lyen	ململ
swak	ٻڏڻ
pcen	صدرآصفعليزرداري
brit	بيانتها
hwec	گھيرو
hwet	آنڊن
hlos	ماڙيءتي
hbon	جوڳي
pcon	ٽامي
hsem	چوٽيء
lwac	سستو
tsos	تڪرارن
kwen	سچاانسان
trun	آورد
trut	بت
hrap	توپخانا
hgap	گرفتاري
trot	گرميپد
grin	پاڙي
hjak	آغوش
hpek	سٿ
hlus	deer
hwos	سمهڻجوڪمرو
tsuc	بش
pcuc	ڳڀيرڻ۾
cris	وارث
clun	وک
hpes	اڻوڻندڙ
nlet	اڻپورا
hrom	پروگرام
pyon	پيان
swet	persuade
dric	لڪل
tyen	چڱيريتواقف
hruk	بيرحمي
frat	لڳايو
hyoc	طمعهوندي
hlep	telicپاسو
nrot	بينالاقوامي
nret	violently
hfif	فلسفي
pfic	نمائندگي
hmek	حساس
hfec	ڀلائي
myik	مڇيمارڻ
truc	چوري
tcop	شرڌا
rwic	رٽائر
htom	معيشت
glan	گيلري
pren	ٻيو
hlek	atelicپاسو
nrak	سنسڪرت
truk	ٺڪ
hjim	prohibitiveمزاج
rwat	ڳنڍ
hcep	سيل
dyan	آنا
jrat	مصنوعي
nren	وحي
ksic	بحران
tsoc	ڳولا
lwan	لنچ
hpos	پائن
hcuf	لوڏا
tcus	ابڙو
pset	وڌائڻ
hkep	ٽامي
swis	ملاح
prim	شاهي
trip	whip
cras	پھراڻ
swap	سويپ
syet	مسودا
htof	چور
clen	چئنل
kwit	شخصيت
klok	ڀؤ
hrok	اصلاح
hguc	اڃ
kcim	خطرو
hpem	کجيء
psik	اسپيڪر
frit	حد
cret	بصر
mrak	نيزن
syen	اجلاس
tcup	نم
hyek	مسافر
trim	زهرا
plak	شڪايت
hyok	ڪنڊ
hgam	ڍڳي
hmok	مل
jrac	نقشي
kloc	نڙ
gyit	ڄاڻيواڻي
hbip	بيئر
mlet	velvet
lyap	فحش
cwen	ڌڻ
bwan	niece
tses	تيرهن
jrit	ثابت
nlak	وارادستخطي
sron	وير
cruc	جمع
broc	برش
dlot	ڊائونلوڊ
krim	ڪريم
pric	گندرف
prut	زوري
hgon	ڄميل
sram	لفظي
pfot	ملازم
hlot	رٿرٿي
djin	پئسنعيوض
hlok	ليپ
hpep	صوف
hwot	مروڙي
dlak	بحث
brik	رڪنيتحاصل
nlis	transcribe
hbet	شرطلڳي
pris	وائرس
hjik	مھماني
blit	childish
hjap	خلعت
tfik	ڌيان
hdaf	پھچڻ
hpop	ناٽڪ
kcaf	روپوش
kcoc	خم
hrum	جيمرمت
cyim	ڳجهه
dyic	تعليمي
hgoc	کڏ
drak	فتنهو
plas	ڪنجوسي
byin	انگن
hzap	عيسائيخانقاھ
nlot	وفاداري
mrik	مشيني
hsop	ڪاميابي
crap	چانديءجو
kyek	ڪيڪ
nrut	مھماني
syes	سر
hjet	سترهن
hjen	جنسمونث
hmom	ماکي
hdec	افسوس
lwen	ڏندڪٿا
slot	چلهي
frac	باغي
gwan	اڳڀرائي
mruk	بهتر
swot	دلدل
zlan	كما
hnem	پراين
hdes	ڊريسنگ
prak	نصيحت
frin	scenery
hfet	جيمخالفت
cros	مصرع
ryon	ناليماتر
tcos	فصل
tsen	پروسيسنگ
hwek	بگھڙ
nlik	نفي
klap	قالين
dras	ھجو
prop	زرخيز
slim	whistle
hgis	پنير
krut	کيچٻين
srot	ڄاڻندي
bjan	ڀلن
nwen	نيوي
myas	ماسڪ
kwaf	ترقيء
twis	cab
pcip	پينسل
srap	سبزي
sren	exhibit
tlun	سلوار
hrup	ڪرپشن
nrip	ڪابينا
srup	سوپ
jran	جراح
bjat	الائونس
gyat	جاسوس
hlem	دوج
srak	تجريدي
kson	تلفظ
cwis	خميس
sret	سچي
hraf	ٽريفڪ
hres	تعمير
hsuf	وس
rwak	ٽوڙيو
twon	زيور
hfus	صحتيابي
hkom	ڪوڊ
djat	(Hunter)
nlut	Newsletter
hsef	نانگ
mris	جمهوريت
bric	بيٽري
mlam	سسو
zran	شيئرنگ
cron	جوش
hzen	ترڻ
traf	پٽي
cwaf	لفافو
srip	سگریٹ
mrot	موٽر
swon	رضاڪار
ryak	رد
pfun	جزوي
blac	سامان
mret	وزارت
hjon	جنسي
kcok	ڪهاڙي
dram	هيرن
kren	متبادل
tcek	گونج
hdif	سڃاڻپ
tfas	سفير
hfot	مشتمل
lwas	سست
hmep	momentaneپاسو
kfin	نسخي
mwin	ريزه
hrem	ري
pram	چڙهڻ
byac	cellar
mren	يادگار
swen	سينيٽ
kras	تابوت
hgun	سڪيء
nlok	پئجيويا
ryic	زرعي
gwin	جھولي
srut	meadow
hkes	پيچيده
hfis	استعيفيڏئي
frak	باربار
hnom	سازش
hcop	سرائي
hlec	مرچ
mlot	ڪيتراسريلا
zrat	اميدوار
proc	سائين
flik	Fox
cyet	undefined
hgim	چمني
slet	hedge
tcok	جيدرستگي
bjit	اڳوڻيميت
brot	bud
bwat	ڪمبل
hdus	سور
gwat	عاج
kret	ست
nwet	مبصر
jwan	آيون
nwis	ميخن
mwic	مک
bzat	اداڪار
gyan	مٺو
zyit	ايگزيڪيوٽو
blic	دوکو
pcet	غيريقيني
tsot	ٻٽو
bwit	چوديواري
tres	دٻاء
hkof	واپرائڻ
nyen	صدائون
hles	سوچيان
cyek	گوني
hjis	سوئي
gjan	سڄو
prec	پڪا
drot	ڪنٽرول
kcek	وکر
twic	ڪڪڙ
brak	بيرل
zwat	عادي
clap	عاديپاسو
tsec	ماهر
bwin	مرعوب
cwet	هوندو
hbek	baker
zlin	زيتون
mron	وإن
drin	ڪهڙو
psap	بينقاب
gjin	سالگراه
clut	ڪوڏر
cwun	خوشبودار
twaf	trivial
pcot	پالتو
krok	کوپڙي
dlik	قانونساز
cwic	خوشقسمتيءسان
srun	frown
crec	تباهه
jlan	حاشيہ
kcip	چيمپئن
blin	ارب
ryik	ڪيميائي
mlas	نبض
flit	چويٿو
hzet	knot
cwik	باقيرھنديجو
twet	گھاگھر
mwik	هفتيوار
tfis	فني
tlon	گاڏي
cram	undefined
grac	مضبوط
kraf	ڪانو
trup	وصف
hduk	ٿلهو
cruk	شعر
nrap	housekeeper
crot	شاهراهه
mlip	مليشيا
hfoc	photograph
nres	سالميت
plos	گڏوگڏ
tfam	شفاف
nlic	اڻويهه
hwok	معني
nlen	مضموننويس
fyic	افاديت
hwuk	منفرد
hgok	حياتياتي
flic	نظريي
flot	مجال
hboc	جواب
hwoc	ڏائڻ
syot	هڪڙو
cwip	champagne
hbes	بينر
lwic	طلاق
blot	بجر
cwot	قيد
cwam	رڳ
prik	اهڙن
hfum	فوم
grik	بجري
zrin	چنبڙائي
gren	سيارو
hfuc	قيامت
claf	إلى
flas	شيدائي
hjot	جاري
hbim	ماني
krek	پاري
hbec	undefined
tsaf	آپگهات
pwas	اڇلائي
plot	صحافي
kfak	خرچيندا
blak	ڪوٺي
hdos	ڄمي
kwis	شاندار
kcos	کيتھمتلائين
psen	پينشن
kres	فعل
hzon	بندر
srim	دستخط
glin	ٽاريندو
mlut	بدمعاش
myot	آمد
fwac	زندهه
troc	مشعل
hgaf	گرامر
hyop	بتيلي
ksip	ناپيد
sres	excursion
hnup	گنبذ
hzun	ضد
mric	سياسي
gjat	ڊ
hros	ڪينسل
zrac	بيھمت
tros	ٽوسٽ
myus	ڪوئو
dwac	آلاپ
byak	بکري
htef	درزي
hfek	سبز
dzan	عائد
nyon	گمنام
zrit	رواجيتيگهڻن
pcos	راندين
hjec	ڳاري
dlas	حذف
mras	ڇٽي
mram	معدني
cwut	صلحنامي
hbok	بدڪ
swun	سپ
dwak	گڏين
plif	ولا
slon	سلائي
tfut	congratulate
djac	پيدا
hjas	مقابلي
kric	rabbit
kwot	موصل
gzan	ضمانت
clot	رانديگر
ksek	مقطع
psam	پورڻ
mwut	owl
htem	مستقل
clon	ستار
dzin	سنڌواسي
rwim	جيحوالي
hyof	فائدو
dron	بلائن
dwit	auditoryevidential
sroc	روانگيواپار
hzot	هجن
djik	ڄاڻيواڻي
kfik	lid
ryun	ريگيوليشن
hmes	ناظم
rwac	هارڊويئر
sruk	سرڪس
sros	ننڍين
bzan	فاقن
kset	ميوزڪبينڊ
bjon	bacon
hjut	لامحدود
tfen	دفاع
zwac	نقصان
dyin	سوچويچار
myis	موسيقار
mlis	ذهني
pret	پوري
tsek	دان
hlom	شهزادي
ksos	کنگهه
crok	مٿيجوسور
flin	زرخيزي
mrun	هاري
swec	بيترتيبي
syuk	چمچو
blun	لغڙ
tcep	وڪيلن
fric	refreshment
rwik	عمودي
rwen	preventing
flet	inferentialevidential
pfac	پبلشر
srek	vinegar
tfun	سرنگ
pwet	puzzle
gyik	چيڪلو
fwot	ڦٽي
lwin	متوازن
jwin	جگر
bwik	sublativeصورت
hdup	dip
hnop	هڪهٽي
bwic	سبميرين
ryen	قطع
hcem	زلزلو
hbos	ليبارٽري
nrek	ورڪر
ryim	ترنم
nyic	تعبير
dwas	سفارتخاني
rwok	لوڌڻ
kram	جمهوريت
ksim	declarativeمزاج
clok	چاڪليٽ
pcec	جوشرفحاصل
nyis	hermit
tyoc	اتفاق
grak	ڀوڳ
zlat	دستانا
hjuk	رڪوع
trif	جاگرافي
djit	منظم
pson	undefined
mwis	سيڙپڪاري
cwec	زباني
hdek	سيڪيولر
blik	hawk
sloc	نفسيات
brap	اڇلايو
jlat	نقل
dros	dose
slam	سامن
pwun	pudding
gwik	مقناطيسي
pcop	پمپ
myen	اهڙيطرح
ksen	آڪسيجن
mrap	foreman
tfot	سند
ksus	غاليچا
trok	بيانبازي
tloc	rung
zyan	oar
nlun	لاگان
hlop	دوربين
jlin	هجي
lyut	cloudy
hsof	سرف
fyik	وسڪي
klet	نسبتا
hwof	ولو
hlum	اٺ
myet	شوقين
klis	تهذيب
hbaf	جيون
gwac	گڏھ
hwum	حيرانٿي
pwik	ڪانه
pron	نواز
myes	وارو
mwen	undefined
kfic	موڪلون
klek	ڪلڪ
cwon	ٽوس
lyak	جڌهن
kwon	لغت
hjam	سوئر
rwon	قوسقزح
crip	سمورن
zwan	ايندڙ
srok	ايڊيٽوريل
craf	corporal
tlok	ٽئنڪ
brip	پوپٽ
tfap	چارٽ
jwat	ڳنڍيل
pros	آپريٽنگ
psun	بدبختي
clet	undefined
hbus	بانس
dyas	فراهمڪرڻوارو
klun	موسمي
jlit	متفقهطور
hdom	سور
kron	ڪاربان
hzam	ڄام
cyot	ٻڌندڙن
hmem	ميوزيم
lwam	رسمالخط
fras	اڏائڻ
psoc	مڪن
hgum	گم
brek	بريڪن
glit	استحڪام
frun	چست
gris	جوش
mroc	ٽاريءمان
bzit	ڪوريئڙي
plut	گجر
glac	لالچ
gzac	ضرب
prun	کاتن
jlet	ڪئلينڊر
nyim	نامزدگي
tlos	کھرب
slut	سلاد
fwit	affirmativeمزاج
pyen	اپليڪشن
nlon	ڪمان
dren	فيسليٽيٽرز
drun	عدماطمينان
cyok	shrug
hfop	فوٽبال
ryac	پارٽنرشپ
gzin	pioneer
hgip	گوبي
tyet	ايٿليٽ
hdof	ideophone
hwup	انمول
lwek	lever
syec	سينيٽر
jyak	رهاياويا
mlim	جيترو
fwic	وسآهر
gzit	گب
blas	reliance
jrin	روزاني
gwak	ankle
drik	oddly
prif	variable
jwit	تنوع
krip	امتياز
ryot	undefined
nwut	واڪ
kcif	زورڏئي
jrak	frog
twek	exessiveصورت
psot	معافي
pfon	اسفنج
sluk	squirrel
nlim	irrealisمزاج
ksaf	scarcity
glak	ٻرندڙجبل
plen	equilibrium
kfaf	scarf
kyon	استحصال
jlik	نوٽ:
psop	پاسپورٽ
kfis	vacancy
fyon	affinity
nram	بداخلاق
hbuk	biscuit
gras	وجد
hyos	apprehensive
flim	فلم
plet	گولي
rwam	جوهر
blis	vanilla
zlit	aids
fyut	fastidious
crim	pyramid
hjif	حرام
crif	shyness
lwap	lute
tyon	اپگرههآهي
mrim	maze
drut	بيان
nrim	وظيفو
kruc	ڪمي
kwam	ناصح
jrik	ڪرڪيٽ
dlut	Jujuloeتمام
pyot	ڪبوتر.
dyon	پاڪستان
prap	ڇوڪريء
bzin	بيج
tyek	تكون
trec	خزانچي
nron	هائيڊروجن
pyet	پرنٽر
tsok	choke
zyin	دائم
slek	سائيڪل
jyin	انجنيئرنگ
ryas	سند
zrak	ريفريش
nyas	dancer
gric	لڏپلاڻ
zlak	خلافورزي
tces	ٽينس
hjun	واتم
twen	weave
kyet	ڪليڪٽر
gwit	spine
kyot	راگگري
fwin	ات
tfuc	loom
dlet	ڊاريڪٽري
pfik	پوڻا
bjet	بجيٽ
trek	حڪمتعملي
kros	بلورن
gjit	scissors
gwic	صفا
frik	نظرياتي
tluc	ٽوال
pruc	گشت
glic	گليشيئر
krun	سمپورن
bjin	جياڳڪٿي
tlaf	حصو
tfet	ڪاريگر
bras	lateral
dwik	مدعا
clec	exhaust
cres	شطرنج
tcef	چيري
tcom	ٿاٻو
nyot	مترجم
tyok	ٽرڪ
cyip	surpassing
grot	جيداڻيجتري
bris	وائرليس
nlam	نيلام
slif	sieve
hgos	زنگ
swoc	unsteady
jyat	ڏيوالو
slum	اسلام
hjes	جانچپڙتال
dzat	tiptoe
slun	معطل
nwot	تسلسل
gyic	گٽار
pfas	بياس
zyik	جست
blen	shiny
hyem	elm
hnep	ڏيٿو
nyut	knitted
ryam	فاعلينشانن
clim	مرچ
jret	نفاست
tfon	tease
jwac	جاوا
hrep	رشيد
dyac	فرنچائز
myip	ننڍنننڍن
rwis	racial
hkem	كاميٹي
nwon	جدت
zwin	پابندي
dyis	وچئيندور
mrec	گوري
fyot	ڏوراپو
mlon	ماپ
pfis	جيپڪيڪرڻ
rwot	مدار
hfok	frugal
glof	گولف
zron	ٻُڙي
hzip	زپ
hwom	بيگهر
bjic	چيگم
pcim	پوري
hjip	چپ
bwac	yawn
mlos	سرشٽيء
mrip	گھڙن
bron	embryo
ksoc	deduction
cyum	خمير
jyan	jargon
plim	plum
mwet	قبرستان
ryet	گريجوئيٽ
glik	آبپاشي
plap	سرمائيدار
tsif	لوچ
gyak	shark
djon	ھونئن
nwun	رهڻوپوندو
cles	حقيقتنگاري
dris	increasingly
hkef	ڪيفي
blus	ايمبولنس
blap	پرس
bjak	undefined
klim	grimace
gyac	سائنسدان
jyit	equanimity
dzit	حقيقتپسند
bwak	آئوٽڊور
dyot	ريڊيو
bwon	ڪلٽيوينس
fris	رسمي
klut	speculate
tfek	گوشت
nrok	nitrogen
zyat	استري
bram	mutter
ryis	introductory
nlip	تجزيو
nros	متضاد
hcof	undress
tfif	ترغيب
kroc	furrow
hdum	يهوديت
pses	شامل
plok	complement
lyet	لينس
pwek	pegativeصورت
kfas	ڪينسر
pwen	ڪوپيادو
nrun	نصيحت
clek	ليک
pcif	vindication
glas	پيچيدگي
zwit	talkative
kces	sufficiency
crem	پرچون
grap	تڪليفن
kwip	مداخلت
dyut	پليجو
crus	واريو
gyet	jade
gram	snarl
kyip	ڪبوتر
nyet	تاء
crop	آبشار
glon	gallon
mrok	هيڻيء
fluc	رواني
dwic	انحرافي
slec	Explorer
srec	undefined
blut	wrestle
myok	نقشنگار
tlek	پلگان
nruk	وچڙندڙ
nwoc	undefined
bjut	squat
hges	حمل
twoc	پسارڪو
kyos	ڪميونسٽ
mrek	عجب
clip	contrition
pwok	prosecutiveصورت
dwot	آمر
zyac	preoccupation
jlic	سيٽلائيٽ
slop	ڦاٽل
ryip	متناسب
psim	ذريگهٽ
byet	بيروزگار
cyop	شوق
rwun	سنڌووجھندڙ
blop	بلب
syok	مددگار
klos	chlorine
lwot	chloride
byic	جراثيم
lyik	چيڪيء
blok	حياتياتي
jlac	عيسي
bret	byteکي
krif	secretion
blet	رقص
nruc	پيشاب
tsus	ٿوم
dyak	وچولوطبقو
tcem	tongs
cyoc	مشڪل
trep	strawberry
dlun	آلودگي
hlup	بياض
hbep	بيسبال
praf	پائريسي
pwis	Participle
grek	گيراج
kruk	crutch
hfof	فاسفورس
rwut	بنياديڍانچي
myam	جمنازيم
krec	ڪرين
jras	ٺيڪيدار
zrik	اطلاح
blam	ناچگھر
klip	artisan
hwef	unpaid
zlac	banana
gret	جنتري
lwuk	rib
nyek	nickel
blos	بس
sles	اهلبيت
tlif	ٽائل
kses	sausage
mwot	ٽماٽي
lyot	خود
tsom	potassium
brut	مجازي
djap	جو؟:نواب
hjok	عام
kfen	حوصله
pcok	نظريي
bzut	جوڙيندي
syek	بيروزگاري
mruc	caterpillar
bwas	برائوزر
klif	calcium
rwet	ٻاهرينگذريلزمان
srif	تاريخيزمان
hwem	spectrum
syom	sodium
tyos	ڇڏ
jyic	يرغمال
hguk	ڪدوء
dwun	wrinkle
swip	سنگن
tlec	ڪمپريشن
blaf	ريپ
tsem	الحاد
mloc	مانيٽر
gyot	conditional
trop	گبول،
rwap	ماهي
hjep	جنس
pyim	پلاٽينم
dlon	ٻٽيشهريتجوتعداد
pcep	لنگهه
twuk	لٽجي
tyec	ڳولهي
syup	سپر
trom	trolley
nyip	مقامي
glis	gasoline
gjik	بأقل
hjos	unattended
hjuc	مار
swek	undefined
psek	arsenic
twok	انگن
tsep	grasshopper
slos	سوشلسٽ
nwim	بيحسيevidentialمزاج
tlop	tablecloth
trus	اختلافي
pwot	leash
djot	sediment
nloc	snub
mwon	mandarin
hjek	جوڪي
crom	تعاون
myon	نموني
twec	situate
ryek	rocket
dlic	dividend
kwet	اسڪيٽ
bwen	اربين
plon	الاٽمنٽ
syon	pant
djis	ڊجيٽل
byut	bitch
hyep	eyelid
dwon	وتري
byis	لاشعور
brec	eyebrow
cyec	sneeze
hwop	واٽ
clus	مزاحیہ
kfun	ادخل
nwum	هندومذهب
fyim	پناهگيرن
cwos	شٽل
tfoc	undefined
pwon	پروٽين
sraf	undefined
hbom	vomit
gyen	لکتونgene
drim	freshman
trem	لوازما
tsup	تفرڪو
slok	سماجيات
kwoc	اسڪواش
bwam	ووٽر
mlok	mobility
kyen	علائقائي
hmop	تحرڪuphill
rwek	retrospective
kfup	پيداٿيندڙ
grok	گاجرا
drap	undefined
lwis	molecular
ksuc	اڪائونٽنٽ
tsop	stink
kyok	ھيرا
nroc	رنگرلين
jlot	solvent
psof	phosphate
hgif	fascinate
kfim	کنری
psos	ورزشجيباري۾
pfen	تصديق
kcom	اقتصاديات
krom	۾ڪاما
tluk	wriggle
hyom	iodine
nwuc	تحرڪجلوا
gjac	miscarriage
pcom	pod
dzic	ڪاريگر
grun	پاڻپڏائيندڙڏاڍو
dzot	مخلتف
hzek	مينگانيز
kfot	ڪيبورڊ
jlas	معتبر
lyim	اشراف
jyen	ين
pcaf	parenthesis
rwip	رگبي
blip	بائبل
kyoc	Causation
lyon	ulcer
flis	inflected
nrif	نبلnibble
kfam	quantum
swes	sweater
lwon	ارتقائي
drec	چيرڦاڙ
gjap	اميدي
lyec	سڌر
tyom	سرمي
pwuk	superessiveصورت
flaf	ألفا
myim	مامون
pcek	اغوا
bjac	پلانٽ
bzac	abridge
bzak	sock
twes	ٽيليويزن
dwut	دستاويزي
ksom	انت
lyis	ٻيلا
lwim	المونيم
ksok	horoscope
sruc	تيز
dlif	ٻلهڻ
byik	قاتل
tfec	اسٽيشنري
hjaf	پستانيہ
ryok	پروٽوڪول
dwis	ڊاء
jlon	سيمي
brus	بيوروڪريسيء
gjak	ڪيتريقدر
lyip	clinical
ryem	radium
href	rarefied
prok	ريفريجيريٽر
slep	undefined
dret	iteration
kluk	آثارقديمه
dlis	idiosyncrasy
kfip	ميدان
mlec	مالش
pfif	specification
nrec	بيحسي
pfet	leaflet
hzoc	underlie
dlam	ideally
nlec	علمالانسانجا
kluc	مزيدار
dyet	sedan
tyif	transitive
krus	cower
nluc	سنفلاور
lyun	آئن
zrot	extradition
ksif	ٺڪرائڻ
psif	emission
crup	چڙھي
fret	تلاشڪندڙ
grut	invert
ksec	classmate
jric	سفرناميوسيلي
mrop	مائيڪرو
srus	پهچندي
gyas	hairdresser
floc	جيهڪلوڪڪهاڻي
plek	capillary
nwop	buttocks
nrom	ڪنٽرولر
twos	دهشتگردي
lwok	نعرن
dwet	اضافيوقت
slem	Sublimate
grip	ڄاري
gwas	واہ
kwok	cobalt
gwon	oat
hdop	تحرڪupriver
glam	گد
bwot	ڪهڙي
bren	انت
byot	وڊيو
bjik	boycott
kwim	سوالنجوابن
cwek	ھاڪي
grif	گوريلا
hgem	هيميگنيشيم
hyes	شعور
fram	دواسازي
nwos	undefined
ryap	rearrange
cwim	reliability
klep	kelp
psec	سزا
djic	عالمي
kfut	curfew
crep	سموسن
frim	اثباتي
gjas	ٻاريو
hdef	ڊيبٽ
ryum	دوستفورم::
pluk	جوتعين
krop	تعاون
nraf	ڀريندڙن
tyes	جڙيل
plip	opine
hgom	گاما
hgus	coefficient
cwuc	heater
zret	ڪٽ
nles	تجزيي
trof	intransitive
hmof	مال
hzim	رعوئيل
dzac	جيماني
psok	postcard
blon	مرکزی
djet	digress
ksum	shareholder
mrup	microbe
clif	helix
cloc	صرفي
tfes	ڀنڊاري
gjis	جينس
jren	سدائي
tlep	ڊيٽابيس
kcup	پرچا
glot	voltage
glut	ڳڻپيندڙ
srep	cyberspace
nwes	investor
ksef	xري
bzis	ويزا
frut	ڍانچو
nyuk	firefly
dyik	detector
plec	splice
brom	bromine
plop	palladium
zlik	silicon
flut	وولٽ
ksop	زيبائشي
gjun	جانون
kfok	hiccup
hpof	پوپڪارن
hzuk	زونگارا
nyoc	چرپر
jwak	يوگا
brim	barium
kles	behead
mwam	ها
fwik	firework
djas	غلامنبي
dyim	آڊيو
tsum	tungsten
drip	dribble
lyaf	alimony
prom	پروگرامر
nrup	پٽ
hfes	reflexive
rwaf	chrysanthemum
dlen	دستاويز
byas	جاڦڙا
fron	heroin
dluk	ڌار
dyun	diagnose
flap	فولڊر
kfet	cathode
dlim	نظرين
prek	پارڪنگ
syoc	عڪس
slus	پهچ
nlos	anticlimax
mlen	selenium
pres	cortex
hlof	sulfur
nlek	موجودهجهڙينشانن
gwot	هوائياڏي
mwip	imposter
klop	cockroach
kwom	chromium
hl6t	liter
nwec	هلائڻ
glip	cyclic
nrop	چوانس
crum	هارمون
dlep	ڊولپر
frot	perforate
bwoc	نصب
fwis	feminist
djok	conjugate
draf	جديد
trum	انتهاپسند
graf	الخوارزمي
lwes	ليزر
mlem	millimeter
flen	flex
zlot	anode
swok	snuggle
klec	undefined
pwim	بچيلوقت
htuf	tuna
fyis	صافڪرڻجوپلانٽ
lwet	sensitivity
mrem	مينفريم
jwic	rejuvenation
droc	demonstrator
clem	هيليم
dzik	bilingual
psem	پلازما
hjom	chromosome
rwuc	ordinal
tyus	عدد
klom	ڪلوميٽر
hfos	فيڪس
nwek	genetics
jrap	شهداء
zwas	appetizer
bwok	broccoli
dwap	adapter
syem	اسپام
blek	vector
tlus	جنگيچال
pyif	ڏکڻوزيرستان:
cwoc	ٺيڪ
mrep	ampere
hbem	وٽامن
hxan	دربان
hxut	subsidize
hk6m	cadmium
hxin	simultaneity
txin	titanium
kxin	undefined
klum	copulate
xlis	hourglass
hqak	syntactic
hxat	تخليقڪرڻ
hxik	ايڪتاب
hxas	ڪمڪار
bxon	بوران
dxin	undefined
hxit	ھيلي
tlum	tellurium
txit	ايندڙن
kxat	oxidize
hvik	ميمن
nluk	اينالاگ
nyem	centimeter
hm6t	molybdenum
hl6m	lithium
ht6t	multimedia
xlit	calorie
ryop	ڏسندي
pxas	pharmacist
hxak	ڪم
lwif	locative
grim	logarithm
hqat	mantis
qlit	ايڪولاجي
xlik	sophisticate
mlep	سانچي
hqit	radioactivity
kxim	اوپنمارڪيٽ
hxen	کڄندڙ
hxot	overeat
kyif	نقل
fwet	freeware
txet	subset
hs6n	ترتيبوار
hxet	eavesdrop
xrat	haircut
hqan	impound
hr6t	iridium
bxat	رفتار
dxet	ڊيسڪٽاپ
hxis	exponential
hxok	headquarter
hxek	misplace
srem	cerium
hp6t	partitive
pxik	partitiveصورت
kxet	وي.سي.آر.
pruk	سپرمارڪيٽ
hvit	قوتاراديجا
xlin	آفلائن
frip	بچاءڪوڊنگ
hvep	overpay
hxon	synchronize
kxit	maximize
hqin	ڦل
tr6n	ٽيپ
ht6n	جڪڙ
hvat	ايندڙ
sl6s	celsius
hn6n	اڻلڀ
ts6t	اصلوقت
hvin	ڪارگر
pxat	جڳھھ
myoc	module
ps6s	بيسڻ
bwek	briefcase
dlok	deluxe
fraf	firewall
hr6k	artifact
txat	lunchtime
hqon	oregano
pxun	plutonium
ks6n	workstation
slef	escalator
xrit	lifeguard
hvut	overcrowd
xrim	yttrium
hx6t	augmentative
hqum	کاتيجونالو
hl6n	salespeople
gron	argon
pxan	پروموشنل
hvac	dishwasher
xlan	globalization
txon	wavelength
xrik	recycle
hxap	backpack
hxac	وريهلايو
xyat	هيپاٽائيٽس
cwep	پگهار
hxos	torus
txif	الخط
qlat	realtor
txot	ڏهينخزان
hxam	milligram
pxis	عڪسل
pwif	پريو
txam	tantalum
myek	thermodynamic
hbop	۾افطار
hqot	solute
xlic	ڄنگهن
gxit	تعصب
hvan	باھوسائڻ
glim	gallium
pfop	پاپاپ
hzum	zirconium
xlon	hotline
qlin	nonlinear
kxam	scandium
blim	beryllium
kxik	ترتيب
nr6n	neuron
hpef	predicative
hruf	router
kxan	factorial
hxic	رھنمائي
xlip	والي
dyek	debug
hxop	wristwatch
qrot	نپوسيو
nwip	niobium
hs6t	restroom
grem	germanium
tles	metalloid
hp6k	prolativeصورت
qyin	جهنگليحيات
txak	antibiotic
mlun	immobilization
txan	actinium
xran	خلاباز
dres	decompress
tr6t	extraterrestrial
hk6t	octet
hxus	کليلذريعو
xlat	crackpot
mraf	marathon
ts6n	ڏهينبهار
ht6s	autism
nlif	ionize
txut	notability
hm6n	ڪرڻباري
kxis	ڪلپآرٽ
xrin	undergoing
xren	redirecting
bxak	سنڌ
pfos	نوازجملي
hvis	feces
hd6n	denominator
brum	boardroom
hqis	شاونسٽ
hk6n	گڏ
xyit	ڦيرائڻاهم
xyin	هڪٻيو
hxun	subsisting
hvas	ڪردار
glok	بلاگ
hvak	meandering
pxit	IPپتو
hvet	اڳيون
xram	safflower
hc6n	obviousness
qran	قرآن
zyen	xenon
hqas	۾کڻان
bzas	blase
hj6n	غيرانساني
hnof	nonremittal
txas	وجھندڙن
hbum	ٻڌمت
ts6s	رھيون
pxin	ingredients
hr6n	مشيرن
hxim	ڏهيناونهاري
dxit	وچسياري۾
hxaf	excavate
nlus	houseplant
txap	حيثيتبار
vrit	ghostwriter
kxak	چوڌاريبيوقوف
bxin	انسانيجسم
hqik	raincoat
hxes	hertz
hxif	hypnothize
xras	ڪلاڪجيحسابسان
pl6k	قانوني
dxat	rashness
hxip	antibody
vrat	shorts
hqek	reshaping
qrit	polarity
pxot	ٽپالآفيس
hxom	فالتوايميل
hqic	نظرثاني
lwun	نيريسبيل
hp6n	maturation
dxan	attaching
xrak	اداڪارڪردار
dxak	آ
hven	containers
mwap	مزاحيهپٽي
qlan	رنگانڌا
xros	undressing
srom	شوروم
hc6t	سگهانٿو
qrat	الٽو
hn6t	inhibition
hqet	ويبسائيٽ
fres	fundraise
froc	forging
xlak	hyperlink
vlat	volubility
dvan	disembarking
gxin	فتح
ryes	receptionist
kxot	connectors
xyan	تڪبندين
vlan	اشتهار
ryom	thoriumجوهر
hluf	وڏيعمر
hquk	ڊوز
lyum	thuliumجوهر
tyem	terbiumجوهر
hp6m	praseodymium
txic	گهرصفحو
mros	motorist
dyam	rhodiumجوهر
pc6n	پرکجوتعداد
nyos	انباڪس
pyek	projector
kxon	krypton
hxuc	کيبچائڻ
qrik	Centricصورت
xwin	inexperience
kxic	وسائڻجواوزار
hvot	flowchart
dxot	ڌؤنري
hqut	ڪمڇڏڻ
pxen	کاتيوار
drok	مقصدڪٺور
flon	موبائيلفون
txos	وچآواز
hqok	obliqueصورت
xwik	صبرصورت
hx6n	prehodiernal
txik	اشهدآڱر
hqen	مرسل
mlap	بدانتظام
hvun	suasion
hvon	ٻاهرپائڻ
vran	ٽپالي
pfes	پروفيسر
pwip	شاعر
hqam	ورزش
gxat	قانون
ks6t	causative
vrin	بهرتي
kxip	ڪلپبورڊ
sr6n	disapproving
vlit	evaluative
tyup	مضافات
mrom	morpheme
xron	headphone
gxak	مهانگي
hrof	trojanگهوڙي
xlas	شل
dzet	redecorate
txac	مسلمان
xrot	unused
txis	Dotٿينديون
syif	سئييونٽن
xrac	ماٿيلي
brif	انگنجوقدر
dlos	modalصورت
txun	صفات
dvat	خرابمزاج
psom	پهريونهٿ
gjek	ٻيوته
nlem	ڪاميٽيجييونٽ
qret	ريزڪيدڪان
txip	ڪيڏانھنڦيراياويندانڪتو
dlek	انفرادي
lwut	وهڪريجيموجوده
dxis	dramatically
hs6m	cesium
vlak	railcar
hn6m	netium
kxap	cardboard
bxan	جدا
myem	مئيجيمهيني۾
gxik	سولحق
hxoc	هوائيفوج
xrok	coworker
kr6t	اسڪرينشاٽ
txok	خودڪار
hxep	اسڪيٽبورڊ
srop	اڄ
pxak	تههخانو
hk6k	قومموسيقي
hl6k	eulersتعداد
pyom	poloniumجوهر
xyam	thalliumجوهر
hvic	لڙائي
lyok	locativeصورت
xlot	قدميون
txen	restatement
kxac	جوابيحملو
qrak	strikebreaker
hbup	ترڻواروتلاءَ
txuk	مختصرگهيرو
tsef	tapered
bxit	ويبميزبان
ksem	صرفپڙهو
byim	rubidiumجوهر
hvam	vanadiumجوهر
lw6n	lanthanum
frum	fluorineجوهر
nyom	neodymium
mlom	multalتعداد
kxas	ذاتي
xret	terabyte
hs6k	سرچانجڻ
frus	corroding
gxan	ڪيتريجنس
vlas	vocalizations
glet	گئسpedal
hvim	رن
bxip	bitmap
qrin	تاروجنس
bvak	abessiveصورت
pxon	دستياب
dvik	adessiveصورت
dvek	agentiveصورت
hlef	ايجنٽڪٺور
kwek	صورتکي
kxen	عامجنس
ht6m	citationفارم
tsuf	transڏونائي
hf6n	fining
tc6t	سڌياعتراض
gvik	ergativeصورت
gxon	fragmentation
ksep	receptor
vyin	موويٿيٽر
pyos	اهڙنآواز
hnef	مائرنفعل
xwit	بنياديشئي
hqim	gnomicمزاج
jlak	فارمولو
vrik	آخريparticle
qyan	ريزهيونٽ
kxaf	روشنيجيرفتار
xyic	phishing
qyit	نازڪنڪتو
hvek	evitativeصورت
bvik	subessiveصورت
hzes	مالڪصورت
prus	ڪمپيوٽروائرس
ples	پروسيسر
pxif	پوليسعملدار
dvak	lativeصورت
brun	جاهن
tsi_k	antessiveصورت
tyum	rutheniumجوهر
vyak	adverbialصورت
pxim	وزيراعظم
syum	strontiumجوهر
sy6n	suspiciousness
hy6n	جنسذي
pxac	empatheticخوشي
vlin	گاڏيجنس
qwin	معدنيجنس
hr6s	حوال
tf6n	ٽونر
xris	يوزرانٽرفيس
hw6n	جيموقعن
xlen	زبانياچار
pyec	اسپريڊشيٽ
vlim	مجازيهونديآهي
bres	ورڊپروسيسر
hqip	ڪڪرڪمپيوٽنگ
vlic	مجازيمشين
pfam	اسپامر
dyap	ٻيوٻولي
txek	nthپاڙ
dxen	ڊيٽاکني
byip	ڪاروباريشخص
hs6c	خوداعتمادي
txim	موڪليندڙ
hb6t	واقعيجيتبديلي
hdem	ڊوميننالو
dxon	مختلفواقعي
lwaf	فليشڊرائيو
sl6t	crastinalزمان
xyik	فلاپيڊسڪ
fyif	reflexiveآواز
bvin	ڪائناتجنس
hm6p	motherboard
tfip	transitiveفعل
jlen	جڳههجنس
xrap	striped
tc6n	تحقيقجنس
sl6n	فنيجنس
xrek	صبرڪٺور
xwan	تجريديجنس
dxif	videoconference
dyip	اڻسڌياظهار
zrek	exocentricصورت
hvuk	evoking
xwat	گذريلperfective
hr6m	rhenium
txaf	triggered
hmef	impersonalفعل
tx6t	متنايڊيٽر
txes	اجتماعياچار
bvat	mistreating
bvuk	absolutiveصورت
ry6t	radian
vlis	مجازيحقيقت
qren	planetaryجنس
gvak	وياڪرڻيصورت
bxok	گنجي
mrum	ڪمپيوٽرپروگرام
ps6t	آپريٽنگسسٽم
hfom	phoneme
tlem	صرفياداشتپڙهڻ
pwam	spyware
kfif	بنياديbenefactive
qwit	حقيقتن
nlaf	انسٽاليشن
nwok	associativeصورت
dzas	dissatisfy
swuk	superlativeصورت
syos	summarizing
kr6n	بجليءجوڪرنٽ
dvin	جماداتجنس
pxom	propositiveمزاج
vris	reciprocalآواز
rwos	aerosol
dr6t	distractor
ht6k	ڏورربطيات
slaf	سماجينيٽورڪنگ
lyuk	لڳولڳشق
qras	superiors
ty6n	teminal
gwet	جلدئيمستقبلزمان
hp6s	applicativeآواز
tsof	antipassiveآواز
ht6p	continutiveپاسو
hn6f	necessitativeمزاج
pfip	اهڙنParticiple
glap	ٽولبار
sy6k	existentialشق
qyat	چمڪندڙشدت
hy6t	وياڪرڻياعتراض
vyan	منٿون
sluf	singulativeتعداد
dvit	ڌڙڪنمدو
qyak	سختڪارروائيفعل
bzik	طبعيات
xlet	superlativeوڏا
hqap	موجودهParticiple
qwat	مالجيرقم
qyik	connectiveparticle
sr6t	پیداسيال
hfem	epentheticmorpheme
tl6t	ٻاهرينمستقبلزمان
mrif	مائڪروفون
pcuk	postpositionalصورت
tfim	بيترتيبيرسائيهونديآهي
fwim	ethium
ly6t	allocutiveمعاهدي
hvap	ويڙھيءبار
hfep	frequentativeپاسو
bvan	distributiveفاعلي
fyun	سچلنڪتوجوتعداد
xyas	erasing
hvif	فعلاضاف
xyis	ماضيجياهڙنParticiple
tl6n	مرڪزيپروسيسنگيونٽ
tfok	locativedirectionalصورت
qwan	وچانوچانسوالڪرڻ
