hnit	lahayn
hnak	kiiskaNOMINATIVE
hkak	kiiskaACCUSATIVE
htak	kiiskatopic
hpap	Aabaha
hmam	hooyo
hyat	waalidka
hcan	hello
hwik	VOCATIVECASE
hsuc	awoowe
htat	ayeeyo
hcac	gaajaysan
hnik	kiiskayaalna
hcit	sifo
hwan	iyo
hman	i
hnan	aad
hwam	noo
htit	waxaa
htac	kiiskacaga
htik	lasonin
hyit	niyaddarealis
htim	niyaddadeontic
hcut	niyaddashuruud
hsit	niyaddaepistemic
hyak	kiiskaxarkaha
htan	gudahamacnaha
hpan	qofkamacnaha
htin	laguburburinkaromadax-bannaan
hyan	burburinkutiirsan
hfap	dhinacahagaagsan
hkat	eelasoodhaafaykacsan
hnin	ragahjinsiga
hmak	kiiskacomitative
hnat	joogowaqti
hpak	kiiskabenefactive
swik	kiiskaessive
htut	quantifiernegatory
hsan	macnahadusha
hpin	kiiskaadpositional
hwin	kiiskagoobta
hkan	meelbannaanoomacnaha
hnac	habkiiska
hyut	niyaddainterrogative
hnam	iyoama
hkit	gaarahama
hsuk	kiiskail
hpik	kiiskaabuuruhu
hcat	dhawaanshaha
hmat	saaraya
hkuk	dabadalaguburburinkaro
hlan	laakiin
hsut	oodhan
hyin	quantifieruniversal
hcin	dhedigjinsiga
hpac	tiradajamac
hyik	midkamidah
htic	ay
hkik	kuwaasoo
tcat	mustaqbalkakacsan
hsin	macnahabulshada
hkac	Goorma
hmip	dhinacamidaanhagaagsanayn
klan	waxaa
hlak	kiiskaelative
hlik	kiiskaillative
htam	niyaddadardaaranka
hlat	quantifierdoorashada
hkam	waamaxay
hwat	eraygiisu&#39;aal
htap	copula
hpat	qof
nyan	lab
hkas	waayeen
tcan	kale
hnuc	tirada
twit	quantifierxaqaagii
hsak	markiilaeego
htuk	kiiskatemporal
htun	ookeliya
htum	niyaddahortative
hyip	dhinacayallow
hlit	niyaddavolitive
pcic	waain
tyut	laba
hsat	arki
hkut	ogaan
hcic	hoos
hcap	kadib
hpam	uguhoreysay
hlac	haysashadaalienable
hkap	marna
hnic	oohanti-katashigiisa
tyat	jir
tcit	niyaddadeliberative
tcin	maalintii
hlam	yimaado
hwak	shaqallada
hkin	tago
lwak	kiiskaperlative
hpip	dhinacahorumarinta
lyan	dheer
hsac	odhan
kyan	sida
htas	markale
hsic	halkan
hcik	qabaa
hcak	hoosmacnaha
hfan	lagahelay
hsun	gacanta
hyac	sidookale
nwan	dhallinyaradaah
tyit	kadhankaah
tlan	ilaah
twak	kiiskadelative
hmin	waxba
hyas	mar
hlap	dhinacasemelfactive
kcac	katagay
hyic	miinshaar
hcas	guriga
hwac	adduunka
tyin	saddex
hnun	neo
hcuk	diirada
pyan	jeclahay
hsis	hadiyojeer
hyam	habeenkii
hyap	Boqor
hkic	intaudhaxaysa
hmas	maanka
cyit	wadnaha
pluc	tiradapaucal
kyik	maxaayeelay,
ksak	kiiskasababaha
tcun	soogabagabeeyay
hnim	magaca
tsan	magacsaxah
klac	dalka
hpun	weydiiyay
cyat	caddaymahalaarkikaro
pcac	wanaagsan
hmac	daqiiqad
hnas	makaro
hwic	biyaha
twim	niyaddadesiderative
kwan	light
tlat	erayga
tyan	albaabka
hsas	subax
syat	ilaa
twik	kiiskaterminative
hpit	cad
pcan	lacag
hyis	saboolkaah
mwan	dhimashada
hfam	foomka
nwik	kiiskainessive
kcat	wada
tsac	intabadan
pyat	saaxiib
psan	qeybtii
hpim	niyaddalagamamaarmaanah
hyuc	wareegsanaa
hfat	diray
hcis	xaaskiisa
kcan	rumaysan
hsik	dadweynaha
htus	macnahagobolka
hpas	ina
clat	carruurta
tyak	sidaas
cwan	rajaynayaa
syin	gacaliyo
hkuc	sare
tyac	akhri
syit	magaalada
hlic	horay
hfit	caddaymahafactive
tcac	gabadh
hcun	maqashiin
ksan	uguyaraan
hyaf	lagayaabee
kyat	Hubaal
tcic	jirka
hwit	soolaabtay
cwat	hawada
hfaf	sharciga
hput	Icaawi
lyat	warqad
ksas	afar
hpic	niyaddahubin
hfuk	dabka
hcam	saacad
twat	dagaal
kyak	dhowr
tlit	labaad
pcin	dambeeya
hmut	badiyay
clan	kun
hfac	qoyska
twan	naf
hwas	su&#39;aal
syan	runta
htis	qaadashada
tsat	niyaddakara
lwik	kiiskaallative
nyin	anthropicjinsiga
hfak	shan
tcak	islacalaamadeysanayaanmaado
htuc	maaddoookaladuwan
hnap	jawaab
hmit	badda
hcuc	cabsi
pcat	fahmo
syas	markalaeego
hcaf	shaki
twut	niyaddadubitative
hkis	madow
tlak	keeno
hyus	quruxbadan
nyit	sort
htip	toban
ksis	story
hpuk	buugga
hlin	elektaroonigaah
hkun	account
lyas	xiisaha
lyit	kuqor
pwat	sariirta
hnis	da&#39;da
hnut	counterfactualshuruud
slas	tahay
hwis	kiiskavialis
pyak	walaalkiis
lyin	line
tyas	miiska
hyun	webiga
kyac	isha
tfan	silamafilaanah
kcin	qotodheer
hmuc	Ujeedada
cyac	dhiig
hmap	kacay
tlin	qabow
hyif	weeraryahanka
tyam	daahay
hnaf	umalaynayaa
hkip	kudhowaad
myan	anigaa
tsin	aqoonta
hkup	nuqul
hsam	ninkeeda
hlis	lix
cwit	nool
cyan	nabadda
myat	xusuuso
tyic	dabiicigaah
hfut	dhici
swas	adeegga
hsap	markalagareebo
pcit	copyright
hyim	ciidan
kyas	faras
plic	mustaqbalka
pcak	galbeed
hpis	bixin
hyuk	cas
hwun	dahab
twin	rabitaan
plan	ciyaaro
hpus	xafiiska
syun	dowladda
kyic	kaniisadda
htaf	xoog
hlun	dhererka
kyin	shirkadda
kyis	Wargeyska
mlan	itimaalka
hcim	gaarahaan
cyas	dhali
twac	window
nyat	beauty
hcus	dambe
htup	waajibaadka
htif	masaafada
pyas	foot
hlas	duurjoogta
ksin	cagaaran
hmaf	dhibaato
myac	dhoola
hsim	hurdo
kyit	undefined
kwik	kiiskaquotative
fwan	booqasho
slan	raac
psit	joogitaanka
hmic	macaan
hmuf	afka
hfin	hodan
tcam	cadowga
psuk	jabay
kcap	markab
pwan	qofkaloodhanyahay
hfic	saamaynta
tcuc	muuqan
hkim	qarsoodiah
pyin	fadlan
pwit	niyaddaprecative
pyit	diiwaankaedeb
cwak	xun
myak	March
tcas	meelaha
hlaf	siijoogo
psat	halkii
nlan	buluug
psac	waxaanmacquulaheyn
kcuk	dugsiga
kcit	guursaday
kcak	cuntada
syis	iyolabaatan
tlac	xasilloon
hcip	arrinlafilayo
kwin	siinta
tsit	joojiyay
pyac	afka
hsus	toddobaadkii
hcup	hall
cyap	layaabeen
tfin	dhashay
fyat	maxkamad
hnip	dhinacagnomic
tsak	ixtiraam
tlas	qiimihiisu
syuc	geed
plat	derbiga
cyak	samada
twip	dhinacainchoative
mlat	amarka
swit	niyaddalit.
mwas	bishii
hwaf	kaamilah
tyap	waayo-aragnimo
ksac	xaaladaha
syac	cusub
hnuk	ugaas
kwak	daboolay
tyuk	bari
pwac	dhagax
hkif	oosharafleh
nyac	jihada
cyis	kursi
tyuc	sugitaanka
tsun	tuulada
tyik	heshiiyaan
hnum	niyaddaogolaanaya
slak	guul
tsic	iskudayaya
slat	kur
hmik	music
hkus	qaylada
hsip	toddobada
hpaf	gaarkaah
nwas	news
tfac	goobta
fyan	beerta
cwas	bilaabaan
hfik	kiiskafurfurista
lyac	bartaan
syik	siyaasadeed
clin	Henry
cyin	been
tsas	tuuray
cyik	xujo
tlap	dabaqa
cyam	xagaaga
tcut	diinta
tcap	baxsado
hlut	qoraaga
pyun	bunni
tcuk	xanuun
swan	guga
hmun	jilicsan
kyun	geeska
nyak	summad
tsis	caddaalad
psas	soosaaro
cyaf	qosli
hwut	illoobin
hyup	yurub
hwap	sideed
psak	maraayay
kyap	lagacabsado
pyic	loobaahanyahay
hmim	dhexdhexaad
hsaf	neefta
hmis	kuwacaqligaleh
hsum	calaamadeysanayaankuleeyihiin
ksat	wacnaa
ksit	qabriga
tsap	jasiirad
kyam	xerada
tcum	taabto
cyun	nasiib
psic	xeebteeda
tyun	domain
mwit	niyaddacommissive
tlut	degree
myit	jiilaalka
kfan	dhaqanka
slac	orodkii
myin	daqiiqadii
tyip	horseedi
klas	galaas
pfat	guddiga
cyic	waxtarla&#39;aan
swam	arrimaha
syam	ammaan
tsut	dhakhtarkaaga
hlip	dhinacacompletive
kcas	gudcur
nyun	diiran
hpuc	cabniinka
tlam	tusaaleahaan
hfun	xanaaq
tsik	inkastoo
tsam	sitoosah
hmup	hat
klak	eyga
slin	lacag
swac	anooaddoonkaagaah
kcam	kibirka
pyik	tareenka
myut	moral
syak	galaan
swat	seefta
kyuk	weerarka
clac	caafimaadka
tyaf	cutubka
swic	bulshada
tfit	sooceliyo
hkaf	rasmigaah
pcas	jaleecada
nyam	ammaan
tfat	labaiyotoban
pcut	hawlan
pwin	khamriga
mwat	dhadhan
fyac	birta
syap	qaybiyo
myap	ganacsiga
hyum	isticmaalaya
fwak	garsoore
klat	kabtanka
twap	dhinacacessative
kcic	cajiibah
kwic	shisheeye
hnif	intensifier
myun	muhiimada
tlic	ugudambeyntii
cyuk	qoorta
syut	xorriyadda
pfan	dhinac
kyuc	qalalan
pcap	geesu
tfak	caddaymaha
tcik	kiiskacaddaymaha
twun	fog
tyis	horumarka
nyap	cidhiidhiah
plit	dhismaha
hpif	page
pwic	xajinaya
syic	murugo
tsip	dembi
syim	buka
tcis	daacad
pcun	bangiga
ksap	aqbalaan
lyam	durdur
tcaf	sitaxadarleh
kwac	dhegta
hpup	kibistii
kcut	dooran
nwam	xoolaha
hsup	zoicjinsiga
nwit	eventiveniyadda
tcim	calaamadeysanayaandhacdolamidah
tlik	kiiskadhufashada
kyus	Iskutallaab
hmus	qaroweyn
kfat	dhicin
nwat	koraan
myic	roob
hpum	dusha
swut	quduuskaah
clis	July
mwun	fashion
hfas	file
cwac	garabka
kwat	raaxada
nwac	qof
tcip	jeclaystay
kfac	cawska
hmuk	sawiri
plin	furitaanka
kwun	June
mlik	kalluunka
klin	magaalada
pfut	naasaha
twam	sheegasho
fyin	kharashka
nlit	idinkaa
mlin	million
pyut	Barya
hluk	daal
ksut	dilaan
cyut	hooskii
psin	miisaanka
kcis	cirro
pyam	geesi
mwac	dhergi
klam	sheegaysa
ksam	qaran
hfip	daciif
klik	dooxada
hkum	niyaddakuteen
clas	jaalleah
cyuc	kulaylka
mlac	hadhaagii
syip	sisiman
pwak	sanduuqa
tcif	dhuuban
psip	mabda&#39;
ksik	cidhibtii
tsim	xilli
flan	sayniska
pcam	muuqata
kcun	dhashay
ksuk	adeerkiis
mlit	liiska
pcik	khatarah
kwas	August
hluc	caankaah
klit	ooaanlagaraneyn
flak	yaqaan
fyit	diiwaankayaqaan
lwat	akhristaha
plun	socda
twas	labajeer
pcis	wadaadkii
fyas	dhaawacay
nlat	madaxtooyada
myuk	Doqon
pfak	naxa
tcuf	sagaal
cwap	naxariis
plac	dilaaca
pyap	gelinaya
lyic	labisatay
hcum	qayladii
lwit	suugaanta
tsuk	darajo
hfup	duufaanka
kcik	jeebka
nwap	november
tyim	december
psaf	maqnaanshaha
nlac	dadka
kyaf	mahad
slis	taxanaha
pyaf	shimbir
mlak	milkiilaha
kwut	jaakad
hwuc	xiriirka
pyis	sidegdegah
twuc	qiiqa
nwak	January
mlic	mashiinka
tlis	ilkaha
ksun	gubashadii
clam	ceeb
klaf	tayada
clit	giraanta
fyak	weedha
fyam	calaamadeysanayaanweedha
kwap	square
hwip	Axaddii
psis	gabayo
pwut	undefined
kyim	iibsadaan
clic	beeraha
pyip	april
kfap	october
psut	shay
kcuc	qadhaadh
nlap	addoon
hsok	dabacsan
htet	text
hbat	uguxumaa
hrit	credit
hzit	muuqaalada
hpet	shaniyotoban
krac	nacabkaa
hduc	boodh
hrik	waxkuoolah
hron	midabka
hnus	sanka
hric	saaxiibtinimo
srik	sahayda
hten	shalay
tlet	hesternalkacsan
slap	kuguuldareysato
hban	xirtaan
hdat	indhala&#39;
fran	duuli
hdan	Ibliisku
htec	sitartiibah
hmon	shaqada
cran	allabarigii
hran	qalbi
hmos	Wasiirka
nrit	tamarta
hcet	necbahay
hset	xarunta
hrin	maangalkajinsiga
hcot	raaxaysan
hrip	kooban
htep	cibaadada
hcif	maqaarka
hrat	saqafka
kran	taaj
hkon	qalcaddii
tran	quusan
hmif	mile
trin	goobada
hgin	xabsi
hkop	cup
hcen	xubin
swin	sokeeye
hrac	meelkasta
hris	caadadii
hbin	noqday
hmot	hilib
hdut	caanaha
hwen	vegetaljinsiga
nran	dhif
hbac	Adeerkay
crut	buundada
hsoc	stock
hsom	cusbo
nris	ooaanwaxbagalabsan
hbit	iskailaali
crin	jaceylka
rwin	Boqorad
hgut	tirin
hdas	qoobka
hnot	hotel
hdin	buuxiyo
hton	maxbuus
hdak	dukaanka
hlet	jaranjarada
hson	cafis
hgek	gay
hras	ciid
hsep	september
hbic	baabba&#39;
hlen	liisanka
hcon	kufilan
hgit	markhaati
kfon	jikada
hbak	iibiyo
tlim	daaweynta
hsot	xawaaraha
kyut	computer
hnen	weligeedah
htek	maktabadda
hzan	ooaykujiraan
hbis	saldhig
hbun	jahwareer
kcus	cuntokariyihii
hgat	lamadegaanka
hwus	dhunkasho
hbif	baraf
hbot	kubad
hrut	dood
hdit	niyaddabenedictive
hdis	eed
hjan	Cadaab
plis	booliiska
hgan	qarin
hsen	duulaan
nrin	jaahil
hyen	daruur
frif	febraayo
hdik	cudurka
hnek	kiiskainitiative
hbam	aayadaa
hmen	kuwais-hoosaysiiya
hdip	lagamamaarmaanahdhac
prat	caddaymahasheegay
hdet	saqdadhexe
hjit	farta
hmoc	meel
pran	-saxaafadeed
kcec	gobolka
hken	waayadan
hloc	Walbahaar
hrak	shaqaalaha
htes	fiirsadaan
rwan	abaalmarin
hdon	deeqdo
htot	fooddiisa
hnet	malaggii
hdun	keli
croc	baadi
hlon	waagu
hyec	idaha
hjin	samir
hrec	referential
mran	hadhuudh
htos	Intabadan
hcos	tallaabooyinka
hkoc	mararkaqaarkood
hlif	faa&#39;iido
clak	sonkorta
hjat	aadanaha
tram	jir
hdic	disk
hkok	cidlo
srat	artist
crak	jiidashada
hmet	email
hden	go&#39;aanka
gran	taliyaha
crac	laanta
hjac	xamaasad
hdim	niyaddayeelista
hcok	degdegay
hyet	saliidda
pwap	biibiile
trat	print
tcot	arrinadag
hdoc	oh
hren	macnahahadal
tcon	duhurkii
krin	qol
plam	alarm
hnes	dareemayaasha
tcen	dhawrid
hsek	dhinaca
plik	dabaqikaro
slik	xariir
hfen	boqolkiiba
hgen	wakiilka
hnon	ururka
crik	jahannamada
tcet	haleysan
mrat	iskuqasan
hdam	niyaddaadmonitive
hgac	hamiga
htoc	bartey
hdac	talada
nwin	dastuurka
srit	qalab
hret	adag
nlin	online
hzat	hir
klic	college
hkek	badhidii
nric	Qarni
hgic	buuxo
hgak	cat
trit	caddaymahasitoosah
tyot	heshiis
hnok	kooban
crit	tagay
slen	kowiyotoban
srin	dareen
hpok	qabiilka
hyot	niyaddaCabsan
cric	hoyga
hruc	fiicnayn
cwin	fuushaan
hzak	gilgil
dyit	warshadaha
hpec	xirfad
nras	kalkaalisada
hcec	baridda
hbut	kabaha
hmec	caddayn
twot	waxqabad
crat	Sabtidii
hkot	awoodda
hnec	qorax
hwuf	carmal
cren	daadiyeen
nrat	xiddiga
hget	martida
hbik	barakayn
brin	hoose
hpot	lahelikaro
trac	caabin
prac	dheegato
hcoc	godan
hpon	gobolka
hwim	ilbaxnimada
dwan	hang
cwok	lamafilaanah
hdok	driving
crun	KaydMaaliyadeed
hzik	abuur
hrot	dhawaanlasoodhaafaykacsan
hket	soojeedo
hcek	alaabtaguriga
hrop	Xadhig
mrac	biimayn
byit	iidda
trak	sannadlahaah
hzin	koonfurta
sric	xafladda
clik	ugaarsiga
trap	deeqsi
hrim	masiixiyad
hrus	amiirad
blat	meeshaallabariga
cyon	yar
hwep	web
krat	jiifoo
tris	iyoguduud
kcot	ururin
hben	doorashada
trik	cabbay
kfit	wiish
tcec	sarrifka
nrik	articleqeexan
grat	boqor
dran	maamulka
hpen	hore
cluk	foolxun
nrac	la&#39;aada
ryin	tababarka
hrun	ooduudduuban
nwic	inch
slit	toogan
gzat	wargeyska
krot	goynta
drit	gadhka
hzis	jeexi
hdap	siddeediyotoban
sris	taariikhigaah
mrut	guud
nyik	dhoobo
bran	aroosadda
drat	kuxirantahay
djan	Rafaa
glat	halleeyolillaahinimada
hpoc	dayrta
pras	xijaab
hgot	kulan
tret	tiyaatarka
tras	isbarbardhigga
rwit	horjeeda
hfon	laxirrira
klot	Tababarahakooxda
hmum	kaftan
drac	hadal
rwas	novel
tset	aargoosiga
hdot	distalsaaraya
ryut	masayr
hwon	martiqaad
byat	lagubo
flac	flash
prot	sawirka
crek	soojeedin
htok	dagaalada
htop	habaar
prit	niyaddaimprecative
hces	ciirsi
klup	kooxda
hnos	daad
dwin	warheynta
prin	kaabiga
mrit	niyaddaassumptive
tcoc	yaacday
hcom	noolaanshaha
grit	onkod
tlot	carruurnimada
hgik	jilibka
hwes	miyir
hzac	labadadhinac
hsec	software
tson	hay&#39;adaha
ryit	rasiidka
dlin	anshaxa
slip	warqada
klon	kacaanka
hfim	beeralay
hpom	madal
cyen	arday
hgec	godkii
hroc	dhaqanka
srac	soogudbiyaan
ryat	musiibadii
kcen	bikrad
hbap	sagootin
krik	dhaleeceyn
krap	suuf
fwat	isbitaalka
kcet	kirada
hgas	gaaska
pfin	lamahuraan
dlit	caleen
ryan	turjumaad
sran	aaska
mrin	bur
hram	taataabtay
dlan	dollar
hzas	Ciyaari
hsos	lixiyotoban
klen	gumeysi
gyin	garabka
hsif	libaax
cluc	lagudaabacay
prip	diyaarinta
hzut	ceeryaamo
dwat	daawo
krit	proofread
sras	buul
hses	afariyotoban
brat	diidmo
flat	acid
hjic	kuwaasoo
slic	hub
hbuc	user
tron	orange
byan	qubeyska
hrif	heerhoose
tlip	Ooga
blan	dambiil
kris	xoghayaha
hyon	Dhanka
tren	maanta
dlat	hodiernalkacsan
hzic	sun
tfic	qoriga
tlen	talanti
hlim	cimilada
dyat	saaxiibkiisa
kcon	dajinta
dlac	dhaqid
krak	qirasho
hbas	Cawaysimina
hkec	dhuxusha
hrek	sooceliyo
hkos	huuri
hwif	kuxigeenka
tric	kumeelgaarah
hdep	dhinacadelimitative
mwak	raso
ksot	lafta
hnoc	Isniinta
nlas	Talaadadii
brac	Arbacadii
frap	federaalka
pfit	wakiilka
pcoc	pole
lyen	linen
swak	saxanka
pcen	Madaxweynaha
brit	hoobtay
hwec	hareereeyo
hwet	caloosha
hlos	dabaqasare
hbon	kaladuwan
pcon	naxaas
hsem	shirwaynaha
lwac	cheap
tsos	tartanka
kwen	qofgaarah
trun	degtey
trut	taalada
hrap	madaafiic
hgap	xiraan
trot	heerkulka
grin	xaafada
hjak	qabsanaysaa
hpek	pack
hlus	deerada
hwos	qolkajiifka
tsuc	baadiyaha
pcuc	dheecaan
cris	kiidhaxalkalahaa
clun	geedkii
hpes	xun
nlet	dhamaystirnayn
hrom	barnaamij
pyon	biyaano
swet	dhaadhiciso
dric	laarkikarin
tyen	sifiicanuyaqaan
hruk	cadaawadda
frat	xilsaaray
hyoc	jirrabaadda
hlep	dhinacatelic
nrot	caalamiah
nret	xoog
hfif	Faylasuuf
pfic	matalaad
hmek	xasaasiah
hfec	daryeelka
myik	kalluumaysiga
truc	xadin
tcop	dibinta
rwic	fariisto
htom	dhaqaalaha
glan	gallery
pren	barbaryaal
hlek	dhinacaatelic
nrak	qaarada
truk	garaaca
hjim	niyaddakahorjoogsadey
rwat	kulanka
hcep	cell
dyan	ukunta
jrat	macmal
nren	waxyoonay
ksic	dhibaatada
tsoc	baadi
lwan	qadada
hpos	geed
hcuf	riix
tcus	dacwayn
pset	kordhiyo
hkep	copper
swis	Badmaaxe
prim	Imperial
trip	jeedal
cras	maaliyada
swap	howlgal
syet	sawir
htof	tuug
clen	channel
kwit	shakhsiyadda
klok	xad-dhaafah
hrok	dibuhabaynta
hguc	harraad
kcim	halis
hpem	ootimirah
psik	Gudoomiyaha
frit	marinkii
cret	raadad
mrak	waran
syen	fadhiga
tcup	qoyan
hyek	socotada
trim	qasacad
plak	cabasho
hyok	xagal
hgam	sac
hmok	dhagaxshiidka
jrac	map
kloc	collar
gyit	ulakacah
hbip	biirka
mlet	marojilicsan
lyap	xad-gudub
cwen	adhigii
bwan	walaasha
tses	saddexiyotoban
jrit	qiil
nlak	qoraalgacmeedka
sron	dagaalyahan
cruc	jimcaha
broc	burush
dlot	download
krim	cream
pric	garoonka
prut	xeerbeegtida
hgon	qaboojiyay
sram	macnoahaan
pfot	dheri
hlot	qorsheeyay
djin	qadaadiic
hlok	orgida
hpep	tufaaxa
hwot	qaloocin
dlak	wadahadlaan
brik	subscribe
nlis	shakiyaan
hbet	bet
pris	virus
hjik	hoteelada
blit	caruureed
hjap	khamiiska
tfik	tarjumayaan
hdaf	gaadhi
hpop	opera
kcaf	qarinaya
kcoc	xusulka
hrum	dayactirka
cyim	lagashakiyo
dyic	waxbarashada
hgoc	god
drak	disorder
plas	sacab
byin	binary
hzap	Abbey
nlot	daacad
mrik	farsamo
hsop	siguulah
crap	dabin
kyek	cake
nrut	iyahoo
syes	sayidow
hjet	toddobaiyotoban
hjen	dhedig
hmom	malab
hdec	nasiibdaro
lwen	Halyeeyga
slot	kariyaha
frac	mucaaradka
gwan	bararin
mruk	loohagaajiyo
swot	qoyan
zlan	kasban
hnem	aamusnaanah
hdes	labiska
prak	wacdiya
frin	muuqaal
hfet	khilaaftay
cros	chorus
ryon	maangalka
tcos	dalagga
tsen	processing
hwek	Yeeyi
nlik	diidmada
klap	rooga
dras	quudhsan
prop	bacrin
slim	dhamaatay
hgis	cheese
krut	qaniini
srot	wehelin
bjan	warwareegaan
nwen	ciidamadabadda
myas	hoosaasin
kwaf	horumarinta
twis	Taksi
pcip	qalin
srap	khudradda
sren	soobandhigid
tlun	surwaal
hrup	musuqmaasuqa
nrip	golahawasiirada
srup	maraq
jran	Dhakhtar
bjat	kaalmada
gyat	sirdoonka
hlem	qayrul
srak	aanlataabankarin
kson	lahjadda
cwis	Khamiis
sret	sidaacadah
hraf	gaadiidka
hres	naqshadaha
hsuf	qubo
rwak	crack
twon	waxsharraxsan,
hfus	kabashada
hkom	code
djat	ugaadhsade
nlut	warsidaha
hsef	Mas
mris	dimuqraadiyadda
bric	batari
mlam	wax
zran	lawadaago
cron	reyreyn
hzen	dabaasha
traf	strip
cwaf	baqshadda
srip	sigaarka
mrot	motor
swon	iskaawaxuqabso
ryak	cadaanyo
pfun	qaybahaan
blac	Alaabtoodii
mret	wasaaradda
hjon	galmada
kcok	faas
dram	diamond
kren	kale
tcek	echo
hdif	aqoonsiga
tfas	Safiirka
hfot	kakooban
lwas	caajis
hmep	dhinacamomentane
kfin	Deji
mwin	khayaali
hrem	ray
pram	fuulitaanka
byac	Maqsin
mren	xusuus
swen	duqowdii
kras	sanduuq
hgun	liqi
nlok	raaxeysan
ryic	beeraha
gwin	lulid
srut	dhulseereah
hkes	adag
hfis	iskacasilay
frak	sijoogtaah
hnom	shirqool
hcop	baar
hlec	basbaas
mlot	luuq
zrat	musharaxa
proc	sokoeye
flik	dawaco
cyet	undefined
hgim	shooladda
slet	deyr
tcok	saxnaanta
bjit	horeeegeeriyooday
brot	biqilka
bwat	buste
hdus	doofaarka
gwat	-maroodi
kret	soosaaray
nwet	observer
jwan	waddo
nwis	ciddiyaha
mwic	shinnida
bzat	actor
gyan	dhididka
zyit	fulinta
blic	khayaal
pcet	hubin
tsot	laab
bwit	xuduud
tres	stress
hkof	isticmaalka
nyen	cabaadaan
hles	eg
cyek	joonyaddiisii
hjis	irbad
gjan	ifafaale
prec	dhaqmaan
drot	gacantaku
kcek	qalooca
twic	digaag
brak	foosto
zwat	caadaysi
clap	dhinacacaadaysi
tsec	khabiir
bwin	yaab
cwet	kumyadu
hbek	dubi
zlin	saytuunah
mron	van
drin	sooco,
psap	bandhigan
gjin	dhalashadiisa
clut	dubbe
cwun	kareysa
twaf	Ciyaalle
pcot	salaaxid
krok	dhakada
dlik	-dejinta
cwic	nasiibwanaag
srun	wajikaduudid
crec	baabbi&#39;innay
jlan	margin
kcip	Kooxdaheysatahoryaalka
blin	billion
ryik	kiimikada
mlas	garaacawadnaha
flit	pilot
hzet	gunti
cwik	haybad
twet	darafkii
mwik	todobaadle
tfis	farsamo
tlon	gaariga
cram	undefined
grac	xoojiyo
kraf	diiqu
trup	sifo
hduk	jillaab
cruk	shabeel
nrap	nadiifiya
crot	highway
mlip	maleeshiyada
hfoc	sawir
nres	daacadnimadiisa
plos	oolagudaray
tfam	hufan
nlic	sagaaliyotoban
hwok	aqoon
nlen	Qormada
fyic	oolnimada
hwuk	gaarah
hgok	organic
flic	fiqiga
flot	birtiina
hboc	waajibaad
hwoc	saaxirad
syot	studio
cwip	champagne
hbes	banner
lwic	furiinka
blot	bool
cwot	maxaabiisahaan
cwam	xididka
prik	dadban
hfum	xumbo
grik	quruurux
zrin	fakaday
gren	caalamka
hfuc	sarakicidda
claf	shelf
flas	taageere
hjot	kulaylaha
hbim	aaboyeelin
krek	mercury
hbec	undefined
tsaf	ismiidaaminah
pwas	rifid
plot	reporter
kfak	ubiso,
blak	balakoonka
hdos	Xumaan
kwis	classic
kcos	ashtakeeyaan
psen	hawlgabka
kres	fal
hzon	daanyeer
srim	saxiixa
glin	cagajiidka
mlut	caanah
myot	dejinta
fwac	aasaasaha
troc	Dhuxul
hgaf	naxwaha
hyop	raaxada
ksip	bakhtiyeen
sres	dalxiiska
hnup	qubbad
hzun	madax
mric	muruqa
gjat	magnitude
hros	marmarin
zrac	fulaynimadaah
tros	rooti
myus	mouse
dwac	wadahadal
byak	orgiga
htef	dawaarle
hfek	barwaaqoobi
dzan	rogaan
nyon	qarsoodi
zrit	diiwaankarasmigaah
pcos	ciyaaraha
hjec	dhalaalid
dlas	tirtirto
mras	dalladda
mram	macdanta
cwut	xabad
hbok	duck
swun	saabuun
dwak	caruusada
plif	Villa
slon	tolidda
tfut	hambalyeeyo
djac	heshiisiiyo
hjas	cabudhinayo
kric	bakayle
kwot	kaari
gzan	damaanad
clot	ciyaaryahan
ksek	cayayaanka
psam	Dhehana
mwut	guumaysgeesaleyda
htem	sijoogtoah
clon	violin
dzin	degan
rwim	sidayukalahorreeyaan
hyof	faa&#39;iido
dron	masduulaagii
dwit	caddaymahamaqalka
sroc	dhoofinta
hzot	joojinta
djik	hanasugina
kfik	dabool
ryun	Xeerarkii
hmes	duqa
rwac	hardware
sruk	meeshu
sros	lagatiradabadanyahay
bzan	mudaharaad
kset	orchestra
bjon	hilibdoofaar
hjut	aanxadlahayn
tfen	difaacaneysa
zwac	khasaaro
dyin	wadatashi
myis	muusikiiste
mlis	maskax
pret	filneyn
tsek	Injineerka
hlom	liin
ksos	qufac
crok	madax
flin	bacriminta
mrun	nijaar
swec	random
syuk	qaaddo
blun	buufin
tcep	jeeso
fric	cosboonaanta
rwik	vertical
rwen	kahortagga
flet	caddaymahainferential
pfac	publisher
srek	khal
tfun	tunnel
pwet	xujo
gyik	xisaabta
fwot	daadan
lwin	iskudheelitiran
jwin	beerka
bwik	kiiskasublative
hdup	maquufin
hnop	monoboli
bwic	gujis
ryen	iyadooaanlooeegin
hcem	dhulgariir
hbos	shaybaar
nrek	shaqaalaha
ryim	laxanka
nyic	fasiri
dwas	safaaradda
rwok	cadhaysiinina
kram	awoodla&#39;aanta
ksim	niyaddadeclarative
clok	shukulaatada
pcec	Shafar
nyis	biday
tyoc	beegay
grak	xoqid
zlat	gashi
hjuk	tu&#39;iyey
trif	juqraafiga
djit	nidaamsan
pson	undefined
mwis	maal-gashiga
cwec	afka
hdek	cilmaani
blik	aboodiga
sloc	cilminafsiga
brap	duugga
jlat	burcadbadeed
dros	qiyaasta
slam	salmon
pwun	daadi
gwik	magnetic
pcop	bamka
myen	sidookale
ksen	oxygen
mrap	Foreman
tfot	shahaadada
ksus	cluster
trok	hadalkiisaa
tloc	arinkii
zyan	seebabka
nlun	login
hlop	xoqad
jlin	higaada
lyut	daruurookaleah
hsof	isticmaalo
fyik	khamrada
klet	xad
hwof	safsaf
hlum	geel
myet	hiwaayadda
klis	go&#39;doomin
hbaf	Biography
gwac	dameer
hwum	belef
pwik	muuqaal
pron	pro
myes	bilkasta
mwen	undefined
kfic	vacation
klek	click
cwon	gadood
lyak	laastikada
kwon	dictionary
hjam	ham
rwon	qaansoroobaad
crip	halkan
zwan	dhaca
srok	tifaftirka
craf	jirka
tlok	taangiga
brip	balanbaalis
tfap	shaxda
jwat	mataanaha
pros	hawlgalka
psun	Fidneeyey
clet	undefined
hbus	baasaboorka
dyas	dealer
klun	raasamaal
jlit	loodhanyahay
hdom	qarow
kron	carbon
hzam	macaanka
cyot	dhegeyste
hmem	museum
lwam	alifbeetada
fras	kalafirdhiso
psoc	tasoo
hgum	xanjo
brek	jejebiyey
glit	xasiloonida
frun	qurmid
gris	dagaal
mroc	khilaaf
bzit	caaro
plut	baradho
glac	damac
gzac	tarma
prun	Lataliyihii
jlet	kalandarka
nyim	magacaabidda
tlos	trillion
slut	salad
fwit	niyaddakuraaca
pyen	codsiyada
nlon	magacaaban
dren	muujiyaan
drun	qanacsanayn
cyok	ruxday
hfop	kubadacagta
ryac	iskaashi
gzin	horyaal
hgip	kaabash
tyet	ciyaaraha
hdof	ideophone
hwup	qiimo
lwek	lever
syec	Senator
jyak	diyaafadin
mlim	qudhaanjada
fwic	waxkuoolah
gzit	uurleedahay
blas	tiirsanaanta
jrin	maalinwalba
gwak	canqowga
drik	dilalka
prif	variable
jwit	kaladuwanaanta
krip	takoorka
ryot	undefined
nwut	maraan
kcif	sifirfircoon
jrak	rihii
twek	kiiskaexessive
psot	kafaaraggud
pfon	isbonji
sluk	Dabagaale
nlim	niyaddairrealis
ksaf	yaraanta
glak	volcano
plen	hoganaya
kfaf	safaleeti
kyon	looganafaa&#39;iidaysto
jlik	dhulkaee
psop	baasaboorka
kfis	firaaqo
fyon	xidhiidhbuuna
nram	sinaysta
hbuk	buskut
gras	riyooday
hyos	Cabsadeen
flim	film
plet	kiniin
rwam	eb
blis	vanilj
zlit	qalabka
fyut	fastidious
crim	Ahraamta
hjif	sharcidarro
crif	xishood
lwap	shareerad
tyon	xiddigaha
mrim	laqdaba
drut	sharaxa
nrim	deeqwaxbarasho
kruc	qubo
kwam	lataliyaha
jrik	cricket
dlut	yeero
pyot	xamaam
dyon	qabsashada
prap	operator
bzin	calaamad
tyek	xagalka
trec	khasnajiga
nron	hydrogen
pyet	printer
tsok	ceejiya
zyin	chronic
slek	baaskiilka
jyin	injineernimada
ryas	gudbinta
zrak	helid
nyas	cayaare
gric	socdaalka
zlak	xad-
tces	tennis
hjun	dabayl
twen	dharsameyn
kyet	ururiyaha
gwit	dhabarta
kyot	gaadhay
fwin	intajeer
tfuc	gooynayaa
dlet	tusaha
pfik	fekeraya
bjet	miisaaniyadda
trek	istaraatijiyad
kros	quartz
gjit	maqas
gwic	biiro
frik	teori
tluc	shukumaan
pruc	roondo
glic	sitoos
krun	dhamaystirmo
bjin	saadaasha
tlaf	kaqayb
tfet	saaraha
bras	lateral
dwik	eedaysanaha
clec	dhammayn
cres	chess
tcef	cherry
tcom	afgembiyaa
nyot	turjumaan
tyok	truck
cyip	sarraysa
grot	khardal
bris	wireless
nlam	xaraashka
slif	shaandho
hgos	miridhku
swoc	maha
jyat	musallif
slum	Islaamka
hjes	tirakoobka
dzat	tiptoe
slun	joojin
nwot	sii
gyic	gitaar
pfas	eexda
zyik	zinc
blen	dhaldhalaalaan
hyem	Elm
hnep	boobka
nyut	knitted
ryam	calaamadeysanayaanyaalka
clim	Waxaynakeeneenuunsiga
jret	macaamiloon
tfon	foorjaynta
jwac	Java
hrep	recipe
dyac	taaso
myip	meter
rwis	jinsiyadda
hkem	dhagaxxiddig
nwon	hal-abuurnimo
zwin	ganaaxay
dyis	DrMakumbe
mrec	shimbirtu
fyot	qormo
mlon	cabiraada
pfis	ansixinta
rwot	falagiisuu
hfok	tashiilid
glof	golf
zron	eber
hzip	zip
hwom	gurila&#39;aan
bjic	calalinta
pcim	oofiya
hjip	chip
bwac	hamaansasho
mlos	jirjirroolaha
mrip	pottery
bron	embriyaha
ksoc	jaro
cyum	khamiirka
jyan	erey
plim	khudaarbulug
mwet	xabaalo
ryet	graduate
glik	waraabka
plap	raasammaaliyade
tsif	barti
gyak	shark
djon	default
nwun	wakhti
cles	xaqiiqo
dris	siikordheysa
hkef	cafe
blus	ambulance
blap	jeebka
bjak	undefined
klim	grimace
gyac	saynisyahan
jyit	lahow
dzit	macquulah
bwak	dibadda
dyot	radio
bwon	bean
fris	aanrasmigaahayn
klut	qiyaasid
tfek	steak
nrok	nitrogen
zyat	mandiil
bram	guryanta
ryis	hordhacaah
nlip	falanqeeyaan
nros	imaanayn
hcof	qaawin
tfif	niyad
kroc	qodo
hdum	Yuhuudda
pses	qaataha
plok	complement
lyet	gashto
pwek	kiiskapegative
kfas	kansarka
pwen	dhilif
nrun	waanada
clek	dillaac
pcif	vindication
glas	kakanaanta
zwit	hadalbadan
kces	filnaanshaha
crem	tafaariiqda
grap	cuskato
kwip	fara-
dyut	dhimis
crus	madaxda
gyet	Jade
gram	ilkojirriqsadaa
kyip	qorratada
nyet	suuf
crop	biyo-dhac
glon	gallon
mrok	kaneecada
fluc	fiican
dwic	weecasho
slec	sahamisa
srec	undefined
blut	legdanto
myok	humaag
tlek	fur
nruk	faafa
nwoc	undefined
bjut	idinkooGoodin
hges	uurka
twoc	raashinka
kyos	communist
mrek	yaabiyo
clip	contrition
pwok	kiiskaprosecutive
dwot	kaligii
zyac	walwalka
jlic	satellite
slop	dacas
ryip	saami
psim	qiyaas
byet	shaqola&#39;aan
cyop	hiwaayad
rwun	Faraj
blop	guluubka
syok	taageere
klos	chlorine
lwot	chloride
byic	bakteeriyada
lyik	dhegdheg
blok	noolaha
jlac	jaajuusiin
bret	byte
krif	dheecaan
blet	ballet
nruc	kaadida
tsus	toon
dyak	dabaqaddadhexe
tcem	birqaabyadii
cyoc	adag
trep	strawberry
dlun	wasakhda
hlup	album
hbep	baseball
praf	burcad-badeednimada
pwis	QAYB
grek	garaashka
kruk	eeulaha
hfof	fosfooraska
rwut	dhismaha
myam	gymnasium
krec	wiish
jras	qandaraasle
zrik	wargelin
blam	ballroom
klip	xooleed
hwef	labixin
zlac	muuska
gret	matoor
lwuk	feeraha
nyek	nickel
blos	baska
sles	faaf
tlif	leben
kses	bolse
mwot	yaanyo
lyot	auto
tsom	potassium
brut	dalwaddii
djap	algebra
hjok	generic
kfen	fikradaha
pcok	indhaha
bzut	Rer
syek	shaqola&#39;aanta
mruc	diir
bwas	browser
klif	calcium
rwet	fogeelasoodhaafaykacsan
srif	taariikhiahmidkacsan
hwem	spectrum
syom	sodium
tyos	wakiilka
jyic	afduub
hguk	ubbada
dwun	duudduub
swip	kororka
tlec	sax
blaf	kufsi
tsem	mulxidnimo
mloc	monitor
gyot	shuruudaysan
trop	baaritaankoodu
rwap	biloodle
hjep	jinsiga
pyim	platina
dlon	tiradadual
pcep	sambabada
twuk	Below
tyec	tag
syup	super
trom	gaariga
nyip	degaanka
glis	baasiin
gjik	kelyaha
hjos	joogin
hjuc	bililiqada
swek	undefined
psek	arsenic
twok	tirakoobka
tsep	koronkorrada
slos	hantiwadaag
nwim	niyaddacaddaymahadareen
tlop	marada
trus	muranka
pwot	xadhig
djot	faar
nloc	Socdo
mwon	Mandarin
hjek	jockey
crom	iskaashi
myon	pneumonia
twec	situate
ryek	gantaal
dlic	saamiga
kwet	qalfoof
bwen	jaceeylka
plon	dhulyar
syon	duurku
djis	digital
byut	jawaan
hyep	indhaha
dwon	dadab
byis	dago
brec	suni
cyec	hindhisto
hwop	watt
clus	qosol
kfun	filanka
nwum	Hinduuga
fyim	qaxootiga
cwos	Slaam
tfoc	undefined
pwon	protein
sraf	undefined
hbom	mantaggiisa
gyen	hiddo
drim	Freshman
trem	accoutrements
tsup	burburisaan
slok	cilmiga
kwoc	squash
bwam	cod-
mlok	dhaqdhaqaaqa
kyen	gobolka
hmop	mooshintaag
rwek	yallow
kfup	saaraayo
grok	karooto
drap	undefined
lwis	kelli
ksuc	xisaabiye
tsop	qurun
kyok	qajaar
nroc	orgy
jlot	dareeraha
psof	phosphate
hgif	fascinate
kfim	xumadoodu
psos	jimicsi
pfen	xaqiijinta
kcom	dhaqaaleyahan
krom	comma
tluk	wriggle
hyom	iodine
nwuc	mooshinmidmarwalba
gjac	dhicis
pcom	xilkiiguddoomiyenimo
dzic	naqshadeeye
grun	raacday
dzot	deeq
hzek	manganese
kfot	keyboard
jlas	aanlagukalsoonaankarin
lyim	kooxaha
jyen	yen
pcaf	qaws
rwip	rugby
blip	bible
kyoc	kadhaxleen
lyon	boog
flis	ereyadani
nrif	qayilaana
kfam	galmada
swes	funaanad
lwon	evolutionary
drec	dissection
gjap	HBS
lyec	toosan
tyom	midabyo
pwuk	kiiskasuperessive
flaf	Alfa
myim	difaacajirka
pcek	afduubka
bjac	warshadkhamri
bzac	abridge
bzak	sharaabad
twes	television
dwut	documentary
ksom	Cosmos
lyis	kaymaha
lwim	aluminium
ksok	horoscope
sruc	dedejiso
dlif	hoomboro
byik	dilaaga
tfec	qalabkaxafiisyada
hjaf	naasleey
ryok	maamuuska
dwis	dioxide
jlon	colon
brus	xafiiseedyada
gjak	Galaxy
lyip	caafimaad
ryem	radium
href	rarefied
prok	qaboojiyaha
slep	undefined
dret	siyaalaha
kluk	qaddiimiga
dlis	idiosyncrasy
kfip	aanlaaqbalikarin
mlec	massage
pfif	faahfaahinta
nrec	dareenka
pfet	buugyarahan
hzoc	xambaarsan
dlam	horseednimo
nlec	cilmigaaadanaha
kluc	kaheli
dyet	sedan
tyif	Transitive
krus	mujrimiintu
nluc	gabbaldayaha
lyun	ra&#39;iyi
zrot	celintiisa
ksif	sahlaya
psif	shahwaddiisu
crup	xirmi
fret	Finder
grut	invert
ksec	fasalka
jric	faahfaahin
mrop	microwave
srus	taqaluseyso
gyas	jaraha
floc	hiddaha
plek	gaddoonka
nwop	badhida
nrom	xakamaysada
twos	argagixisada
lwok	dhigyo
dwet	dheeraadkaah
slem	sublimate
grip	sol
gwas	wow
kwok	Cobalt
gwon	sareeen
hdop	mooshinNiilka
glam	futada
bwot	bovine
bren	mindhicirka
byot	video
bjik	bandowgu
kwim	kediska
cwek	hockey
grif	dhuumaalaysiga
hgem	magnesium
hyes	wacyiga
fram	farmashiyaha
nwos	undefined
ryap	Dibuhabaynta
cwim	halaynta
klep	kelp
psec	celiso
djic	dunidaoodhan
kfut	Bandowga
crep	hamburger
frim	Aragtida
gjas	shidid
hdef	debit
ryum	uranium
pluk	qiimeeyo
krop	duwo
nraf	canshuur
tyes	iskudhafan
plip	opine
hgom	gamma
hgus	Wehliyaha
cwuc	kululeeyaha
zret	gooyaan
nles	falanqeeye
trof	intransitive
hmof	Mall
hzim	bismuth
dzac	Maqaaxi
psok	kaadh
blon	wada
djet	iilataan
ksum	saamiga
mrup	microbe
clif	galool
cloc	morphological
tfes	caterer
gjis	jiinis
jren	inlays
tlep	database
kcup	coupon
glot	danab
glut	calculator
srep	cyberspace
nwes	Maal
ksef	xray
bzis	fiisada
frut	kaabayaasha
nyuk	firefly
dyik	qalabka
plec	splice
brom	bromine
plop	palladium
zlik	Silicon
flut	volt
ksop	qurxiyo
gjun	duyaarin
kfok	hingo
hpof	daangada
hzuk	zoo
nyoc	xidhiidh
jwak	yoga
brim	barium
kles	gooyay
mwam	haa
fwik	buleer
djas	jazz
dyim	audio
tsum	tungsten
drip	dayayana
lyaf	looqoro
prom	barnaamijyada
nrup	aqbasho
hfes	awtomatik
rwaf	bamam
dlen	dukumentiyada
byas	tallaalka
fron	heroin
dluk	kafurid
dyun	ogaado
flap	folder
kfet	cathode
dlim	fikradaha
prek	ladhigto
syoc	sawir
slus	helitaanka
nlos	anticlimax
mlen	sayliniyam
pres	kiliyaha
hlof	baaruud
nlek	calaamadeysanayaantacaluqahadda
gwot	garoonka
mwip	ninkii
klop	baranbaro
kwom	chromium
hl6t	liter
nwec	sikastabahaahaatee
glip	xilliile
nrop	payroll
crum	hormone
dlep	sameeysa
frot	perforate
bwoc	curyaamin
fwis	doodaa
djok	conjugate
draf	casriyeeyo
trum	xagjirkaah
graf	geynta
lwes	laser
mlem	millimeter
flen	hayalkasan
zlot	anode
swok	snuggle
klec	undefined
pwim	waqtidhiman
htuf	tuna
fyis	Warshad
lwet	dareenka
mrem	mainframe
jwic	isbedel
droc	banaanbax
clem	helium
dzik	labaluqadood
psem	plasma
hjom	koromosoom
rwuc	horsanaanta
tyus	abyoonaha
klom	kilomitir
hfos	fax
nwek	genetics
jrap	kaashawiito
zwas	qaybhoreed
bwok	broccoli
dwap	adabtarada
syem	spam
blek	dulinka
tlus	tabtii
pyif	cayimin
cwoc	hagaagi
mrep	ampere
hbem	vitamin
hxan	doorman
hxut	kabto
hk6m	cadmium
hxin	simultaneity
txin	titanium
kxin	undefined
klum	copulate
xlis	aqrisid
hqak	naxwaha
hxat	-abuurka
hxik	buuggae
hxas	goobtashaqada
bxon	boron
dxin	undefined
hxit	helicopter
tlum	tellurium
txit	xirmin
kxat	oxidize
hvik	waafajiyo
nluk	analog
nyem	centimitir
hm6t	molybdenum
hl6m	lithium
ht6t	multimedia
xlit	calorie
ryop	robot
pxas	farmashiistaha
hxak	shaqadaguriga
lwif	LOCATIVE
grim	logarithm
hqat	lugadhaadheer
qlit	ecology
xlik	sophisticate
mlep	template
hqit	shucaaca
kxim	kiilo
hxen	kiraystaha
hxot	iskabadin
kyif	copier
fwet	freeware
txet	hoosaad
hs6n	iskuxigxiga
hxet	dhagaysannoRuuxiise
xrat	xiiro
hqan	impound
hr6t	iridium
bxat	bandwidth
dxet	desktop
hxis	jibbaaranaha
hxok	xarunta
hxek	aanuqalmin
srem	cerium
hp6t	partitive
pxik	kiiskapartitive
kxet	cajalad
pruk	supermarket
hvit	geyaan
xlin	offline
frip	encryption
hvep	lacag
hxon	waafajinta
kxit	kordhiyo
hqin	seminar
tr6n	rikoodh
ht6n	guntinta
hvat	socda
sl6s	Celsius
hn6n	iyakana
ts6t	waqtigadhabtaah
hvin	loodardar
pxat	newsstand
myoc	module
ps6s	baasto
bwek	shandad
dlok	tamashlaynta
fraf	brannmur
hr6k	artifact
txat	qadada
hqon	ugdoon
pxun	plutonium
ks6n	Kundarbetsplats
slef	escalator
xrit	xeeligeeda
hvut	buux-
xrim	yttrium
hx6t	hadalada
hqum	username
hl6n	iibiya
gron	argon
pxan	xayaysiis
hvac	dhaqa
xlan	Caalamiyeynta
txon	Milanello
xrik	recycle
hxap	boorsada
hxac	qeybtiilabaad
xyat	hepatitis
cwep	jeegaaga
hxos	torus
txif	typeface
qlat	realtor
txot	bartamihiidayrta
hxam	milligram
pxis	pixel
pwif	Falanqeynta
txam	tantalum
myek	thermodynamic
hbop	jejebiyeen
hqot	solute
xlic	wheelchair
gxit	xasuuqa
hvan	demineed
glim	gallium
pfop	arbushinilaa
hzum	zirconium
xlon	hotline
qlin	Fansaarada
kxam	scandium
blim	beryllium
kxik	reserved
nr6n	neuron
hpef	predicative
hruf	router
kxan	factorial
hxic	xeerka
xlip	laliska
dyek	Debug
hxop	wristwatch
qrot	neutron
nwip	niobium
hs6t	musqulaha
grem	germanium
tles	metalloid
hp6k	kiiskaprolative
qyin	noole
txak	antibiotic
mlun	joojin
txan	actinium
xran	cir
dres	decompress
tr6t	leeska
hk6t	octet
hxus	ilfuran
xlat	crackpot
mraf	marathon
ts6n	gugabartamaha
ht6s	autism
nlif	ionize
txut	notability
hm6n	emitting
kxis	farshaxankaclip
xrin	qaliin
xren	dhidbidda
bxak	bookmark
pfos	weedhapro
hvis	saxarada
hd6n	hooseeyaha
brum	shaqadaagaasime
hqis	genusnormer
hk6n	ururiso
xyit	muhiimkaaheeshaqada
xyin	midlabaad
hxun	isada
hvas	doorarka
glok	blog
hvak	meandering
pxit	ciwaankaIP:ga
hvet	udhaw
xram	safflower
hc6n	obviousness
qran	Quraanka
zyen	xenon
hqas	dhaaranayaa
bzas	blase
hj6n	aadanahanon
hnof	nonremittal
txas	sameeyayaal
hbum	Budhiism
ts6s	murmid
pxin	maaddooyinka
hr6n	raashinka
hxim	bartamihiixagaaga
dxit	bartamihiiqaboobaha
hxaf	kabxid
nlus	houseplant
txap	xaaladdabar
vrit	ghostwriter
kxak	Doqonagagaarka
bxin	jirkaaadanaha
hqik	raincoat
hxes	Hertz
hxif	hypnothize
xras	saacadoodba
pl6k	maxadyada
dxat	rashness
hxip	antibody
vrat	gaab
hqek	eedeega
qrit	polarity
pxot	boosto
hxom	mailjunk
hqic	Falanqayayaasha
lwun	Jeanbuluug
hp6n	koriinkedu
dxan	lifaaqaya
xrak	dooractor
dxak	shil
hven	weelasha
mwap	stripmaadda
qlan	midabkaindhahala&#39;
xros	dharka
srom	macradka
hc6t	sheekaynta
qrat	foorari
hn6t	Iscelin
hqet	website
fres	lacag
froc	dhidbey
xlak	HyperLink
vlat	volubility
dvan	shek
gxin	guulaysanaya
ryes	dhaweeyaha
kxot	Xidhiidhiyayaasha
xyan	xadaynta
vlan	xayeysiistaha
ryom	ebthorium
hluf	da&#39;
hquk	durto
lyum	thuliumlaeb
tyem	terbiumlaeb
hp6m	praseodymium
txic	pageguriga
mros	Darawalka
dyam	rhodiumlaeb
pc6n	tiradamaxkamad
nyos	mailkooda
pyek	borojektar
kxon	krypton
hxuc	badbaadinta
qrik	kiiskawadaaagin
xwin	kasbay
kxic	bakhtiiye
hvot	Xaashidagigan
dxot	yogurt
hqut	kabax
pxen	waaxeedyada
drok	keebkagool
flon	telefoonkagacanta
txos	codkadhexe
hqok	kiiskauugu
xwik	kiiskabukaanka
hx6n	prehodiernal
txik	fartamurdisada
hqen	diraha
mlap	furin
hvun	suasion
hvon	duugoobin
vran	mailside
pfes	professor
pwip	Abwaan
hqam	shaqeeyaan
gxat	sharcinimada
ks6t	sababaya
vrin	qore
kxip	guddigaclip
sr6n	Kalinimada
vlit	sameyaan
tyup	xaafad
mrom	morpheme
xron	headphone
gxak	qaali
hrof	farasqoriga
xlas	curyaan
dzet	redecorate
txac	wareejinayn
xrot	aanlaisticmaalin
txis	dhibicfurta
syif	unugyadasi
xrac	yaab
brif	qiimahabinary
dlos	kiiskamodal
txun	sifooyinkaa
dvat	xunhagaajiyey
psom	gacantauguhoreysay
gjek	kalehaddii
nlem	unitofmass
qret	dukaankatafaariiqda
txip	dhibicxaafuun
dlek	gaarah
lwut	socodkahadda
dxis	fideen
hs6m	cesium
vlak	railcar
hn6m	netium
kxap	kartoonada
bxan	fogaadaan
myem	bishaMay
gxik	xuquuqdamadanigaah
hxoc	ciidankacirka
xrok	booskaas
kr6t	shaashada
txok	sitoosah
hxep	skeidgareeyo
srop	smartphone
pxak	saftayquful
hk6k	musicdad
hl6k	eulerstirada
pyom	ebPolonium
xyam	ebthallium
hvic	duulay
lyok	kiiskaLOCATIVE
xlot	guryaha
txen	restatement
kxac	counterattack
qrak	strikebreaker
hbup	barkaddadabaasha
txuk	circuitgaaban
tsef	tapered
bxit	webciidankii
ksem	akhriookaliya
byim	ebrubidium
hvam	vanadiumlaeb
lw6n	lanthanum
frum	ebfluorine
nyom	neodymium
mlom	tiradamultal
kxas	shakhsiyeeyo
xret	terabyte
hs6k	searchengine
frus	xagta
gxan	Galaxyjinsiga
vlas	vocalizations
glet	baydalkagaaska
hvim	Runtime
bxip	bitmap
qrin	xiddigajinsiga
bvak	kiiskaabessive
pxon	aheyn
dvik	kiiskaadessive
dvek	kiiskaagentive
hlef	keebkawakiilka
kwek	inkiiska
kxen	caadijinsiga
ht6m	foomkayeerida
tsuf	nidaamnambarotrans
hf6n	safeeyo
tc6t	shaytoosah
gvik	kiiskaergative
gxon	qaybsanaanta
ksep	receptor
vyin	tiyaatarkamovie
pyos	codkadadban
hnef	faluguna
xwit	waxhoose
hqim	niyaddagnomic
jlak	guud
vrik	walxahafinal
qyan	unitkhayaali
kxaf	xawaarahaiftiinka
xyic	phishing
qyit	dhibicmuhiimah
hvek	kiiskaevitative
bvik	kiiskasubessive
hzes	kiiskahantiyeen
prus	viruscomputer
ples	processor
pxif	sarkaalkatirsanbilayska
dvak	kiiskalative
brun	socdaalka
tsi_k	kiiskaantessive
tyum	ebruthenium
vyak	kiiskaadoommadiisa
pxim	ra&#39;iisulwasaaraha
syum	ebstrontium
sy6n	shaki
hy6n	nooleynjinsiga
pxac	farxadfahmadna
vlin	jinsigagaari
qwin	jinsigamacdanta
hr6s	gudbinta
tf6n	toner
xris	interfaceuser
hw6n	dhaarinta
xlen	magacafkaah
pyec	isbiriidhshiit
vlim	xusuustadalwaddii
bres	eraygiiprocessor
hqip	daruurKombuyuutarada
vlic	mashiinkadalwaddii
pfam	spammer
dyap	luqadlabaad
txek	xididnth
dxen	macdantaxogta
byip	qofkaganacsiga
hs6c	iskalsoonida
txim	tilmaamayaa
hb6t	isbedelkadhacdada
hdem	magacadomain
dxon	Haddiiaydhacdoookaladuwan
lwaf	flashdrive
sl6t	crastinalkacsan
xyik	diskkumbiyuutarka
fyif	codkaawtomatik
bvin	koonkanjinsiga
hm6p	motherboard
tfip	Transitivefal
jlen	degaankajinsiga
xrap	xariijimo
tc6n	jinsigacilmi
sl6n	farshaxankajinsiga
xrek	keebkabukaanka
xwan	aanlataabankarinjinsiga
dxif	muuqaal
dyip	hadalaantoosahayn
zrek	kiiskaexocentric
hvuk	fidinshubhooyin
xwat	hagaagsaneelasoodhaafay
hr6m	rhenium
txaf	qarxiyeen
hmef	falaanahayn
tx6t	editorqoraalka
txes	magacwadareed
bvat	uladhaqmaan
bvuk	kiiskaabsolutive
ry6t	raadiyan
vlis	xaqiiqadadalwaddii
qren	Planetaryjinsiga
gvak	kiiskanaxwe
bxok	bidaarta
mrum	barnaamijcomputer
ps6t	nidaamkahawlgalka
hfom	phoneme
tlem	akhrixasuustaookaliya
pwam	spyware
kfif	benefactivecore
qwit	galnnimada
nlaf	rakibidda
nwok	kiiskaisraacinayo
dzas	dissatisfy
swuk	kiiskasedaxaad
syos	koobaya
kr6n	haddakorontada
dvin	walaxjinsiga
pxom	niyaddapropositive
vris	codkaisdhaafsi
rwos	buufis
dr6t	distractor
ht6k	isgaarsiinta
slaf	shabakadahabulshada
lyuk	burburinxigta
qras	Madaxdannadii
ty6n	teminal
gwet	ugudhakhsahabadanmustaqbalkakacsan
hp6s	codkaapplicative
tsof	codkaantipassive
ht6p	dhinacacontinutive
hn6f	niyaddanecessitative
pfip	QAYBdadban
glap	toolbar
sy6k	laguburburinkarojiritaanka
qyat	xooggaiskaIftoYuuna
hy6t	waxnaxwe
vyan	ugaga
sluf	tiradasingulative
dvit	durationxad-dhaafah
qyak	halfaltallaabo
bzik	physics
xlet	degreesedaxaad
hqap	QAYBjoogo
qwat	qadarooahwalaxda
qyik	walxahaconnective
sr6t	dheecaansupercritical
hfem	morphemeepenthetic
tl6t	mustaqbalkafogkacsan
mrif	makarafoonka
pcuk	kiiskapostpositional
tfim	helitaankarandomxasuusta
fwim	ethium
ly6t	heshiiskaallocutive
hvap	barkitaab
hfep	dhinacafrequentative
bvan	yaalkafurfurista
fyun	sabayntirodhibic
xyas	tirtiro
hvif	falaffix
xyis	QAYBdadbaneelasoodhaafay
tl6n	unitprocessingdhexe
tfok	kiiskajihoLOCATIVE
qwan	Su&#39;aalahaBadiyaLaWeydiiyo
