ni	infinitiv
na	nominativfall
ka	ackusativfall
ta	ämnefall
ca	Hallå
wu	vokativfall
kcah	hungrig
ti	genitiv-fall
ci	adjektiv
wa	och
mi	mig
sa	dig
nyah	oss
ya	Det
ma	destinationfall
yi	dativfall
li	Realishumör
tu	deontichumör
cu	villkorlighumör
si	epistemiskhumör
yu	instrumentalfall
nu	interiörsammanhang
pa	personsammanhang
tyah	huvudsats
la	beroendeklausul
fa	perfektivaspekt
ki	dåtidspänd
ne	maskulinkön
mwah	comitativefall
ra	presenteraspänd
pwah	benefactivefall
swih	essivefall
no	Negatorykvantifierare
pi	ytasammanhang
da	adpositionalfall
te	platsfall
to	utrymmesammanhang
ga	sättfall
ri	frågandehumör
ba	ocheller
ku	exeller-eller
so	källafall
pwih	ablativfall
ksah	anslutning
tsah	demonstrativ
ko	klausul-tail
pyah	men
wi	universellkvantifierare
ji	femininkön
pu	flertalantal
bi	framtidaspänd
co	socialsammanhang
me	imperfectiveaspekt
klah	det
twah	relativfall
twih	SLUT-fall
di	direktivhumör
tlah	valfrikvantifierare
kyah	vad
tcah	frågaord
ja	copula
cyah	person
clah	andra
do	antal
tlih	bestämdkvantifierare
se	tidsammanhang
myah	timligfall
tyuh	endast
tcih	MANANDEhumör
tyih	retrospektivaspekt
lo	volitivehumör
cwah	efter
nlah	oförytterligbesittning
nlih	omistligbesittning
cyih	deliberativhumör
lwah	perlativefall
pfih	progressivaspekt
tsih	här
ce	undersammanhang
pcah	också
lwih	delativefall
swah	semelfactiveaspekt
nyih	neo
fu	fokus
plah	kärlek
po	paucalantal
kyih	därföratt
ksih	orsaksfall
gi	namn
tfah	rättsubstantiv
crih	synligbevis
kceh	bättre
dwih	desiderativehumör
wo	ord
srah	framtills
tweh	terminativefall
nwih	inessivefall
pcih	nödvändigthumör
crah	tro
ro	angesammanhang
cwih	hoppas
kwih	factivebevis
fi	kommatillbaka
psih	OPTATIVhumör
tseh	potentialhumör
lweh	allativefall
nrih	antropiskakön
tceh	sammaämnemarkör
re	olikämne
croh	rädsla
mrah	förstå
cyuh	tvivel
twuh	tvivelaktighumör
myih	vacker
lyih	intressera
flah	kontravillkorlig
we	Vialisfall
clih	kall
pyih	fred
su	bortsettfrån
kwah	önskan
le	längd
bo	sannolikhet
mlah	problem
syah	leende
slih	sova
zi	citerade
twoh	quotativefall
mo	inclusiveperson
kcih	snälladu
rwih	BEDJANDEhumör
mrih	artigregistrera
rwah	blivandeaspekt
cyeh	undra
go	gnomicaspekt
tsoh	respektera
za	inchoativeaspekt
jwih	jussivehumör
mwih	toleranthumör
sloh	framgång
prih	privat
de	distributivfall
tcoh	smärta
ryah	skratta
mlih	klok
ye	possessivmarkör
ke	commissivehumör
creh	fåfäng
mweh	completiveaspekt
nrah	värma
nroh	ilska
bwah	trots
trah	stolthet
mroh	moralisk
slah	hälsa
syih	social
pe	upphörandeaspekt
krih	nyfiken
tfih	intensifierings
fe	slutligen
prah	åtsidan
trih	bevis
nwah	bevisfall
srih	ledsen
zo	Zoickön
nweh	eventivehumör
cwoh	sammahändelsemarkör
plih	multiplikativfall
dwah	önskad
kcoh	trött
drah	nöjd
lu	spekulativhumör
frih	bekantregistrera
frah	sårad
mruh	lura
djih	sympati
krah	tacka
cruh	skam
fyah	frasmarkör
ryih	förutbestämda
kruh	bitter
tyeh	text
kreh	grym
tleh	hesternalspänd
kfah	offra
dyih	hat
cloh	rationellkön
nloh	njutav
psah	förtvivlan
sleh	vegetalkön
nruh	oskyldig
drih	beundran
sroh	förlåta
brih	bas
kluh	förvirring
bwih	välsignelsehumör
klih	skyldig
grih	okunnig
nyeh	initiativfall
nleh	ödmjuk
dlih	försenadnödvändigt
proh	rapporteradbevis
mloh	melankoli
du	singularis
jrih	tålamod
freh	referential
kloh	ensam
kroh	charm
tcuh	entusiasm
kcuh	induktivhumör
xa	samtalasammanhang
nreh	nervös
pseh	aspekt
ge	ombud
mu	förmaninghumör
byah	ambition
pcoh	fulltmedfolk
treh	direktbevis
yo	orolighumör
cwuh	chock
tloh	nyligendåtidspänd
dlah	bestämdartikel
cluh	ful
myuh	humör
dyah	distalademonstrativ
rwuh	svartsjuk
troh	FÖRBANNANDEhumör
dzih	likgiltighet
swuh	assumptivehumör
bzah	skoj
gwih	nämligen
dloh	hodiernalspänd
dweh	delimitativeaspekt
kweh	exklusivperson
truh	temperatur
tfeh	Telicaspekt
lyeh	atelicaspekt
ru	hindrandehumör
kfih	barnslig
cyoh	misstänksam
nluh	lojalitet
cweh	fälla
nwoh	animerad
sruh	spänning
ksoh	sexuell
lyah	lat
mreh	momentaneaspekt
pceh	ångradesig
bjih	föredettadenavlidne
pcuh	osäkerhet
xi	vanligaspekt
blih	bunden
tsuh	trivial
fwih	majestätisk
grah	smickrande
brah	godtycklig
cleh	välvillig
sreh	formellregistrera
pfah	välgörande
droh	auditivbevis
flih	inferentialbevis
sweh	sublativefall
ksuh	deklarativhumör
pleh	privilegierad
psoh	oövervinnerlig
be	verbal
mwoh	dagdröm
kleh	elände
glah	girighet
kseh	jakandehumör
zrah	missnöje
dyoh	idiofoner
syoh	awed
gwah	överdrivenfall
zlih	irrealishumör
zrih	blyghet
byih	anpassning
ryeh	pronomenmarkör
fwah	sparsam
bjah	extatisk
kxah	jämnmod
gvih	pegativefall
pxih	rättfärdigande
xrah	löperut
tfoh	hädanefter
kxih	ånger
ryoh	prosecutivefall
qyah	upptagenhet
r6	particip
txah	avlägsendåtidspänd
xrih	historiskspänd
dxah	dubbelantal
syuh	super
vweh	överarbetad
n6	sensoriskbevishumör
bweh	besatthet
xlih	munter
txih	sting
sluh	självnöjd
txoh	rörelseuppför
xe	retrospektiv
pxah	snärja
vwah	rörelseutför
xyih	elit
fleh	varieradlutning
psuh	superessivefall
syeh	satyr
qi	transitiv
xruh	krypaihop
zwah	Wow
tr6h	rörelseuppförfloden
qwah	oambitiösa
xlah	runtomivärlden
tyoh	intransitiv
tluh	anticlimax
qa	nuvaranderelevansmarkör
kxoh	hundentrött
rwoh	ordningstal
ve	vektor
kyoh	kilo
swoh	sekventiell
pxeh	partitivfall
txeh	augmentative
dxih	predicative
pxoh	prolativefall
pfoh	profras
blah	blasé
fyih	ickemänsklig
xo	skådespelareroll
pc6h	rättegångantal
greh	centreradfall
groh	målavtryckare
dxoh	mittenröst
rweh	snedfall
xwah	patientfall
xu	prehodiernal
xroh	slitaut
ks6h	orsakande
vi	binary-värde
dleh	modalfall
gjeh	Else-om
xreh	medarbetare
lwoh	locativefall
ml6h	multalantal
gjih	galaxkön
qlah	stjärnakön
bvih	abessivefall
dvah	adessivefall
je	agentivefall
t6	ombudavtryckare
kxeh	tillfall
gxih	gemensamkön
tc6h	citatform
ts6h	transsiffra
ryuh	direktobjekt
gveh	ergativefall
pyoh	passivröst
qe	ändligverb
xwih	primärobjekt
myoh	gnomichumör
vrih	slutligpartikel
va	evitativefall
bveh	subessivefall
dxeh	besattfall
dvih	mulativafall
tsa7h	antessivefall
dyeh	adverbialfall
mleh	animerakön
pfeh	empatheticglädje
xleh	fordonkön
qlih	mineral-kön
xloh	verbalsubstantiv
dreh	andraspråk
bvah	självförtroende
qrah	ändraavhändelse
fo	olikhändelse
sl6h	crastinalspänd
fyoh	reflexivröst
bxih	universumkön
jlih	transitivverb
kyeh	lokalitetkön
txuh	forskningkön
s6	konstnärligkön
preh	patientavtryckare
sr6h	abstraktkön
nyoh	indirekttal
zreh	exocentricfall
kfeh	dåtidperfektiv
jo	opersonligverb
kxuh	kollektivsubstantiv
bu	absolutivefall
qrih	planetkön
kfoh	kärnabenefactive
kwoh	associativfall
pluh	superlativfall
jrah	elektrisknuvarande
glih	livlöskön
p6	propositivehumör
vrah	ömsesidigröst
lyuh	påvarandraföljandeklausul
gleh	snartframtidaspänd
lyoh	applikativröst
ps6h	antipassiveröst
tfuh	continuativeaspekt
nr6h	necessitativehumör
pr6h	passivparticip
sy6h	existentiellklausul
qyih	lysandeintensitet
gluh	singulativeantal
kwuh	överdrivenvaraktighet
xyah	endahandlingverb
vlih	superlativgrad
djah	presenteraparticip
m6	beloppavämne
ti7	connectivepartikel
f6	epentheticmorfem
tli7h	avlägsenframtidaspänd
si_	postpositionalfall
l6	allocutionavtal
k6	frequentativeaspekt
bzih	distributivpronomen
tu7	flyttal-nummer
vo	verb-suffix
ki7	dåtidpassivparticip
ta_	locativeriktningsfall
