hnit	nauni
hnak	nominativekesi
hkak	accusativekesi
htak	madakesi
hpap	baba
hmam	mama
hyat	wazazi
hcan	hodi
hwik	vocativekesi
hsuc	babu
htat	grandparent
hcac	njaa
hnik	genitivekesi
hcit	kivumishi
hwan	na
hman	mimi
hnan	wewe
hwam	sisi
htit	ni
htac	marudiokesi
htik	dativekesi
hyit	realismood
htim	deonticmood
hcut	mashartimood
hsit	epistemicmood
hyak	instrumentalkesi
htan	mamboyandanimazingira
hpan	mtumazingira
htin	kifunguhuru
hyan	tegemezikifungu
hfap	perfectivekipengele
hkat	sikuzanyumauliopo
hnin	masculinejinsia
hmak	comitativekesi
hnat	sasauliopo
hpak	benefactivekesi
swik	essivekesi
htut	negatorywatakwimu
hsan	usomazingira
hpin	adpositionalkesi
hwin	eneokesi
hkan	nafasimazingira
hnac	njiakesi
hyut	interrogativemood
hnam	naau
hkit	kipekee-au
hsuk	chanzokesi
hpik	ablativekesi
hcat	ukaribu
hmat	demonstrative
hkuk	kifungumkia
hlan	lakini
hsut	zote
hyin	wotewatakwimu
hcin	kikejinsia
hpac	wingiidadi
hyik	moja
htic	yao
hkik	ambao
tcat	baadayeuliopo
hsin	kijamiimazingira
hkac	lini
hmip	imperfectivekipengele
klan	kuna
hlak	jamaakesi
hlik	illativekesi
htam	agizomood
hlat	electivewatakwimu
hkam	nini
hwat	swalineno
htap	copula
hpat	mtu
nyan	kiume
hkas	naweza
tcan	wengine
hnuc	idadi
twit	assertivewatakwimu
hsak	wakatimazingira
htuk	mudakesi
htun	tu
htum	hortativemood
hyip	retrospectivekipengele
hlit	volitivemood
pcic	lazima
tyut	mbili
hsat	ona
hkut	kujua
hcic	chini
hcap	baadaya
hpam	kwanza
hlac	alienablemilki
hkap	kamwe
hnic	inalienablemilki
tyat	umriwa
tcit	taamalimood
tcin	siku
hlam	kuja
hwak	vowel
hkin	kwenda
lwak	perlativekesi
hpip	maendeleokipengele
lyan	mudamrefu
hsac	kusema
kyan	jinsi
htas	tena
hsic	hapa
hcik	kufikiri
hcak	chiniyamazingira
hfan	kupatikana
hsun	mkono
hyac	pia
nwan	vijana
tyit	dhidiya
tlan	mungu
twak	delativekesi
hmin	kitu
hyas	maramoja
hlap	semelfactivekipengele
kcac	kushoto
hyic	msumeno
hcas	nyumba
hwac	dunia
tyin	tatu
hnun	mamboleo
hcuk	lengo
pyan	upendo
hsis	daima
hyam	usiku
hyap	mfalme
hkic	katiya
hmas	akili
cyit	moyo
pluc	paucalidadi
kyik	kwasababu
ksak	causalkesi
tcun	done
hnim	jina
tsan	sahihinoun
klac	nchi
hpun	aliuliza
cyat	inayoonekanaevidential
pcac	bora
hmac	wakati
hnas	hawawezi
hwic	maji
twim	desiderativemood
kwan	mwanga
tlat	neno
tyan	mlango
hsas	asubuhi
syat	mpaka
twik	terminativekesi
hpit	nyeupe
pcan	fedha
hyis	maskini
mwan	kifo
hfam	fomu
nwik	inessivekesi
kcat	pamoja
tsac	maranyingi
pyat	rafiki
psan	nusu
hpim	muhimumood
hyuc	pandezote
hfat	alimtuma
hcis	mke
kcan	kuamini
hsik	umma
htus	halimazingira
hpas	mwana
clat	watoto
tyak	hivyo
cwan	matumaini
syin	wapenzi
hkuc	juu
tyac	kusoma
syit	mji
hlic	tayari
hfit	factiveevidential
tcac	msichana
hcun	kusikia
ksan	angalau
hyaf	labda
kyat	hakika
tcic	mwili
hwit	kurudi
cwat	hewa
hfaf	sheria
hput	kusaidia
lyat	barua
ksas	nne
hpic	optativemood
hfuk	moto
hcam	saa
twat	vita
kyak	kadhaa
tlit	pili
pcin	nyuma
hmut	waliopotea
clan	elfu
hfac	familia
twan	nafsi
hwas	swali
syan	ukweli
htis	maamuzi
tsat	uwezomood
lwik	allativekesi
nyin	anthropicjinsia
hfak	tano
tcak	sawasomomarker
htuc	tofautisomo
hnap	jibu
hmit	bahari
hcuc	hofu
pcat	kuelewa
syas	suala
hcaf	shaka
twut	dubitativemood
hkis	nyeusi
tlak	kuleta
hyus	nzuri
nyit	aina
htip	kumi
ksis	hadithi
hpuk	kitabu
hlin	umeme
hkun	akaunti
lyas	maslahi
lyit	kuandika
pwat	kitanda
hnis	umri
hnut	counterfactualmasharti
slas	sanaa
hwis	vialiskesi
pyak	kaka
lyin	mstari
tyas	meza
hyun	mto
kyac	jicho
tfan	ghafla
kcin	kina
hmuc	madhumuni
cyac	damu
hmap	kufufuka
tlin	baridi
hyif	mbele
tyam	marehemu
hnaf	kudhani
hkip	karibu
myan	yangu
tsin	maarifa
hkup	nakala
hsam	mume
hlis	sita
cwit	hai
cyan	amani
myat	kumbuka
tyic	asili
hfut	kuanguka
swas	huduma
hsap	isipokuwa
pcit	hatimiliki
hyim	jeshi
kyas	farasi
plic	baadaye
pcak	magharibi
hpis	kulipa
hyuk	nyekundu
hwun	dhahabu
twin	hamu
plan	kucheza
hpus	ofisi
syun	serikali
kyic	kanisa
htaf	nguvu
hlun	urefu
kyin	kampuni
kyis	karatasi
mlan	uwezekano
hcim	hasa
cyas	kubeba
twac	dirisha
nyat	uzuri
hcus	mwisho
htup	wajibu
htif	umbali
pyas	mguu
hlas	porini
ksin	kijani
hmaf	shida
myac	tabasamu
hsim	usingizi
kyit	alinukuliwa
kwik	quotativekesi
fwan	ziara
slan	kufuata
psit	uwepo
hmic	tamu
hmuf	kinywa
hfin	tajiri
tcam	adui
psuk	iliyovunjika
kcap	meli
pwan	umojamtu
hfic	ushawishi
tcuc	itaonekana
hkim	siri
pyin	tafadhali
pwit	precativemood
pyit	politekusajili
cwak	mabaya
myak	maandamano
tcas	maeneo
hlaf	kukaa
psat	badala
nlan	bluu
psac	haiwezekani
kcuk	shule
kcit	ndoa
kcak	chakula
syis	ishirini
tlac	utulivu
hcip	wanaotazamiwakipengele
kwin	kutoa
tsit	kusimamishwa
pyac	lugha
hsus	wiki
hcup	ukumbi
cyap	ajabu
tfin	aliyezaliwa
fyat	mahakama
hnip	gnomickipengele
tsak	heshima
tlas	thamani
syuc	mti
plat	ukuta
cyak	mbinguni
twip	inchoativekipengele
mlat	amri
swit	jussivemood
mwas	mwezi
hwaf	kamilifu
tyap	uzoefu
ksac	mazingira
syac	safi
hnuk	duke
kwak	kufunikwa
tyuk	mashariki
pwac	jiwe
hkif	vyeo
nyac	mwelekeo
cyis	kiti
tyuc	kusubiri
tsun	kijiji
tyik	kukubaliana
hnum	permissivemood
slak	mafanikio
tsic	kujaribu
slat	kilima
hmik	muziki
hkus	kilio
hsip	saba
hpaf	binafsi
nwas	habari
tfac	eneolatukio
fyan	bustani
cwas	kuanza
hfik	distributivekesi
lyac	kujifunza
syik	kisiasa
clin	henry
cyin	uongo
tsas	kutupwa
cyik	mamlaka
tlap	sakafu
cyam	majira
tcut	dini
tcap	kutoroka
hlut	mwandishi
pyun	brown
tcuk	maumivu
swan	spring
hmun	laini
kyun	kona
nyak	alamayabiashara
tsis	haki
psas	kuzalisha
cyaf	kicheko
hwut	kusahau
hyup	Ulaya
hwap	nane
psak	kupita
kyap	kutisha
pyic	required
hmim	kati
hsaf	pumzi
hmis	busara
hsum	kutochukuamarker
ksat	mazuri
ksit	kaburi
tsap	kisiwa
kyam	kambi
tcum	kugusa
cyun	bahati
psic	pwani
tyun	uwanja
mwit	commissivemood
tlut	shahada
myit	baridi
kfan	mwenendo
slac	mbio
myin	dakika
tyip	kusababisha
klas	kioo
pfat	bodi
cyic	bure
swam	mambo
syam	salama
tsut	daktari
hlip	completivekipengele
kcas	giza
nyun	joto
hpuc	kunywa
tlam	mfano
hfun	hasira
tsik	licha
tsam	mojakwamoja
hmup	kofia
klak	mbwa
slin	fedha
swac	mtumishi
kcam	kiburi
pyik	treni
myut	maadili
syak	kuingia
swat	upanga
kyuk	mashambulizi
clac	afya
tyaf	aya
swic	kijamii
tfit	refund
hkaf	rasmi
pcas	mtazamo
nyam	utukufu
tfat	kuminambili
pcut	wanaohusika
pwin	mvinyo
mwat	ladha
fyac	chuma
syap	kusambaza
myap	biashara
hyum	kutumia
fwak	hakimu
klat	nahodha
twap	kukomakipengele
kcic	curious
kwic	kigeni
hnif	intensifier
myun	umuhimu
tlic	hatimaye
cyuk	shingo
syut	uhuru
pfan	pande
kyuc	kavu
pcap	kando
tfak	evidential
tcik	evidentialkesi
twun	mbali
tyis	maendeleo
nyap	nyembamba
plit	jengo
hpif	ukurasa
pwic	kuikopesha
syic	kusikitisha
tsip	dhambi
syim	wagonjwa
tcis	waaminifu
pcun	benki
ksap	kukubali
lyam	mkondo
tcaf	makini
kwac	sikio
hpup	mkate
kcut	kuchagua
nwam	wanyama
hsup	Zoicjinsia
nwit	eventivemood
tcim	sawatukiomarker
tlik	multiplicativekesi
kyus	kuvuka
hmus	nene
kfat	kuthubutu
nwat	kukua
myic	mvua
hpum	uso
swut	takatifu
clis	Julai
mwun	mtindo
hfas	faili
cwac	bega
kwat	faraja
nwac	mtuyeyote
tcip	taka
kfac	nyasi
hmuk	kuteka
plin	ufunguzi
kwun	Juni
mlik	samaki
klin	mjimkuu
pfut	matiti
twam	madai
fyin	gharama
nlit	lenu
mlin	milioni
pyut	omba
hluk	uchovu
ksut	kuua
cyut	kivuli
psin	uzito
kcis	gray
pyam	jasiri
mwac	kuridhika
klam	kuwaambia
ksam	kitaifa
hfip	dhaifu
klik	bonde
hkum	mapemamnomood
clas	njano
cyuc	joto
mlac	mabaki
syip	usawa
pwak	sanduku
tcif	ncha
psip	kanuni
ksik	matokeo
tsim	msimu
flan	sayansi
pcam	inaonekana
kcun	kuzaa
ksuk	mjomba
mlit	orodha
pcik	hatari
kwas	Agosti
hluc	maarufu
klit	haijulikani
flak	ukoo
fyit	ukookusajili
lwat	msomaji
plun	kutembea
twas	marambili
pcis	kuhani
fyas	waliojeruhiwa
nlat	ikulu
myuk	kumdanganya
pfak	neema
tcuf	tisa
cwap	huruma
plac	kupasuka
pyap	kuweka
lyic	wamevaa
hcum	kelele
lwit	fasihi
tsuk	cheo
hfup	dhoruba
kcik	mfukoni
nwap	Novemba
tyim	Desemba
psaf	kukosekana
nlac	idadiyawatu
kyaf	kuwashukuru
slis	mfululizo
pyaf	ndege
mlak	mmiliki
kwut	kanzu
hwuc	mahusiano
pyis	haraka
twuc	moshi
nwak	Januari
mlic	mashine
tlis	meno
ksun	kuungua
clam	aibu
klaf	ubora
clit	pete
fyak	maneno
fyam	manenomarker
kwap	mraba
hwip	Jumapili
psis	mashairi
pwut	limeagizwakimbele
kyim	kununua
clic	mashamba
pyip	Aprili
kfap	Oktoba
psut	vitu
kcuc	uchungu
nlap	mtumwa
hsok	huru
htet	Nakala
hbat	mbaya
hrit	mikopo
hzit	vipengele
hpet	kuminatano
krac	kikatili
hduc	vumbi
hrik	vitendo
hron	rangi
hnus	pua
hric	kirafiki
srik	usambazaji
hten	jana
tlet	hesternaluliopo
slap	kushindwa
hban	kuvaa
hdat	kipofu
fran	kuruka
hdan	shetani
htec	hatuakwahatua
hmon	ujumbe
cran	sadaka
hran	dhamiri
hmos	waziri
nrit	nishati
hcet	chuki
hset	kituocha
hrin	mantikijinsia
hcot	kufurahia
hrip	kifupi
htep	ibada
hcif	ngozi
hrat	paa
kran	taji
hkon	ngome
tran	kukatatamaa
hmif	maili
trin	mzunguko
hgin	gerezani
hkop	kikombe
hcen	mwanachama
swin	kiraia
hrac	kilamahali
hris	desturi
hbin	kuwa
hmot	nyama
hdut	maziwa
hwen	vegetaljinsia
nran	nadra
hbac	binamu
crut	daraja
hsoc	hisa
hsom	chumvi
nris	wasionahatia
hbit	kuepuka
crin	Pongezi
rwin	malkia
hgut	kuhesabu
hdas	ngoma
hnot	hoteli
hdin	kujaza
hton	mfungwa
hdak	duka
hlet	ngazi
hson	msamaha
hgek	mashoga
hras	mchanga
hsep	Septemba
hbic	uharibifu
hlen	leseni
hcon	kutosha
hgit	shahidi
kfon	jikoni
hbak	kuuza
tlim	matibabu
hsot	kasi
kyut	kompyuta
hnen	milele
htek	maktaba
hzan	zenye
hbis	msingi
hbun	mkanganyiko
kcus	mpishi
hgat	jangwa
hwus	busu
hbif	barafu
hbot	mpira
hrut	hoja
hdit	barakamood
hdis	hatia
hjan	adhabu
plis	polisi
hgan	kujificha
hsen	msafara
nrin	wajinga
hyen	wingu
frif	Februari
hdik	ugonjwa
hnek	mpangokesi
hbam	shangazi
hmen	wanyenyekevu
hdip	kuchelewamuhimu
prat	taarifaevidential
hdet	usikuwamanane
hjit	kidole
hmoc	mahalifulani
pran	vyombovyahabari
kcec	mkoa
hken	sikuzahivikaribuni
hloc	melancholy
hrak	wafanyakazi
htes	kutazama
rwan	zawadi
hdon	kuchangia
htot	pajilauso
hnet	angel
hdun	umoja
croc	makosa
hlon	alfajiri
hyec	kondoo
hjin	uvumilivu
hrec	rejea
mran	mahindi
htos	wengi
hcos	hatua
hkoc	marakwamara
hlif	faida
clak	sukari
hjat	ubinadamu
tram	sura
hdic	disk
hkok	upweke
srat	msanii
crak	charm
hmet	email
hden	uamuzi
gran	gavana
crac	tawi
hjac	shauku
hdim	kufatamood
hcok	haraka
hyet	mafuta
pwap	bomba
trat	magazeti
tcot	jamboimara
hdoc	oh
hren	mjadalamazingira
tcon	saasitamchana
krin	cabin
plam	kengele
hnes	neva
tcen	uchunguzi
hsek	kipengele
plik	husika
slik	hariri
hfen	cent
hgen	wakala
hnon	muungano
crik	kuzimu
tcet	defective
mrat	mchanganyiko
hdam	mawaidhamood
hgac	tamaa
htoc	namnafulani
hdac	shauri
nwin	katiba
srit	chombo
hret	imara
nlin	online
hzat	tide
klic	chuo
hkek	mkia
nric	kizazi
hgic	msongamano
hgak	paka
trit	mojakwamojaevidential
tyot	mkataba
hnok	yaliyomo
crit	kutelekezwa
slen	kuminamoja
srin	Instinct
hpok	kabila
hyot	apprehensivemood
cric	makazi
hruc	rude
cwin	wanaoendesha
hzak	kuitingisha
dyit	sekta
hpec	taaluma
nras	muuguzi
hcec	mafundisho
hbut	viatu
hmec	hazieleweki
twot	shughuli
crat	Jumamosi
hkot	uwezo
hnec	mwangawajua
hwuf	mjane
cren	kumwaga
nrat	nyota
hget	mgeni
hbik	awabariki
brin	ndani
hpot	inapatikana
trac	upinzani
prac	unatokana
hcoc	mashimo
hpon	jimbo
hwim	ustaarabu
dwan	hutegemea
cwok	mshtuko
hdok	kuendeshagari
crun	hazina
hzik	mbegu
hrot	hivikaribunisikuzanyumauliopo
hket	ari
hcek	samani
hrop	kamba
mrac	adventure
byit	sikukuu
trak	mwaka
hzin	kusini
sric	sherehe
clik	uwindaji
trap	kiliberali
hrim	ukristo
hrus	princess
blat	madhabahuni
cyon	vidogo
hwep	mtandao
krat	Kardinali
tris	zambarau
kcot	kukusanya
hben	uchaguzi
trik	mlevi
kfit	kuinua
tcec	kubadilishana
nrik	uhakikamakala
grat	Kaizari
dran	utawala
hpen	awali
cluk	ugly
nrac	wapole
ryin	mafunzo
hrun	roll
nwic	inch
slit	risasi
gzat	gazeti
krot	kukata
drit	ndevu
hzis	machozi
hdap	kuminanane
sris	kihistoria
mrut	patola
nyik	matope
bran	bibi
drat	wanategemea
djan	kubwa
glat	unyenyekevu
hpoc	vuli
pras	pazia
hgot	mkutano
tret	ukumbiwamichezo
tras	kulinganisha
rwit	mpinzani
hfon	kutengeneza
klot	kocha
hmum	ucheshi
drac	mjadala
rwas	riwaya
tset	kisasi
hdot	distaldemonstrative
ryut	wivu
hwon	mwaliko
byat	kuteketezwa
flac	flash
prot	portrait
crek	kupendekeza
htok	migogoro
htop	laana
prit	imprecatorymood
hces	wanyonge
klup	klabu
hnos	mafuriko
dwin	kutojali
prin	upeowamacho
mrit	assumptivemood
tcoc	mwinuko
hcom	maelewano
grit	radi
tlot	utoto
hgik	goti
hwes	fahamu
hzac	kuheshimiana
hsec	programu
tson	taasisi
ryit	kupokea
dlin	nidhamu
slip	kuingizwa
klon	mapinduzi
hfim	mkulima
hpom	jukwaa
cyen	mwanafunzi
hgec	pango
hroc	mila
srac	kuwasilisha
ryat	janga
kcen	bikira
hbap	kuaga
krik	kukosolewa
krap	pamba
fwat	hospitali
kcet	kodi
hgas	gesi
pfin	kuepukika
dlit	jani
ryan	tafsiri
sran	mazishi
mrin	unga
hram	kimapenzi
dlan	dola
hzas	mzaha
hsos	kuminasita
klen	koloni
gyin	mrengo
hsif	simba
cluc	ujanja
prip	maandalizi
hzut	ukungu
dwat	dawa
krit	sahihisha
sras	kiota
hses	kuminanne
brat	pingamizi
flat	acid
hjic	yaani
slic	silaha
hbuc	user
tron	machungwa
byan	umwagaji
hrif	primitive
tlip	kuanzisha
blan	kikapu
kris	katibu
hyon	Wakatihuohuo
tren	leo
dlat	hodiernaluliopo
hzic	sumu
tfic	bunduki
tlen	vipaji
hlim	haliyahewa
dyat	mate
kcon	ufunuo
dlac	osha
krak	kukiri
hbas	yasiyonamsingi
hkec	makaayamawe
hrek	kurejesha
hkos	mtumbwi
hwif	makamu
tric	muda
hdep	delimitativekipengele
mwak	rundo
ksot	mfupa
hnoc	Jumatatu
nlas	Jumanne
brac	Jumatano
frap	shirikisho
pfit	mwakilishi
pcoc	pole
lyen	sanda
swak	kuzama
pcen	rais
brit	umwagajidamu
hwec	kuzingirwa
hwet	tumbo
hlos	ghorofani
hbon	mbalimbali
pcon	shaba
hsem	mkutanowakilele
lwac	nafuu
tsos	mashindano
kwen	kipekeemtu
trun	kutua
trut	sanamu
hrap	artillery
hgap	kuwakamata
trot	joto
grin	jirani
hjak	kukumbatia
hpek	pakiti
hlus	kulungu
hwos	chumbachakulala
tsuc	kichaka
pcuc	kutokwa
cris	mrithi
clun	mwaloni
hpes	unpleasant
nlet	pungufu
hrom	mpango
pyon	piano
swet	kuwashawishi
dric	asiyeonekana
tyen	vizuriinayojulikana
hruk	ukatili
frat	kupewa
hyoc	majaribu
hlep	telickipengele
nrot	kimataifa
nret	ukali
hfif	mwanafalsafa
pfic	uwakilishi
hmek	nyeti
hfec	ustawi
myik	uvuvi
truc	kuiba
tcop	mdomo
rwic	kustaafu
htom	uchumi
glan	nyumbayasanaa
pren	sambamba
hlek	atelickipengele
nrak	bara
truk	kubisha
hjim	kikwazomood
rwat	tai
hcep	kiini
dyan	yai
jrat	bandia
nren	msukumo
ksic	mgogoro
tsoc	kutafuta
lwan	chakulachamchana
hpos	pine
hcuf	kushinikiza
tcus	sue
pset	kupanua
hkep	shaba
swis	baharia
prim	kifalme
trip	mjeledi
cras	shati
swap	sweep
syet	mchoro
htof	mwizi
clen	channel
kwit	utu
klok	ziada
hrok	mageuzi
hguc	kiu
kcim	kutishia
hpem	palm
psik	msemaji
frit	kizingiti
cret	athari
mrak	mkuki
syen	kikao
tcup	uchafu
hyek	msafiri
trim	bati
plak	malalamiko
hyok	angle
hgam	ng'ombe
hmok	kinu
jrac	ramani
kloc	collar
gyit	makusudi
hbip	bia
mlet	velvet
lyap	matumizimabaya
cwen	kundi
bwan	mpwa
tses	kuminatatu
jrit	kuhalalisha
nlak	muswada
sron	shujaa
cruc	Ijumaa
broc	brush
dlot	download
krim	cream
pric	lami
prut	jury
hgon	waliohifadhiwa
sram	literally
pfot	sufuria
hlot	iliyopangwa
djin	sarafu
hlok	leap
hpep	apple
hwot	inaendelea
dlak	kujadili
brik	kujiunga
nlis	nukulu
hbet	bet
pris	virusi
hjik	ukarimu
blit	kitoto
hjap	vazi
tfik	kutafakari
hdaf	kufikia
hpop	opera
kcaf	mafichoni
kcoc	elbow
hrum	kukarabati
cyim	tuhuma
dyic	elimu
hgoc	shimo
drak	machafuko
plas	applause
byin	binary
hzap	Abbey
nlot	uaminifu
mrik	mitambo
hsop	mafanikio
crap	mtego
kyek	keki
nrut	kuwakaribisha
syes	sir
hjet	kuminasaba
hjen	kike
hmom	asali
hdec	kwabahatimbaya
lwen	legend
slot	jiko
frac	waasi
gwan	jazwa
mruk	kuboresha
swot	swamp
zlan	kulipwa
hnem	animated
hdes	dressing
prak	kuhubiri
frin	scenery
hfet	kupinga
cros	chorus
ryon	mantiki
tcos	mazao
tsen	usindikaji
hwek	wolf
nlik	kukataa
klap	carpet
dras	kumdharau
prop	rutuba
slim	filimbi
hgis	jibini
krut	kuuma
srot	kusindikiza
bjan	tanga
nwen	Navy
myas	mask
kwaf	kuendeleza
twis	teksi
pcip	kalamu
srap	mboga
sren	maonyesho
tlun	suruali
hrup	rushwa
nrip	barazalamawaziri
srup	supu
jran	upasuaji
bjat	posho
gyat	kupeleleza
hlem	reckless
srak	abstract
kson	lafudhi
cwis	Alhamisi
sret	dhati
hraf	trafiki
hres	usanifu
hsuf	ovyo
rwak	ufa
twon	pambo
hfus	ahueni
hkom	kificho
djat	wawindaji
nlut	jarida
hsef	nyoka
mris	demokrasia
bric	betri
mlam	nta
zran	kugawana
cron	thrill
hzen	kuogelea
traf	strip
cwaf	bahasha
srip	sigara
mrot	motor
swon	kujitolea
ryak	majibu
pfun	sehemu
blac	mizigo
mret	wizara
hjon	ngono
kcok	shoka
dram	diamond
kren	mbadala
tcek	echo
hdif	utambulisho
tfas	balozi
hfot	wajumbe
lwas	wavivu
hmep	momentanekipengele
kfin	encoding
mwin	imaginary
hrem	ray
pram	kupanda
byac	pishi
mren	kukumbukwa
swen	seneti
kras	jeneza
hgun	kumeza
nlok	kujiingiza
ryic	kilimo
gwin	swing
srut	meadow
hkes	tata
hfis	kujiuzulu
frak	kurudia
hnom	njama
hcop	baa
hlec	pilipili
mlot	melody
zrat	mgombea
proc	mlinzi
flik	fox
cyet	kujutia
hgim	chimney
slet	ua
tcok	usahihi
bjit	zamanimarehemu
brot	bud
bwat	blanketi
hdus	nguruwe
gwat	pembezandovu
kret	dondoo
nwet	waangalizi
jwan	avenue
nwis	misumari
mwic	nyuki
bzat	muigizaji
gyan	jasho
zyit	mtendaji
blic	udanganyifu
pcet	kutokuwanauhakika
tsot	mara
bwit	mpaka
tres	msongo
hkof	matumizi
nyen	tunaugua
hles	kufananana
cyek	gunia
hjis	sindano
gjan	jambo
prec	kuishi
drot	kudhibitiwa
kcek	Curve
twic	kuku
brak	pipa
zwat	habitual
clap	habitualkipengele
tsec	mtaalam
bwin	kumvutia
cwet	imepakana
hbek	baker
zlin	mizeituni
mron	van
drin	kujishughulisha
psap	kuwafichua
gjin	sikuyakuzaliwa
clut	nyundo
cwun	harufunzuri
twaf	yasiyonamaana
pcot	pet
krok	fuvu
dlik	bunge
cwic	bahatinzuri
srun	frown
crec	kuharibu
jlan	margin
kcip	bingwa
blin	bilioni
ryik	kemikali
mlas	mapigo
flit	majaribio
hzet	fundo
cwik	Mkuu
twet	skirt
mwik	kilawiki
tfis	kiufundi
tlon	gari
cram	kujipendekeza
grac	kuimarisha
kraf	jogoo
trup	sifa
hduk	ndoano
cruk	tiger
nrap	housekeeper
crot	barabara
mlip	wanamgambo
hfoc	picha
nres	uadilifu
plos	plus
tfam	uwazi
nlic	kuminatisa
hwok	waliohitimu
nlen	insha
fyic	ufanisi
hwuk	kipekee
hgok	kikaboni
flic	theolojia
flot	kuelea
hboc	kumlazimu
hwoc	mchawi
syot	studio
cwip	champagne
hbes	bendera
lwic	talaka
blot	bolt
cwot	uhamisho
cwam	mshipa
prik	watazamaji
hfum	povu
grik	changarawe
zrin	apron
gren	sayari
hfuc	ufufuo
claf	rafu
flas	shabiki
hjot	kitropiki
hbim	holela
krek	zebaki
hbec	wema
tsaf	kujiua
pwas	kukwanyua
plot	mwandishiwa
kfak	kutanua
blak	balcony
hdos	doa
kwis	classic
kcos	kuwashitaki
psen	pensheni
kres	kitendo
hzon	tumbili
srim	saini
glin	kusita
mlut	sifambaya
myot	kuagiza
fwac	mwanzilishi
troc	mwenge
hgaf	sarufi
hyop	yacht
ksip	haiko
sres	excursion
hnup	kuba
hzun	ukaidi
mric	misuli
gjat	ukubwa
hros	RUB
zrac	waoga
tros	toast
myus	panya
dwac	mazungumzo
byak	mbuzi
htef	tailor
hfek	kustawi
dzan	kulazimisha
nyon	bilamajina
zrit	rasmikusajili
pcos	michezo
hjec	kuyeyuka
dlas	kufuta
mras	mwavuli
mram	madini
cwut	truce
hbok	bata
swun	sabuni
dwak	doll
plif	villa
slon	kushona
tfut	kumpongeza
djac	kupatanisha
hjas	kukandamiza
kric	sungura
kwot	kondakta
gzan	kuhakikisha
clot	mchezaji
ksek	wadudu
psam	mkao
mwut	owl
htem	kudumu
clon	violin
dzin	mkazi
rwim	mtiririko
hyof	manufaa
dron	joka
dwit	auditoryevidential
sroc	kusafirisha
hzot	ukomeshaji
djik	msiweke
kfik	mfuniko
ryun	udhibiti
hmes	Meya
rwac	vifaa
sruk	circus
sros	wachache
bzan	kutulizaghasia
kset	orchestra
bjon	Bacon
hjut	ukomo
tfen	kutetea
zwac	hasara
dyin	ukombozi
myis	mwanamuziki
mlis	kiakili
pret	duni
tsek	mbunifu
hlom	lemon
ksos	kikohozi
crok	maumivuyakichwa
flin	uzazi
mrun	seremala
swec	random
syuk	kijiko
blun	puto
tcep	chaki
fric	kiburudisho
rwik	wima
rwen	kuzuia
flet	inferentialevidential
pfac	mchapishaji
srek	siki
tfun	handaki
pwet	puzzle
gyik	hisabati
fwot	fade
lwin	uwiano
jwin	ini
bwik	sublativekesi
hdup	kuzamisha
hnop	ukiritimba
bwic	manowari
ryen	bilakujali
hcem	tetemeko
hbos	maabara
nrek	mfanyakazi
ryim	dansi
nyic	kutafsiri
dwas	ubalozi
rwok	kumfanya
kram	kukosauwezo
ksim	declarativemood
clok	chocolate
pcec	upendeleo
nyis	hermit
tyoc	bahatimbaya
grak	mwanzo
zlat	glove
hjuk	kupigamagoti
trif	jiografia
djit	utaratibu
pson	hauonekani
mwis	uwekezaji
cwec	matusi
hdek	kidunia
blik	kipanga
sloc	saikolojia
brap	chakavu
jlat	pirate
dros	dozi
slam	salmon
pwun	pudding
gwik	magnetic
pcop	pampu
myen	vilevile
ksen	oksijeni
mrap	msimamizi
tfot	cheti
ksus	nguzo
trok	rhetoric
tloc	rung
zyan	kasia
nlun	Ingia
hlop	darubini
jlin	herufi
lyut	cloudy
hsof	surf
fyik	whiskey
klet	kiasi
hwof	Willow
hlum	ngamia
myet	amateur
klis	kutengwa
hbaf	wasifu
gwac	punda
hwum	uvumi
pwik	mtazamo
pron	pro
myes	kilamwezi
mwen	reverie
kfic	likizo
klek	click
cwon	mviringo
lyak	elastic
kwon	kamusi
hjam	ham
rwon	upindewamvua
crip	hili
zwan	zinazotokea
srok	wahariri
craf	viboko
tlok	tank
brip	butterfly
tfap	chati
jwat	pacha
pros	uendeshaji
psun	omen
clet	unyonge
hbus	mianzi
dyas	muuzaji
klun	mkusanyiko
jlit	usiojulikana
hdom	ndoto
kron	carbon
hzam	jam
cyot	msikilizaji
hmem	makumbusho
lwam	alfabeti
fras	kuwatawanya
psoc	ngumi
hgum	gum
brek	kuvunja
glit	utulivu
frun	kuoza
gris	fujo
mroc	msuguano
bzit	buibui
plut	viazi
glac	uchoyo
gzac	kuzidisha
prun	spin
jlet	kalenda
nyim	uteuzi
tlos	trilioni
slut	saladi
fwit	usawawakijinsiamood
pyen	maombi
nlon	majina
dren	kuonyesha
drun	kutoridhika
cyok	shrug
hfop	soka
ryac	ushirikiano
gzin	waanzilishi
hgip	kabichi
tyet	riadha
hdof	idiophone
hwup	mchangomkubwasana
lwek	lever
syec	seneta
jyak	malazi
mlim	ant
fwic	ufanisi
gzit	wajawazito
blas	utegemezi
jrin	kilasiku
gwak	kifundochamguu
drik	oddly
prif	kutofautiana
jwit	utofauti
krip	ubaguzi
ryot	kunyenyekewa
nwut	sidewalk
kcif	kikamilifu
jrak	frog
twek	kupindukiakesi
psot	upatanisho
pfon	sifongo
sluk	squirrel
nlim	irrealismood
ksaf	uhaba
glak	volkano
plen	msawazo
kfaf	skafu
kyon	kunyonya
jlik	kijiolojia
psop	pasipoti
kfis	nafasi
fyon	mshikamano
nram	kinyumechamaadili
hbuk	biskuti
gras	maono
hyos	apprehensive
flim	filamu
plet	kibao
rwam	chembe
blis	vanilla
zlit	misaada
fyut	fastidious
crim	piramidi
hjif	kinyumechasheria
crif	shyness
lwap	kinanda
tyon	elimuyanyota
mrim	maze
drut	maelezo
nrim	udhamini
kruc	kobe
kwam	mshauri
jrik	kriketi
dlut	kuashiria
pyot	mbaazi
dyon	kukabiliananahali
prap	operator
bzin	beji
tyek	pembetatu
trec	mwekahazina
nron	hidrojeni
pyet	printer
tsok	hulisonga
zyin	sugu
slek	baiskeli
jyin	uhandisi
ryas	maambukizi
zrak	mahitaji
nyas	dancer
gric	uhamiaji
zlak	kukiuka
tces	tennis
hjun	windy
twen	weave
kyet	ushuru
gwit	mgongo
kyot	chord
fwin	mzunguko
tfuc	kufungwa
dlet	directory
pfik	thinker
bjet	bajeti
trek	mkakati
kros	quartz
gjit	mkasi
gwic	kubadili
frik	kinadharia
tluc	kitambaa
pruc	doria
glic	glacier
krun	ukamilifu
bjin	utabiri
tlaf	kushiriki
tfet	watengenezaji
bras	lateral
dwik	mshtakiwa
clec	kutoleanje
cres	chess
tcef	cherry
tcom	mashaka
nyot	translator
tyok	lori
cyip	inapita
grot	haradali
bris	wireless
nlam	mnada
slif	ungo
hgos	kutu
swoc	unsteady
jyat	bankrupt
slum	islam
hjes	sensa
dzat	njongwanjongwa
slun	kuahirisha
nwot	mwendelezo
gyic	guitar
pfas	upendeleo
zyik	zinc
blen	shiny
hyem	elm
hnep	kinyang'anyiro
nyut	knitted
ryam	pronounmarker
clim	spice
jret	sharpness
tfon	tease
jwac	java
hrep	kichocheo
dyac	franchise
myip	mita
rwis	ubaguziwarangi
hkem	Comet
nwon	innovation
zwin	marufuku
dyis	medieval
mrec	shomoro
fyot	footnote
mlon	kipimo
pfis	kuridhiwa
rwot	obiti
hfok	frugal
glof	gofu
zron	sifuri
hzip	zip
hwom	wasionamakazi
bjic	kubugia
pcim	kutimiza
hjip	chip
bwac	yawn
mlos	mole
mrip	ufinyanzi
bron	kiinitete
ksoc	punguzo
cyum	chachu
jyan	jargon
plim	plum
mwet	graveyard
ryet	Hitimu
glik	kilimochaumwagiliaji
plap	ubepari
tsif	elasticity
gyak	papa
djon	chaguo-msingi
nwun	punctual
cles	uhalisia
dris	inazidi
hkef	cafe
blus	ambulance
blap	mkoba
bjak	ecstatic
klim	grimace
gyac	mwanasayansi
jyit	equanimity
dzit	kweli
bwak	nje
dyot	radio
bwon	maharage
fris	isiyorasmi
klut	kubashiri
tfek	steak
nrok	nitrogen
zyat	wembe
bram	kunong'ona
ryis	utangulizi
nlip	kuchambua
nros	zinazokinzana
hcof	undress
tfif	motisha
kroc	mitaro
hdum	Judaism
pses	mpokeaji
plok	inayosaidia
lyet	Lens
pwek	pegativekesi
kfas	kansa
pwen	pawn
nrun	kukumbusha
clek	leak
pcif	uthibitisho
glas	utata
zwit	talkative
kces	kujitosheleza
crem	Rejareja
grap	kunyakua
kwip	kuingiliakati
dyut	discount
crus	uongozi
gyet	jade
gram	gwafua
kyip	mjusi
nyet	pedi
crop	maporomokoyamaji
glon	gallon
mrok	mbu
fluc	ufasaha
dwic	kupotoka
slec	Explorer
srec	expiring
blut	kushindana
myok	mosaic
tlek	kuziba
nruk	kuambukiza
nwoc	Tangu
bjut	squat
hges	mimba
twoc	vyakulanavinywaji
kyos	kikomunisti
mrek	amaze
clip	toba
pwok	prosecutivekesi
dwot	dikteta
zyac	preoccupation
jlic	satellite
slop	slipper
ryip	sawia
psim	takriban
byet	ajira
cyop	hobby
rwun	kigezo
blop	bulb
syok	msaidizi
klos	chlorine
lwot	chloride
byic	vimelea
lyik	nata
blok	kibaiolojia
jlac	jipa
bret	Byte
krif	secretion
blet	ballet
nruc	mkojo
tsus	vitunguu
dyak	darajalakati
tcem	koleo
cyoc	changamoto
trep	strawberry
dlun	uchafuzi
hlup	albamu
hbep	baseball
praf	uharamia
pwis	Mmoja
grek	karakana
kruk	mkongojo
hfof	phosphorus
rwut	kimuundo
myam	gymnasium
krec	crane
jras	mkandarasi
zrik	kuwaarifu
blam	ballroom
klip	fundi
hwef	hazijalipwa
zlac	banana
gret	jenereta
lwuk	ubavu
nyek	nickel
blos	basi
sles	censor
tlif	tile
kses	sausage
mwot	nyanya
lyot	auto
tsom	potassium
brut	virtual
djap	algebra
hjok	generic
kfen	dhana
pcok	macho
bzut	Budge
syek	ukosefuwaajira
mruc	caterpillar
bwas	kisakuzi
klif	calcium
rwet	kijijinisikuzanyumauliopo
srif	kihistoriauliopo
hwem	wigo
syom	sodiamu
tyos	mdhamini
jyic	mateka
hguk	gourd
dwun	kasoro
swip	Mwiba
tlec	Jibu
blaf	ubakaji
tsem	atheism
mloc	kufuatilia
gyot	masharti
trop	probe
rwap	robomwaka
hjep	jinsia
pyim	platinum
dlon	mbiliidadi
pcep	mapafu
twuk	scouring
tyec	tag
syup	super
trom	kitoroli
nyip	ndaniyanchi
glis	petroli
gjik	figo
hjos	unattended
hjuc	kupora
swek	overworked
psek	arseniki
twok	takwimu
tsep	panzi
slos	ujamaa
nwim	hisiaevidentialmood
tlop	Tablecloth
trus	utata
pwot	leash
djot	mashapo
nloc	ofarlig
mwon	mandarin
hjek	jockey
crom	kushirikiana
myon	pneumonia
twec	situate
ryek	roketi
dlic	mgao
kwet	skate
bwen	obsession
plon	mgawohuo
syon	chupi
djis	digital
byut	Bitch
hyep	Eyelid
dwon	diagonal
byis	subconscious
brec	eyebrow
cyec	kuchafya
hwop	watt
clus	hilarious
kfun	occupancy
nwum	Uhindu
fyim	wakimbizi
cwos	kuhamisha
tfoc	kichomi
pwon	protini
sraf	binafsiameridhika
hbom	matapishi
gyen	jeni
drim	freshman
trem	iliyosheheni
tsup	kuwavunja
slok	sosholojia
kwoc	boga
bwam	wapigakura
mlok	uhamaji
kyen	kikanda
hmop	mwendouphill
rwek	retrospective
kfup	cube
grok	karoti
drap	kumnasa
lwis	Masi
ksuc	mhasibu
tsop	uvundo
kyok	tango
nroc	orgy
jlot	kutengenezea
psof	phosphate
hgif	sihiri
kfim	alkali
psos	gymnastics
pfen	uhakiki
kcom	mchumi
krom	comma
tluk	wriggle
hyom	madini
nwuc	mwendokuteremka
gjac	kuharibikakwamimba
pcom	ganda
dzic	designer
grun	majisifu
dzot	wafadhili
hzek	manganese
kfot	keyboard
jlas	uhakika
lyim	wasomi
jyen	yen
pcaf	mabano
rwip	mchezowaraga
blip	Biblia
kyoc	Sababu
lyon	kidonda
flis	Inflected
nrif	nibble
kfam	quantum
swes	sweta
lwon	evolutionary
drec	dissection
gjap	spa
lyec	linear
tyom	antimoni
pwuk	superessivekesi
flaf	alpha
myim	kinga
pcek	utekajinyara
bjac	kampuniyabia
bzac	abridge
bzak	sock
twes	televisheni
dwut	documentary
ksom	cosmos
lyis	misitu
lwim	alumini
ksok	horoscope
sruc	kuharakisha
dlif	dolphin
byik	muuaji
tfec	vifaavya
hjaf	mamalia
ryok	itifaki
dwis	dioxide
jlon	colon
brus	urasimu
gjak	galaxy
lyip	kliniki
ryem	radium
href	rarefied
prok	jokofu
slep	satyr
dret	iteration
kluk	archaeological
dlis	idiosyncrasy
kfip	haikubaliki
mlec	massage
pfif	vipimo
nrec	hisia
pfet	kipeperushi
hzoc	zinasababisha
dlam	walau
nlec	anthropolojia
kluc	kitamu
dyet	sedan
tyif	elekezi
krus	cower
nluc	alizeti
lyun	ion
zrot	extradition
ksif	kadhibisha
psif	chafu
crup	mwingiliano
fret	finder
grut	Geuza
ksec	classmate
jric	ratiba
mrop	microwave
srus	oust
gyas	hairdresser
floc	ngano
plek	kapilari
nwop	matako
nrom	mtawala
twos	ugaidi
lwok	kaulimbiu
dwet	nyongeza
slem	sublimate
grip	Grill
gwas	wow
kwok	cobalt
gwon	oat
hdop	mwendoupriver
glam	hajakubwa
bwot	bovin
bren	bowel
byot	video
bjik	kususia
kwim	jaribio
cwek	magongo
grif	msituni
hgem	magnesium
hyes	ufahamu
fram	Apoteket
nwos	unambitious
ryap	upya
cwim	kuegemea
klep	kelp
psec	reimburse
djic	dunianikote
kfut	amriyakutotokanje
crep	hamburger
frim	theorem
gjas	kuwasha
hdef	debit
ryum	urani
pluk	kutathmini
krop	kuratibu
nraf	walipakodi
tyes	jumuishi
plip	alitoamaoniyake
hgom	gamma
hgus	mgawo
cwuc	heater
zret	Ondoa
nles	mchambuzi
trof	intransitive
hmof	mall
hzim	bismuth
dzac	Diner
psok	Postcard
blon	muunganiko
djet	digress
ksum	mbia
mrup	kidudu
clif	helix
cloc	maumbile
tfes	caterer
gjis	jeans
jren	alignment
tlep	database
kcup	kuponi
glot	voltage
glut	calculator
srep	mtandao
nwes	mwekezaji
ksef	X-ray
bzis	visa
frut	miundombinu
nyuk	kimulimuli
dyik	detector
plec	ganga
brom	bromini
plop	palladium
zlik	silicon
flut	volt
ksop	mapambo
gjun	gromning
kfok	kwikwi
hpof	popcorn
hzuk	zoo
nyoc	connotation
jwak	yoga
brim	barium
kles	behead
mwam	yeah
fwik	firework
djas	jazz
dyim	redio
tsum	Tungsten
drip	pigachenga
lyaf	alimony
prom	programu
nrup	pembejeo
hfes	reflexive
rwaf	Chrysanthemum
dlen	nyaraka
byas	chanjo
fron	heroin
dluk	kukatwa
dyun	kutambua
flap	folder
kfet	cathode
dlim	itikadi
prek	maegesho
syoc	snapshot
slus	upatikanaji
nlos	anticlimax
mlen	selenium
pres	cortex
hlof	kiberiti
nlek	sasaumuhimumarker
gwot	uwanjawandege
mwip	mzushi
klop	cockroach
kwom	chromium
hl6t	lita
nwec	hatahivyo
glip	cyclic
nrop	mishahara
crum	homoni
dlep	developer
frot	toboa
bwoc	hujuma
fwis	masualayakijinsia
djok	conjugate
draf	kisasa
trum	msimamomkali
graf	algorithm
lwes	laser
mlem	millimeter
flen	flex
zlot	anode
swok	snuggle
klec	mbwauchovu
pwim	sehemuyamuda
htuf	tuna
fyis	kusafishia
lwet	unyeti
mrem	mainframe
jwic	rejuvenation
droc	demonstrator
clem	helium
dzik	bilingual
psem	plasma
hjom	chromosome
rwuc	makutano
tyus	integer
klom	kilometa
hfos	faksi
nwek	genetics
jrap	bisibisi
zwas	appetizer
bwok	broccoli
dwap	ADAPTER
syem	baruataka
blek	vector
tlus	mbinu
pyif	isiyojulikana
cwoc	alright
mrep	ampea
hbem	vitamini
hxan	doorman
hxut	kutoaruzuku
hk6m	cadmium
hxin	iliwezeshamambo
txin	titanium
kxin	kilo
klum	--jamii
xlis	hourglass
hqak	kisintaksia
hxat	ubunifu
hxik	ekitabu
hxas	mahalipakazi
bxon	boroni
dxin	inductance
hxit	helikopta
tlum	tellurium
txit	Tareheyamwisho
kxat	oxidize
hvik	kujipanga
nluk	Analog
nyem	sentimita
hm6t	molybdenum
hl6m	lithiamu
ht6t	multimedia
xlit	calorie
ryop	robot
pxas	mfamasia
hxak	kaziyanyumbani
lwif	locative
grim	logarithm
hqat	vunjajungu
qlit	ikolojia
xlik	sophisticate
mlep	template
hqit	mionzi
kxim	kilo
hxen	renter
hxot	overeat
kyif	mwiga
fwet	freeware
txet	subset
hs6n	utaratibuwakudumu
hxet	eavesdrop
xrat	haircut
hqan	impound
hr6t	Iridium
bxat	Bandwidth
dxet	desktop
hxis	kielelezo
hxok	Makaomakuu
hxek	misplace
srem	cerium
hp6t	partitive
pxik	partitivekesi
kxet	mkanda
pruk	madukamakubwa
hvit	willpower
xlin	offline
frip	encryption
hvep	overpay
hxon	synchronize
kxit	maximo
hqin	semina
tr6n	Stereo
ht6n	kitango
hvat	ujao
sl6s	celsius
hn6n	neon
ts6t	halisiwakati
hvin	kuhuisha
pxat	newsstand
myoc	moduli
ps6s	pasta
bwek	briefcase
dlok	deluxe
fraf	firewall
hr6k	artifact
txat	lunchtime
hqon	oregano
pxun	plutonium
ks6n	workstation
slef	escalator
xrit	lifeguard
hvut	overcrowd
xrim	yttrium
hx6t	augmentative
hqum	username
hl6n	salespeople
gron	argon
pxan	uendelezaji
hvac	Dishwasher
xlan	utandawazi
txon	wavelength
xrik	kusaga
hxap	backpack
hxac	Anzishatena
xyat	hepatitis
cwep	malipo
hxos	torus
txif	typeface
qlat	realtor
txot	katikatiyavuli
hxam	milligram
pxis	pixel
pwif	preview
txam	tantalum
myek	thermodynamic
hbop	vunja
hqot	solute
xlic	wheelchair
gxit	mauajiyakimbari
hvan	kuzimamoto
glim	gallium
pfop	popup
hzum	zirconium
xlon	jourtelefon
qlin	nonlinear
kxam	scandium
blim	berili
kxik	configure
nr6n	neuron
hpef	predicative
hruf	router
kxan	factorial
hxic	mwongozo
xlip	mpirawawavu
dyek	Debug
hxop	saayaMkono
qrot	neutron
nwip	niobamu
hs6t	choo
grem	Gerimani
tles	metalloid
hp6k	prolativekesi
qyin	viumbehai
txak	antibiotic
mlun	immobilization
txan	actinium
xran	astronaut
dres	decompress
tr6t	extraterrestrial
hk6t	octet
hxus	wazichanzo
xlat	crackpot
mraf	marathon
ts6n	katikatispring
ht6s	autism
nlif	ionize
txut	notability
hm6n	kutotoa
kxis	kipandechasanaa
xrin	kufanyiwa
xren	imetuma
bxak	alama
pfos	promaneno
hvis	kinyesi
hd6n	denominator
brum	Boardroom
hqis	chauvinist
hk6n	kukusanya
xyit	mabadilikoufunguo
xyin	mojanambili
hxun	MwanaAdamu
hvas	majukumu
glok	blog
hvak	meandering
pxit	ipanuani
hvet	karibuna
xram	katamu
hc6n	udhahiri
qran	kurani
zyen	xenon
hqas	kumwapisha
bzas	Blasé
hj6n	zisizobinadamu
hnof	noncommittal
txas	watunga
hbum	mabudha
ts6s	ugomvi
pxin	viungo
hr6n	ration
hxim	katikatiyamajira
dxit	katikatibaridi
hxaf	excavate
nlus	nyumbakupanda
txap	hadhibar
vrit	ghostwriter
kxak	kumdanganyakuzunguka
bxin	binadamu-mwili
hqik	raincoat
hxes	hezi
hxif	hypnotize
xras	hourly
pl6k	msaidiziwawanasheria
dxat	papara
hxip	antibody
vrat	kaptula
hqek	reshaping
qrit	polarity
pxot	ofisiyaPosta
hxom	Junkmail
hqic	mkaguzi
lwun	bluu-jean
hp6n	kukomaa
dxan	attaching
xrak	muigizajijukumu
dxak	ajali
hven	vyombo
mwap	Comic-strip
qlan	rangi-kipofu
xros	mvuo
srom	showroom
hc6t	chatting
qrat	Juuchini
hn6t	kolinesterasi
hqet	tovuti
fres	fundraise
froc	forging
xlak	hyperlink
vlat	volubility
dvan	disembarking
gxin	mshindi
ryes	receptionist
kxot	connectors
xyan	uwekaji
vlan	mtangazaji
ryom	thoriumchembe
hluf	Uzee
hquk	kuingiza
lyum	thuliumchembe
tyem	terbiumchembe
hp6m	praseodymium
txic	nyumbaniukurasa
mros	motorist
dyam	rhodiumchembe
pc6n	kesiidadi
nyos	Inbox
pyek	projector
kxon	Kriptoni
hxuc	rescuing
qrik	centrickesi
xwin	ulimbukeni
kxic	Kizima
hvot	flowchart
dxot	mgando
hqut	kuingianje
pxen	idara
drok	lengotrigger
flon	Simuyarununu
txos	katikatisauti
hqok	obliquekesi
xwik	mgonjwakesi
hx6n	kablahodiernal
txik	kidolechakati
hqen	mtumaji
mlap	zisizo
hvun	suasion
hvon	kuvaanje
vran	mail-carrier
pfes	profesa
pwip	mshairi
hqam	Fanyamazoezi
gxat	uhalali
ks6t	causative
vrin	recruiter
kxip	kipandechabodi
sr6n	disapproving
vlit	evaluative
tyup	kitongoji
mrom	morpheme
xron	headphone
gxak	gharamakubwa
hrof	trojanfarasi
xlas	amepooza
dzet	redecorate
txac	kujisalimisha
xrot	outnyttjade
txis	dottumbo
syif	sivitengo
xrac	kushangaza
brif	mapacha-thamani
dlos	modalkesi
txun	sifa
dvat	--tukuta
psom	kwanzamkono
gjek	kingine-kama
nlem	kitengo-ya-habari
qret	rejarejaduka
txip	maratatu-kumweka
dlek	mmojammoja
lwut	mtiririko-sasa
dxis	kasi
hs6m	cesium
vlak	railcar
hn6m	Nerium
kxap	kadi
bxan	wakienda
myem	mweziwamay
gxik	kiraia-haki
hxoc	Jeshilaanga
xrok	coworker
kr6t	screenshot
txok	mojakwamoja
hxep	skateboard
srop	smartphone
pxak	kofiakufuli
hk6k	folk-muziki
hl6k	euler's-idadi
pyom	poloniumchembe
xyam	thalliamuchembe
hvic	kuvamia
lyok	locativekesi
xlot	kujaa
txen	restatement
kxac	counterattack
qrak	strikebreaker
hbup	Bwawalakuogelea
txuk	mzungukomfupi
tsef	tapered
bxit	mtandaojeshi
ksem	kusomatu
byim	rubidiumchembe
hvam	vanadiumchembe
lw6n	lanthanum
frum	florinichembe
nyom	neodymium
mlom	multalidadi
kxas	kubinafsisha
xret	terabyte
hs6k	searchinjini
frus	corroding
gxan	galaxyjinsia
vlas	vocalizations
glet	gesi-kanyagio
hvim	Runtime
bxip	bitmap
qrin	nyotajinsia
bvak	abessivekesi
pxon	hazipatikani
dvik	adessivekesi
dvek	agentivekesi
hlef	wakalatrigger
kwek	kwakesi
kxen	kawaidajinsia
ht6m	citationfomu
tsuf	transnumeral
hf6n	fining
tc6t	mojakwamojakitu
gvik	ergativekesi
gxon	kugawanyika
ksep	receptor
vyin	movie-ukumbi
pyos	watazamajisauti
hnef	finiteverb
xwit	msingikitu
hqim	gnomicmood
jlak	generalization
vrik	mwishochembe
qyan	imaginary-kitengo
kxaf	kasi-ya-mwanga
xyic	hadaa
qyit	muhimuyakiwango
hvek	evitativekesi
bvik	subessivekesi
hzes	mwendawazimukesi
prus	kompyutavirusi
ples	processor
pxif	polisiafisa
dvak	lativekesi
brun	touring
tsi_k	antessivekesi
tyum	rutheniumchembe
vyak	adverbialkesi
pxim	WaziriMkuu
syum	Strontiumchembe
sy6n	suspiciousness
hy6n	animatejinsia
pxac	hurumafuraha
vlin	garijinsia
qwin	madinijinsia
hr6s	rufaa
tf6n	toner
xris	userinterface
hw6n	kuapishwa
xlen	matusinoun
pyec	spreadsheet
vlim	virtualkumbukumbu
bres	nenoprocessor
hqip	wingukompyuta
vlic	virtualmashine
pfam	spammer
dyap	pililugha
txek	nth-mzizi
dxen	datamadini
byip	biasharamtu
hs6c	binafsikujiamini
txim	akimaanisha
hb6t	mabadilikoyatukio
hdem	uwanjajina
dxon	tofautitukio
lwaf	flashgari
sl6t	crastinaluliopo
xyik	floppydisk
fyif	reflexivesauti
bvin	ulimwengujinsia
hm6p	Motherboard
tfip	elekeziverb
jlen	eneojinsia
xrap	striped
tc6n	utafitijinsia
sl6n	kisaniijinsia
xrek	mgonjwatrigger
xwan	abstractjinsia
dxif	videoconference
dyip	mojakwamojahotuba
zrek	exocentrickesi
hvuk	evoking
xwat	sikuzanyumaperfective
hr6m	rhenium
txaf	yalisababisha
hmef	impersonalverb
tx6t	Nakalamhariri
txes	pamojanoun
bvat	kuwatendeavibaya
bvuk	absolutivekesi
ry6t	radian
vlis	virtualukweli
qren	planetaryjinsia
gvak	kisarufikesi
bxok	bald
mrum	kompyutampango
ps6t	uendeshajimfumo
hfom	phoneme
tlem	kusomatukumbukumbu
pwam	spyware
kfif	msingibenefactive
qwit	rationality
nlaf	kufunga
nwok	associativekesi
dzas	dissatisfy
swuk	superlativekesi
syos	muhtasari
kr6n	umemesasa
dvin	inanimatejinsia
pxom	propositivemood
vris	kubadilishanasauti
rwos	erosoli
dr6t	mpurukushaji
ht6k	mawasilianoyasimu
slaf	kijamiimitandao
lyuk	mfululizokifungu
qras	wakubwa
ty6n	terminal
gwet	harakabaadayeuliopo
hp6s	applicativesauti
tsof	antipassivesauti
ht6p	continuativekipengele
hn6f	necessitativemood
pfip	watazamajiMmoja
glap	toolbar
sy6k	existentialkifungu
qyat	luminouskiwango
hy6t	kisarufi-kitu
vyan	kutamka
sluf	singulativeidadi
dvit	kupindukiamuda
qyak	singlehatuaverb
bzik	fizikia
xlet	superlativeshahada
hqap	sasaMmoja
qwat	kiasiyaDutu
qyik	connectivechembe
sr6t	supercritical-maji
hfem	epentheticmorpheme
tl6t	kijijinibaadayeuliopo
mrif	kipazasauti
pcuk	postpositionalkesi
tfim	randomupatikanajikumbukumbu
fwim	ethidium
ly6t	allocutionmakubaliano
hvap	kitabubar
hfep	frequentativekipengele
bvan	distributivepronoun
fyun	floating-kumweka-idadi
xyas	erasing
hvif	kitendo-suffix
xyis	sikuzanyumawatazamajiMmoja
tl6n	katiusindikajikitengo
tfok	locativedirectionalkesi
qwan	marakwamaraaliulizamaswali
