வினையெச்சம்: எல்லையற்ற, முடிவிலி, தோற்றம், மூல
நியமிக்கும்வழக்கு: முன்னிடைச்வழக்கு
வேற்றுமையைவழக்கு: 
தலைப்புவழக்கு: பொருள்வழக்கு
பெற்றோர்: பெற்றோர், முக்கிய, மூத்த, கீரை
அப்பா: அப்பா
அம்மா: அம்மா, அம்மா, தாய்க்குரிய
வணக்கம்: பை, வணக்கம், ஏய்
மூதாதையர்: முன்னோடி, தாத்தா
தாத்தாபாட்டி: தாத்தா, பாட்டி
பசி: பட்டினி, பட்டினிகிடந்தால்
ஆறாம்வேற்றுமைவழக்கு: சொந்தம்வழக்கு
பெயரடை: 
மற்றும்: தொகை, மூலம், ஒரு
என்னை: நானே, நான், என், நாங்கள், சுவைக்க
நீங்கள்: அவர்கள், உனக்கு, நீ, யா
எங்களுக்கு: நாங்கள், எங்கள், நம்முடைய
அது: அவன், அந்த, அவள், இந்த, இந்த, எந்த
இலக்குவழக்கு: நோக்கம்வழக்கு
dativeவழக்கு: 
உண்மையானமனநிலை: 
deonticமனநிலை: 
நிபந்தனைமனநிலை: subjunctiveமனநிலை, அனுமானமனநிலை
அறிவுசார்மனநிலை: 
கருவியாகவழக்கு: 
உள்துறைசூழல்: 
நபர்சூழல்: 
சார்ந்துஉட்கூறு: 
குறைவின்மைஅம்சம்: 
கடந்தபதட்டமான: 
ஆண்பால்பாலினம்: ஆண்பால்பாலினம்
comitativeவழக்கு: 
தற்போதையபதட்டமான: 
benefactiveவழக்கு: 
essiveவழக்கு: 
இல்லை: இல்லை, அல்லாத, அரிதாகத்தான், முடியவில்லை, சுருதி, ஒருபோதும், அல்லது, யாரும், மாறாக, எந்த, முடியாது, மிஸ்
அதன்: தங்கள், அவரது, அவள், அவரை, அந்த, அவளுடைய, என்ற, யாருடைய, சுயாதீன
மேற்பரப்பில்சூழல்: 
adpositionalவழக்கு: 
இடம்வழக்கு: 
விண்வெளிசூழல்: 
வழிவழக்கு: 
கேள்விக்குரியமனநிலை: 
மற்றும்அல்லது: 
பிரத்தியேகஅல்லது: 
மூலவழக்கு: 
நீக்குவதற்கானவழக்கு: 
வெளிப்படுத்துகிறது: திட, கணிசமான, கான்கிரீட், அறிவுறுத்தும், உத்தரவு, வியத்தகு, வெளிப்படுத்த, வெளிப்படையான, புகுத்துவதற்கான
ஆனாலும்: இன்னும், எனினும், என்றாலும், என்றாலும், இருப்பினும்
அனைத்து: அனைவருக்கும், எல்லோருக்கும், மொத்த, முழு, ஒட்டுமொத்த, முழு, எல்லாம், எந்த, பெருகிய, முற்றிலும்
பெண்மையைபாலினம்: 
அவர்கள்: அவர்கள், அவள், அந்த, தங்கள், அவர்களது, குடும்பபெயர், இந்த, அதே, நியாயமான, ஒத்த, செய்ய
பன்மைஎண்: 
ஒரு: ஒற்றை, ஒரு, ஒரு, தனியாக, ஒரு, இதையொட்டி, எனினும்
யார்: யாரோ, எவர், எந்த, யாருடைய, போன்ற, யாரை, எதுவும், யாரையும், அந்த, தங்கள், அந்த, பாட, யா
எதிர்காலபதட்டமான: 
சமூகசூழல்: 
எப்பொழுது: எப்போது, எப்போதும்
imperfectiveஅம்சம்: 
அங்கு: இருக்கிறது, வியாழக்கிழமை
மேலும்: மீது, மிகவும், மேலும், அப்பால், மேல்நோக்கி, மேல்நோக்கி, பல, விட, மாறாக, மேலும், மேலும், பிளஸ், இன்னும், இன்னும், வேறு, பல, பல, மற்ற, இல்லையெனில், மற்றொரு, ஓய்வு
வெளியே: வெளியே, வெளி, வெளி, வெளிப்புற, வெளிப்புறங்களில், ஆஃப், வெளியே-ன், அப்பால், வரை, மீது, மீது, முன்னும்பின்னுமாக, விட்டுவிட, வெளியேறும்
உறவினர்வழக்கு: உறவினர்வழக்கு
அனுமானம்வழக்கு: 
செய்: செய்ய, செய்ய, மேற்கொள்ள, விடாது, செயல்படுத்த, செய்தது, தெரிவித்தல், வைத்து, என்ன, வினை, எதுவும், என்பதை, எதுவாக, வேலை
உத்தரவுமனநிலை: அறிகுறியாகமனநிலை
கேள்விவார்த்தை: 
இடைச்சொல்: இணைப்பு, பத்திர, கொத்து, இணைப்பு
நபர்: ஆண், மக்கள், தனிப்பட்ட, யாரோ, யாரோ, பையன், மனித, முகம், ஆளுமை, அவரை, அவர்கள், தனிப்பட்டமுறையில், பாதசாரி, சக
ஆண்: ஆண்பால், குறிப்பிட, பண்புள்ள, ஆண், மென்மையான, பெண்
முடிந்த: முடியும், வலிமை, சாத்தியமான, இருக்கலாம், வாய்ப்பு, வாய்ப்பு, மே, சாத்தியம், முடியும்
எண்: அளவு, தொகை, எண்ணிக்கை, எண், எண், அளவு, எண்கள்
மிகவும்: பெரிதும், மிகவும், இவ்வளவு, மிகவும், மிகவும், மோசமாக, பரவலாக, மிகவும், உண்மையில், மோசமாக, மிகப்பெரிய, கணிசமாக, நிறைய, பல, பாரிய, மிகவும், மிகவும், மிகவும், இதுவரை, அழகான, சரி, சரி, எல்லாம்சரி, தீவிர, புண், ஏராளமாக, வழக்கத்திற்குமாறாக, நம்பமுடியாத, சிறந்த, பலவீனமான, கடுமையாக, தீவிரமாக
நேரம்: போது, கணம், போது, சரியானநேரத்தில், கால, உலகியல், பதட்டமான, காலஅட்டவணை, காலம், வானிலை, மீண்டும், மணி, பார்வை
நேரம்சூழல்: 
உலகியல்வழக்கு: 
பற்றி: தொடர்பாக, பற்றி, கிட்டத்தட்ட, ஏறத்தாழ, என்ற, மூலம், விட, சுற்றி, ஐந்து, மீது, கிட்டத்தட்ட, சுமார், விஷயம், மரியாதை, அத்தியாயம், மருந்து
எழுத்தியல்: இலக்கியரீதியாக, உண்மையான, அசல், அறுதி, வாய்மொழி, இலக்கிய, சரியான, துல்லியமான, துல்லியமான
மட்டுமே: வெறும், வெறுமனே, வெறுமனே, புள்ளி, வெறும், முற்றிலும், நின்றுவிடவில்லை, அரிதாகவே, வளைகுடா, தனியாக, வெற்று
சிறிய: சிறிய, சிறிய, லேசான, சற்று, பிட், சிறிய, குட்டி, சிறிய, சிறிய, சில, சிறிது, குறுகிய
பிறகு: மீண்டும், யா, முதல், முன்பு, சேடன், பின்னர், பின்பு, இருப்பினும், பின்னர், அடுத்தடுத்த, பின்னர், பின்னர்
hortativeமனநிலை: 
சுயபரிசோதனைஅம்சம்: 
பெரிய: பெரிய, பெரிய, உன்னத, தீவிர, பரந்த, உரத்த, மகத்தான, மாபெரும், மிகப்பெரிய, மேலாதிக்க, நல்ல, நன்றாக, கணிசமான, பெரிய, கணிசமான, அற்புதமான, சிறந்த, உகந்த, பெரும், முக்கிய, சரியான, குறிப்பிடத்தக்க, புத்திசாலித்தனமான, தண்டு, மேக்ரோ
volitiveமனநிலை: 
முன்: முன், முன், முன்பு, முந்து, வரை, வரை, முன், முன்னர், எதிராக, எதிராக, முன்னோக்கி, முன்னெடுக்க, தூரம், மேலே, முந்தைய, முன்பு
வேண்டும்: வேண்டும், அவசியம், தேவையற்ற, வேண்டும், தேவை, பேசலாம், செய்யவேண்டும், வேண்டும், வேண்டும்
இரண்டு: இரட்டை, இரண்டு, தவிர, ஜோடி
பார்க்க: பார்க்க, பார்வை, பார்வை, அறிவிப்பு, உணர, பார்க்க, எல்லையைக், பார்க்கவும், சந்திக்க
தெரியும்: அறிந்துகொள்ள, அறிவாரா, கற்று, கொடி, தெரியும், புரிந்து
கீழே: கீழ்நோக்கி, கீழ்நோக்கி, கீழ், கீழே, கீழே, அடியில், குறைவான, கீழே, தாழ்வான, கீழே
முதல்: அறிமுக, ஆரம்ப, முதல், முதல், முதலில், ஆரம்பத்தில்
சொந்த: தன்னை, உங்களை, சுதந்தரித்துக்கொள்கிறது, தனிப்பட்டமுறையில், அவரது, தன்னை, சுய, தனிப்பட்ட
உடைமைமாற்றத்உடைமை: 
மாற்றமுடியாதஉடைமை: 
பழைய: பயன்படுத்தப்படும், பண்டைய, வயது, முதியவர்கள், முன்னாள், முன்னாள், வயது, முன், முன்னோடி
deliberativeமனநிலை: 
நாள்: தினசரி, நாம், வேலை, விவகாரம், வேலை
எங்கே: எங்கு, அதன்படி, இடத்தில்
வந்து: செய்ய, வரை, அடைய, வருகையை, வரும், ஆக, ஏற்படும்
வழி: முறை, முறை, நடைபாதை, வழிமுறையாக, பாதை, பாதை, பாதை, வழித்தடம், பாதை, முறையில், சாலை, தெரு, சர்க்கரை, பாடல், போக்கு, பழக்கம், எப்படி, செயல்முறை, முறையில், சமயத்தை
வேலை: வேலை, வேலையை, செயலில், பணி, தொழிலாளர், தொழிலாளர், வாழ்க்கை, செயல்பாடு, இயக்குகிறது, செயல்பாட்டு, வணிக, செயல், வேலைஅவுட், வேலை, தொழில்சார், வேலை, கலைப்படைப்புகள்
உயிர்: பிரபலமான, உயிர், உயிர், இயக்கம், இயக்கம், போக்குவரத்து, எழுத்துக்களை, அச்சு
சென்று: நடக்க, கட்டணம், புறப்படு, புறப்படும், குடியேறுவதற்கான
perlativeவழக்கு: 
முற்போக்கானஅம்சம்: 
நீண்ட: நீடித்திராது, நீடித்த, உயரமான, சேர்ந்து, காலம், சகாப்தம், பதட்டமான, விட்டு, சித்தரிக்க
சொல்ல: பேச்சு, சொல்ல, பேச, பிரதிநிதித்துவம், தொடர்புபடுத்த, என்று
கூட: மேலும், ஒன்று, வரை, வரை, மேலும், மிகவும், இதேபோல், மேலும், மேலும், தன்னை
மீண்டும்: பின்னால், பின்புற, பின்னோக்கி, பின்தங்கிய, திரும்பிவருதல், மீட்க, மீளமை, மீண்டும், மீண்டும், முன்பு, படி-க்கு, வாபஸ், மீட்க, மீட்டெடுக்க
இங்கே: மணிக்கு
என்று: நினைத்து, நினைத்தேன், கருத்தில், கற்பனை, கருத்தரிக்க, தியானம், என்று, என்று, மனதில், உணர, தெரிகிறது, குறிப்பிடுகிறது, கருத்தில்
ஒவ்வொரு: எல்லாம், ஒவ்வொரு, எந்த, எந்த, நோக்கி, ஒன்றுக்கு, எல்லோருக்கும், வகுக்கும், முழு, சராசரி
கடந்த: இறுதியில், பிந்தைய, இறுதி, இறுதி, மற்றொரு, வேறு, சமீபத்திய, சமீபத்திய, முடிவுக்கு, கடந்த, தாங்க, நீடிக்கின்றனர், முந்தைய, தாமதமாக
கீழ்சூழல்: 
எடுத்து: ரிசார்ட், ஆக்கிரமிக்க, எடுக்க, தத்தெடுக்க, கிராப், கிடைக்கும், பெறும், அழைத்து, ப, பிடிப்பு, வசூலிக்க, ஏற்க, கொண்டு, செயல்படுத்த, சுட, விண்ணப்பிக்க, ஒதுக்க, பிரயோக
கண்டறியப்பட்டது: கண்டுபிடிக்க, கண்டறிய, கண்டுபிடிப்பு, கண்டறிதல், அணுக, கிடைக்கும், சந்திக்க
கை: கை, மணிக்கட்டில், ஆயுத
இளம்: இளைஞர், இளைய, டீன்-ஏஜ், இளைஞனை, புதிய
கொடுக்க: கடன், வழங்கும், சலுகை, வழங்கும், வழங்க, விடாது, வாங்க, வைத்து, தானம், நாம், வழங்க, விருது, தனிம, சுழற்சி, ஒப்பு, கடமைப்பட்டிருக்கிறேன்
கடவுள்: தெய்வீக
delativeவழக்கு: 
எதுவும்: ஏதாவது, பொருள், எந்தஒரு, எதுவும், யாரும், யாரும், சில, சில, சில, சற்றே
வலது: ஜோடி, சரியான, துல்லியமாக, நியாயமான, நீதி, நியாயப்படுத்தி, நியாயமற்ற, தகுதி, உரிமத்தை, சட்டம், சரியாக, உண்மை, சில, உறுதி, உரிமம், நன்கு, முழுவதும், காரணமாக, சரியான, ஒழுங்காக, பொருத்தமான, அதற்கான
முறை: உடனடியாக, உடனடியாக, முறை, முறை, முறை
semelfactiveஅம்சம்: 
விட்டு: விட்டு, விட்டு, தவிர்க்க
பகுதி: பிரிவில், ஓரளவு, பகுதியை, ஓரளவுக்கு, பார்சல், பின்னம், பிரிவில், பங்கு, பிட், துண்டு, பத்தியில், துணைக்குழு, அத்தியாயம், துறை, அத்தியாயத்தில், பகுதி, பிரிவு, வார்டு, துறை, விகிதம், சார்பில், பங்கேற்க, குவாண்டம்
வீட்டில்: வீட்டில், வளாகத்தில், கோவில், வீடுகள், வீட்டு
உலக: உலகினில், உலக, பிரபஞ்சம்
தலைவர்: தலைப்பு, முக்கிய, தலைமை, அத்தியாயம், தலைவர், தலைவர், தலைவர், இயக்குனர், முதலாளி, பேனா, தலைவலி, முடி
மூன்று: மூன்றாவது, ஒன்பதாவது, வரி
கவனம்: நோக்கம், நோக்கம், இலக்கு, நோக்கம், கவனம், கவனம், செறிவு, குவிகிறது, பார்வை
அன்பு: பாசம், தொண்டு, போன்ற, ஈர்ப்பு
எப்போதும்: என்றென்றும், தொடர்ந்து, எப்போதும்
இரவு: சாயங்காலம், இரவு, இரவு, இன்றிரவு
ராஜா: ராஜாவாகி, ஆண்டவன், மன்னர், அதிபர், இளவரசன்
இடையே: மத்தியில், மத்தியில், என்ற, உள்ள, ஒரு, உள்ள, நடுத்தர, மத்தியில், போது
இதயம்: உற்சாகம், ஊக்குவிக்கும், கவிழ்க்க, கரோனரி
paucalஎண்: 
ஏனெனில்: காரணமாக, முதல், வழக்கு, காரணம், காரணம்
காரணவழக்கு: 
பெயர்: குடும்பபெயர், பெயர்ச்சொல், கைவினை
முறையானபெயர்ச்சொல்: 
நாடு: தேசிய, நில, பூமி, அரசு, தரையில், மண், கட்சி, கிராமப்புறங்களில்
கேட்டார்: கேட்க, கலந்தாலோசிக்க, விடுக்கின்றோம், கேள்விகள்
தெரியும்சான்றுத்: 
சிறந்த: உயர்ந்த, சிறந்த, சிறந்த, ஏற்றதாக, நிலுவையில், மேலும், தூரம், நல்ல
பக்க: பக்கவாட்டு, சாதகமாக, சாதகமாக, சார்பில், இதையொட்டி, பக்கம், அம்சம், அரை, தரப்பும், நோக்கி, அருகில், ஒதுக்கி
நிச்சயமாக: பாடத்திட்டத்தை, பாடம், விரிவுரை, நிச்சயமாக, நிச்சயமாக, நிச்சயமாக, விகிதம், பாதை, நம்பிக்கை
போதும்: போதுமான, போதுமானஅளவு, போதுமான, போதிய, மிகவும், நிறைய, போதிய, மிகவும், அழகான, கணிசமான, கணிசமாக, கணிசமான, குறிப்பிடத்தக்க, கணிசமாக, நியாயமான, வைத்து, முழுமையாக
உடனே: விரைவில், விரைவான, வரியில், விரைவில், வேகமாக, உடனடியாக, விரைவான, அவசரம், அவசர, அதனால், உடனடியாக, உடனடியாக, அருகிலுள்ள, ஆரம்ப, படம்
முழு: முழுமையாக, போதுமானஅளவு, அறுதி, முழுமையான, நிறைவற்ற, முழு, சரியாக, சரியான, அப்பட்டமான, துல்லியமாக, முழுமையான, முழு, பரந்த, அளவு, முற்றிலும், முற்றிலும், முற்றிலும், முடிக்கப்பட்ட, நிறைவேற்றப்படுகிறது, சாதிக்க, உள்ளார்ந்த, நிறைவேற்ற, பூர்த்தி
அறை: அறை, நான்காவது, படுக்கையறை, சமாதானம், பெட்டியா, பாதாள, ஆழம்
நீர்: திரவ, திரவ, கண்ணீர்மல்கிய
desiderativeமனநிலை: 
ஒளி: பளபளப்பு, பிரகாசமான, மெழுகுவர்த்தி, லேசான, பாணி, சிறிது, வெளிர், தெளிவான, பகல், வெளிப்பாடு
சொல்: சொல், ஒலி, சொல்லகராதி, சொற்றொடர், வினை, பெயர்ச்சொல், வார்த்தைகளை, கால
கதவை: வாயில், வாசல்படியில், நுழைவு, அத்தியாயம், துறைமுக, போர்டல்
பயன்பாடு: பயன்படுத்த, பயன்பாடு, நுகர்வு, செலவு, நுகர்வோர், ஈடுபட, பயன்பாடு, பயன்பாடு, விண்ணப்பிக்க, பயன்படுத்துகின்றனர், நுகர்வு
காலை: ஏ.எம், காலை
terminativeவழக்கு: 
சக்தி: வலிமை, ஆற்றல், வலிமை, வலுவான, படை, சக்திவாய்ந்த, மாறும், கலவை, ஆதிக்கம், அதிகாரம்
தங்களை: நம்மை, உங்களை, தன்னை, நானே, தன்னை, தன்னை, சுய, ஈகோ, தனியாக
குரல்: ஒலி, உரக்க, வாக்குச்சீட்டில், ஆடியோ, வாக்கு, உருப்படியை, வதந்தி, வதந்தி, சத்தம்
வெள்ளை: வெற்று, புகார்
பணம்: செல்வம், வெள்ளி, நிதி, பணம், நாணய, நிதி, பண
அடுத்த: அருகில், இணைந்து, அடுத்தமுதல், பின்வரும், பின்னர், பரிமாணத்தை, முதல், அடுத்தடுத்த, பின்னர், பின்னர், பின்னர், பின்பு, முன்னும்பின்னுமாக, முன்னோக்கி, தூரம், மேலே, தொடர
ஏழை: கை, வறுமை, கெட்ட, பலவீனமான
மரணம்: இறப்பு, இறக்கும், இறந்த
வடிவம்: வடிவம், அச்சு, வடிவம், உயர, முறை, விவசாய, வடிவ, அமைப்பியல்
inessiveவழக்கு: 
ஒன்றாக: ஒரேநேரத்தில், சேர்ந்து, கூட்டு, கூட்டு, தொகுப்பு, இணைந்து, இணைந்து, இணைக்க
விஷயம்: வழக்கு, விவகாரம், விஷயம், நிகழ்வு, பிரச்சனை, பொருள், பொருள், பொருள், பிரச்சினை, கேள்வி, பொருட்களை, தலைப்பு, ஆர்வத்தினை
அடிக்கடி: அடிக்கடி, தொடர்ந்து, வழக்கமாக, அடிக்கடி, பொதுவாக, பொதுவாக, பொதுவாக
நண்பன்: நட்பு, காதலன், சக, துணையை, இணை
ஆர்டர்: அமைப்பு, ஏற்பாடு, ஏற்பாடு, ஒப்பந்த, வரிசை, கட்டளை, இதையொட்டி, வரிசையில், வரிசை, வரிசை, வரிசைமுறையிலான், அழைக்க, அதனால், நாம், தவிர்க்க, எழுத்துப்பிழை
கட்டாயம்மனநிலை: 
சுற்று: வட்டமான, வட்டம், மடியில், கோளம்
வைத்து: நடத்த, பராமரிக்க, போட, வைத்து, தொகுப்பு, பேஸ்ட், தக்கவைத்து, பாதுகாப்பு, ஈடுபட, போன்ற, பாதுகாப்பு, பாதுகாப்பு, பாதுகாக்க, காவலில்வைக்கவும், கடைபிடிக்கின்றன, தங்க, இருக்கும், நிலையான, பராமரிப்பு
மனைவி: மனைவி, பெண்
நம்பிக்கை: நம்பிக்கை, கணக்கிடு, கருதுகின்றன, நம்பிக்கை, நம்பிக்கை, நம்பிக்கை, நம்பிக்கை, நம்பிக்கை, நம்பிக்கை, சார்ந்திருத்தல்
அருகில்: கடந்து, அருகில், கிட்டத்தட்ட, சுற்றி, நெருக்கமான, கிட்டத்தட்ட, அடுத்தடுத்த, கிட்டத்தட்ட, அருகிலுள்ள, அண்மையிலுள்ள, அண்டை, அண்டை
பொது: பொது, பார்வையாளர்களை, பொதுவான, பொதுவாக
நிலைசூழல்: 
மகன்: திரள், சிறுவன்
நூறு: நூறாவது, முகம், சதவீதம், நூற்றாண்டு
குழந்தைகள்: குழந்தை, பிள்ளைகள், குழந்தை, குழந்தை
இதனால்: அதன்மூலம், அதனால், எனவே, போன்ற, ஆம், எனவே
நம்புகிறேன்: விரும்புகிறேன், வாய்ப்பை, எதிர்பார்க்கலாம், நம்பிக்கை, நம்பிக்கை, எதிர்பார்க்கப்படுகிறது, எதிர்பார்க்க, எதிர்பார்ப்பு
மேலே: வரை, மீது, மாடிக்கு, உயர், மேல், மேம்பட்ட, மேல், முழுவதும், பற்றி, வழியாக, மீது, மேல்நிலை, மீது, மேலே
அன்பே: காதலன், விலை
படிக்க: வாசிப்பு, பாட, லில்லி, வாசகர்
நகரம்: நகரம், நகராட்சி, கவுண்டி, நகர்ப்புற
ஏற்கனவே: தயாராக, தயார், தயாராக, எப்படியும், முன்
உண்மையில்: உண்மை, உண்மையில், உண்மைத்தன்மை, உண்மை, உண்மையான, உண்மையான, உண்மையில், உண்மையில், உண்மையில், செய்தது
factiveசான்றுத்: 
பெண்: பணிப்பெண், மகள், பெண், பெண், காதலி, தனியாக
கேட்கிற: கேட்க, கேட்டு, உணர
குறைந்தது: குறைந்த, குறைந்தபட்ச, குறைக்க, கழித்தல், குறைவான, குறைந்த, மிகவும், சிறந்த, அதிக, உகந்த
ஒருவேளை: ஒருவேளை, இருக்கலாம், மறைமுகமாக, வலிமை, சாத்தியமான, சாத்தியம், வாய்ப்பு, சாத்தியமான, கூறப்படும்
திறந்த: தெளிவான, வெற்று, தெளிவாக, வெற்று, வெளிப்படையாக, காலியாக, வெளிப்படையான, வெளிப்படையான, வெளிப்புற, பற்றாக்குறை, வெளிப்படையாக, அம்பலப்படுத்த, சுமை, வெளிப்படுத்த
உடல்: இறைச்சியைப், உடல், உடல், உடல், கார்பஸ், உறுப்பு, பிணத்தை
விமான: காற்று, காற்று, விமானபோக்குவரத்து, வானிலை, விமானநிறுவனம், விமானம்
இயல்பு: இயற்கை, செய்கிறது, இயற்கையாகவே, தோற்றம், வம்சாவளியை, உள்நாட்டு, வன, பாத்திரம்
உதவி: உதவி, பயனுள்ளதாக, உதவி, உதவி, உதவி, போட, நிவாரண
கடிதம்: மின்னஞ்சல், லெட்டர், எழுத்து
நான்கு: நான்காவது
optativeமனநிலை: subjunctiveமனநிலை
தீ: சூடான, சுடர், காய்ச்சல், நெருப்பிடம், புத்தர்
இலவச: சுதந்திரம், சுதந்திரம், விலக்கு, இலவச, வீண், சுதந்திரமாக, காலியாக, தளர்வாக, வெளியீடு
போர்: போர், போராட்டம், சண்டை, போர்க்களத்தில், மல்யுத்தம்
இரண்டாவது: மற்ற, இரண்டு, படி-க்கு, மற்றொரு, இரண்டாவதாக
ஐக்கிய: ஒருமை, ஒற்றுமை, உள்ளடக்கிய, தொழிற்சங்க, கூட்டுப்பணிகளின், நட்பு, தனிப்பட்ட, ஒருமித்த, கூட்டு, கலப்பு, கூட்டணி, கூட்டமைப்பு
அழைப்பு: சவால், ஆக்ஸைடாவதும், முறையீடு, மீது, இணைப்பு, கலவை, கூட்டு, இணைவு, அழைப்பை, வாழ்நாள், உரையாடல், தொலைபேசி
ஏன்: ஒத்த, இதேபோல்
இழந்தது: இழப்பு, இழக்க, காணாமல், மறைந்துவிடும்
ஆயிரம்: ஆயிரத்தில், ஆடைகள், துணி
குடும்ப: வீட்டு, உயிர்பிழைத்தவர்
ஆன்மா: ஆவி, பேய், சூத்திரதாரி
பாதுகாப்பு: சம்பந்தப்பட்ட, அக்கறை, கவனம், தியானம், சேவை, ஸ்பான்சர்ஷிப், பாதுகாப்பு, பாதுகாப்பு, பாதுகாப்பு, பாதுகாப்பு, பாதுகாப்பு, பாதுகாப்பு, பாதுகாப்பு, பாதுகாப்பு, பாதுகாப்பு, எச்சரிக்கை, சிகிச்சை, சிகிச்சை, காவலில், கவலைப்பட, கவலை, வருந்ததக்க
அர்த்தம்: குறிப்பால், உணர்வு, பொருள், அர்த்தமுள்ள, குறிக்க, நடுத்தர, முகவர், நடுத்தர, சராசரி, மிதமான, அடிப்படையில், புரிந்து
வெவ்வேறு: தனித்துவமான, வேறுபடுகின்றன, பல்வேறு, பல்வேறு, பல, வித்தியாசம், தனி, மாறுபாடு, தனியாக, மாறுதன்மையே, வகையீட்டு, போலல்லாமல், மாறுபாடு, மாறுபடும், பல்வேறு, மற்ற, வேறு, மற்றொரு, பல, வித்தியாசமாக, பல்வேறு
சாத்தியமானமனநிலை: 
allativeவழக்கு: 
மனிதப்பண்புகள்பாலினம்: 
ஐந்து: ஐந்தாவது, ஆண்டு, ஐந்து
வாழ: உயிர், வாழ, நடந்து, வாழ்க்கை, கூடு, மாவட்டத்தில், அக்கம், அக்கம், உயிரோடு, கலகலப்பாக, மூல, நேராக, நேரடியான, வசிப்பிடத்தை, நேரடி
வெவ்வேறுபொருள்: 
பதில்: வடக்கு, பதில், பதில், தீர்வு, ஒத்திருக்கிறது, பதிலளிக்க, வடக்கு, பிரதிசெய்கை
கடல்: கடல், கடல், கடல்
அச்சம்: அச்சம், பயம், பயங்கரவாத, பிரமிப்பு, பயமாக, பீதி, பதட்டம், மனக்கவலையை, திகில், பயத்தின், பயந்து, தாழ்வுமனப்பான்மைதான்
கடின: கடினமான, கடினமான, சிக்கலான, கடுமையான, உரத்த, வன்முறையில், கடுமையான, கடுமையான, கடுமையான, சவாலான, தந்திரமான, திட, இறுக்கமான
அடிப்படையில்: கால, சொல்லியல், பிரச்சினை, அடிப்படையில், அடிப்படையில், அடிப்படையில், அடிப்படையில், அடிப்படையில், அடிப்படையில், சொத்து
சந்தேகம்: சந்தேகத்தின், அவநம்பிக்கை, தயக்கமும், சந்தேக, சப்ளையர்
dubitativeமனநிலை: 
கருப்பு: தொகுதி
அழகான: நல்ல, நல்ல, அழகான, அழகாக, நன்றாக, அழகான, ஆடம்பரமான, குளிர், அழகான
இருண்ட: மனச்சோர்வு, இருள்
வகையான: வகைப்பாடு, வகைப்படுத்த, வகைப்படுத்தி, வகையான, இனங்கள், பல்வேறு, உருப்படியை
பத்து: தசாப்தத்தில், பத்தாவது, நியாயமான
நிகழ்ச்சி: காட்சி, செய்ய, செயல்திறன், ஆர்ப்பாட்டம், வழங்கல், குறிப்பிடுகிறது, குறிக்க, நிகழ்ச்சி, திட்ட, கண்காட்சியின், கலை, படத்தை, ஓவியத்தை, திரை
கதை: கட்டுக்கதை, வரலாறு, கதை, கற்பனை, சதி, கதை, பேச்சு, தலைப்பு
புத்தகம்: சுருள், இருப்பு, பவுண்டு, பாடநூல்
மின்னணு: மின்னணு, எலக்ட்ரான், மின்னல், மின்சார, மின்சாரம், மின், எலக்ட்ரீஷியன், மின்னஞ்சல், முன்னாள்
கணக்கு: காரணம், காரணம், கணக்கிட, கணக்கீடு, கால்குலஸ், மசோதா, கணக்கீடு, எண்ண, கணக்கிடு, கணித
குறி: மார்க்கர், சுவடு, பாதை, மதிப்பெண், லோகோ, சிறப்பம்சமாக, டிக், டேக், அடையாளம், சமிக்ஞை, அடையாளம், கோல், பிராண்ட், பாத்திரம், லேபிள், உணர்வை, அடையாள, எச்சரிக்கை, சின்னமாக, ஐகான்
ஆர்வம்: மலர், ஆர்வம், அக்கறை
எழுத: எழுது, எழுத்து, வகை, எழுதப்பட்ட, நிலையான
படுக்கையில்: 
தேவையான: அத்தியாவசிய, முக்கியமான, பயனுள்ள, விமர்சன, முக்கிய, குறிப்பிடத்தக்க, முக்கியத்துவமற்ற, ஒருங்கிணைந்த, முக்கியமான, முக்கியமாக, தேவை, அவசியம், பெ, பெ, பெ, அவசர, ஒட்டும், தேவை, தேவையான, தேவைப்படும்
யோசனை: நினைத்தேன், கருத்தில், கருத்து, கருத்து, உள்நோக்கு, நினைத்து, கற்பனை, கற்பனை
vialisவழக்கு: 
சகோதரர்: உடன்பிறப்பு, சகோதரி, நெருப்பிடம், சக
சிலநேரங்களில்: எப்போதாவது, எப்போதாவது, சிறிது
வரி: கம்பி, நூல், வரிசையில், லேன், கடத்தல், கோடு, பட்டை, வரி, ஸ்கிரிப்ட், கோடுகள், தலைப்பு
அட்டவணை: மேசை, அட்டவணை, அட்டவணை, அட்டவணை
நதி: தலையணை, தலையணை, ஃப்ளக்ஸ்
கண்: நியமிக்க, சுற்றி, பனி
தகவல்: செய்தி, விளக்கம், விளக்கம், தகவல், அறிவு, தகவல்கள், சாதனை, தெரிவிக்க
திடீரென்று: திடீர், எதிர்பாராத
விசித்திரமான: வித்தியாசமாக, ஆச்சரியம், விந்தை, ஒற்றைப்படை, தெரியவில்லை, அற்புதமான, குறிப்பிடத்தக்க, அசாதாரண, நம்பமுடியாத, அற்புதமான, வினோதமான, வேடிக்கையான, அந்நியன், கவர்ச்சியான, விகாரமான, அசாதாரண, வித்தியாசமான, மர்மமான, ஆர்வமாக
ஆழமான: ஆழமாக, ஆழம், விரிவான, ஆழமற்ற, முழுமையான, விரிவான, பரந்த, விமர்சன, ஆழமான, உள்ள, உள்ளே, உட்புற, புழு
மாற்றம்: மாற்றம், மாறுபாடு, மாற்றம், மாற்றும், பிறழ்வு, மாற்றம், மாற்ற, திருத்தும், மாற்றம், குவிதல், வேறுபாடுகள், மாறுபாடு, மாறுதன்மையே
உணர்வு: உணர, உணர்வு, கருத்து, உணர்வை, உணர்ச்சி, மனநிலை, ஈர்க்கப்பட்டார், உணர்ச்சி, உணர்ச்சி, உணர்வு, உணர்வு, உணர்வு, உணர்வு, உணர்வு, உந்துவிசை, கருத்து, கருத்துரு, கருத்து
நோக்கம்: பொருள், நோக்கம், நோக்கம், இலக்கு, இலக்கு, எண்ணம், நோக்கம், நோக்கம், இலக்கு, நன்மை, நன்மை
சந்தோஷமாக: மகிழ்ச்சியான, மகிழ்ந்தாள், இன்பம், மகிழ்ச்சி, மகிழ்ச்சி, மகிழ்ச்சி, மகிழ்ச்சி, மகிழ்ச்சி, வேடிக்கை, மகிழ்ச்சியுடன், அதிர்ஷ்டம், மகிழ்ச்சி, எமோடிகான்களை, அடிக்கடி, அனுபவிக்க, விரும்புகிகிறது, மகிழ்ச்சியற்ற
இரத்த: இரத்தம், இரத்தம்தோய்ந்த, ரத்தம்சிந்தப்படும்
உயர்ந்தது: இளஞ்சிவப்பு
தென்: தெற்கு, நண்பகல், நண்பகலில்
குளிர்: குளிர்காலத்தில், குளிர், உணர்ச்சியற்று
நிலையை: இடம், நிலைமை, நிலை, வாய்ப்பு, வாய்ப்பு, விண்வெளி, நிலைப்பாடு, காட்டி, இடத்தில், பதவியை, உருப்படியை, நோக்குநிலை, போட, அமைந்துள்ள, நிலையிடமாகவும்
நிற்க: நிலையம், செங்குத்து, அணுகுமுறை, நிலைப்பாடு, நிறுத்த, காட்டி, போஸ், கடையில், இருக்கும், தங்க, இருக்கும், இருக்கிறது, எதிராக
நினைக்கிறேன்: அனுமானம், கருதுகோள், கருதி, தத்தெடுக்க, கருதுகின்றன, தற்காலிகஆதாரமாகக், போட, வீட்டு, கூறப்படும்
என்னுடைய: என்
வெட்டு: பற்றாக்குறை, குறை, குறைப்பு, குறைபாடு, குறைக்க, பற்றாக்குறை, மிஸ், வெட்டு, குறுக்கிட, வெட்டுவது, குறைக்க, பயிர், உடைந்த, மீறும், சதி
நகல்: இனப்பெருக்கம், பிரதிசெய்கை, பெருக்கும், படியெடுத்தல், பிரதியொன்று, குளோன், பதிப்பு, மருந்து, செயல்திட்டமாக, செல்வம்
கணவர்: ஆண், மனைவி
ஆறு: செக்ஸ்
குறைந்த: குறைவான, குறுகிய, மலிவான, மலிவாக, கருச்சிதைவு, குறைந்த, கீழே, ஆழமற்ற, மந்தமான, குறைபாடு, எளிதாக்க, குறைக்க, குறைக்க, குறைக்க
நினைவில்: குறிப்பு, நினைவுகூர்வது, ஞாபகப்படுத்த, மனப்பாடம்
விளைவு: செல்வாக்கு, பாதிக்கும், உணர்வை, தாக்கம், ஆதிக்கம், திறமையான, திறம்பட, திறன், விளைவு, விளைவாக, வெளிப்பாடு, விளைவு, சம்மந்த
விழ: இலையுதிர், வழக்கு, அமைந்துள்ள, விபத்தில், குறைகிறது, முறிவு, சரிவு, கைவிட, சரிவு, குறைக்க
தவிர: வரை, வெளியே, தவிர, தவிர-ல், வெளியே-ன், தவிர, தவிர, ஒதுக்கி-ல், இல்லாமல்
பதிப்புரிமை: 
இராணுவம்: படைகள், துருப்பு, தொகுப்பாளர், சிப்பாய்
ரன்: வெளியேற, வாய்க்கால், இயங்கும், இயக்க, இயக்குகிறது, இயக்கி, கியர், நடவடிக்கைகளை, செயல்பாட்டு, பாதுகாக்க
குதிரை: குதிரை, மணிக்கு, கருத்தை, வார்த்தையினாலும்பிழைப்பான்
எதிர்காலத்தில்: பின்னர், பின்னர், பின்பு, குளிர்காலத்தில்
மேற்கு: மேற்கு
செலுத்த: ஊதியங்கள், ஊதிய, சம்பளம், உந்துதல், கட்டணம், ஊதியம், கட்டணம், செலவு, நாம்
சிவப்பு: குறைப்பு
தங்கம்: 
ஆசை: தன்னிச்சையாகசெயலாற்றல், ஆர்வமாக, பசியின்மை, விரும்புகிறேன், பிக்கள், விடுக்கின்றோம், காமம்
விளையாட: நடனம், சூதாட்டம், விளையாட்டு, கன்னத்தில், பொம்மை, ரோல், சுழல், சுழற்ற
மாஸ்டர்: ஆண்டவன், முதன்மை, முக்கிய, பேராசிரியர், ஆதிக்கம், ஆட்சி, திரு, பண்புள்ள, முன்னணி, மிஸ்டர்,, உரிமையாளர், சூத்திரதாரி, கட்டுப்பாடு
அலுவலக: நிறுவனம், மேசை, அமைச்சகம்
அரசு: அரசு, வரிசையில்
தேவாலயத்தில்: 
நீளம்: உயரம், உயரத்தில், சாண், சேர்ந்து, கால, உயரமான
நிறுவனம்: நிறுவனம், மாநகராட்சி, சமூகத்தின், வணிக, பெருநிறுவன, நிறுவனம், நிறுவனம், நிறுவனம், நிறுவனம், துணிகர, நிறுவன
காகித: தாள், அட்டை, à:, செய்தித்தாள்
நிகழ்தகவு: வாய்ப்பு, வாய்ப்பு, வாய்ப்பு, சாத்தியமான, சாத்தியம், வாய்ப்பை, வாய்ப்பு, சாத்தியமான, மாறிகள், முரண்பாடுகள்
குறிப்பாக: சிறப்பு, சிறப்பாக, குறிப்பாக, குறிப்பாக, குறிப்பிட்ட, சரியாக, முக்கியமாக, பெரும்பாலும், முதன்மையாக, குறிப்பிட்ட, முக்கியமாக, பொதுவாக
தாங்க: செயல்படுத்த, தாங்க, பொறுமை, சகிப்புத்தன்மை, உள்ளது, சுதந்தரித்துக்கொள்கிறது, வாங்க, பொறுத்துக்கொள்ள
சாளரத்தில்: 
ஒப்பந்தம்: நெறிமுறை, தீர்வு, சமரசம், ஒருமித்த, ஒப்பந்தம், ஏற்கிறேன், ஒப்பந்தம், ஒப்பந்தம், ஒப்பந்தம், நாண், ஒப்பந்த, மாநாடு, ஏற்பாடு, பேரம்
அழகு: அழகாக, திறமை, அழகியல்
கடமை: பொறுப்பு, பொறுப்பு, கடமை, பொறுப்பு, சுங்க, பணி, வேலையை, கடன், கடமைப்பட்டிருக்கிறேன், வேண்டும், பயன்படுத்துகின்றனர், விதி
அனுப்பு: பரிமாற்றத்திற்கு, சமர்ப்பிப்பு, பதவியை, ஒளிபரப்பு, மின்னஞ்சல், ஒலிபரப்பு, வேண்டும், வழங்க, சமர்ப்பிக்க
தொலைவில்: அகற்றுதல், எல்லை, பிரிப்பு, தெரு, இடைவெளி
அமைதி: அமைதி, அமைதியான, அமைதியாக, தனிமை, சமாதானம்
கால்: கால், சப்பாணியாய், தொடையில், கால், கால், தனக்காகப், இயங்கும், ஒழுங்காக, படி
காட்டு: பெருமளவில், சட்டவிரோத, கடுமையான, வன, காட்டில்
இறக்க: இறந்த, இறக்கும், ஆஃப், மூடப்பட்டது
சேமிக்க: சேமிப்பு, பாதுகாப்பு, மீட்க, பாதுகாப்பதற்காக, பாதுகாப்பு, மனப்பாடம், கடை, மீட்டு, மீட்பு, பதிவு, பாதுகாப்பு, பாதுகாக்க, விடுபட
பச்சை: மூல, கச்சா
பிரச்சனையில்: தொந்தரவு, பிரச்சினை, பிரச்சனை, துன்பங்களையும், சிரமம், பிசைந்து, பாதிக்கப்பட்ட, சிக்கல், தடையாக, தர்மசங்கடத்தில், சங்கடம்
புன்னகை: சிரிப்பின்
தவறு: தவறு, பிழை, தவறாக, மோசமாக, தவறாகநடத்து, தவறான, தவறு, தோல்வி, குறைபாடு, தவறாக, ஆய்ந்தறியாமல்
தூங்கு: தூங்கி, கனவு, தூக்கம்
quotativeவழக்கு: 
தொடங்கி: தொடங்கும், தொடக்கத்தில், மேற்கொள்ள, புதிதாக, தொடங்கிய, ஆரம்ப, ஆரம்ப, தொடங்கப்படுவதற்கு, அறிமுக, கொள்கை, மேற்கொள்ளவேண்டும், தொடங்க
நடவடிக்கை: பணி, புள்ளி, படி, நிலை, செயல், செயல்முறை, செயலில், அறுவைசிகிச்சை, செயல்பாட்டு, செயல்படுத்த, ஆர்வலர், நடவடிக்கை, நடைமுறையில், நடைமுறையில், இயக்குகிறது, பங்கு, மரணதண்டனை, இயக்க, நடத்தை
விஜயம்: அணுகல், பேட்டி, அணுக, பயண, பயணம், பயணம், சுற்றுப்பயணம், தத்துவம், விமர்சிக்க, சந்தித்தல், பரிசு
பின்பற்றவும்: இணக்கம், கடைபிடிக்கின்றன, பின்வரும், தொடர, பாடல், உடன், கீழ்ப்படிய, அடுத்தடுத்த, நீடிக்கின்றனர்
முயற்சி: முயற்சி, முயற்சி, முயற்சி, முயற்சி, சோதனை, சோதனை, மாதிரி, விடாமுயற்சி, விசாரணை, தேர்வு, பரீட்சை
முன்னிலையில்: இருப்பு, இருக்கிறது, நிறுவனம், சொத்து, நிகழ்வு, பார்வை, வருகை
கனரக: திரும்பச்செய்தல், பெரிதும், கடினமான, கடுமையான, எடை, தீவிரமாக, மகத்தான, கல்லீரல், பெரிய, பாரிய
இனிப்பு: இனிப்பு, சாக்லேட், மென்மையான, சாதுவான, அழகான
வாய்: வாய்வழி, குவளை, வாய், முகம்
பணக்கார: நிறைய, ஏராளமாக, பணக்கார, ஆடை, தாராள
எதிரி: விரோத, எதிர்ப்பாளர், எதிராக
கப்பல்: படகு, புறப்பட்டது, கப்பற்படை, படகோட்டம், கப்பல், கப்பல், படகு, தொப்பை, விலகி
நிலை: பந்தயம், பந்தய, அரசு, நிலைமை, சூழ்நிலைக்கு, நிலை, அதிர்ஷ்டம், நிலை, நிலை, உடற்பயிற்சி, தேவை
இவர்களும்: கொண்டிருக்கிறது, சேர்க்கிறது, உள்ளடக்கியது, சேர்ந்தவை, கொண்டிருக்கும், தவிர
உள்ளடக்கியநபர்: 
தோன்றும்: தோற்றம், எழும், வெளிப்பட, எழுச்சி, தெரியும், தெரிகிறது, பார்க்க, முற்றுகையிடும்
இரகசிய: மர்மமான, மர்மம், முள், நிலத்தடி
தயவுசெய்து: கனிவான, கேட்க, கருணை
precativeமனநிலை: 
கண்ணியமாகபதிவு: 
தீய: தீங்கு, மோசமான, தீய, கெட்ட, மோசமாக, பரிதாபம், தவறான, மோசமாக
மார்ச்: அணிவகுப்பு, எதிர்ப்பு, ஆர்ப்பாட்டம், செவ்வாய்
மெதுவாக: படிப்படியாக, மெதுவாக, மெதுவாக, மெதுவாக, தாமதமாக, படிப்படியாக
அதற்குபதிலாக: அதற்குபதிலாக, மாறாக, தவிர, மாற்று, பதிலீட்டு, இதற்குமாற்றாக, சார்பில்
நீல: சியான்
சாத்தியமற்றது: 
பள்ளி: வளாகத்தில், ஏணி
விழாவில்: வாய்ப்பு, நிகழ்ச்சி, நிகழ்வு, வாய்ப்பு, அவென்யூ, பேரம், மணிக்கு
திருமணம்: திருமணம், திருமணம், திருமண
உணவு: உணவு, உணவில், டிஷ், ஏப், சாப்பிடவேண்டும்
இருபது: 
எளிதாக: வாய்ப்பு, உடனடியாக, பொறுப்பாக, எளிதாக, வசதிக்காக, லேசான, சற்று, சிறிது, வசதியான, நேரடியான, சுருக்கமாக
வருங்காலஅம்சம்: 
மொழி: மொழியியல், தாய்மொழி, அடித்தளம்
வெளிப்பாடு: வெளிப்படுத்த, அறிக்கை, சொற்றொடர், புகுத்துவதற்கான, வெளிப்பாடு, வார்த்தையினாலும்பிழைப்பான், சமன்பாடு, பிரதிநிதித்துவம்
வாரம்: ஞாயிறு, வாராந்திர
மண்டபம்: தியேட்டர், கூடத்தின், விண்வெளி, அறை, வரவேற்புரை, லவுஞ்ச், இடைகழி, ரன்னர், லாபி, துளை, சுமையில்
ஆபத்து: ஆபத்தான, ஆபத்து, தீங்கு, மரியாதை
வழக்கம்: பொதுவாக, பொது, பொதுவான, வழக்கமான, பொதுவான, வழக்கமாக, சாதாரண, அசாதாரண, பொதுவாக, சுமாரான, சாதாரண, ஒழுங்கற்ற, வழக்கமான, வழக்கமான, சாதாரண, பொதுவாக, பொதுவாக, முக்கிய, வழக்கமான, பழக்கமானவர்கள், வெற்று, சுமார், எளிய, மிதமான
பிறப்பு: பிறந்த, மறுபிறப்பு, உள்ளார்ந்த
நீதிமன்றம்: நீதித்துறை, டிஷ், மன்றம், வழக்கு
gnomicஅம்சம்: 
மதிப்பு: தகுதி, மதிப்பு, மதிப்புமிக்க, செல்லுபடியாகும், தகுதி, செலவு, விலை
மரம்: ஆலை, மரம், தண்டு, உத்திரம்
சுவர்: 
சொர்கம்: வானத்தில்
inchoativeஅம்சம்: 
jussiveமனநிலை: 
தொனி: சுருதி, மெல்லிசை, டன், டன், நிழல், சூரை, ஒலி
சம்பந்தமாக: மரியாதை, கருதி, கருதுகின்றன, கவனம், கருத்தில், கருத்தில், உறவு, சங்கம், உறவு, கருத்தை, பாதுகாப்பு, உறவுகள், தொடர்புபடுத்த, தொடர்புடைய, தொடர்புடைய, சம்பந்தப்பட்ட, சேர்ந்தவை, தொடர்பாக, தொடர்புடைய, ஒத்திருக்கிறது, தொடர்புடைய
மாதம்: சந்திரன்
அனுபவம்: அனுபவ, அனுபவங்களை, அனுபவம், நிபுணத்துவம், அனுபவம், சோதனை
சூழ்நிலை: சூழ்நிலையில், சூழ்நிலைக்கு, நிலைமை, தளர்வாக
புதிய: புதிதாக, தூய, சுத்தமான, தூய்மையான, புதிய, புதிய, சமீபத்திய
பிரபு: ஆட்சியாளர், இளவரசன், பெருமகனார்
மூடப்பட்ட: உள்ளடக்கும், பாதுகாப்பு, ஆஃப், மூடப்பட்டது, உட்புற, கவர், ஆட்சி
பிணைப்பு: அளவிற்கு, தடையும், எல்லை, எல்லை, கட்டுப்பாடு, தடை, இணைக்கப்பட்ட, சார்ந்திருக்கிறது, ஜெர்மானிய, எல்லை, எல்லைக்குட்படுத்த
கிழக்கு: கிழக்கு, முன்பு, முந்தைய, முன், முன், ஓரியண்ட்
கல்: பளிங்கு, ராக், மாணிக்கம்
திசையில்: நோக்குநிலை, பரிமாணத்தை, போக்கு, தரப்பும், அறிவுறுத்தல்
நாற்காலியில்: இருக்கை, நாற்காலியில், மல, லவுஞ்ச்
ஆதரவு: தக்க, ஒப்புதல், உதவி, உதவி, அடைப்புக்குறி, உதவி, அடிப்படையில், ஊன்றுகோலாக
தேதி: வரலாறு, என்கவுண்டர்
கிராமத்தில்: குக்கிராமம், கிராமப்புறங்களில்
துறையில்: கோளம், உலகினில், பிராந்தியம், பிரதேசத்தில், பகுதியில், மண்டலம், துறை, டொமைன், அரங்கில், அரங்கம், விண்வெளி, விளிம்பு, கிராமப்புறங்களில், முகாமில், விவசாய
காத்திருக்க: எதிர்பார்க்க, நடத்த, தங்க
அனுமதி: அனுமதிக்க, காது, அனுமதி, அனுமதி, விட்டு, உரிமம், உரிமம், ஒப்புதல், பதிப்பு, உடைமை, ஒப்புதல்
அனுமதியளிக்கும்மனநிலை: 
வெற்றி: வெற்றிகரமான, வெற்றி, செழிப்பு, சாதனை, வெற்றி, வெற்றி, வெற்றி, வெற்றி, வெற்றி, வாய்க்கும்
மலை: மலை, மலையின், எரிமலை
இசை: இசை, பாரம்பரிய
சேய்மைவெளிப்படுத்துகிறது: 
பிற்பகல்: இரவு, நண்பகல், நண்பகலில், சாயங்காலம்
அழுகை: துக்கம்அனுஷ்டிக்க, கத்தி, அலறல்
மரியாதை: மரியாதை, மரியாதை, கண்ணியம், மரியாதையான, கெளரவமான, மரியாதைப், மரியாதை, மகிமை, விகிதம், விலை
ஏழு: 
தனியார்: தனிப்பட்ட, சுய, தனிப்பட்டமுறையில், சிறப்பு, தனியுரிமை, குறிப்பிட்ட, பிரத்தியேக
உட்கார: தங்க, குடியேற
செய்தி: செய்தி
காட்சி: தளத்தில், பார்வை, சூழல், காட்சி, காட்சி, நிலை, பார்வை, வாய்ப்பை, கூடாரத்தில், தோற்றம்
தோட்டத்தில்: தோட்டக்காரன், பூங்கா
இனம்: இன, பந்தய, இயங்கும், போட்டியில், போட்டியில், ஒப்பந்தம், இனப்பெருக்கம், போட்டியில், தேசிய, ஸ்க்ரேம்பில், சரிகை
பங்கீட்டுவழக்கு: 
அறிய: ஆய்வு, கற்று, வேண்டுமென்றே
அரசியல்: அரசியல், அரசியல், அரசியல்வாதி, கொள்கை
பேச்சு: விரிவுரை, பேச்சு, உரையாடல், சொற்பொழிவு, பேச்சு
பொய்: தவறான, ஏமாற்ற, ஏமாற்ற, கையாள
நடித்தார்: வீசுவதற்கு, தூக்கி, எறிந்தால், டாஸ், வடிவம், அச்சு, வெளியீட்டு, சிந்த, விட்டுவிட
சாப்பிட: உணவு, ஏப், டிஷ், சாப்பிடவேண்டும், நுகர்வு
தரை: கம்பளம், தரையில், கீழே, மண், நடக்க, உயர், உயரமான, இலக்கு
கோடை: வெப்பம், சூடான, வெப்பமூட்டும்
மதம்: மத, கடன், சமயத்தை, வளர்ப்பு
படம்: உருவப்படம், ஓவியம், படத்தை, புகைப்படம், புகைப்பட, புகைப்படம், புகைப்படம், பிரதியொன்று, வரைதல், படம், படம், உவமை, சித்தரிப்பு, அத்தி, எண்ணிக்கை
தப்பிக்கும்: வெளியேற
ஆசிரியர்: எழுத்தாளர், ஆசிரியர், ஆசிரியர்
பழுப்பு: சாம்பல், சாம்பல், பழுப்பு, வெண்கல, சாக்லேட், கோதுமை
தீர்மானிக்கப்படுகிறது: உறுதியை, முடிவு, தீர்மானிக்க, திட்டவட்டமான, உறுதியான, வடிவமைப்பாளர், குறிப்பிட்ட, அறிந்துகொள்ள, நிலையான, சில, முடிவு, துணிகாரணி, நிலையான
வலி: காயம், வேதனையான, வலி, வருத்தத்தை, புண், தாங்கொணாத்துயர்
வசந்த: இறகு, எங்கள், நம்முடைய
மென்மையான: concessive, மென்மையான, இறுதியாக, ஒப்பந்தம், மெதுவாக, மெதுவாக, மென்மையான, சாதுவான, லேசான, மென்மையானது, உள்ளார்ந்த
மூலையில்: கோணம், பரந்த
: , , , , , , , , , , , , , , , , , , , , , , , , , , , , , , , , , , , , , , , , , , , , , , , , , , , , , , , , , , , , , , , , , , , , , , , , , , , , , , , , , , , , , , , , , , , , , , , , , , , , , , , , , , , , , , , , , , , , , , , , , , , , , , , , , , , , , , , , , , , , , , , , , , , , , , , , , , , , , , , , , , , , , , , , , , , , , , , , , , , , , , , , , , , , , , , , , , , , , , , , , , , , , , , , , , , , , , , , , , , , , , , , , , , , , , , , , , , , , , , , , , , , , , , , , , , , , , , , , , , , , , , , , , , , , , , , , , , , , , , , , , , , , , , , , , , , , , , , , , , , , , , , , , , , , , , , , , , , , , , , , , , , , , , , , , , , , , , , , , , , , , , , , , , , , , , , , , , , , , , , , , , , , , , , , , , , , , , , , , , , , , , , , , , , , , , , , , , , , , , , , , , , , , , , , , , , , , , , , , , , , , , , , , , , , , , , , , , , , , , , , , , , , , , , , , , , , , , , , , , , , , , , , , , , , , , , , , , , , , , , , , , , , தி, ஒரு, ஒரு, சமர்ப்பிக்க, வலுப்படுத்த, சோதனை, ரெயின்கோட், அணைப்பான், வரவேற்பாளர், சன்ஸ்கிரீன், தொகுப்பாளர், ப்ரொஜெக்டர், மயக்கும், எலக்ட்ரீஷியன், குளிக்க, சென்டிமீட்டர், பர்ஸ், தயக்கமும், உறுதிப்படுத்தல், வண்டி, சரக்கு, பழக்கமானவர்கள், சாதாரண, தீங்கு, தையல்காரர், வயலின், தோட்டக்காரன், தச்சு, குவளை, பசை, காலஇடைவெளிகளில், நடைபாதையில், சூறாவளி, தாவணி, சுற்றுலா, வெண்ணிலா, பேட்ஜ், இனிப்பு, வில், வருங்கால, கிடங்கு, காசாளர், திண்டு, பேஸ்ட்ரி, நூலகர், உடற்பயிற்சிக்கூடம், கிரேன், செஃப், பொதுவான, தூய்மையான, பணியாளர், ஆலோசகர், காகிதம்முதலியஎழுதுபொருள்கள், மசாஜ், பேக்கரி, சேடன், நுண்ணலை, பிளம்பர், கிரில், பங்குதரகர், கையேட்டை, ஹாம்பர்கர், ஹீட்டர், ஒப்பனை, பார்பெக்யூ, பாப்கார்ன், பின்விளைவுள்ளதுமான, லோகோ, சூரை, பசியைதூண்டும், டைமர், மருந்தாளர், பயணிகள், அட்டைப்பெட்டி, செயல்திட்டமாக, கைப்பெட்டியை, படிக்கட்டு, நீச்சல், லெட்டர், பாத்திரங்கழுவி, பையுடனும், கடல், சக்கரநாற்காலியில், நடைபாதை, கைப்பந்து, கண்டிஷனர், பிணிக்கை, sauna,, புதுப்பித்து, டோனர், தொழில், குலுக்கல்
உற்பத்தி: தயாரிப்பு, உருவாக்க, உற்பத்தி, ஜோடிக்கப்படுவார், உற்பத்தி, உற்பத்தி, பயிர், பயிர்கள், தயாரிப்பு, உருவாக்கம், உருவாக்கம்
சிரிப்பு: வேடிக்கைப், சிரிப்பு
மறக்க: கண்டுக்கொள்ளாமல், மறுக்க, கவனத்தில்
ஐரோப்பா: 
எட்டு: எட்டாவது
கடந்துசென்ற: மூலம், மூலம், கடந்து, வழியாக, கடந்துவிட்ட, பத்தியில், கடப்பு, மாற்றம், மாற்றம், இடைகழி
பயங்கரமான: பரிதாபம், பயங்கரமான, மோசமாக, அச்சுறுத்தலான, மிகப்பெரிய, சோக, ஆபத்தான, பயத்தின், அரக்கத்தனமான, இவ்வளவு
நிமித்தம்: நோக்கம், சாதகமாக, சாதகமாக
மூச்சு: சுவாச, மூச்சு, சுவாச, வளர்ந்தவர்கள், ஈகோ, மூச்சுத்திணறல், பெருமூச்சு, விஸ்பர், உள்ளிழுக்க, முகர
பாண்டித்தியம்: நியாயமான, விவேகமான, நளினமான, சிந்தனை, புத்திசாலி, ஸ்மார்ட், அறிவார்ந்த, முதிர்ந்த, புத்திசாலித்தனமான
சொந்தம்மார்க்கர்: 
இனிமையான: மகிழ்வளிக்கும், சுவாரஸ்யமாக, சாதகமான, வசதியாக, வசதியாக, ஆர்வத்தினை, நல்ல, நன்றாக, வகையான, அழகாக, வேடிக்கை
செய்தபின்: முற்றிலும், முழுமையாக, முற்றிலும், முற்றிலும், தீவிரமாக, சரியான, உண்மையிலேயே, முற்றிலும், மிகவும், சரியாக, முற்றிலும், அறுதி
நினைவக: மனப்பாடம், குறிப்பு, நினைவு, சுவடு
கல்லறை: தீவிர, கடுமையான, பெரிதும், கல்லறை, விமர்சன
நவீன: சமகால, அதிநவீன, புதுமையாக, நாகரீகமாக, சமீபத்திய, சொற்பொழிவு, பிந்தைய, மேம்பட்ட, இப்போதெல்லாம்
ஸ்பாட்: புள்ளி, டாட், மணிக்கு, இடம், கறை, இணைப்பு, இடத்தில், எங்கும், வளாகத்தில், நிலையிடமாகவும், தளத்தில், உள்ளூர், கண்டறிவது, அடையாளம், பெருங்குடல்
இடைவெளி: முறித்து-ல், பிரேக், ரிசார்ட், லவுஞ்ச், குறுக்கீடு, இடைவெளி, இடைவெளி, நொறுக்கு, நொறுக்கு, நிறுத்த, இடைநிறுத்தம், குறுக்கிட, அமைதியற்ற
தீவின்: 
தொட: தொடர்பு, குழாய்
சம: சமமான, அதே, ஒத்த, சரியாக, சரி, எல்லாம்சரி, சமமாக, பட்டம், சம, ஒரே
கரையில்: காப்பு, விளிம்பில், கடற்கரையில்
வாக்குறுதி: தெரிவித்தல், அர்ப்பணிப்பு, உறுதிமொழியை, நியமனம், உத்தரவாதம்
commissiveமனநிலை: 
திட்டம்: திட்டம், ஒப்பந்தம், திட்டம், திட்டம், முயற்சி, பிளானர், செயல்திட்டமாக, திட்டம், திட்டம், சதி, ஓவியத்தை, திட்ட, அமைப்பு, பிளாட், வரைதல், வடிவமைப்பு, கருத்தாகும், திட்டமிடல், சிந்தித்தல்
ஆச்சரியம்: வியத்தகு, எதிர்பாராத, தற்செயலான, ஆச்சரியம், தெரியவில்லை, வியக்கத்தக்க, ஆச்சரியமாக
நிமிடம்: 
ஷாட்: சுட, படப்பிடிப்பு, புல்லட், வெடிபொருட்கள், புகைப்படம், புகைப்படம், அடி, களமிறங்கினார், ஆட்சிகவிழ்ப்பு, தூக்கி, சட்ட, கிக்
வழிவகுக்கும்: தலைமை, முன்னணி, விலகி, புல்லட், இயக்கி, வழிகாட்டும், கொண்டு, ஒல்லியான
கண்ணாடி: கண்ணாடியில், படிக, ஜாடி, கண்ணாடி, பக்கம், ஏற்றுமதி
குழு: அடுக்கில், சபை, வரை, உயரும், சவாரி, குழு, குழு, குழு, ஆலோசனை, விளிம்பில், கமிஷன், மாத்திரை, பதிப்பு
உதாரணமாக: உதாரணமாக, உவமை, மாடல், முறை, உருவகம், முன்மாதிரி, போன்ற, பிரதிநிதித்துவம், மாதிரிவிண்ணப்ப, வழக்கு, முன்னோடி, மாதிரி, முன்னுதாரணம், விளக்குவதற்கு, ஆம்
பாதுகாப்பான: பாதுகாக்க, பாதுகாப்பு, பாதுகாப்பு, பாதுகாப்பாக, நம்பிக்கை, காப்பீடு, உறுதி, பாதிப்பில்லாத, அகற்றுதல்
மருத்துவர்: மருத்துவர், சிகிச்சை, பயிற்சியாளர், மருத்துவ, பல்
வகுப்பு: வகையான, வட்டபாதையில்சுற்றி, வகுப்பறையில், தர, பிரிப்பு, அடுக்கு, வகை, சாதனை, மாவட்டத்தில்
முழுமையாக்கும்அம்சம்: 
மீண்டும்மீண்டும்: அடிக்கடி, வழக்கமான, நிலையான, தொடர்ந்து, எப்போதாவது, அடிக்கடி, வழக்கமாக, காலஇடைவெளிகளில், திரும்பச்செய்தல், மீண்டும், மீண்டும், திருத்தம், மறுசெய்கை
இராணுவ: கவுண்டி
சூடான: சூடான, வெப்பம், அரவணைப்பு, வெப்பநிலை, வெப்பமூட்டும், கிராம், புழுக்கம்
பானம்: பானம், குடிவெறி
கோபம்: கோபம், ஆத்திரம், சீற்றம், எரிச்சல், இருந்தபோதும், சினம்கொள்ள, கோபமாக
நேரடியாக: நேராக, நேரடி, மறைமுக, தானியங்கி, நேரடியான, உடனடியாக, நேராக்க, உடனடியாக, வாய்மொழி
தொப்பி: தொப்பி, ஹெல்மெட்
நாய்: 
வேலைக்காரன்: உக்கிராணக்காரன், பணியாளராக, பணியாளர், பணிப்பெண், அடிமை, உள்நாட்டு
பெருமை: திமிர்பிடித்த, பெருமை, பெருமையுடன், இறுமாப்பு
கூட்டத்தில்: அவசரத்தில், நெரிசலான, கும்பல், அளவு, அளவு, மக்கள்தொகை, தொகுப்பாளர், குவியல், மிகவும், நிறைய, பல, தீவிரமாக, போதிய, மொத்தமாக, கூட்டம்
ரயில்: வண்டி, கார், வேகன், வண்டி, ரயில், ரயில், கல்வி
தார்மீக: அறநெறி, விறைப்பான, நெறிமுறை, நெறிமுறைகள், மனஉறுதியை, ஆன்மீக
கிரேக்கம்: 
பொருந்தும்: வழக்கு, பொருத்தமான, மிகவும்பொருத்தமானது, இணக்கமான, சரியான, வசதியான, அதற்கான, ஒத்திருக்கிறது, தகுதி, தொடர்புடைய, ஒப்பந்தம், சரி, சரியான, துல்லியமான, யதேச்சையாகநடந்தது
உள்ளிடவும்: பதிவு, நுழைவு, அரசு, குறிப்பிடுகிறது, நுழைக்க, சேர்க்கிறது, பதிவு, பதிவு
ஆட்சி: நிர்வாகம், ஆதிக்கம், ஆட்சி, தீர்ப்பு, தீர்ப்பு, தீர்ப்பு, நடுவர், ஆட்சி, சட்டம், சட்டம், விதிமுறை, அரசு, கட்டுப்படுத்தும், ராஜாவாகி, கட்டுப்பாடு, மருந்து
வாள்: கத்தி, கத்தி
தாக்குதல்: படையெடுப்பு, படையெடுத்து, ஆக்கிரமிப்பு, குற்றம், தாக்குதல், குற்றம், வேலைநிறுத்தம், தொடங்கிய, தாக்குதல், RAID
சுகாதார: ஆரோக்கியமான, வாழ்த்த
பத்தி: வசனம், உட்கூறு, துண்டின், புள்ளி, அணுகுமுறை, நிலைப்பாடு, சம
சமூக: சமூகத்தின், சமூக
பணத்தைதிரும்ப: பதில், பதிலளிக்க
மன்னிக்கவும்: வருத்தப்பட, துருவ, மன்னிப்பு, தவிர்க்கவும், மன்னிப்பு, பரிதாபம், துக்கம், பாதிக்கப்படுகிகிறது, பாதிக்கப்பட்ட, வருத்தத்தை, வேதனையான, துக்கம், சோகம், துக்கம்அனுஷ்டிக்க, துன்பங்களையும்
தைரியம்: பறித்து, தைரியமான, நம்பிக்கை, நரம்பு, மனோபலம், தைரியம், துணிச்சலான, கப்பல்
அதிகாரி: சாதாரண, முறையாக, அதிகாரப்பூர்வமாக, அதிகாரி, எழுத்தர், அதிகாரத்துவ, அங்கீகரிக்க
வழங்கப்படும்: வழங்கும், சலுகை, வழங்கும், அறிமுகம், கிடைக்கும், வழங்கல், ஒதுக்கீடு, பூர்த்தி, என்றால்
கோரிக்கை: பிரார்த்தனை, தேவை, கூற்று, தேவைப்படும், தேவை, விசாரணை, விசாரணை, வரியில், முயற்சியில், பயன்பாடு, விரும்புகிறேன்
பார்வையில்: பார்வை, பார்வை, அணுகுமுறை, கருத்து, மேற்பார்வை, பார்வை, பார்க்க, குறிப்பிடத்தக்க, எல்லையைக், கண்ணைகூசும்
பரவல்: விவரம், நீட்டிக்க, நீட்டிப்பு, விரிவாக்கம், விரிவாக்க, பரவலாக, நோய்த்தாக்கம், பரவல், சிதறல், ஊடுருவி, வீச்சு, பரப்பு
எதிர்: முன், எதிர்க்கும், மாறாக, எதிர்க்கும், எதிராக, முழுவதும், எதிர், போலல்லாமல், முரண்படுகின்றன, கவிழ், வைக்கவும், எதிராக, எதிர்ப்பு, எதிர்ப்பு, தலைகீழாக
பன்னிரண்டு: டஜன்
ஈடுபட்டுள்ள: நிச்சயதார்த்தம், பிஸியாக, சம்பந்தப்பட்ட, பங்கேற்க, ஆக்கிரமிக்கப்பட்ட, ஈடுபட, மடி, நடைமுறைக்கேற்ற, தலைகீழ்
மது: மது, மது
சுவை: சுவை, சுவை, ருசியான, தூண்டில், அனுபவம்
இரும்பு: எஃகு, உலோக
விநியோகிக்க: பரிமாற்றத்திற்கு, வரிசைப்படுத்த, வெளியிட, வெளியீட்டு, பரவல், பரப்பு, விநியோகம், ஒதுக்க, பங்கு, பிளவை, பிளவு, பிரிக்க, வகைப்படுத்த, பங்கீட்டு, வழங்கல்கள்
வர்த்தக: வர்த்தக, வணிக, காமர்ஸ், ஒருவிற்பனைப், இணைய, பேரம், பரிவர்த்தனை, மார்க்கெட்டிங், வணிக
நீதிபதி: தீர்ப்பு, தீர்ப்பு, நடுவர், ஜூரி
ஆர்வத்துடன்: அவசர, அவசர, சம்பந்தப்பட்ட, எச்சரிக்கைவிடப்பட்டிருந்த, கவலை, பதட்டம், அக்கறை, கவலைப்பட, சிந்தனை, சங்கடமான, வருந்ததக்க, பயம், முனைப்புடன், குழப்பமான, ஆபத்தான, ஆர்வத்துடன், ஆர்வமாக, அமைதியற்ற, கூச்சமாக, ஆர்வத்தை, அமைதியின்மை, மனக்கவலையை
கேப்டன்: 
நிறுத்துதல்அம்சம்: 
வெளிநாட்டு: வெளிநாட்டில், அன்னிய, வெளிநாட்டவர், கவர்ச்சியான, அந்நியன், வெளி, வெளிநாட்டு
தீவிரப்படுத்தி: தீவிரப்படுத்தும்
முக்கியத்துவம்: தேவை, சம்பந்தம், பொருள், முக்கியத்துவம், முக்கியமான, வலியுறுத்தல்
இறுதியாக: இறுதியில், இறுதியில், வரையறுக்கப்பட்ட, இறுதி, இறுதி, முனையத்தில், இறுதியாக, இறுதியில், தூக்கியெறிய
நிரூபிக்க: ஆதாரம், உறுதி, உறுதிபடுத்தவும், நிரூபிக்க, சாட்சியமளிக்க, புரிந்து, வெளிப்படையான
தடுக்க: போர்நிறுத்தஒப்பந்தம், காப்பாராக, காவலில்வைக்கவும், நசுக்கிவிடும், கட்டுப்படுத்த, தடுக்கும், தொகுதி, நிதானப்படுத்த, பின்வாங்க, தடை, தவிர்க்க, ஒடுக்க, இடைநிறுத்த, சப்பாணியாய்
கழுத்து: தொண்டை, உருப்படியை
சுவாரஸ்யமான: வேடிக்கை, வேடிக்கையான, கருத்துகளுக்கு, ஆர்வத்தினை, கவர்ச்சிகரமான, ஈர்க்க, ஈர்க்கக்கூடிய, வரைய, முறையீடு, வாபஸ், உற்சாகமான, ஆர்வமாக
சட்ட: நீதித்துறை, சட்டம், முறையான, சட்ட, கோட்பாடுகள்
உலர்: தண்டு, தூள்
சேவை: சேவை, சம்பாதிக்க, பூர்த்தி, சலுகை
ஆதாரங்கள்: சான்றுத், ஆதாரம், வழிகாட்டும், துப்பு, அடைவு, காட்சி, சாட்சி, தெளிவாக, சாட்சியமளிக்க
சான்றுத்வழக்கு: 
தொலைதூர: விட்டு, இதுவரை, ஆஃப், தவிர, மடிக்கணினி, தொலை, தூரவிலகி, வெகுதொலைவில், விரட்டி
முன்னேற்றம்: சுவடு, முன்னேற்றத்தை, வளர்ச்சி, முற்போக்கான, வளர்ச்சி, முன்னெடுக்க, தொடர, முன்னேற்றம், முன்னேற்றம், வளர்ச்சி, பதவிஉயர்வு, முறையில், செயல்முறை
குறுகிய: மெல்லிய, இறுக்கமான, குறுகிய, எல்லைக்குட்படுத்த, எரிச்சலூட்டும், குறைக்க, வரையறுக்கப்பட்ட
கட்டிடம்: உருவாக்க, அமைப்பு, கட்ட, கட்டுமான, வளாகத்தில், எலும்புக்கூட்டை
தேடல்: கண்டுபிடிக்க, கண்டறிய, கண்டுபிடிப்பு, தேடலை, கண்டறிதல், முயன்று, நாட, ஆராய்ச்சி, கணக்கெடுப்பு, நோக்கத்தில், விசாரணை, விசாரணை, விசாரணை, ஆய்வு, கண்டுபிடிப்பு
வருத்தம்: மனஅழுத்தத்துடன், துரதிர்ஷ்டவசமாக, துன்பகரமான, பயத்தை, வருத்தம், வருத்தம், மகிழ்ச்சியற்ற
பாவம்: குற்ற, துரதிர்ஷ்டவசமாக, தெரிவித்தல்
உடம்பு: தவறான, புண், நோய், நோயாளி, நோய்
நேர்மையான: நேர்மையான, விசுவாசமான, நேர்மையாக, வெளிப்படையான, நேராக, நேர்மையற்ற
வங்கி: பெஞ்ச், தகரம்
காட்டில்: காட்டில், வனவியல்
அளவிட: பாதை, அளவீடு, எடையை, மீட்டர், மீட்டர்
ஸ்ட்ரீம்: ஓட்டம், உட்கூறு, தற்போதைய, மின்சாரம், ஃப்ளக்ஸ், ஜெட்
கவனமாக: நெருக்கமாக, கவனமாக, எச்சரிக்கையாக
ரொட்டி: சுடுவது, விதைத்து, ரொட்டி, பருக்கை, பான்
கூடுதல்: கூடுதல், உதிரி, மேலும், அதிகமாக, உபரி, மேலும், கூடுதலாக, துணை, சேர்க்க, குடல்வால், ய, பக்கவாட்டு, போனஸ்
தேர்வு: தேர்வு, தேர்வை, தேர்வு, தேர்ந்தெடுக்கப்பட்ட, அழைத்து, தேர்ந்தெடுக்கப்பட்டுள்ள, டயல், வாக்கு, தேர்வு, விருப்பம், நியமிக்க
விலங்கு: உயிரினம், ஆண்பால்
zoicபாலினம்: 
eventiveமனநிலை: 
பெருக்கல்வழக்கு: 
பெற: ஆதாயம், பெற, கையகப்படுத்தல், பெறும், கிடைக்கும், கண்டுபிடிக்க, பாதுகாக்க, பாதுகாக்க, தக்க, வருவிக்க, எடுக்க, உள்ளது, சாதிக்க, அடைய, திருமணம்
கடந்து: முழுவதும், கடப்பு, கடந்து, தாண்ட, ஊடுருவி
தடித்த: பருமனான, அடர்ந்த, அடர்ந்த, கொழுப்பு
வளர: பயிரிட, உயரும், வளர்ச்சி
மழை: ஈரமான, மழை, மழை, வீழ்படிவு, அல்லாத, விளக்குமாறு
அமைதியாக: 
மேற்பரப்பு: முகம், நிலை, விமானம், பகுதியில், மூலக்கூறு
புனித: புனித, புகழ்பெற்ற
ஜூலை: 
ஃபேஷன்: நாகரீகமாக, முறையில், முறை, அணுகுமுறை, செயல்முறை
அறிக்கை: உறுதியை, அறிக்கை, விகிதம், உறவு, உறவு, நியாயமான, கண்காட்சி, கட்டுரை, வெளிப்பாடு
கோப்பு: ஆவணம், லாட்ஜ், சுயவிவர, காப்பகத்தை
தோள்பட்டை: தண்டு, அச்சு, சித்தரிப்பு, சீப்பு, கை
அரச: ஏகாதிபத்திய, முடியாட்சி, இராச்சியம், பேரரசு, உண்மையான, உண்மையான
பாடல்: இசைக்கு, பாடல், பாடும், கவிதை, பாட
ஆறுதல்: எளிதாக்க, நிம்மதியான, ஆசுவாசப்படுத்தும், ஊக்கம், வசதிக்காக, ஓய்வு, நிவாரண, வசதி
யாரையும்: யாரையும், யாரோ, யாரோ, யாரும், எல்லோருக்கும், அனைவருக்கும், எவர்
புல்: வைக்கோல், களை, மூலிகை, புல்வெளி, கிராம், வைக்கோல்
திறப்பு: பூர்வாங்க, ஆரம்ப, கண்டுபிடிப்பு, இடைவெளி, ஸ்லாட், வெளிப்படையாக, ஆரம்ப
ஜூன்: 
மீன்: மீன்
தலைநகர்: அத்தியாயம், நிதி, சொத்து
மார்பக: மார்பு, பால்
கல்வி: கல்வி, பாடம், கல்வி, கல்வியறிவு, உருவாக்கம், பயிற்சி, படித்த, கல்வி, அறிவுறுத்தல், கற்று, கற்பித்தல்
கூர்மையான: பிரகாசமான, கடுமையான, கடுமையான, தீவிரமாக, காரமான, கூரான, கடுமையான, முனைப்புடன், மிருதுவான, தெளிவாக, கண்ணைகூசும்
இழப்பில்: கட்டணம், செலவு, செலவு, பதிப்பு, வெளியீடு, வசூலிக்க, செலவிட
உன்: உங்கள்
மில்லியன்: மில்லயனாவது
பிரார்த்தனை: கேட்க, பிரார்த்தனை, பிச்சையெடுத்து, கடன்
சோர்வாக: சோர்வு, சோர்வை
கொலை: கொலை, கொலை, அகற்ற
நிழல்: நிழல்
நிறை: தரமான, கூட்டு, அளவு, மொத்தமாக, பன்மை, நிறைய, பெருந்தொகைப், கொத்து, கும்பல், குற்றம், மாவை, பாஸ்தா
நிறுவப்பட்டது: நிறுவ, திட, உறுதியாக, நிலையான, உருவாக்கம், நிறுவ, பதவியில், founds, ஸ்தாபனத்தின், உருவாக்கம், அமைக்க
திருப்தி: மகிழ்ச்சி, திருப்தி, மனநிறைவு, மகிழ்ச்சி, திருப்தி, திருப்தி, உள்ளடக்கம்
காசோலை: சரிபார்க்கவும், பார்க்க, பார்க்க, சோதனை, தேர்வு, ஆய்வு, ஆய்வு, தேர்வு, சோதனை, தணிக்கை, புதுப்பித்து, இடைநிலை, கணக்கெடுப்பு, விசாரணை, அறிந்துகொள்ள, திருத்தியமைக்கிற, கட்டுப்பாடு
நல்லொழுக்கம்: கருணை, நன்மை, கருணை, பண்பு, பண்பு, பண்பின்
தங்க: பொன்னிற
தேசிய: தேசிய, தேசிய, இன, உள்நாட்டு, தேசியவாத
முக்கிய: முதன்மை, முக்கிய, முக்கிய, முக்கிய, தலைமை, முன்னணி, பிரதான
பள்ளத்தாக்கில்: பேசின்
யூகிக்க: அனுமானம், சந்தேக, கருதுகின்றன, மதிப்பீடு, மதிப்பின்படி, கணிப்பு, கணிக்க, முன்அறிவிப்பு, ஊகம், தெய்வீக, அனுமானங்கள், எதிர்பார்க்கப்படுகிறது, மதிப்பீடு, மதிப்பீடு, மதிப்பீடு, தோராய, யூகிக்கக்கூடிய
ஊகமனநிலை: அனுமானமனநிலை
மஞ்சள்: வெளிர், அம்பர், பொன்னிற
எஞ்சியுள்ள: எச்சம், எஞ்சிய, மீதமுள்ள, மிச்சத்தை, ஓய்வு
வளைந்த: வளைந்த, வளைவு, போக்கு, முறுக்கப்பட்ட, சாய்வு, ஸ்லாண்ட், மடிப்பு, கருத்து, அனுமானம்
பெட்டியில்: சூட்கேசை, அலமாரியை, நிதி, கிட், முடியும், அட்டைப்பெட்டி, பின், காசாளர், சதுர, ஓடு, கட்டம்
சீசன்: பருவகால, அத்தியாயம், நிலையம், சகாப்தம்
அறிவியல்: அறிவியல், அமைப்பியல், மொழியியல்
வெளிப்படையாக: வெளிப்படையாக, தெளிவான, வெளிப்படையான, வெளிப்படையாக, வெளிப்படையாக, கூறப்படும், தெளிவாக, தெளிவாக
துளை: துளை, துரப்பணம், மந்தமான, சலித்து, துளைத்து, தொந்தரவு, மன்றம், சலித்து, sightsee
மாமா: அத்தை
பட்டியலில்: குறியீட்டு, அட்டவணை, அட்டவணை, மெனு, பதிவு
ஆகஸ்ட்: 
அமைதியாக: அமைதியான, சாந்தமான, அமைதியான, அமைதியாக, மெதுவாக, நிம்மதியான, அமைதி, மெதுவாக
பிரபலமான: நோய்த்தாக்கம், பிரபலமான, முக்கிய, நாட்டுப்புற, முன்னணி, மூத்த
அறியப்படாத: அந்நியன்
தெரிந்திருந்தால்: அறிமுகம், பரம்பரையில், சந்ததி, பயன்படுத்தப்படும்
தெரிந்திருந்தால்பதிவு: 
நடைபயிற்சி: நடக்க, ஜாக்கிரதையாக, தொடர, உயர்வு, உலா, பாதசாரி
இருமுறை: இரட்டை
அறிவுசார்: மனதில், உளவுத்துறை, மன, அறிவார்ந்த, மனநல, சிந்தனையாளர், ஞானம், ஆன்மீக
பூசாரி: மதகுருமார்கள்
காயமடைந்த: காயம், காயம், காயம்
அரண்மனை: 
அடிக்க: தோல்வி, பஞ்ச், கன்னத்தில்அறை, தட்டுங்கள், ஸ்லாம், ரிதம், கடக்க, வேலைநிறுத்தம், பிட், வெற்றி, வெற்றி, வெற்றி
முட்டாளாக்க: வேடிக்கையான, தந்திரம், ஏமாற்ற, ஏமாற்ற, முட்டாள், முட்டாள், பைத்தியம், பைத்தியம், பைத்தியம், தவறாகவழிநடத்த, அறியாமை, அறியாமை
ஒன்பது: ஒன்பதாவது, புதிய
அனுதாபம்: இரக்க, பச்சாத்தாபம், பரிதாபம், கருணை, அனுதாபம், கருணையுடன்
வெடிப்பு: குண்டுவெடிப்பு, வெடிப்பு, வெடிக்க, வேகப்பந்து, ஏற்றம், வலிப்பு, களமிறங்கினார்
உடையணிந்து: ஆடை, கவுன், சீருடையில், ஆடைகள், ஆடை
இலக்கியம்: இலக்கிய, பொருள், அலங்காரத்தில்
தொகுப்பு: செறிவு, குவிப்பு, தொகுப்பு, குழு, கலவை, வரிசை, கேலரி, தொகுப்பு, தொகுப்பு, தொகுப்பு, தொகுப்பு, திறமை, தீர்மானம், முடிவுக்கு, அனுமானம், சேகரிக்க
காலியாக: வெற்று, காலியாக, தேடுவதாகவும், ஓய்வு, பூஜ்ய, வெறுமையை, வெற்றிடம், வீண், வெற்று
புயல்: சூறாவளி, விலகி
பாக்கெட்: பையில், பாக்கெட்
தண்டனை: தீர்ப்பு, தீர்ப்பு, கருத்தாகும், தேற்றம், கருத்து, திட்டம், தண்டனை, தண்டனை, சொற்றொடர், ஆக்கினைக்குள்ளாகத்தீர்த்து,, பகிரங்கமாகக்கண்டனம், பெனால்டி, தண்டிக்க
நவம்பர்: 
டிசம்பர்: 
நடக்கும்: ஏற்படும், நிகழ்வு, இருக்கும், எழும், என்ன, அல்லது, எந்த, வரும்
இல்லாத: இல்லாமல், பற்றாக்குறை, பற்றாக்குறை
நன்றி: நன்றியை, நன்றியுடன், நன்றி, நன்றி, ஒப்பு, ஒப்பு, ஒப்புக்கொண்டாலும்,, பாராட்ட, தணிக்கையாளர்
தொடர்: சங்கிலி, சரம், வரிசை, வரிசை, தொகுப்பு, இதையொட்டி, எல்லை, வரிசையில்
முகவரி: கண்டுபிடிக்க
பறவை: விமானம், விமானம், ஜெட், விமானம், விமானம், விமானநிறுவனம், ஆந்தை
கோட்: கவுன், கவர், ஜாக்கெட், ஃபர்
தயார்: தயாராக, தயார், ஏற்பாடு, தயாரிப்பு, முறைப்படுத்துதல், நோக்கம், தயாராக, ஆர்வமாக, விருப்பமற்ற, சுண்ணாம்பு, சித்தப்படுத்து, உருவாக்க, அமைக்க, உருவாக்க, உருவாக்க
விரைவில்: விரைவில், வேகமாக, விரைவான, விரைவான
புகை: புகை, எரிக்க, ஒத்தி
ஜனவரி: 
இயந்திரம்: இயந்திரங்கள், இயந்திரம், விமானம்
நகரும்: நடவடிக்கை, மொபைல், அடங்க, இயக்கம், இயக்கம், குடியேறுவதற்கான, டிக்
பற்கள்: பல், கியர், இந்த, பேன்
அவமானம்: அவமானம், வெட்கமாக, வெட்கப்படவில்லை, சங்கடப்பட, இக்கட்டான, சங்கடம், வெற்று, நிர்வாண, அவமானம், சீற்றம்
மூளை: சூத்திரதாரி, மஜ்ஜை
மோதிரம்: குட்டி, டயல், சுருட்டை, லூப், டயர், டயர்
சொற்றொடர்மார்க்கர்: 
புரிதல்: புரிந்து, புரிதல், உணர்வு, பிடியில், பச்சாத்தாபம், அறிவு, உணர, நுண்ணறிவால், கருத்து, விழிப்புணர்வு
பழம்: விளைவாக, விளைவு
தேநீர்: பிக்கள், கார், இருபடிச்
விளக்க: விளக்கம், விளக்குவதற்கு, வெளிப்படுத்த, புகுத்துவதற்கான, அறிவிக்க, தெளிவுபடுத்த, விளக்குவது, கருத்து, விளக்கம், விவரிக்க, விளக்கியை
வரவேற்பு: வாழ்த்து, வரவேற்பு, மகிழ்விக்க, ஏய், வணக்கம், வாழ்த்த
கவிதை: கவிதை, வசனம், நகராட்சி, மணிக்கு
வாங்க: கொள்முதல், பெற, வாங்க, சந்தை, கடை, மலிவாக, முதலீடு, ஷாப்பிங்
உண்மையும்: நேர்மையற்ற, விசுவாசமான, உண்மையாய், அர்ப்பணித்து, சரியான, நம்பகமான
உற்சாகத்தை: தூண்டுதல், உற்சாகமாக, வம்பு, பதற்றம், தூண்டும், மகிழ்ச்சி, தூண்டுதல், பறிப்பு, உற்சாகம், வைராக்கியம், ஆர்வத்துடன், அவசர, உணர்வு
ஏப்ரல்: 
அக்டோபர்: 
கசப்பான: துன்பங்களையும், தாங்கொணாத்துயர், வேதனையான, கசப்புடன், பாதிக்கப்பட்ட, வலி, கொடுக்கு, எழுதப்பட்ட
தளர்வான: சுயாதீன, தளர்வாக, தீர்க்க, தீர்க்க, காலியாக, சுதந்திரமாக
உரை: வார்த்தைகளை
மோசமான: கெட்ட, மோசமாக, கடினமான, பாதகமான, மோசமான, இருந்தபோதும், மிகவும், அதிக, குறைந்த, குப்பை, குப்பையை, குப்பை
கடன்: அடமான, கடன்அட்டை, கடன், கடன், கடன், கடன், கவுரவத்திற்காக, செல்லுபடியாகும், நம்பகத்தன்மை
அம்சங்கள்: கூறுகள், செயல்பாடுகளை, அம்சங்கள், அம்சம்
திறன்: செயல்படுத்த, தகுதிவாய்ந்த, முடியும், திறன், திறன், திறனற்று, சாத்தியமான, வாங்க, திறமையான, திறமையான, திறன், திறன், திறன், திறமைஉடைய, திறன், பயனுள்ள
பதினைந்து: 
கொடுமையான: கடுமையான, கடுமையான, ,அன்பில்லாதவராகவும்
சேர: பங்கேற்க, கலந்து, சம்பந்தப்பட்ட, மேற்கொள்ளவேண்டும், கடைபிடிக்கின்றன, பங்கு, ஈடுபாடு, ஐக்கியப்பட, இணைக்க, புதுமுகம், ஒருங்கிணைக்க
குற்றம்: குற்ற, குற்றம், குற்றம், குற்றவியல்
தூசி: அணை, தூள், அழுக்கு
நடைமுறை: செயல்பாட்டு, நடைமுறைக்கேற்ற, நடைமுறையில், வசதியான, கிட்டத்தட்ட, எளிது, பிரயோக
வண்ண: வண்ண, வரைவதற்கு, சாய, வெளிர், வண்ண, வண்ணமயமான, பறிப்பு, தெரு, குறியீட்டு
அழிக்க: ரெக், கீழறுக்க, நாசவேலை, சிதைக்கும், இடிக்க, ஈர்ப்பு, நொறுக்கு, பாழாக்கி, குழப்பு, அழிக்க, அழிக்க, அழிவு
அதிகரி: தொடர, அதிகரிக்க, மலையின், உயர்த்த, சேர்க்க, நுழைக்க, வளர்ச்சி, பெரிதாக்க, உயர்வு, பூஸ்ட்
மூக்கு: அலகு
நட்பு: மிகவும்பொருத்தமானது, சாதகமான, ஒத்த, கனிவான, நேர்மையான, நட்பு, நட்பு, வகையான
நேற்று: நாளை, இப்போதெல்லாம்
நேற்றையபதட்டமான: 
தோல்வி: தோல்வி, வெற்றியடையவில்லை, தோல்வி, முடியவில்லை, குழப்பு, ஏமாற்றம்
தொடர்ந்து: தொடர, தொடர்ச்சியான, தொடர்ந்து, தொடர்ச்சி, தொடர்ந்து, நீடிக்கின்றனர், ஒதுக்க, நடத்த, முதல், இணைக்க, தொடங்கும், செய்ய
நீக்க: விடுபட, வாபஸ், அகற்ற, நீக்குதல், துடைக்க, அழிக்க, நீக்க, ஒழிக்கும், கழித்தால், வரைய, இழுக்க, வெளியேற்ற, உறிஞ்சி
அணிய: செயல்படுத்த, போர்ட்டர்
குருட்டு: 
ஈ: பறக்கும், குதிக்க, விமானம், விமானபோக்குவரத்து
பாராட்டு: புகழையும், பாராட்டகிறது, புகழ், தகுதி, வாழ்த்த, பாராட்டு
பணி: 
தியாகம்: பாதிக்கப்பட்ட, இரையை, விபத்துக், எண்ணிக்கை
உடற்பயிற்சி: வேலைஅவுட், வேலையை, நடைமுறையில், நடைமுறையில், விளையாட்டு, உடற்பயிற்சி, ஒத்திகை, துரப்பணம், இயக்கம், இயக்கம், பிரச்சாரம், தடகள
மனசாட்சி: சுட்டுப்பெயர், உணர்வு
கோட்பாடு: கொள்கை, கோட்பாட்டாளர், தேற்றம், தத்துவார்த்த
அமைச்சர்: 
வெறுக்கிறேன்: மோசமான, வெறுக்கத்தக்க, வெறுப்பு, வெறுப்பு, பாரபட்சம், காழ்ப்புணர்ச்சி, சினம்கொள்ள, வெறுப்படைந்த, வெறுப்பு
ஏரி: வெறும்
சென்டர்: மத்திய, சென்டர், நிலையம், தலைமையகம், நடுத்தர
மயக்கம்: மயக்கத்தில், விரக்தியிலும், ஆற்றொணா, பலவீனமான, வெளிர்
பகுத்தறிவுபாலினம்: 
சுருக்கமான: சுருக்கமாக, சுருக்க, குறுகிய, விரைவில், அட்டை, கச்சிதமான, கண்ணோட்டம், பொருளாதார
வழிபாடு: சடங்கு
பொருட்கள்: தயாரிப்பு, சரக்கு, உருப்படியை, ஒருவிற்பனைப், பொருட்கள், பொருட்களை, சரக்கு, மால், அங்கமாகி
தோல்: தோல், உறிஞ்சுதல், பட்டை, ஷெல், தலாம், ஃபர், அனுபவம்
கூரை: மொட்டைமாடியில், உச்சவரம்பு, உள்ளடக்கும், பாதுகாப்பு
கிரீடம்: 
கோட்டை: கூண்டு, பூட்ட, குடும்பபெயர்
அரியணை: 
இணைக்கப்பட்ட: ஈடுபட, நிபந்தனை, இணைக்கவும், இணைக்கப்பட்ட, சார்ந்து, இணை, ஜோடி
மைல்: போக்கு, சாய்வு, ஒல்லியான, சாய்வு, தயாராக
சிறையில்: சிறையில்
முற்றிலும்: நன்கு, வசதியாக, ஒழுங்காக, சுமூகமாக, முழுமையான, மிகவும், முற்றிலும், முற்றிலும், முற்றிலும், மிகவும், முற்றிலும், முழுமையாக, முற்றிலும், முற்றிலும், சரியாக, துல்லியமாக, துல்லியமாக
கப்: குவளை
உறுப்பினர்: உறுப்பு, உறுப்பினர், மூட்டு, உள்
சிவில்: உள்நாட்டு, குடிமகன், குடிமை, பொதுமக்கள்
எல்லாஇடங்களிலும்: முழுவதும், எங்காவது
இணங்க: மரணதண்டனை, இயக்க, செயல்படுத்த, ஒத்திருக்கிறது, உடன், சந்திக்க, கீழ்ப்படிய, உள்ளடக்கம், திருப்தி, கடைபிடிக்கின்றன, பொருள், இணக்கம்
அதேநேரத்தில்: போது, என்றாலும், எனினும், என்றாலும், இருப்பினும், அதேசமயம், இருப்பினும்
தொகுதி: மிகவும், அளவிற்கு, அளவு, ஒப்பீட்டளவில், அளவு, தொகுதி, தொகுதி, மொத்தமாக, சுற்றளவு, பாதுகாப்பு, அளவு, கண்டம், உட்கூறு
விருப்ப: வாடிக்கையாளர், விருப்ப, உடையில், நடைமுறையில், பழக்கம், பயன்படுத்தப்படும்-க்கு
வில்: பரம, வில், வெங்காயம், வளைவு
இறைச்சி: இறைச்சியைப், மாட்டிறைச்சி
காய்கறிக்பாலினம்: 
அரிய: அரிதாக, அரிதாகத்தான், எப்போதாவது
உறவினர்: உறவினர்
பாலம்: தர, டெக், கால், பூல்
பாதுகாக்க: பாதுகாப்பு, பாதுகாப்பு, பாதுகாப்பு, பாதுகாப்பதில்லை, பாதுகாக்க, பாதுகாக்க, பராமரிக்க, பாதுகாப்பதற்காக, பாதுகாக்க, பாதுகாப்பு, பாதுகாப்பு
உப்பு: மிகைப்படுத்தப்பட்ட, பெரிதுபடுத்த, உப்பு, கடலோடி
அப்பாவி: சுத்தமான
ராணி: 
நடனம்: தேடுவதாகவும், நடனம், குதிக்க, தவிர்க்க
விடுதி: விடுதி
நிரப்ப: உள்ளடக்கம், உள்ளடக்கங்களை
கைதி: குற்றவாளி
மாடிப்படி: மாடிபடிக்கட்டு, படிக்கட்டு, ஏணி, அலமாரியை
கே: ஓரின
மணல்: 
வன்முறை: வன்முறை, கடுமையான, கொந்தளிப்பான, அற்புதமான, கடுமையான, வலுவான, தீவிர, தீவிரமான, பெருமளவில், தீவிர
செப்டம்பர்: 
அழிவை: அழிவு, நாசவேலை, சேதம், கெடுக்க, பேரழிவு, இடிபாடுகளில், ரெக், இடிக்க
கால்நடைகள்: மாடு
உபகரணங்கள்: இயந்திரத்தை, சாதனம், காகிதம்முதலியஎழுதுபொருள்கள், கிட், கியர், அலங்காரத்தில், சமாளிக்க, வசதி, அங்கமாகி
உணரப்படும்: கருத்து, அறிவாரா, உணர, அடையாளம், அங்கீகாரம், விழிப்புணர்வு
எங்கும்: எங்காவது, எங்கு, எங்கும், மற்றஇடங்களில்
சமையலறை: சமையல், குக்கர்
விற்க: விற்பனை, அரை, விற்பனையாளர், துரோகம்
வேகம்: திசைவேகம், வேகத்தில், வேகத்தை, தீவிரமாக, இயக்கவியல், இயக்கம், முடுக்கி
கணினி: கம்ப்யூட்டிங்
நித்திய: எப்போதும், என்றென்றும், எல்லையற்ற, நிரந்தர
நூலகம்: நூலகர், செல்வக்குமார்
குழப்பம்: குழப்பம், குழப்பம், வம்பு, குழப்பமான, குழப்பி, அராஜகம்
கட்டுரை: கட்டுரை, உருப்படியை, பிரிவில், உட்கூறு, விட்டம், பொறியாளர்
சமையல்காரர்: செஃப், சமையல், சுடுவது, கொதி
இசைக்குழு: பெல்ட், ரிப்பன், டேப், அணி, குழு, ஆடைஅவிழ்ப்பு, பட்டை, மண்டலம், இழையில், கொத்து, கொத்து, லேன்
பாலைவனத்தில்: வனாந்தரத்தில், வனாந்திரத்தில்
முத்தம்: 
பனி: ஐஸ்கிரீம், டேப், பனி
பந்து: ரப்பர், கோளம், புல்லட், படை, குழந்தை, மாத்திரை, வெறுமையை, விநியோக
குச்சி: பங்கு, கரும்பு, கடைபிடிக்கின்றன, மரம், உத்திரம், பேட்டிங், கோல், ஊழியர்கள், துருவ
வாதம்: தர்க்கம், நடவடிக்கை, சர்ச்சை, விவாதம், விவாதம், சர்ச்சை, பாதை, வலியுறுத்தல், கேள்வி, கேள்விகள்
கண்காணிக்க: ஆய்வு, ஆய்வு, ஆராய, விசாரணை, கவனிப்பு
ஆசியும்மனநிலை: 
வேலைநிறுத்தம்: நிலுவையில், அதிர்ச்சிதரும், வேலைநிறுத்தம், கணிசமான, குறிப்பிடத்தக்க, கணிசமான, குறிப்பிடத்தக்க, ஈர்க்கக்கூடிய, ஆச்சரியம், வியத்தகு, குறிப்பிடத்தக்க
குற்றவாளி: குற்ற, கடமைப்பட்டிருக்கிறேன், புண்படுத்த, குற்றவாளி, குற்றவாளி, ஆக்கினைக்குள்ளாகத்தீர்த்து,
துப்பாக்கி: துப்பாக்கி, ஆயுதம்
காவல்: செயல்படுத்த, மேற்பார்வை
மறைக்க: சுரக்கின்றன, மறைக்க
பயணம்: பிரச்சாரம், இயக்கி, பயணம், பயணம், பிரயாணம், சுற்றுப்பயணம், சிலுவைப்போரில்
மேகம்: மின்வெளி
கழிவு: பயனற்றது, தேவையற்ற, மறுக்கிறது, மறுப்பது, நிராகரிப்பு, குப்பை, குப்பை, குப்பையை
பிப்ரவரி: 
நோய்: நோய், நோய், கரோனரி, திருப்திகரமான, திருப்தி, நோய்
முயற்சிவழக்கு: 
உலகளாவிய: 
எஸ்டேட்: நன்கு, தோட்ட, சொத்து, நில, சொத்து, உரிமை, அதிர்ஷ்டம், செல்வம்
தாழ்மையான: தோல்வி, சுமாரான
தாமதம்: ஒத்தி, தாமதமாக
தாமதமாககட்டாயம்: 
தகவல்சான்றுத்: 
துரதிருஷ்டவசமான: எதிர்பாராதவிதமாக, துரதிர்ஷ்டமான, தற்செயல், மகிழ்ச்சியற்ற, துன்பகரமான, போதிய, பொருத்தமற்ற, பொருத்தமற்ற
நள்ளிரவு: வடக்கு
ஹீரோ: போர்வீரன், சாம்பியன்
விரல்: கால், ஐக்கிய
பத்திரிகை: ஊடக, பத்திரிகை, பத்திரிகை, அச்சிடும், வகை, சூத்திரம், மிகுதி
வெகுமதி: பரிசு, பரிசு, விருது, போனஸ், இழப்பீடு, ஈடு
பழி: தவறு, குறைபாடு, குறைபாடு, கடன், குற்ற, அதட்டல், மீதுவழக்குதொடுக்க, பொறுப்பு, பொறுப்பு, குற்றஞ்சாட்டத், குற்றம்சாட்டுகின்றனர், ஆக்கினைக்குள்ளாகத்தீர்த்து,, பகிரங்கமாகக்கண்டனம்
துன்பம்: துன்பங்களையும், பாதிக்கப்பட்ட, வேதனையான, துன்பகரமான, அலுப்பு, பாதிக்கப்படுகிகிறது, வருத்தத்தை, முரண்பாட்டை
நெற்றியில்: 
விளம்பரம்: விளம்பரம், விளம்பர, விளம்பரம், விளம்பரம், அறிவிப்பு, விளம்பரம், அறிவிப்பு, அறிவிப்பு, செய்ய, ஐந்து, அறிக்கை, வலியுறுத்தல், பதவிஉயர்வு, ஊக்குவிக்க
தேவதை: நிலஉரிமையாளர், தேவதை, கடுமையான, தந்திரமான, தூதர்
புகழ்: மகிமை, புகழ், வதந்தி, வதந்தி, விளம்பர, விளம்பரம், கவுரவத்திற்காக
ஒருமைஎண்: 
விடியல்: அந்தி
மன்னிக்க: தவிர்க்கவும், மன்னிப்பு, பொறுத்துக்கொள்ள, விலக்கு, நிவாரணம், பதவிநீக்கம், மன்னிப்பு
ஆடுகள்: ஆட்டுக்குட்டி, வெள்ளாடு, அளவு, நற்சிந்தனை
தீர்மானம்: தீர்க்க, தீர்வு, முடிவு, தீர்மானம், ஆய்வு, முறிவு, இயக்கத்தடை, உறுதியை, சிதைவு
பொறுமை: மனோபலம், பொறுமை, நோயாளி, பொறுமையிழந்து, சகிப்புத்தன்மை, சகிப்புத்தன்மை, நிதானம்வேண்டும்
குறிப்புடன்: குறிப்பு, பார்க்கவும், குறிப்பிடவும், உத்தரவு
சோளம்: கோதுமை, கொம்பு, தானிய
முக்கிய: பத்திர, பொத்தானை, சுவிட்ச், முக்கிய, முக்கிய, முக்கிய, முக்கிய, முக்கிய, முக்கிய, முக்கிய, துப்பு, அந்த
பெரும்பான்மை: நிறைய, மிகவும்
அறியாமை: அறியாமை, கேலிக்குரிய, முட்டாள், அறியாமை, கட்டைவிரல்
பலவீனம்: இயலாமை
இலாப: நன்மை, ஆதாயம், நன்மை, சாத்தியமான, வெற்றி, பயனாளியின்
மணி: அலாரம், கடிகாரம், மணி
வளிமண்டலத்தில்: சூழல், வானத்தில், விமானபோக்குவரத்து, வெளிசார்ந்த, காலநிலை, சுற்றியுள்ள
மனித: மனித
வட்டு: வட்டு, துண்டு, எதிர், சிலிண்டர், தட்டு, பதிவு, தட்டில்
தனியாக: தனியாக, தனிமை, தனியாக, ஒற்றை, வெறுமனே, அமைதியான, வனாந்திரத்தில்
கலைஞர்: நடிகை, ஓவியர், மகிழ்விப்பாளர்
அழகை: கவர்ந்திழுக்கும், ஈர்ப்பு, மாய, எழுத்துப்பிழை, அழகியல்
அடிமை: அடிமை, பத்திர
கவர்னர்: பழமைவாத, ஆட்சியாளர்
கிளை: 
மனநிலைதான்: ஏற்பாடு, கட்டமைப்பு, போக்கு, போக்கு, ஒதுக்கீடு, அமைப்பு, மனநிலை, அட்டவணை, காலஅட்டவணை, குடியிருப்பு, இலக்கு
அதிர்ஷ்டம்: அதிர்ஷ்டம், விதி, அதிர்ஷ்டம், மகிழ்ச்சி, வாய்ப்பு, அதிர்ஷ்டம்
பெறப்பட்ட: கிடைக்கும், பெறும், வருவிக்க, எடுக்க, அடைய, மீட்டெடுக்க
ஒப்பீட்டுமனநிலை: அனுமானமனநிலை, துப்பறியும்மனநிலை
சமூகம்: சமூகத்தின், வகை, மக்கள்
எண்ணெய்: கொழுப்பு, எரிபொருள், தொல்பொருள், மஜ்ஜை, வெப்ப, வெண்ணெய்
குழாய்: குழாய், குழாய், குழாய், கப்பலின்பிற்பகுதி
அச்சு: பதிப்பு, அழுத்தம், அச்சிடும், அச்சு, அச்சு, உணர்வை
ஓ: யா, வரிசை
சொற்பொழிவுசூழல்: 
விளிவேற்றுமையில்வழக்கு: 
அறைக்கு: குடிசை, கூடாரத்தில், லாட்ஜ், அறை, செல், பெட்டியா
பதட்டமாக: பதட்டமான, குழப்பி, தொந்தரவு, வருத்தம், சங்கடப்பட, குழப்பமான, தொல்லை, பயத்தை, நரம்பியல், கவலை, நரம்பு, வலுவான, சக்திவாய்ந்த, தீவிர
வேறுபாடு: முறையே, வித்தியாசமாக, வேறுபாடுகள், பன்முகத்தன்மை, வேறுபடுகின்றன, வேறுபடுத்தி, இடைவெளி, வேறுபடுத்தி, வித்தியாசம், வேறுபடுத்திப், மாறுபாடு, மாறுபாடு
சுமை: உணர, சுமை
பட்டு: பிடியில், பிடியில்
அலட்சியம்: தூற்றும், வெறுப்பு, வெறுப்பு, வெறுப்பு, வெறுப்பு, அதட்டல், அவமானம், சீற்றம், அலட்சியம்
நரகத்தில்: 
பிரிக்கப்பட்ட: தனி, ஒதுக்கி, தவிர, தனித்துவமான, வேறுபடுகின்றன, தனியாக, தூரவிலகி, தனி, தனிமை, ஒதுக்கப்பட்ட, பிரிக்கப்பட்ட, பிரிப்பு, வேறுபடுத்தி, தனிமைப்படுத்த, பிரிவுநிலை
கலப்பு: கலவை, கலவை, கலப்பு, கலந்து, கூட்டு, இணைவு
மர: மரம், உத்திரம்
சிகிச்சை: சிகிச்சை, சிகிச்சை, சிகிச்சை, செயல்முறை, கருத்தில், சிகிச்சை, தீர்வு, ஒப்பந்தம், ஆற, நடந்து, உதவி, கன்னம், தாடை
எச்சரிக்கை: எச்சரிக்கை, எச்சரிக்கை, எச்சரிக்கை, நினைவு, அறிவிப்பு
இந்தஅறிவுரையைமனநிலை: 
லட்சியம்: ஏமாற்றம், ஏமாற்றம், காமம், ஊக்கம், லட்சிய
மகசூல்: திறன், இனப்பெருக்கம், வருமானம்
எப்படியோ: சற்றே, ஏதாவது
ஆலோசனை: ஆலோசகர், குறிப்பை, ஆலோசனை, ஆலோசனை, ஆலோசனை, முனை, வழக்கறிஞர், வழக்கறிஞர், வழக்கறிஞர்
அரசியலமைப்பு: à:, அரசியலமைப்பு, சம்பவம், நிகழ்வு
கருவி: கருவி, கப்பல், நிறுவனம், உறுப்பு, கொள்கலன், பயன்பாடு, சாதனம்
நிலையான: நிலையான, ஸ்திரப்படுத்த, வழக்கமான, வழக்கமாக, நிலையான, நிலையான, தொடர்ந்து, தொடர்ச்சியான, நிலையான, நிலையான, நிலையான, சரி, சீரான, நிரந்தர, நிலையான, நிம்மதியான
உறுப்புகள்: காரணிகள், உறுப்பு, கூறு, மூலப்பொருள், கூறுகள், சாரம், நட்பு, காரணி, அளவுரு
தொடர்ச்சியானஅம்சம்: 
ஆன்லைன்: 
அலை: அலை, படம்
கல்லூரி: ஆசிரிய, அகாடமி, வளாகத்தில், பல்கலைக்கழக
வால்: வரிசை, பாதை
தலைமுறை: சந்ததி
பூனை: 
நேரடிசான்றுத்: 
கைவிடப்பட்ட: புறக்கணிப்பு, விட்டு, வனாந்திரத்தில், விட்டுவிட, கைவிட, கலைத்து, ரத்து
பதினொரு: 
உள்ளுணர்வு: தன்னிச்சையான
பழங்குடி: தண்டு, தண்டு, சுமை, பற்றாக்குறை, குறை, குறைபாடு, பற்றாக்குறை, பற்றாக்குறை
பயம்மனநிலை: 
தங்குமிடம்: ரிசார்ட், குடியிருப்பு, தீர்வு, வாழ்விடம், குடியிருப்பு, பாதுகாப்பு, தங்குமிடம், தஞ்சம், துறைமுகம்
முரட்டுத்தனமாக: முரட்டுத்தனமாக, கடினமான, ,அன்பில்லாதவராகவும், கடுமையான
சவாரி: சவாரி, சவாரி
தொழிலை: தொழில்சார், வாழ்க்கை, ஆக்கிரமிப்பு, தொழில்முறை, தொழிற்கல்வி, வணிக
விளக்கு: மெழுகுவர்த்தி
காபி: கஃபே, போதுமான, போதுமானஅளவு, போதுமான
செவிலியர்: சகோதரி
உறுதி: உத்தரவாதம், வாரண்ட், உறுதிமொழியை, உத்தரவாதம், காப்பீடு, உறுதி, அறிந்துகொள்ள, உறுதி, வழங்கும், பூர்த்தி, உறுதி, சமாதானப்படுத்த, உறுதிபடுத்தவும், பாதுகாக்க, பல்லேடியம்
காலணிகள்: ஷூ, சந்தனம்
குழுவினர்: ஊழியர்கள், கூட்டம், அணி, கொத்து, பணியாளர்கள்
முற்றத்தில்: குறியீடு, பக்கம், அவனுடன்
தெளிவற்ற: தெளிவின்மை, தெளிவற்ற, தெளிவற்ற, தெளிவாக, மர்மமான, நிச்சயமற்ற, காலவரையற்ற, அலை, காலியாக, புரிந்து
அபார்ட்மெண்ட்: பிளாட், வட்டம், பெட்டியா, தொகுப்பு, வேகன்
செயல்பாடு: பரிவர்த்தனை, செயல்பாடு, நடவடிக்கைகளை
சனிக்கிழமை: வாரஇறுதியில்
வைத்திருப்பவர்: 
சூரியஒளி: சூரிய, சன்ஸ்கிரீன், பிரகாசம், பகல்
விதவை: 
தொடர்பு: தொடர்பு, கடித, தொடர்பு, தொடர்பு, தொடர்பு, தொடர்பு, உறவு, தொடர்புபடுத்த, உறவு, இணையுறவு, சம்பந்தம், அறிவிப்பு, அறிவிப்பு, பரிவர்த்தனை, தெளிப்பு, தொழில்சார், உரையாடல், இடைமுகம், உரையாடல்
பிரதிபலிப்பு: சிந்தித்தல், நிர்பந்தமான, கற்பனை
அமைப்பு: திசு, அமைப்பு, ஏற்பாடு, அலங்காரத்தில், மாநகராட்சி, பயன்பாடு, நிறுவனம், நிறுவனம், அமைப்பு, அமைப்பு, அமைப்பு, அமைப்பு, நிறுவனம், நிறுவனம், சங்கம், நிறுவனம், நிறுவன, விமானநிறுவனம், ஏற்பாடு
நட்சத்திர: 
விருந்தினர்: அந்நியன், பார்வையாளர், அன்னிய, வெளிநாட்டவர், புதுமுகம், வாடிக்கையாளர், வாடிக்கையாளர், தொகுப்பாளர்
பட்டியில்: வெற்று, பப், சுமை, சரக்கு, சரக்கு, கஃபே, பேரியம், ஆடைஅவிழ்ப்பு, கட்டு, பெல்ட்
பாட்டில்: ஜாடி, நோய்
ஆசீர்வதிப்பார்: ஆசி, வாழ்த்த
பரபரப்பை: கையாள, கலந்து, வருவதற்காக, கலகம்அடக்கும், தூண்ட
சண்டை: மாறுபாடு, சர்ச்சை, சண்டை, வழக்கு, வாதிடுகின்றனர், கருத்துவேறுபாடு
உள்: உள்ள, உள்ளே, உள்துறை, உள், உள்ளூர், உள்நாட்டு, உட்புற, மன, உள், முக்கிய, முக்கிய
எதிர்ப்பு: எதிர்ப்பு, எதிர்க்கும், எதிர்ப்பு, எதிர்ப்பு, எதிர்ப்பு, சினம்கொள்ள, ஆட்சேபனை
வெற்று: வெற்று, வெற்று, வெற்று, கேபிள், துளை
மாகாணத்தில்: மாகாண, மாவட்டத்தில், கவுண்டி, கொழுப்பு
நாகரிகம்: கலாச்சாரம்
செயலிழப்பு: மேற்பார்வை
அதிர்ச்சி: அடி, அதிர்ச்சி, அதிர்ச்சி, மோதல், தாக்கம், ஸ்டன்
விதிவிலக்கு: பகுதி, பாகுபாடு, ஒரேமாதிரியான, விலக்கு, மோதல், நிலுவையில், விலக்கு, துப்பறியும்
திரிபு: மனஅழுத்தம், பதற்றம், சுமை, சோர்வு, முயற்சி, தீவிரம், தழுவி, இன, இன
ஓட்டுநர்: இயக்கி, இயக்கி, வழிகாட்டும், சவாரி
சத்தியம்: பதவியேற்பு, உறுதிமொழியை
புதையல்: நகை
விதை: விந்து, நட்டு, துகள், திரு
கோபுரம்: 
பிடித்த: பிடித்த
சமீபத்தில்: சமீபத்திய, புதிதாக, புதிதாக, இப்போதெல்லாம், பின்பு
விழித்து: உணர்வு, மனஉறுதியை, எழுப்ப, எச்சரிக்கை, தூண்ட
தளபாடங்கள்: 
கயிறு: தண்டு, சரம், பட்டா, ஜெர்மானிய
சாகச: துணிகர, தீங்கு, சூதாட்டம்
ராயல்டி: ராஜாவாகி
விருந்து: கட்சி, கொண்டாட்டம், விருந்து, விடுமுறை, இரவு
ஆண்டு: ஆண்டு, ஆண்டுதோறும்
அளவில்: சட்ட, கட்டமைப்பை, பாதை, விகிதம், ஏணி, மாடிபடிக்கட்டு, படிக்கட்டு, அளவு, அளவுகோல், பரிமாணத்தை, நிலை, அளவிற்கு, விகிதாசார
அதன்விளைவாக: விளைவு, எனவே
அடித்தளம்: அடித்தளம், அடிப்படையில், அடிப்படையில், அடிப்படை, முதன்மை, தொடக்க, கோர், அடிப்படை, ஆழமற்ற, இளங்கலை, அடிப்படையில், மேடையில், அடித்தளங்களை, அடிப்படையில், அடிக்கோடிடும்
விழா: சடங்கு, செயல்பாடு, கொண்டாட்டம், கச்சேரி, சூத்திரம், உணர்வு
வேட்டை: வேட்டை, பாதிக்கப்பட்ட, இரையை, துரத்தல், படப்பிடிப்பு
தாராளவாத: தாராள, சுதந்திரமாக
பெரும்பாலும்: கணிசமாக, குறிப்பிடத்தக்க, மிகவும், முக்கியமாக, பெரும்பாலும், பெரிதும், பரவலாக, பெரும்பான்மையாக, முதலில், அடிப்படையில், அடிப்படையில், பெருகிய
இளவரசி: மகள், மணமகள்
பலிபீடத்தின்: பரிசுத்தஸ்தலத்தின்
வலை: பிணையம், நிகர, கட்டம், திசு, கேன்வாஸ், பின்னல்
ஊதா: கருநீலம்
சேகரிக்க: சேகரிக்க, குவிக்க, சுருக்க, டயல், மிச்சத்தை
தேர்தல்: தேர்வு, தேர்ந்தெடுக்கப்பட்டுள்ள, பாதை, கருத்துகணிப்பு, திமிங்கிலம், தேர்வை, தேர்ந்தெடுக்கப்பட்ட
குடித்துவிட்டு: மது, குடிவெறி
ஊற்ற: கவிழ்க்க, சிந்த, கசிவு, தூக்கியெறிய
லிப்ட்: உயர்த்தி, உயர்த்தி, முன்னேற்றம், உயர்த்த, உயர்வு
சைகை: அடையாளம், சமிக்ஞை, சின்னமாக, அடையாள, அணுகுமுறை, காட்டி, குறிப்பை, அடையாளம்
நிர்வகிக்க: மேலாண்மை, மேற்பார்வை, கையாள, நிர்வாகம், ஆட்சி, விலகி, கட்டுப்பாடு, இயக்குகிறது, என்று, ஏற்பாடு, ஏற்பாடு, கட்டமைக்க, செய்ய, பராமரிக்க
பரிமாற்றம்: இடமாற்று, தலைகீழ், பண்டமாற்றுமூலம்மாற்று, மாற்று, பரிமாற்று, நாணய, பண, மாற்று, மாற்று
திட்டவட்டமானகட்டுரை: 
பேரரசர்: மன்னர்
பூச்சு: முடிக்கப்பட்ட, முடிவுக்கு, இறுதியில், பூச்சு, மீது, அலங்காரம், தீர்மானம்
அசிங்கமான: மோசமான, வெறுக்கத்தக்க, மகிழ்ச்சியான, சுவாரஸ்யமாக, வேடிக்கையான
உண்மையான: உண்மை, உண்மையான, உண்மையான, மெய்நிகர், சரியான, அசல், செய்கிறது, உள்ளார்ந்த, உள்நாட்டு, சில, நம்பிக்கை, பத்தியில், நேர்மையான
அங்குல: சுங்க, கட்டைவிரல்
தாடி: கன்னம்
கிழிக்க: பறிக்க, அரிப்பு
எதிர்க்க: எதிர்ப்பு, எதிர்ப்பு, வேறுபடுத்திப், எதிர்ப்பு, மாறாக, எதிர்க்கிறது, குறுக்கிட, எதிர்க்கும், மறுக்கிறது, நிராகரிக்க, எதிர்க்கும், பொருள், தாங்க, விரோதத்தை, முரண்பாடு
வணிகர்: வியாபாரி, வணிகநபர், ஒருவிற்பனைப்
சுதந்திரம்: சுயாதீன, சுதந்திரம், சுதந்திரமாக, சுதந்திரம், சுயாட்சி, விடுதலை
வாசனை: வாசனை, சுவை, சுவை
பதினெட்டு: 
வரலாற்று: வரலாற்று, வரலாறு, வரலாற்றாசிரியர், வரலாற்று
மொத்த: மொத்த, மதிப்பீட்டு, அழுக்கு, மூல, கச்சா, தூண்டுதல், மேக்ரோ, ஆர்வமாக, கடுமையான, தீவிர, டாட், ஒட்டுமொத்த
ரூட்: தண்டு, புதிதாக, பாதை, அசல், தோற்றம்
மண்: மண், கோழை, களிமண், அழுக்கு, மலர்
எளிமை: எளிய, பணிவு
முக்காடு: திரை, புறப்பட்டது, படகோட்டம், திரை, சவ்வு
தியேட்டர்: தியேட்டர்
ஒப்பீடு: ஒப்பிடவும், ஒப்பீட்டு, இணையுறவு, விகிதம், மோதல், ஒப்பிடக்கூடிய
தொகுப்பு: கூறு, அமைப்பு, உருவாக்கம், கட்டுமான, ஆவார்கள், கட்ட, ஏற்பாடு, கட்டமைப்பு, கட்டமைக்க
போட்டி: எதிர்ப்பாளர், அதிருப்தியடைந்த, போட்டி, போட்டி, போட்டியிட, போட்டியாளர், எதிர், முரண்பாடான, எதிர்ப்பு
உணர: அடைய, அடையாளம், அங்கீகாரம், அடையாளம், கண்டறிய, தெரியாமல், இயக்க, உணர, உணர, புரிந்து, பிடியில், சாதிக்க, மனப்பாடம்
சமநிலை: சமநிலை, சமமாக, சமத்துவம், கிடைமட்ட, விகிதாசார, சம, வரவுசெலவுதிட்டம்
பயிற்சியாளர்: பயிற்சியாளர், பயிற்சியாளர், உபாத்தியாய், வழிகாட்டியான
நகைச்சுவை: நகைச்சுவை, நகைச்சுவையான, மனநிலை, நகைச்சுவை, ஜோக்
நாவல்: கற்பனை, புதிய, புதிதாக
பழிவாங்கும்: காழ்ப்புணர்ச்சி
வளங்கள்: சொத்து, மூல, வள, வழிமுறையாக, வழங்கல்
பொறாமை: பொறாமை, பொறாமை
சக்கர: பைக், வட்டம், சுழற்சி
எரிந்த: எரிக்க
ஃபிளாஷ்: மின்னல், பளபளப்பு, பிரகாசம், பிரகாசஒளி
பரிந்துரைக்கிறது: கருத்து, பரிந்துரை, முன்மொழிய, சிபாரிசு, திட்டம், பரிந்துரைக்க, குறிப்பால், கருத்து, குறிப்பிடுகிறது, கருத்தாகும்
imprecatoryமனநிலை: 
ஆதரவற்ற: 
குழுக்கள்: குழு, டெக்
கிளப்: பேட்டிங்
வெள்ள: மூழ்கடித்துவிடும்
இன்பம்: அனுபவிக்க, இன்பம், மகிழ்ச்சி, மகிழ்ச்சி, மகிழ்ச்சி, மகிழ்ச்சி, மகிழ்ச்சி, மகிழ்ச்சி, உற்சாகம்
அலட்சியம்,: அக்கறையின்மை, கவனக்குறைவாக, புறக்கணிப்பு, புறக்கணிக்க, கண்டுக்கொள்ளாமல்
அடிவானத்தில்: 
assumptiveமனநிலை: அனுமானமனநிலை
செங்குத்தான: உயரத்தில், செங்குத்தாக, மிகவும்
நல்லிணக்கம்: சமரசம், இசைக்கு
குழந்தைபருவத்தில்: 
முழங்கால்: மடியில்
பரஸ்பர: ஒருவருக்கொருவர், தலைகீழ், பொதுவான, கூட்டு, தொடர்பு, ஊடாடும்
மென்பொருள்: பயன்பாடு, திறமை
காயம்: காயம், தீங்கு, சேதம், காயப்படுத்தும், காயம், அதிர்ச்சி, காயம், மீறல்
ரசீது: பெறும், நுழைவு, வரவேற்பு, சேர்க்கை, ஏற்பு, ரசீது
ஒழுக்கம்: பொருள்
சீட்டு: வழுக்கும், ஸ்லைடு, சறுக்கு, ஆய்ந்தறியாமல்
புரட்சி: புரட்சிகர, ஆட்சிகவிழ்ப்பு, சுழற்சி, கிளர்ச்சி, கிளர்ச்சி
விவசாயி: விவசாயிகள்
பக்கவாதம்: அடி, ஆட்சிகவிழ்ப்பு, அவசரத்தில், ஸ்க்ரேம்பில்
சலுகை: சலுகைபெற்ற, விருப்பம், ஒதுக்கீடு, உரிமையை, சலுகை, சலுகை
மாணவர்: மாணவர், அறிஞர், இளங்கலை, கல்வி
குகை: 
பாரம்பரியம்: பாரம்பரிய, பாரம்பரியமாக, சுங்க, சரணடைய
சோகம்: தொற்றுநோய், சோகம், முரண்பாடு
சத்திரத்திற்கு: பப்
கன்னி: பணிப்பெண்
பிரியாவிடை: குட்பை, பை, பைபை
திறனாய்வு: விமர்சிக்க, விமர்சனத்தை, விமர்சனம்
பருத்தி: கம்பளி
மருத்துவமனையில்: தஞ்சம்
வாடகைக்கு: கட்டணம், வேலைக்கு, வரி, அஞ்சலி, குத்தகை, பயன்படுத்துகின்றனர், ஈடுபட, வாடகைக்குஎடுக்கப்பட்ட, à:
எரிவாயு: 
தவிர்க்கமுடியாத: தவிர்க்கமுடியாமல்
கொடிய: முக்கிய
இலை: தாள், கத்தி
வெளியீடு: வெளியிட, வெளியீட்டு, அச்சிடும், பிரகடனம், ஒளிபரப்பு, வெளியீடு, வெளியீடு, பரவல், அறிவிக்க
மொழிபெயர்ப்பு: மொழிபெயர், மொழிபெயர், விளக்கம், தொற்றுநோய், பரிமாற்ற, பதிப்பு
கடற்கரை: இழையில், கடற்கரையில்
இறுதிசடங்கு: அடக்கம், கல்லறை, அடக்கம்
மாவு: தூள், மாவை, சரியான, துல்லியமான, துல்லியமான, உணவு
கர்ஜனை: வியத்தகு, கத்தி, சத்தம்
காதல்: இடுப்பு, இடுப்பு
குடிசை: குடிசை, லாட்ஜ், சிந்த
நடித்துக்காட்டும்தன்மைஉடைய: 
டாலர்: 
பதினாறு: அறுபது
சட்டசபை: சந்தித்தல், மாநாடு, காங்கிரஸ், கட்டமைப்பு, பேரணியில்
காலனி: 
சாரி: வார்டு, தொகுப்பு, மூட்டு, துடுப்பு, விமானம், விமானபோக்குவரத்து
சிங்கம்: 
தந்திரமான: தந்திரமான, தந்திரம், திறமைஉடைய, புத்திசாலி, இராஜதந்திர
நாடகம்: பாசாங்கு, வியத்தகு
மூடுபனி: மூடுபனி
மீயுரை: ஹைப்பர்லிங்க்
மருத்துவம்: மருந்து, தீர்வு, தெளிப்பு, மருந்து
பதினான்கு: இல்லாமல், பிரத்தியேக, சைன்
அமிலம்: புளிப்பான, அமில, மலை, மலையின்
அதாவது: எந்த, அதாவது
பயனர்: பயனாளியின், நுகர்வோர்
பிஷப்: 
ஆரஞ்சு: 
குளியல்: குளியலறையில், மழை, குளியல்தொட்டியில்
வழித்தோன்றல்: கலவை, படியெடுத்தல், வருவிக்க
பழமையான: ஆரம்ப, ஆரம்ப, பண்டைய
கூடை: பின், பையில், கூடைப்பந்து
செயலாளர்: ஆசிரியர்
இரட்சிப்பின்: பாதுகாப்பு, விடுதலை, வணக்கம், மீட்பு, மீட்பு, மீட்டெடுக்க
இன்று: 
hodiernalபதட்டமான: 
உத்தேசித்துள்ள: நோக்கம், எண்ணம், ஆர்வம், முனைப்புடன், நோக்கம், விருப்பமற்ற, அர்ப்பணிக்க, சமர்ப்பிக்கிறேன், உறுதியை
நீராவி: 
விஷம்: விஷ, நச்சு, களைக்கொல்லி, பாய்ஸான்
திறமை: திறமை, திறமையான, தகுதி, திறன், திறமை
பயனுள்ள: செல்லுபடியாகும், திறம்பட, திறமையான, திறன், செல்வாக்கு, பயனுள்ள, செயலில், கிடைக்கும், ஈர்க்கக்கூடிய
கழுவும்: சலவை
வாக்குமூலம்: ஒப்பு, சமயத்தை, அங்கீகாரம், சேர்க்கை, கூற்று
முட்டாள்தனத்தை: குப்பை, நியாயமற்ற, பொருத்தமற்ற
நிலக்கரி: கார்பன்
துணை: துணை, பை, துணை
தற்காலிக: இடைவெளி, கால, உலகியல், சாதாரண, தற்செயலான, டைமர், போது, சமகால
delimitativeஅம்சம்: 
எலும்பு: கால், எலும்புமுறிவு, எலும்புக்கூட்டை
திங்கள்: 
செவ்வாய்க்கிழமை: மூன்றாவது
புதன்கிழமை: நான்காவது
மத்திய: கூட்டமைப்பு, மத்திய
விரும்பத்தக்கதாக: கவர்ச்சிகரமான, சாதகமான
பிரதிநிதி: பிரதிநிதித்துவம், சார்பில், பிரதிநிதி, வழக்கறிஞர், துணை, செய்திதொடர்பாளர்
கைத்தறி: உள்ளாடை
மடு: மூழ்கடிக்க, பேசின், துத்தநாகம், ஒத்திசைக்க
மருமகன்: மருமகள், பேரன், பேத்தியை
முற்றுகை: சரவுண்ட், இருக்கை
வயிறு: தொப்பை, வயிற்று, அணி
உச்சிமாநாடு: உச்ச, மேல், முனை, மாநாடு, ரிட்ஜ்
பிரத்தியேகநபர்: 
பறிமுதல்: சமாளிக்க, எல்லைக்குட்படுத்த, காவலில்வைக்கவும், இடஒதுக்கீடு, பறிக்க, ஆக்கிரமிக்கப்பட்ட, ஆக்கிரமிக்க, கைப்பற்றுகிடங்கில், கிராப், பிடியில், உணர, கிடைக்கும், உறுதிப்படுத்த, உடைமை
வேலி: ஹெட்ஜ்
சிலை: சிற்பம்
ஆடம்பர: 
பீரங்கி: ஷேவ்
கைது: ப, பிடிப்பு, காவலில்வைக்கவும், கட்டு, சப்பாணியாய், கருத்துரு
பேக்: பார்சல், பாக்கெட், தொகுப்பு, மடிக்க, மூட்டை, மூடப்பட்டது, மூடப்பட்டது, போர்த்தி, பேக்கேஜிங்
சுற்றியுள்ள: சுற்றி, அக்கம், அண்டை, அண்டை, அக்கம், புற, சுற்றியுள்ள, அடுத்தடுத்த, பரந்த, சூழல், சுற்றுச்சூழல்
கண்டிப்பாக: கடுமையான, ஒத்திசைவான, துல்லியமாக, இறுக்கமான, கடுமையான, நிச்சயமாக, முற்றிலும், நிச்சயமாக, இறுக்கமாக, கடுமையான, உறுதி, சரியாக, துல்லியமாக
எஞ்சிய: ஓய்வு, மீதமுள்ள, கடந்துவிட்ட, மிச்சத்தை
மான்: 
புஷ்: 
இரயில்: ரயில், ரயில்
வெளியேற்ற: விடுதலை, இறக்கும், வெளியீடு, பதவியைவிட்டுவிலகவேண்டும், வெளியேற்ற, வெளியிடுவதில்லை
வாரிசு: மரபுரிமையாக, சுதந்தரித்துக்கொள்கிறது
ஓக்: 
விரும்பத்தகாத: மகிழ்ச்சி, மகிழ்வளிக்கும், கூச்சமாக, கோபமாக, பயத்தை, மோசமான, சங்கடமான
பியானோ: 
சம்மதிக்க: சமாதானப்படுத்த, கொண்டாட, நினைவாக
கண்ணுக்குதெரியாத: மர்மமான, மறைந்துவிடும்
நன்குஅறியப்பட்ட: பிரபலமான, பேர்போன, முக்கிய
கொடுமை: 
சலனமும்: மயக்கு
telicஅம்சம்: 
சர்வதேச: உலக, பன்னாட்டு
தலையிட: குறுக்கீடு, தலையீடு, தலையீடு, தொந்தரவு, தொந்தரவு, குழப்பமான, குறுக்கிட, தொந்தரவு, எரிச்சல், தொல்லை, மோதல், எரிச்சலூட்டும், நாம், இடையூறு
நுட்பமான: மைக்ரோ, தந்திரம், கைவினை, மென்மையானது, மென்மையான, இறுதியாக, நன்றாக, மெல்லிய, நளினமான, மென்மையான
தத்துவஞானி: தத்துவ
நேர்த்தியான: நாகரீகமாக, மென்மையானது, அற்புதமான, சிறந்த, குறிப்பிடத்தக்க, புகழ்பெற்ற, நம்பமுடியாத, அற்புதமான, வலுவான, தனி
நலன்புரி: கருணை, செழிப்பு, ஒதுக்கீடு
மீன்பிடி: 
திருட: திருட்டு, திருட, கொள்ளை, தேய்த்தால், திருட்டு, தவறாகநடத்து
லிப்: அலகு, வாய்வழி, விளிம்பில்
ஓய்வு: ஓய்வு, ஓய்வு, பணியில்இருந்துஓய்வுபெற்றவர், பின்வாங்க, ஓய்வு, ஓய்வு, வாபஸ், ஓய்வூதிய
பொருளாதாரம்: பொருளாதார, பொருளாதார, பொருளாதாரம், மந்த, சேமிப்பு, வீட்டு, பொருளாதார
நீட்டிக்க: நேராக்க, நீட்டிக்க, பாதை, பண்பின், துண்டு, பத்தியில், துண்டு, துண்டின், பிரிவில், விகிதம்
இணை: இணைந்து, இணக்கமான, இணை, இணை, கிடைமட்ட
atelicஅம்சம்: 
தடைமனநிலை: தடைமனநிலை
டை: கழுகு
முட்டை: 
செயற்கை: செயற்கை
உத்வேகம்: நோக்கம், உள்நோக்கம், உந்துவிசை, ஊக்குவிக்கும், உள்நோக்கு, ஊக்கம், தூண்டல், தூண்டுதல், ஊக்க, ஊக்குவிக்க
இடைநேரம்: ஒரேநேரத்தில்
நெருக்கடி: தீங்கு, சரிவு, தீர்ப்பு, தீர்ப்பு, அவசர
கண்ணியமாக: மரியாதை, படித்த, நெறிமுறை
முத்திரை: முத்திரை, அச்சிடும், உணர்வை
மதியஉணவு: காலை, இரவு, பண்ணையில், உணவு, சாப்பிடவேண்டும்
இருந்தபோதிலும்: இருந்தபோதும், என்றாலும், என்றாலும்
இயற்கை: சூழ்நிலையில், சுற்றியுள்ள, சூழல், சூழல், சுற்றுச்சூழல், கிராமப்புறங்களில், இயற்கை, பார்வை, பார்வை, வாய்ப்பை, மேற்பார்வை
கலை: கலை, கலைப்படைப்புகள்
கூட்டணி: தொழிற்சங்க, லீக், கூட்டணி, இணைக்க, கூட்டு, விண்மீன்
அதிகபட்ச: அதிகரிக்க, தீவிர, இறுதி, மிகவும், விட, மீது, தாண்ட
அதிசயம்: தெரியவில்லை
செப்பு: வெண்கல
தூய்மை: கற்பு, துல்லியம், துல்லியமான
குடியரசு: ஜனநாயகம்
தொலைபேசி: தொலைபேசி, மொபைல்
சவுக்கை: பட்டா
சட்டை: சட்டை
அறிமுகப்படுத்த: அறிமுகம், வழங்கல், நிறுவ, தொடங்க, விடாது, ஒதுக்கீடு, சிபாரிசு, குறிப்பு, புகுத்த, வழங்க, விநியோக, சித்தரிக்க, சித்தரிக்க, தொடர்பு, நுழைக்க
சோபா: நாற்காலியில்
ஸ்வீப்: துடைக்க, ஸ்கேன்
திருடன்: 
சேனல்: வாய்க்கால்
சீர்திருத்தம்: முன்னேற்றம், திருத்தம், பரிணாமவளர்ச்சி, திருத்தும், திருத்தம், சுத்தி, திருத்தம், மேம்படுத்தல்
தாகம்: தாகம்
அச்சுறுத்தும்: அச்சுறுத்தல், அச்சுறுத்தும், அச்சுறுத்தலான
பனை: 
ஊக்குவிக்க: ஊக்கம், ஊக்குவிக்கும், இயக்கி, மிகுதி, ஊக்குவிக்க, ஊக்க, விடுக்கின்றோம், உற்சாகம்
பேச்சாளர்: செய்திதொடர்பாளர், விரிவுரையாளர்
வாசலில்: நுழைவு, சேர்க்கை
தூண்ட: லாபி, விடுக்கின்றோம், காரணம், எச்சரிக்கை, தூண்ட, போஸ், மயக்கு, வருவதற்காக, ஊற, வருவிக்க, தூண்டல், இணை
சுத்தமாகவும்: நேர்த்தியாகவும், சுத்தமான, நல்ல, அற்புதமான, ஆடம்பரமான, அழகாக, நன்றாக
அமர்வு: சந்தித்தல், மாநாடு, செமஸ்டர்
சித்திரவதை: பாதிக்கப்பட்ட, வேதனையான, வன்முறை, கசக்க, ஆலோசகர்
ஈரமான: அழுக்கு, ஈரமான, புழுக்கம்
பயணி: பார்வையாளர், பயணி, சுற்றுலா, பயணிகள், பிரயாணம், பயண
ஆலை: தொழிற்சாலை, உற்பத்தி, ஆலை, குழாய், மதுவடித்தல், கோதுமை
வரைபடம்: அட்டை, வரைபடம், வரைபடம், கட்டணம், டிக்கெட், சின்னமாக, ஐகான், தலைமை
நீரூற்று: மூல, நீர்வீழ்ச்சி, பின்னம்
காலர்: சரவுண்ட், மண்டலம்
பதிலாக: மாற்று, புரட்டுகின்றனர், உதிரி, மாற்று, மாற்று, பதிலீட்டு, இடப்பெயர்ச்சி, மாற்ற, மாறுபடும், திருத்தும், துணை, மாற்ற, சுவிட்ச், நிவாரணம், ஏற்ப, ஈடு
வேண்டுமென்றே: வேண்டுமென்றே, வேண்டுமென்றே, அறிவாரா, உணர்வு, உறுதியானநோக்கத்துடன், தற்செயலான
பீர்: பைண்ட்
வெல்வெட்: 
சாதகமாக: நற்சிந்தனை, தீவிரமாக, சாதகமாக, சாதகமாக, முற்றிலும், முற்றிலும்
ஈர்ப்பு: ஈர்ப்பு, ஈர்ப்பு, தீவிரமாக
பிரசங்கம்: பிரசங்கிப்பார், சொற்பொழிவு, விரிவுரை
பங்குதாரர்: சக, இணை, காதலி, காதலன், ஜோடி, துணையை, பொதுவான, கூட்டு, பங்குதாரர், சக, மனைவி
தவறாக: தவறாக, தவறாக, மட்டமான
மந்தையை: குழு, கூட்டம், திரள், அதிபர்
பதின்மூன்று: முப்பது
நியாயப்படுத்த: வாரண்ட், கெஞ்சுகிறேன், வழக்கறிஞர், நியாயம், நியாயப்படுத்தி, முறையான, சரி
கையெழுத்துப்பிரதி: மசோதா, ஸ்கிரிப்ட், வாதியாகவும்
வெள்ளி: வெள்ளி, வெள்ளி
தூரிகை: சீப்பு
பதிவிறக்க: பதிவேற்ற
கிரீம்: ஐஸ்கிரீம்
அசுரன்: மாபெரும், அரக்கத்தனமான
உறைந்த: நிறுத்தப்படலாம்
பானை: பான், குவளை, ஜாடி, கொள்கலன், குக்கர், பேட், கப்பல்
அரிசி: 
நடத்தை: நடத்தை, நடத்தை, பாத்திரம், பழக்கம், பண்பு, போக்கு, நடத்தை
நாணயம்: நாணய, பென்னி
வருவாய்: வருமானம்
வலியுறுத்துகின்றனர்: உரத்த, உந்துதல், உறுதிப்படுத்த, அடிக்கோடிட்டு, வலியுறுத்த, நீடிக்கின்றனர், வலியுறுத்துவது, தேவைப்படும், வலியுறுத்தல், இழுவை, வலியுறுத்தினார், வாதிடுகின்றனர், குற்றம்சாட்டுகின்றனர்
பாய்ச்சல்: 
ஆப்பிள்: மன்னிப்பு, மன்னிப்பு
விவாதிக்க: விவாதம், பேச்சுவார்த்தை, வாதிடுகின்றனர், புல, பேச்சு
பின்னணி: 
படியாக்கம்: ஏற்ப, மாற்றியமைத்தன, உருவகப்படுத்த
பொழுதுபோக்கு: பொழுதுபோக்கு, மகிழ்விப்பாளர், ஓய்வு, கருத்துகளுக்கு, மகிழ்விக்க, வேடிக்கை, பொழுதுபோக்கு, தளர்வு, உல்லாச, விருந்தோம்பல்
வைரஸ்: 
குழந்தைத்தனமாக: பாடகியாக
அங்கி: ஆடைத், ஆடை, கவுன், சீருடையில், அலங்காரத்தில், அலமாரி
பிரதிபலிக்கும்: சிந்தித்தல், தியானம், தியானம், வெளிப்படுத்த, திட்ட, சித்தரிக்க
மாற்ற: மாற்ற, மாற்றும், சுவிட்ச், பிறழ்வு, மாற்றம், மாற்றம்
அவுட்லைன்: சுயவிவர, உயர, சுருக்கம், ஓவியத்தை, அம்பலப்படுத்த, கண்ணோட்டம், வரைவு
ஓபரா: 
முழங்கை: அடைப்புக்குறி
இணைப்பு: குடல்வால், இணைப்பு, இணைப்பு, இணைப்பு, இணைப்பு
பழுது: மறுசீரமைப்பு, முன்னேற்றம், வரையறுத்துள்ளனர், திருத்தம், திருத்தும், திருத்தம்
ஃபிஸ்ட்: பஞ்ச், பிடியில்
சந்தேகத்திற்கிடமான: சந்தேகத்தின், சந்தேக
வேதம்: பைபிள், நிகழுகிறது, ஸ்கிரிப்ட்
குழி: துளை, குழி, பூல், பள்ளத்தில், போரான்
கோளாறு: குழப்பம், அராஜகம், அமைதியின்மை, இடையூறு, குழப்பம், பயத்தை, குறுக்கீடு, தவறு, தடையாக
கைத்தட்டல்: கைத்தட்டல், கைத்தட்டல், ஒப்புதல்
பைனரி: இருவினைச்
அபே: மடத்தில்
arrow: 
முனைகிகிறது: பொறுப்பாக, வழக்கமாக, பொதுவாக, நோக்குநிலை, நிறைய, கொண்டிருக்கும், பாதுகாக்க, போக்கு
விரிவாக: விரிவான, வரையறுக்க, தெளிவுபடுத்த, அபிவிருத்தி, சிக்கலான, தந்திரமான, வேலைஅவுட்
விசுவாசத்தை: அர்ப்பணித்து, விசுவாசமான, நம்பிக்கை, உண்மையாய், நேர்மையாக, அவநம்பிக்கை, நம்பகத்தன்மை, நம்பிக்கை, நம்பிக்கை
நடுங்குபவர்களாகவும்: நடுக்கம், அதிர்வு
வெளிநாட்டில்: சுட, வெளிநாட்டில், தஞ்சம்
இயந்திர: இயந்திரங்கள், மெக்கானிக், இயக்கவியல், பொறியாளர்
வெற்றிகரமாக: நன்றாக, வெற்றி, வெற்றியடையவில்லை, விளைவு
பொறி: பிடியில், குற்றவாளி
கேக்: பேஸ்ட்ரி, பை, குக்கீ, மாவை
ஐயா: திரு, மிஸ்டர்,, ஆண்டவன், பண்புள்ள
தயங்க: தயக்கமும், தட்டுங்கள், முற்றுகையிடும், அதிர்வெண், மிதவை
பதினேழு: 
பெண்மையை: பெண்மையை, பெண், பெண், மென்மையானது
தேன்: 
பங்குகளை: பந்தயம், விகிதம், குவியல், பங்கு, பின்னம், பங்களிப்பு, சூதாட்டம், பங்குதாரர்
செங்கல்: ஓடு
செவி: கட்டுக்கதை
அறுவடை: பயிர், பயிர்கள்
அடுப்பு: குக்கர், அடுக்கில், அடுப்பில், நெருப்பிடம்
கிளர்ச்சி: கிளர்ச்சி, கிளர்ச்சி, ஆட்சிகவிழ்ப்பு
பழங்காலத்து: பண்டைய
வடிகிறது: உயர்த்துவதற்காக, வீக்கம், பணவீக்கம், வீக்கம், பெரிதாக்க
மேம்படுத்த: உயர்த்த, அதிகரிக்க, சரி, தீர்வு, சிகிச்சை, ஆற, முன்னேற்றம், சேர்க்க, கூட்டு, பரப்பு
கிண்ணத்தில்: 
முறைக்க: சரி, எல்லையைக்
தொழில்துறை: உற்பத்தி, தொழில்மயமாக்கல், தொழில்
டிரஸ்ஸிங்: சாஸ், கட்டு
தீம்: தலைப்பு, மையக்கருத்தை, பொருள், பிரச்சினை, நோக்கம்
துறவி: 
மேலாளர்: உக்கிராணக்காரன், தலைமை, முதலாளி, நிர்வாகி, இயக்குனர், மதிப்பீட்டாளர், தலைவர், நிர்வாகி
இழுவை: வரைய, இழுக்க, சுமையில், வாபஸ், திரும்பப், கத்தரிக்கோல், இழுவை, அலமாரியை, மருந்து
கோரஸ்: இயக்கி
பகுத்தறிவு: நியாயப்படுத்தி, தர்க்கம், தருக்க, நியாயமற்ற, விவேகமான, நியாயமான, நியாயமான, வெளிப்படையான
செயலாக்க: தொகு, செயலி, செயல்முறை, செயல்முறைகள், செயல்முறை
ஓநாய்: 
கம்பள: கம்பளம்
பழங்காலத்தில்: பண்டைய, சகாப்தம்
வளமான: ஃபோரியர்
விசில்: புல்லாங்குழல்
சீஸ்: 
கடிக்க: வெட்டுவது, செதுக்கும், கொடுக்கு, பருக்கை, வாய், தீங்கு, இடர்பாடுகளாலும்
கதீட்ரல்: 
அலைய: உலா, குடியேறுவதற்கான, உயர்வு, புறப்படு, விலகல்
கடற்படை: கடல், கப்பற்படை
மூடிமறைக்கும்: முகப்பில், புழு
பென்சில்: பேனா
காய்கறி: சைவ
கால்சட்டை: காற்சட்டை, காலுறை
ஊழல்: ஊழல், மாசு
மந்திரிசபை: அலமாரியில், மறைவை, அலமாரி, கழிப்பறை
சூப்: 
அறுவைசிகிச்சை: அறுவைசிகிச்சை, அறுவைசிகிச்சை, அறுவைசிகிச்சை, ஆய்வாளர்
கொடுப்பனவு: மாற்று, மாற்று, இழப்பீடு, அருகமைவாக, ஒதுக்கீடு, குடல்வால்
உளவு: உணர
பொறுப்பற்ற: கவனக்குறைவாக, அசுத்தமான, அலட்சியம், நியாயமற்ற
கிசுகிசு: வதந்தி, வதந்தி, அரட்டை
அமைப்புகள்: அமைப்பு
டோக்கன்: 
சுருக்கம்: சுருக்கம், பாடத்திட்டங்கள்
உச்சரிப்பு: உச்சரிக்க, உச்சரிப்பில், பேச்சுவழக்கில், வலியுறுத்தல்
நேர்மையுடன்: நேர்மையாக, தீவிரமாக, நேர்மையான, உண்மையாய்
ஒப்புதல்: தத்தெடுக்க, அங்கீகரிக்க, ஒப்புதலைத்தான், உறுதி, உறுதிபடுத்தவும், ஒப்புதல், ஒப்புதல், ஒப்புதல், ஏற்க, வழங்க, சாதகமான, அங்கீகாரத்தையோ
கட்டிடக்கலை: அமைப்பு, கட்டுமான, அமைப்பு
கிராக்: சந்து, வேகப்பந்து, புறப்படு, விட்டுவிட, எலும்புமுறிவு
நடைபாதை: கட்டுப்படுத்து, சுருதி, கோழை, நடைபாதையில், நடைபாதை, பேக்கேஜிங்
தீர்க்கமான: முக்கியமான, முக்கிய, தீர்மானிக்க, முடிவு, உறுதியான, ஒதுக்க, குறிப்பிடவும், இறுதி, விமர்சன, ஆட்சிகவிழ்ப்பு
எதிர்மறை: பாதகமான, மறுப்பு, எதிர்மறையோ, அழிக்க
திருவிழா: கச்சேரி, எபிபானி, கொண்டாட்டம்
தேசத்துரோகம்: 
வேட்டையாடி: வேட்டையாடும்
பாம்பு: ஊர்வன
பேட்டரி: 
துப்பறியும்: துப்பறியும், புலன்விசாரணை
நீந்து: நீச்சல்
உறை: சூழ்நிலைக்கு, வினையடை
சிகரெட்: புகை, களை
மோட்டார்: ஆட்டோமொபைல், இயந்திரம், நோக்கம், மோட்டார்சைக்கிளில், மோட்டார்சைக்கிள்
தன்னார்வ: சமர்ப்பிக்கிறேன், தன்னார்வ, தொண்டு
எதிர்வினை: எதிர்வினை, பதில், பதிலளிக்க, வினை, கருத்து, வெளிப்பாடு, அணுஉலை
பேக்கேஜ்: சாமான்களை, சரக்கு, தண்டு, சூட்கேசை, லாஜிஸ்டிக்
செவிடு: 
சாறு: சாறு
பாலியல்: செக்ஸ், பாலியல்
வைர: மாணிக்கம்
எதிரொலி: 
அடையாள: அடையாளம், அடையாள, அடையாள, அறிமுகம், அடையாளம்காணக்கூடிய, அங்கீகாரம்
தூதர்: தூதர், தூதர், வளர்சிதை
சோம்பேறி: அழுகிய
momentaneஅம்சம்: 
சறுக்கல்: அறுவைசிகிச்சை, விலகல், போக்கு, போக்கு, ஓட்டம், நிலைப்பாடு
கற்பனை: ஆடம்பரமான, கற்பனை, கற்பனை, கற்பனை, கற்பனை, அகநிலை
ரே: பீம், இடைகழி, ஆரம், நிதி
ஏறும்: உயரும், ஆலை, விதைத்து, ஏறு, ஆட்டுக்குட்டி
மை: டோனர்
மறக்கமுடியாத: முக்கிய
சத்தம்: சத்தம், கத்தி, உரத்த, உரக்க
செனட்: பாராளுமன்றத்தில்
போக்குவரத்து: வண்டி, போக்குவரத்து, சுமையில், போக்குவரத்து, விண்கலம், பரிமாற்ற, உருவகம், கடத்தல்
சவப்பெட்டியில்: பாதை
விழுங்க: வாய், நிறைய
ஈடுபடுத்தி: தொடர, திருப்தி, இணைத்துக்கொள்ள, உட்பொதி, வரிசைப்படுத்த
விவசாய: விவசாயம், விவசாயம், விவசாய
ஊஞ்சலில்: 
பசும்புல்: மேய்ச்சல், முன், புல்வெளி
சிக்கலான: சிக்கலான, சிக்கலாக்கும், அதிநவீன, கலவை, தந்திரமான
ராஜினாமா: ராஜினாமா, ஓய்வு, பின்னோக்கி, பின்வாங்க, விட்டுவிட
தாழ்மையானபதிவு: 
மிளகு: 
குதிரைவண்டி: 
வேட்பாளர்: விண்ணப்பதாரர், வருங்கால, பணியமர்த்த
நரி: 
புகைபோக்கி: நெருப்பிடம், ஸ்டாக்
அதிகாரவரம்பு: அதிகாரம், தீர்ப்பு, தீர்ப்பு, திறன்
முன்னாள்இறந்தவரின்: 
ஜனநாயக: ஜனநாயகம்
போர்வை: உச்சவரம்பு, கவர், கம்பளம், பாதுகாப்பு
பன்றி: விதைத்து
தந்தம்: யானை
இலகுவான: எழுத்தாளர்
பார்வையாளர்: மேற்பார்வையாளர், பார்வையாளர், இன்ஸ்பெக்டர்
நகங்கள்: ஆணி, நகம்
தேனீ: 
நடிகர்: நடிகை, நடிகை, வாதியாகவும்
வியர்வை: தைத்து
போலிஷ்: பேச்சுவழக்கில், பிரகாசம்
மாயையை: மோசடி
நிச்சயமற்ற: நிச்சயமற்ற, தெளிவின்மை
இரண்டாம்: சிறிய
கிராமப்புற: மாகாண, கிராமப்புறங்களில், கிராமவாசி
சுழற்சி: லூப், சைக்கிள்ஓட்டுதல், வட்டமுறை, நோய்த்தாக்கம், பரவல், வட்டம், சுழற்சி, அதிர்வெண், சுழற்சி, சுழற்ற, போக்குவரத்து, sightsee, கடத்தல்
புலம்பல்: 
ஒத்திருக்கின்றன: ஒத்த, ஒற்றுமை, ஞாபகப்படுத்த, தொடர்புடைய, போன்ற
மேற்கோள்: சாறு, மேற்கோள், மேற்கோள், கடன், கடன், கடன், குறிப்பு, மதிப்பீடு, மேற்கோள்
வேலையிலிருந்து: பதவிநீக்கம், பதவிநீக்கம், பையில்
எரிச்சலை: இடையூறு, குறுக்கீடு, குறுக்கீடு, துன்பங்களையும், அலுப்பு, தொந்தரவு, சத்தம், குழப்பமான
ஊசி: ஊசி, முள், சுட்டிக்காட்டி
கட்டுப்படுத்தப்பட்ட: கட்டுப்பாடு
தடை: கட்டுப்பாடு, கட்டுப்பாடு, தடை, தடை, தடை, தடையாக, தொகுதி, குறுக்கீடு, ஊனமுற்றோருக்கு, தொந்தரவு
தங்கியிருக்கிறது: எண்ண, கணக்கிடு, சார்ந்திருக்கிறது, நம்பிக்கை, உத்தரவாதம், ரிலையன்ஸ், சார்ந்து, சார்ந்திருத்தல்
கோழி: கோழி
பீப்பாய்: வாளி
பழக்கமானவர்கள்அம்சம்: 
நிபுணர்: சிறப்பு, அனுபவம், சிறப்பு, குறிப்பிட்ட, நிபுணத்துவம்
ஈர்க்க: பாதிக்கும், உணர்வை, ஈர்க்க, ஈர்க்கப்பட்டார்
வேன்: வால்வு
விருதினை: தூக்கம்
வரையறை: வர்ணனை, அடையாள, விளக்கம், உறுதியை, அளிப்பதை, நீதி
பிறந்தநாள்: ஆண்டுநிறைவு
சுத்தியல்: 
மணம்: வாசனை
அற்பமான: குட்டி, முக்கியத்துவமற்ற, லேசான, குறு
தோண்ட: தோண்டு, துரப்பணம், குழி
pet: சாரம், வளர்ப்பு
மண்டை: 
சட்டமன்றம்: பாராளுமன்றத்தில், சட்டம், சட்டமன்ற
குதிகால்: குதிக்க, கணுக்கால்
சிடுசிடுப்பு: 
காப்புரிமை: உரிமம், உரிமம்
பில்லியன்: 
இரசாயன: வேதியியல், ரசாயனங்கள், வேதியியலாளர், கீமோதெரபி
துடிப்பு: உந்துவிசை, மணிக்கட்டில், வேகத்தை, சரிகை
பைலட்: சோதனை, சோதனை, இயக்கி
முடிச்சு: பெருந்தொகைப், முனை, நடத்த, ஒப்பந்த, முடிவுக்கு, தசாப்தத்தில், பின்னப்பட்ட, சந்தி, மூல, கச்சா, பாரபட்சம்
பாவாடை: ராக்
மனஅழுத்தம்: மந்த, சரிவு, துக்கம், வருத்தத்தை, சோகம், மனஅழுத்தத்துடன், மனஅழுத்தம்
தொழில்நுட்ப: தொழில்நுட்பம், தொழில்நுட்பம், தொழில்நுட்ப, தொழில்நுட்ப, மேம்பட்ட
வாகன: இயக்கி, கார், வண்டி, வழிமுறையாக, ஆட்டோமொபைல்
நோக்கம்: விஸ்தரிக்கப்படுவது, டொமைன், உலகினில், எல்லை, அடைய, அளவிற்கு
தாவர: ஆலை
சூரியஉதயம்: 
பங்களிக்க: பங்களிப்பு, தானம், கூட்டு
கொக்கி: தொடர்புபடுத்த, இணைக்க, தொடர்பிருப்பதாக, அடைப்புக்குறி
புலி: 
பூண்: கை, சில்லறை
நெடுஞ்சாலை: சாலை
குடிப்படை: 
நேர்மை: செறிவு
ஒளிபுகும்: வெளிப்படைத்தன்மை, தெளிவான, தெளிவாக, தெளிவாக, வெளிப்படையான, வெளிப்படையாக, தெளிவாக, வெளிப்படையான, நேரடியான
பத்தொன்பது: 
எண்ணும்: எண்ண, மதிப்பீட்டு, கணக்கீடு, கணக்கீடு
தகுதி: தகுதி, தகுதி, முடியும், தகுதி, தகுதி, தகுதி, திறமையான, தகுதிவாய்ந்த, செல்லுபடியாகும், திறன்
கரிம: தொல்பொருள், அத்தியாவசிய
இறையியல்: 
மிதவை: படகு, மிதவை, கப்பற்படை
சூனிய: 
ஸ்டூடியோ: லேபிள், பட்டறை, ஆய்வு
மதுவை: 
பேனர்: கொடி, சுவரொட்டி, டிக்கெட்
விவாகரத்து: விவாகரத்து
ஆணி: மின்னல், ஆணி, திருப்பம், திருகு
நரம்பு: நரம்பு
செயலற்ற: பார்வையாளர்களை, ஊனமுற்ற
சரளை: மதிப்பீட்டு
கிரகம்: முதன்மை, விண்மீன்
அலமாரியில்: கசக்க, அலமாரியில்
ரசிகர்: 
வெப்பமண்டல: உணர்ச்சி
கட்ட: புகைப்பட, நிலை, காலம், கட்ட, படி
தன்னிச்சையான: தன்னிச்சையான, விருப்ப, ஒப்பந்தம், ஒப்பந்தம், கட்டுப்பாடற்ற
எக்ஸ்டஸி: டிரான்ஸ், உற்சாகம், இன்பம், மகிழ்ச்சி
பாதரசம்: வெப்பநிலை
தற்கொலை: 
நிருபர்: பத்திரிகையாளர்
இழந்துவிட: இடர்பாடுகளாலும், திரும்பப், ஒதுக்கப்பட, கழித்தால், அழிக்க, திருட
பால்கனியில்: மொட்டைமாடியில், மாட
போர்க்: நாட்டுப்புற
ஊழியர்: தொழிலாளி, கூலித்தொழிலாளி, வேலை, காரணி, சார்ந்து, எழுத்தர், பணியாளர்கள், தொழிலாளர், தொழிலாளர், ஊழியர்கள்
முதலாளி: முதலாளி, உரிமையாளர், உரிமையாளர்
அகலம்: பரந்தளவில், வழங்கல், பரந்த, அரை
தழல்: 
எரிச்சல்: கோபமாக, உற்சாகமாக, எரிச்சல், தூண்டும், தூண்டுதல், சலித்து, ஊக்க, தூண்டுகிறது, ஊக்க, உள்நோக்கம்
கிளாசிக்: பாரம்பரிய, உகந்த
குரங்கு: சிம்பன்சி
ஏற்கத்தக்க: ஏற்க, ஏற்பு, நம்பத்தகுந்த
கையொப்பம்: 
பாடகர்: வாசகர்
ஆச்சாரமான: பழமைவாத, வழக்கமான, பாரம்பரிய
நாற்றங்கால்: தோட்ட
தத்தெடுப்பு: பயன்படுத்துகின்றனர், தத்தெடுக்க, ஏற்பு, அனுமானம், ஒப்புதல், கட்சி, வரவேற்பு, சேர்க்கை, மடியில், குவாண்டம்
தயக்கம்: தயக்கமும், வெறுப்பு
இறக்குமதி: அறிமுகம், வருமானம்
ஜோதி: 
இலக்கணம்: இலக்கண
வைப்பு: குவிக்க
காலனித்துவ: புலம்பெயர்ந்த
படகு: படகு, படகு
பயமுறுத்த: பயத்தின், பயங்கரங்கள், பின்வாங்க, அலாரம், எச்சரிக்கைவிடப்பட்டிருந்த, முற்றுகையிடும்
அதன்விளைவால்: விளைவு, அத்தியாயத்தில், முக்கியமான, கணிசமான, முன்னணி, முக்கிய, கணிசமாக, குறிப்பிடத்தக்க, கணிசமான, அர்த்தமுள்ள, மறைமுக
அழிந்து: காணாமல், மறைந்துவிடும், இறந்த
குவிமாடம்: 
தடிமன்: 
பிடிவாதமாக: உறுதியான
தசை: 
ரிக்டர்அளவில்: அளவு, மொத்தமாக, வீச்சு, பாதை, அளவு, தீவிரம்
துடைப்பான்: 
சிற்றுண்டி: சிற்றுண்டி
சுட்டி: எலி
அசை: நிகழுகிறது, எழுத்துக்களை
நடுநிலை: ஆண்பால், நியாயமான, மதச்சார்பற்ற
கண்டறிய: மதிப்பீடு, அடையாள, அடையாளம், அடையாளம், கண்டறிதல், கண்டறிவது, மீட்டெடுக்க, கண்டுபிடிக்க
வளம்: செழிப்பு, வாய்க்கும், ஏற்றம், நகை, மாணிக்கம், மலர்
சுமத்த: படை, செயல்படுத்த, தீர்மானிக்க
பெயரில்லா: 
சாதாரணபதிவு: 
கன்று: அவசரம்
கையேடு: வழிகாட்டும், செயல்திட்டமாக, வழிகாட்டு, கையேட்டை, பிராண்ட், தலைமை, பாடநூல், அறிவுறுத்தல், தலைவர், மேற்பார்வையாளர், ஆவணம், ஆவணங்கள், அறுவைசிகிச்சை, உற்பத்தி
எதிர்பார்ப்பு: எதிர்பார்க்கப்படுகிறது, வருங்கால, எதிர்பார்க்க, எதிர்பார்ப்பு, எதிர்பார்க்கலாம், கணிப்பு, கணிக்க, முன்அறிவிப்பு, ஒதுக்கீடு
உருகுகின்றன: ஆவியாகி, மாந்திரீகம், இணைவு, ஐக்கியப்பட, கரையக்கூடிய
குடை: பாராசூட், பூஞ்சை
துவக்க: ஷூ, தண்டு
கனிம: அயோடின், ஊட்டச்சத்து, உலோக, மாங்கனீசு
போர்நிறுத்தஉடன்பாடு: யுத்தநிறுத்த
வாத்து: 
சோப்பு: 
பொம்மை: குழந்தை, பொம்மை
வில்லா: தேவதை, லாட்ஜ்
தையல்: தைத்து, தைக்க
சரிசெய்யும்: மத்தியஸ்தம், ஐக்கியப்பட, ஐக்கியப்படுத்தும், சரி, சரிசெய்தல்
கெண்டி: 
முயல்: 
நடத்துனர்: ஏணி, கண்காணிப்பாளர், இயக்கி, தலைவர்
ஆட்டக்காரர்: நடிகை
பூச்சி: பூச்சி, புழு, பிழை
உணவகம்: 
தீவிரவாத: போராளி, தீவிரவாத, முற்போக்கான, புரட்சிகர, தீவிர, முழு, முழுவதும், முழு, அறுதி, ஒருங்கிணைக்க
குடியுரிமை: வசிப்பிடத்தை, செய்கிறது, உள்நாட்டு, உள்நாட்டு, குடியிருப்போர், குடியிருப்பு
டிராகன்: காத்தாடி
செவிப்புலசான்றுத்: 
தாமதி: நீடித்திராது
மூடி: கவர், தொப்பி, டெக், வால்வு
மேயர்: சந்தை
வன்பொருள்: பொருள்
படைப்பு: 
சிறுபான்மை: சில, தசம
அகழி: பள்ளத்தில், குழி
இசைக்குழுவிற்கு: 
பன்றிஇறைச்சி: 
வழக்கு: மீதுவழக்குதொடுக்க, வழக்கு, வழக்கு, வழக்கு, நோக்கத்தில், கூற்று, வாதியாகவும்
அனுகூலமற்ற: இழப்பு, இடர்பாடுகளாலும், பாதகமான, குறைபாடு, ஊனமுற்றோருக்கு, சிரமம்
துணி: துணி, ஆடை, துண்டு, கேன்வாஸ், திசு, நிவாரண, அமைப்பு
இசைக்கலைஞர்: இசையமைப்பாளர், இசை
மன: ஆன்மீக, மன, மனஉறுதியை, மன, அகநிலை, உளவியல், அறிவாற்றல், மனநல
முறையற்ற: தவறாக, ஏற்றுக்கொள்ளமுடியாத, குற்றமுள்ள, பொருத்தமற்ற, எதிர்பார்க்கப்படுகிறது, சட்டவிரோத, போதிய, பொருத்தமற்ற, நியாயமற்ற
கட்டடவடிவமைப்பாளர்: 
திருமணம்செய்: 
எலுமிச்சை: 
இருமல்: இருமல்
கருவுறுதல்: இனப்பெருக்கம், இனப்பெருக்கம், பிறப்புறுப்பு
சீரற்ற: தோராயமாக, வரிசையின்றி, தற்செயலான, சாதாரண, தன்னிச்சையான, இயலாததாகவோ
ஸ்பூன்: வாளி
நாட்குறிப்பில்: தினசரி, செய்தித்தாள், பத்திரிகை, நாட்காட்டி
பலூன்: 
அனுமானசான்றுத்: 
வெளியீட்டாளர்: ஆசிரியர், வெளியீட்டு
சாம்பல்: சாம்பல், சாம்பல்
உதவிப்படைவீரர்: பதவியேற்பு
புதுப்பிக்க: மறுமலர்ச்சி
பாதிக்கப்படுகின்றன: பாதிக்கப்படக்கூடிய, முக்கிய, விவேகமான, உணர்ச்சி, பொறுப்பாக
சுரங்கப்பாதை: சுரங்கப்பாதை
புதிர்: குழப்ப, குழப்பமான
பொறிமுறையை: செயல்முறை, வழக்கமான, முறையான, இயந்திரங்கள், இயந்திரத்தை, அணுகுமுறை, கொள்கை
கணிதம்: கணித, கணித, முடிவிலி
ஃபேட்: 
சீரான: விகிதம், இணையுறவு, விகிதம், சீரான, நிலையான
sublativeவழக்கு: 
டிப்: டைவ், உட்பொதி, கைவிட, குறைகிறது, நிகழ்வு, சாய்வு, சாய், சாய்வு, ஊற, சரிவு, சரிவு, ஸ்லாண்ட்
அலகு: ஒற்றுமை, நிறுவனம், தொகுதி, அலகு, ஒருமை
ஏகபோக: பிரத்தியேக
சூதாட்ட: சூதாட்டம், விளையாட்டு, போட்டியில், அனுமதி, பந்தய
நீர்மூழ்கி: 
பொருட்படுத்தாமல்: 
நிலநடுக்கம்: வலிப்பு
ஆய்வக: ஆய்வக
கருத்துகள்: கருத்து, கருத்தை, வர்ணனை, பதில்
மேற்கொள்ளவும்: கடந்து, அனுபவம், பெறும்
சுயகட்டுப்பாடு: 
தூதரகம்: 
தலைவர்: தலைவர், தலைவர்
கண்டுபிடித்தல்: கண்டுபிடிப்பு
அறிவித்தல்மனநிலை: 
கையுறை: 
நெடுஞ்சாண்கிடையாக: 
நிலவியல்: 
முதலீட்டு: முதலீடு, துணிகர
ஒப்புமை: சமத்துவம், ஒற்றுமை, நாட்டம், சொந்தம், விகிதம்
பருந்து: கழுகு, ஊடுருவு
உளவியல்: உடலியல், உளவியல்
குப்பை: ரத்து, குப்பை, குப்பை, துண்டு, எறிந்தால், வீசுவதற்கு
கொள்ளையர்: ஹேக்கர்
பங்கு: பங்கு, பங்கு, பங்கு, அறிமுகம், பாத்திரம், நிலைப்பாடு
டோஸ்: அளவு, உணவில், ஈவு, ரேஷன்
சால்மன்: 
புட்டு: இனிப்பு
காந்த: கவர்ச்சிகரமான, நானே
பம்ப்: குண்டு, வெற்றிடம்
ஆக்சிஜன்: 
விளிம்பு: விளிம்பில், விளிம்பில், குறு, விளிம்பு, புற, எல்லை, எல்லை
சான்றிதழ்: உறுதிப்படுத்தல்
பதக்கம்: 
சொல்லாட்சி: 
ஏணிப்படி: படிக்கட்டு, ஜாக்கிரதையாக, படி
சுரண்டு: புதிதாக, மேய், புண்படுத்த
உள்நுழை: படையெடுப்பு, பதிவு
தொலைநோக்கி: நுண்ணோக்கி
அட்டிகை: தோல்வி, பேஸ்ட், சங்கிலி
எழுத்துப்பிழை: எழுத்துப்பிழை
சர்ஃப்: 
விஸ்கி: 
ஒட்டகம்: 
அமெச்சூர்: 
வயது: முதிர்ந்த, வயது, வயது
சுயசரிதை: மின்சாரம்
கழுதை: 
முன்னோக்கு: மேற்பார்வை
சார்பு: தொழில்முறை, நற்சிந்தனை, தகவமைப்பு
மாதாந்திர: பத்திரிகை
விடுமுறை: விட்டு, விடுமுறை, ஓய்வு
கிளிக்: சிறுகுழுஅவர்களுடைய, படம், தட்டுங்கள்
ஓவல்: 
மீள்: ரப்பர், நெகிழ்வான
அகராதி: சொல், சொல்லகராதி, முன்
பகிர்வு: பிளவை, பிரிவு, முறிவு, இயக்கத்தடை, எண்ண, பெட்டியா, பிரிவில், துண்டு, கூறு, கூறுகள்
ஹாம்: தொடையில்
வானவில்: 
உயிரினம்: உயிரினம், உருவாக்கம்
துப்பும்: துணையை, தாய்மொழி
கடையின்: வெளியேறும், சாக்கெட், வெளியீடு, புறப்படும், பிடியில், ஸ்லாட்
தொட்டி: நீர்த்தேக்கம், கொள்கலன், குழாயில்
பட்டாம்பூச்சி: 
விளக்கப்படம்: வரைபடம், வரைபடம், கிராபிக், கிராபிக்ஸ், திட்டம், அட்டவணை, அட்டவணை
இரட்டை: இரட்டை, இரட்டை, ஜோடி, ஜோடி
அவமதித்த: அவமானம், அவமானம், குற்றம், புண்படுத்த, குற்றம், வாய்மொழி, தாக்குதல்
சுதந்திரமாக: சுயாதீன, சுதந்திரமாக, தவிர, தளர்வாக, தனியாக
சதுப்பு: 
கனவு: கனவு
ஜாம்: ஜெல்லி, சுருங்க
கேட்பவரின்: கேட்க
அருங்காட்சியகம்: 
ஸ்திரத்தன்மை: ஸ்திரப்படுத்த
வெளியிட: அறிவிக்க, வெளிப்படுத்த, கண்டறிதல், அம்பலப்படுத்த, மீளமை, வெளியிட, கண்டறிய, வேறுபடுத்தி, வெளிப்படையான
ஆக்கிரமிப்பு: தொந்தரவு, குழப்பம், ஆக்கிரமிப்பு, ஆக்கிரமிப்பு, தாக்குதல், குண்டுதாரி
உராய்வு: மோதல்
பங்கு: வருகை, பங்கேற்க, ஈடுபாடு
கப்பல்துறை: வழித்தடம்
சிலந்தி: ஃபிஷர்
உருளைக்கிழங்கு: 
தயாரிப்பாளர்: உற்பத்தியாளர், தயாரிப்பாளர், தயாரிப்பு, உற்பத்தி, உற்பத்தி
பேராசை: பட்டினி, பசியின்மை
அகால: ஆரம்ப
பெருக்கவும்: வெற்றி, இனப்பெருக்கம், பெருக்கல், இரட்டை
புள்ளியியல்: புள்ளியியல், எண்ணிக்கை, புள்ளிவிவரம்
பரிந்துரையை: பரிந்துரைக்க, நியமனம், தேர்வை, நிச்சயதார்த்தம்
டிரில்லியன்: 
உடன்பாட்டுமனநிலை: 
பயன்பாடுகள்: பயன்பாட்டை, செயல்முறைகள், விண்ணப்பிக்க, பயன்பாடு
பெயரளவு: மேய், குறிப்பிட்ட, சம
அதிருப்தியை: 
தொற்று: பாதிப்பை, தொற்று, மாற்றம், ஒலிபரப்பு, தொற்று
அலட்சியமாக: இழுப்பு
கால்பந்து: கால்பந்து, கிக், கால்சியம்
முன்னோடியாக: முக்கிய, புதுமைவிரும்பிகள்
அசாதாரண: அசாதாரண, வழக்கத்திற்குமாறாக, கிறுக்கர், அசாதாரண, மிகைப்படுத்தப்பட்ட, தனி, ஏற்றதாக, ஒருமை
விடுபடுதல்: இயல்புநிலை, ஆய்ந்தறியாமல், குறைபாடு, அலட்சியம், புறக்கணிப்பு, நீக்குதல்
குறைப்பு: நெரிசலான, மிகுதி, பிசைந்து, குறைப்பு, உந்துதல், அழுத்தம், ஈர்ப்பு, பிடியில், பிடியில்
சதவிதம்: சதவீதம், சதவீதம்
idiophone: 
நெம்புகோல்: 
திரும்பப்பெற: திரும்பிவருதல், பின்னடைவு, பின்வாங்க, சாக்கெட், நினைவுகூர்வது, தீர்மானம், அனுமானம், வெளியீடு, சம்மந்த, வாபஸ், மொத்த
செனட்டர்: 
எறும்பு: 
கர்ப்பிணி: தாய்க்குரிய, கருத்தரிக்க
தினமும்: தினசரி
உருக்கொள்வதற்கு: வீழ்படிவு, வண்டல், திசைவேகம், அவசர, முடுக்கி
மாறி: மாறுபடும், மாறிகள், உலக, மொபைல்
சுருள்: சுருட்டை, வீசுவதற்கு, சுருள், சுருள்
சல்பர்: சல்பர், உடைந்த
கண்ட: கண்டம்
கட்டளையிட: அறிவுறுத்தல், கட்டளை
தவளை: 
அதிகப்படியானவழக்கு: 
அரை: அரை, அரை
irrealisமனநிலை: 
உட்புறங்களில்: உட்புற, உள்ளே, உள்ள
சுரண்ட: பயன்படுத்த, உறிஞ்சி, சாதனை, ஆராய, கொள்ளை, உறிஞ்சுதல்
புவியியல்: நிலத்தடி
பாஸ்போர்ட்: 
ஒழுக்கங்கெட்ட: தீய, அழுகிய
பிஸ்கட்: குக்கீ
ஒத்துழைப்பு: ஒத்துழைக்க, கூட்டு, ஒருங்கிணைப்பு, உதவி, பங்களிப்பு
ஏற்படுத்திக்கொள்ள: செய்ய, அப்பட்டமான, உருவாக்கம், உருவாக்க, எழுது, உருவாக்க, பொய்ப்பதிவுரு, எழுத்துரு, பெருக்கும்
அணுவின்: அணு, துகள், தனிப்பட்ட
எய்ட்ஸ்: உதவி, நிவாரண
அணிவித்தார்: மென்மையானது, எரிச்சலூட்டும்
பிரமிடு: 
சட்டவிரோத: சட்டவிரோத, அல்லாத
கூச்சம்: வெட்கப்படவில்லை, சுருங்குதல்
வீணை: ஸ்லாண்ட்
வானியல்: 
பிரமை: தெளிவின்மை
உதவித்தொகை: ஸ்பான்சர்ஷிப், விருது
ஃபைபர்: ஃபைபர், மூட்டை, பாரபட்சம்
கிரிக்கெட்: 
புறா: 
தழுவல்: ஏற்ப, அங்கமாகி, இணக்கம், மாற்றம், சரி, தேர்வுமுறை, தகவமைப்பு, விடுதி
மறுப்பும்: மறுப்பதற்கு, ஏற்கமறுக்கும், எதிர்ப்பு, எதிர்க்கும், எதிர்ப்பு, எதிர், எதிர்ப்பாளர், எதிர்க்கும், மறுக்கிறது, சுவடு, நிராகரிக்க, பதவிநீக்கம், தடுப்பதிகார, புண்படுத்த, உபாத்தியாய், ஏற்கிறேன், கருத்துவேறுபாடு
ஆபரேட்டர்: கேரியர்
முக்கோணம்: 
பொருளாளர்: காசாளர்
ஹைட்ரஜன்: 
பிரிண்டர்: 
சோக்: சுண்ணாம்பு
நாள்பட்ட: எதிர்ப்பு, தீவிர, கடுமையான, பெரிதும், தீவிர, கடுமையான, தீவிரப்படுத்தும்
சமாளிக்க: என்கவுண்டர், ஏற்ப, எதிர்கொள்ள, ஈடு, கடக்க, சமாளிக்க, contrastive, ஒப்பந்தம், சாதிக்க
சங்கடத்தை: குழப்பி, குழப்பமான
அறிகுறி: அடையாளம், சலுகை, காட்சி, கண்காட்சியின், வழங்கல், நிகழ்வு, கண்டறியும், நோய், பண்பு
மிதிவண்டி: பைக், சைக்கிள்ஓட்டுதல், சுழற்சி, சவாரி
பொறியியல்: தொழில்நுட்பம், தொழில்நுட்ப, இயக்கவியல்
சுழல்: சுருள், சுழல்
கேமரா: அறை
நடனகலைஞர்: 
இடம்பெயர்வு: குடியேறுவதற்கான, குடியேற்றம்
டென்னிஸ்: 
அடிமையாகி: சார்ந்து, சார்ந்திருத்தல், ரிலையன்ஸ், அடிமை
நெசவு: பின்னல், பின்னப்பட்ட, பின்னல், திசு, அமைப்பு
முதுகெலும்பு: 
வறுக்கவும்: கொதி
எளிதாக்கும்: ஊக்குவிக்க, தூண்டுதல், முடுக்கம், வளர்ப்பு, எளிதாக்க, எளிமைப்படுத்த, வசதி, பயன்பாடு, நிவாரணம்
குத்துவதற்கு: கொடுக்கு, துளைத்து, கிராப், முயற்சி, முயற்சி
கடவுச்சொல்: சமிக்ஞை, கோல், கோஷம், என், குறியீடு
துருவத்தில்: கூரான, முனை
வருத்தத்தை: ஏமாற்றம், மனஅழுத்தத்துடன், ஊக்கம், வருத்தத்தை, தூண்டும்
மூலோபாயம்: மூலோபாய, உத்திகள், கொள்கை
ரோந்து: காலஇடைவெளிகளில், பெட்ரோல்
பனிப்பாறை: 
பாதியிலேயே: அரை, ஓரளவுக்கு, அரை
குறிப்பாணை: ஒப்பந்தம், ஒப்பந்த, மாநாடு, ஒப்பந்தம், வாரண்ட், பிரதிநிதித்துவம்
கூம்பு: 
சமச்சீர்: 
பிரதிவாதி: வழக்கறிஞர், எதிர்க்கும்
மசூதி: 
வெளியேற்ற: உமிழ்வு, வெளியேற்றுவீர்கள்
சதுரங்க: 
கரு: அணு, செல், சாரம், கோர், மத்திய, கரு, கரு, கர்னல், பொருள்
செர்ரி: 
தவறுகிறோம்: குறைகிறது
டிரக்: லாரி, சரக்குக், பாடல்
வயர்லெஸ்: வானொலி
ஏலத்தில்: விற்பனை
சல்லடை: சரிசெய்வதற்கான
நிலையற்று: நிலையற்ற, உறுதியற்ற, நிச்சயமற்ற, கூச்சமாக, அமைதியற்ற
சக்: உறிஞ்சி, ஊற
அன்பில்லாத: ,அன்பில்லாதவராகவும், விரோத, பாதகமான, தீங்கு
மக்கள்தொகைகணக்கெடுப்பு: கணக்கீடு
தயாராக: கால், தயாராக, தயாராக
ஓய்வெடுக்க: ஆசுவாசப்படுத்தும், நிம்மதியான, தளர்வு, ஓய்வு, நிவாரணம்
தொடர்ச்சி: தொடர்ந்து, தொடர்ச்சி, இணைந்து
குமிழி: 
கிட்டார்: முதலியன
கோடல்: விருப்பம், பாரபட்சம், விலகல்
பளபளப்பான: பிரகாசமான, ஏ.எம், புத்திசாலித்தனமான
எது: எந்த, எதுவாக, எந்த, எவர், மத்தியில், நீருக்கடியில்
பின்னிவிட்டாய்: பின்னல், பின்னப்பட்ட, பின்னல்
எழு: உயர்வு, மிதவை, தொண்டை, விமானம், பிரபலமான, விமானம், விமானம், விமானம், விமானநிறுவனம்
சுட்டுப்பெயர்மார்க்கர்: 
மசாலா: அனுபவம்
ஜாமீன்: பத்திர, உத்தரவாதம், உறுதிமொழியை, உத்தரவாதம், ஆதரவாளரை, நகை, மாணிக்கம்
கேலி: மயக்கு, தொந்தரவு, எரிச்சல், வசீகரித்தன
ஜாவா: 
செய்முறையை: முறை, ஊக்க, மருந்து, சூத்திரம், அறிவுறுத்தல், மெய்
கலப்பை: தீர்க்க, விமானக்கடத்தல்
நீரோடி: வாய்க்கால்
வால்மீன்: குற்றவாளி
கண்டுபிடிப்பு: கண்டுபிடிப்பு, கண்டுபிடிப்பு
இடைக்கால: மத்தியில்
அலங்கார: அலங்காரம், அலங்கரிக்க, ஒப்பனை
பிளாஸ்டிக்: 
அடிக்குறிப்பு: 
பால்: பால், சாதாரண, வழக்கமான
கோல்ப்: 
பூஜ்யம்: பூஜ்ய, காலியாக
ZIP: சுருங்க
தூண்டுதல்: 
சிப்: துண்டு, துண்டு, துண்டு, துண்டின்
ஒடுக்குகிற: ஒடுக்க, நசுக்கிவிடும், தாழ்த்து, மூழ்கடித்துவிடும், தவறாகநடத்து
கொட்டாவி: ஆவியாகி
சமத்துவமின்மை: 
மோல்: களிமண்
மட்பாண்ட: மண், களிமண்
இல்லத்தரசி: 
பகுத்தறிவற்ற: நியாயமற்ற
சுரங்க: சிறிய
ஈஸ்ட்: நொதி, மாவை, பேஸ்ட்ரி
இடைமறிப்பு: தடுக்கும், சமாளிக்க
பிரீமியம்: போனஸ், பரிசு, விருது
விருப்பத்தை: மாற்று, மாற்று, மாற்று, வெள்ளரி, தேர்வு, தேர்வை, மாறுபாடு, விரும்புகிகிறது, விருப்பம், விருப்ப, பதிலீட்டு, மகிழ்ந்தாள்
பட்டதாரி: பரீட்சை, கடந்து
திவால்: தோல்வி
பாசன: 
முதலாளித்துவ: முதலாளித்துவத்தின்
நெகிழ்ச்சி: நெகிழ்வு
வடிவியல்: வடிவியல்
சுறா: 
சேமிப்பு: பாதுகாக்க, பாதுகாப்பதற்காக, கடை, சேமிப்பு
வட்டம்: வாய்ப்பை, எதிர்பார்ப்பு, நம்பிக்கை
ரியலிசம்: 
ஆம்புலன்ஸ்: 
பணப்பை: பர்ஸ், தொகுப்பு
பழிப்பு: குவளை, சிரிப்பின், நெளிவு
விஞ்ஞானி: அறிவியல், அறிஞர், ஆராய்ச்சியாளர், புலன்விசாரணை, உயிரியலாளர்
குடல்: குடல்
மனஅமைதி: 
யதார்த்தமான: உண்மையான, உண்மை, உண்மையில், உண்மையில், உண்மையிலேயே, நேர்மையான, நடைமுறைக்கேற்ற, உண்மையான, வெளிப்படையான
பொருத்தமற்ற: முரண்பாடான, பொருத்தமற்ற, பொருத்தமற்ற, முக்கியத்துவமற்ற
பீன்: நட்டு, வேர்க்கடலை, தானிய
முறைசாரா: சாதாரண, முறையாக
பேத்தி: பேரன், பேத்தியை, மருமகள், சந்ததி
மாமிசத்தை: வெட்டுவது
நைட்ரஜன்: 
முணுமுணுப்பு: விஸ்பர்
பெர்ரி: பறித்து, வளைகுடா
ஆய்வு: இட, பகுப்பாய்வு, ஆய்வு, ஆய்வு
முரண்பாடான: வேறுபடுத்திப், contrastive, முரண்பாடான, எதிர்க்கும், மாறாக, வேறுபடுத்தி, வேற்றுமையை, வேறுபடுத்தி, தனித்துவமான, பல்வேறு
வானவேடிக்கை: பந்தயம், பந்தய, சுடர்
பாப்: படம், களமிறங்கினார்
கழற்று: ஆடைஅவிழ்ப்பு, ஆடைகள்
நிறைவுடன்: துணை, சித்தப்படுத்து, கூடுதலாக, நிரப்பு
pegativeவழக்கு: 
புற்றுநோய்: 
சிப்பாய்: அடமான, சிப்பாய், உறுதிமொழியை
கசிவு: கசிவு, இழப்பு, கைவிட
அடர்த்தி: நெரிசலான, தீவிரம்
மெல்லும்: 
சிக்கலான: சிக்கல்
பேச்சாளராக: தொடர்பு, சுறுசுறுப்பான
விடுதலை: விலக்கு, விடுதலை, விடுபட, நிவாரணம், தகுதி
துருவ: தீவிர, துருவ
தள்ளுபடி: விலக்கு, விற்பனை, சலுகை, அனுமானம்
டாக்ஸி: வண்டி
வரிசைக்கு: தலைமை, அமைப்பு, மறுநிகழ்வு
snarl: 
அப்பாவியாக: நேரியல், வெற்று
ஜனாதிபதி: ஜனாதிபதி
வாங்குபவர்: வாடிக்கையாளர்
கேலன்: 
கொசு: 
வருந்து: துக்கம்அனுஷ்டிக்க, ஆக்கினைக்குள்ளாகத்தீர்த்து,, வருத்தப்பட
விலகல்: விலகல், விலகல், ஈடு, ஏதாவது
மொசைக்: பல்வேறு
பிளக்: இணைப்பு, ரசீது
கர்ப்ப: கருத்துரு, கருத்தரிக்க, செயல்படுத்த, சுமை
மளிகை: 
கம்யூனிஸ்ட்: 
கவர்வது: ஆச்சரியம், அற்புதமான, அதிர்ச்சிதரும், தவறாகவழிநடத்த, குழப்ப, ஸ்டன், குழப்பு, வியப்பாகவும்
prosecutiveவழக்கு: 
சர்வாதிகாரி: 
சிந்தனையுடன்: வேலை, பதட்டம், கவலைப்பட, அக்கறை
செயற்கைக்கோள்: விசாரணை
தோராயமான: தோராய, சுமார், approximative, கிட்டத்தட்ட, நடைமுறையில், ஏறத்தாழ, சுமார்
வேலையற்ற: வேலை
செயல்படுத்த: செயல்படுத்த, செயல்படுத்த, அமலாக்க, மரணதண்டனை, இயக்க
விளக்கை: வெங்காயம், வால்வு
ஆதரவாளர்: உதவி, தாங்க, அடைப்புக்குறி
தாமரை: லில்லி
குளோரைடு: 
பாக்டீரியா: பூஞ்சை, பாக்டீரியா
பின்னல்: முறை
உயிரியல்: உயிரினம், உயிரியல்
feign: பாசாங்கு, உருவகப்படுத்த
பைட்: 
சுரப்பு: சுரக்கின்றன
பாலே: துடுப்பு, வாக்குச்சீட்டில்
சிறுநீர்: சிறுநீரை
பூண்டு: 
நடுத்தரம்,நடுத்தரவர்க்கம்: 
சலவை: சலவை
குணாதிசயம்: வேறுபடுத்தி, பாத்திரப்படைப்பு
ஸ்ட்ராபெரி: 
நோட்புக்: மடிக்கணினி
ஆழ்நிலை: 
ஆல்பம்: 
பேஸ்பால்: 
கடற்கொள்ளையை: 
பஃபே: 
பெயரெச்சம்: பங்கு, நுழைபவர்
கேரேஜ்: 
ஆய்வுக்கு: கண்டறியும், கண்டறிய, அறிவாற்றல், அடையாளம்
பறி: பயமுறுத்துவது, பறித்து, கட்டுப்படுத்தும், நிர்ப்பந்திக்கின்றனர்
பாஸ்பரஸ்: 
கட்டமைப்பு: அமைப்பு, கட்டமைப்பு, கட்டமைப்பு, நிறுவன
பசை: பசை
ஆய்வறிக்கை: விளக்கவுரை
கைவினைஞர்: மெக்கானிக், பிளம்பர்
வாழை: திசு
விலாஎலும்பு: கியர்
நிக்கல்: 
தற்போது: இப்போது, தற்போதைய, தற்போதைய, இப்போதெல்லாம், வரிசை
பேருந்து: நாம்
தணிக்கைக்: தணிக்கை, விமர்சகர்
ஏவுகணை: ராக்கெட்
தொத்திறைச்சி: ஹாட்டாக்
கையாளுதல்: இயக்குகிறது, கையாள, செயல்பாட்டு, தந்திரம், ஏமாற்ற, கையாள, அறுவைசிகிச்சை, மோசடி
தக்காளி: 
வலுப்படுத்தும்: ஒருங்கிணைப்பதற்கு, தீவிரப்படுத்தும், உறுதி, வலுவான, வலுப்படுத்த
குவிந்த: 
பொட்டாசியம்: 
இயற்கணிதம்: இயற்கணித
அணிகலன்கள்: 
ஆப்டிகல்: காட்சி
வேலையின்மை: பேக்கரி
ஆயுதங்களைகளைய: ஆயுத, ஆயுதம், ஆயுத
தனி: தனி, தனி, தனி, மண், தனியாக
உலாவி: ஸ்கேனர்
வரலாற்றுபதட்டமான: 
திறன்: திறன், திறன், திறன், ஈவு, திறன், திறன், கல்வியறிவு
ஸ்பெக்ட்ரம்: 
சோடியம்: 
வெறித்தனம்,: வலிப்பு
அறங்காவலர்: நிர்வாகி, விசுவாசமான
பணயக்கைதிகள்: அடமான, உறுதிமொழியை
தடகள: கணித, தடகள
தோல்சுருக்கம்: குறைபாடு, தெரிவித்தல்
உள்ளனர்: இணைத்துக்கொள்ள, உள்ளடக்கங்களை, ஆவார்கள், கட்ட, சம்பந்தப்பட்ட, ஈடுபட, உள்ளடக்கியது, சேர்ப்பதற்காக, கொண்டிருக்கும், கொண்டிருக்கிறது, அடைய, சேர்க்கிறது
கிளிப்: பிரதான, அடைப்புக்குறி, பிணிக்கை
முன்னுரிமை: கவனம், விருப்பம், விரும்புகிகிறது
கற்பழிப்பு: சீற்றம், தாண்ட, ஆக்கிரமிப்பு
மானிட்டர்: பாடல், மேற்பார்வை, பார்க்க, தொடர
தொகுதியில்: வாக்காளர், வாக்காளர்கள், லேசான
கலாச்சார: கலாச்சாரம்
பாலினம்: கம்ப்யூட், செக்ஸ், ஆண்குறி, இனங்கள், பாலியல்
பிளாட்டினம்: 
இரட்டைஎண்: 
சிறப்பு: தொழிற்கல்வி, பண்பு, பண்பின், குறிப்பிட்ட, சிறப்பு, நிபுணத்துவம், சிறப்பு, தனி, பிரத்தியேக, நிபுணத்துவம்
நுரையீரல்: 
சூப்பர்: தனி, பாரிய, நம்பமுடியாத, மேற்பார்வையாளர்
ரெயில்தண்டவாளங்களின்மேல்கையால்தள்ளப்படும்வண்டி: வண்டி, வண்டி, வேகன்
காளான்: பூஞ்சை, அச்சு
உள்நாட்டில்: உள்ளூர்
துாண்டு: தூண்ட, தொந்தரவு
பெட்ரோல்: பெட்ரோல்
பூசணி: ஸ்குவாஷ், மஜ்ஜை
சிறுநீரக: உயரம், நீட்டிப்பு
திருட்டை: கொள்ளை, சூறையாடல், இரையை, கெடுக்க, திருட, சுமையில்
ஆர்சனிக்: 
நத்தை: சுருள்
நுண்ணிய: 
சோசலிச: சொந்தம்
வடிகட்டி: 
விரிவுபடுத்தும்: விரிவாக்க, பரந்த, சேர்க்க, உயர்த்த, அதிகரிக்க, நீட்டிக்க, பரந்தளவில், விரிவாக்கம்
சர்ச்சைக்குரிய: சர்ச்சை, முரண்பாடு, தெளிவற்ற, குழப்பமான, தெளிவின்மை, முரண்பாடான
தோல்வார்: குத்தகை, பட்டா
தொகுப்பாளராக: 
நிமோனியா: 
கொள்ளுவோம்: வைத்து
வெட்டும்: கடப்பு, சந்தி, வரிசையெண்ணுக்குரியவை
ஒற்றுமை: ஐக்கியப்பட, பேரணியில், நாட்டம், ஒற்றுமை, ஒற்றுமை, சகாப்தம்
கீல்: விரிவான, லூப், அச்சு
நெடுக்கு: செங்குத்து, நீடித்திராது, இனங்கள்
ஈவுத்தொகை: ஒதுக்கீடு
மழுங்கியது: மெதுவாக
ஸ்கேட்: ஸ்கை
பதுங்கு: வளைவு
உள்ளீடு: குறியீட்டு, அதிவேகமான, துண்டு
இயலாமை: ஊனமுற்றோருக்கு, இயலாமை, குறைபாடு, நிறைவற்ற, ஊனமுற்ற, குறைபாடு
சாம்பியன்ஷிப்: சாம்பியன், வெற்றி, போட்டியில்
புகைப்பட: புகைப்பட
டிஜிட்டல்: எண்ணிக்கை, எண், எண்
பிச்: 
கண்ணிமை: 
ஆழ்: 
புருவம்: 
தும்மல்: 
பெருங்களிப்புடைய: மகிழ்ச்சியான, வேடிக்கை, மகிழ்ச்சி, வேடிக்கையான, மகிழ்ந்தாள், வேடிக்கையான, கருத்துகளுக்கு, நகைச்சுவையான, கேலிக்குரிய, மகிழ்வளிக்கும்
அகதி: புலம்பெயர்ந்த
புரதம்: முட்டைவெள்ளை
டம்ப்: குவியல், ஸ்டாக், விரட்டி, குப்பை, குப்பை, வீசுவதற்கு
கண்டுபிடிக்கலாம்: பரிணாமவளர்ச்சி, அபிவிருத்தி
வாந்தி: 
மரபணு: மரபணு, மரபணு
புதியவர்களை: 
ஒன்றாக்க: இணைவு, ஐக்கியப்பட, ஐக்கியப்படுத்தும், இணைக்க, ஒருங்கிணைப்பதற்கு, ஒருங்கிணைப்பு, குவிகிறது, இணைக்க
சமூகவியல்: 
இயக்கம்: மொபைல், சிறிய, இயக்கம், இயக்கம்
பிராந்திய: கவுண்டி, பகுதியில், மண்டலம், வார்டு, கோளம், துறை, புற, மாகாண
இயக்கம்மேல்நோக்கி: 
நீர்த்துப்போக: மெல்லிய, லேசான
சுயபரிசோதனை: கடந்த, சுயபரிசோதனை
தலைகீழ்: கவிழ், மாறாக, தலைகீழ், தலைகீழ், பேரழிவு, கடத்தல்
தொலைக்காட்சி: தொலைக்காட்சி, படம்
கன: திட
தொடரியல்: விதி, ஓய்வூதிய, அமைப்பு
உற்பத்தித்: செயல்திறன், வெளியீடு
கேரட்: 
மூலக்கூறு: மூலக்கூறு, இருந்தால்,தொகுதி, மூலக்கூறு, அணு, அணு
கூட்டுக்குழுமம்: சிறுகுழுஅவர்களுடைய, குழு, கொத்து
கணக்காளர்: தணிக்கையாளர்
வகையீடு: பாகுபாடு, வேற்றுமையை, வேறுபடுத்தி, வேறுபடுத்தி, இயக்கத்தடை, வித்தியாசம், வேறுபடுத்திப், வேறுபாடுகள், மாறுபாடு
கிடைக்கும்: அணுகல், கையகப்படுத்தல், கிடைக்கும், கிடைக்கும், வருகை, திறன்
களியாட்டம்: 
கரைப்பான்: கலைத்து
பாஸ்பேட்: 
அறிமுகம்: தூண்டில், அறிமுகம், அறிமுகம், முதலில்
கமா: கோமா, கட்சி
அனுமானம்: 
இயக்கம்கீழ்நோக்கி: 
கொடை: தொகுப்பாளர்
உளவியலாளர்: 
குளோரின்: வெள்ளாடு
விசைப்பலகை: 
உயரடுக்கு: உயர்ந்த
அடைப்பு: அடைப்புக்குறி
ரக்பி: 
புண்: புண், காயம், அதிர்ச்சி, கொதி
தொனித்திரிபு: 
சிறுகசிறுககொரித்துதின்: 
கருக்கலைப்பு: கருச்சிதைவு
ஸ்வெட்டர்: ஜாக்கெட்
பரிணாம: வளர்ச்சி, பரிணாமவளர்ச்சி, வளர்ச்சி, முன்னேற்றத்தை
குறியீட்டில்: அடையாளம், சின்னமாக, குறிப்பு
துள்ளல்: ஏற்றம், குதிக்க
இடர்: ஒதுக்க, பிரிவில், பிரிவு, பிளவை
கேச்: பதுங்கி
ஆண்டிமனியை: 
superessiveவழக்கு: 
கட்டி: கட்டி, மொத்தமாக
ஆல்பா: 
தொப்புள்: தொப்பை, துருவ
நோய்எதிர்ப்பு: சுவாச, எதிர்ப்பு
குறுக்குங்கள்: எல்லை, எல்லைக்குட்படுத்த, கட்டுப்படுத்த, சுருக்கமாக, கச்சிதமான
இழுக்கும்: பிடிப்பு, வசீகரித்தன, வேட்டை, ஈர்க்க
சாக்: 
திரைப்பட: படம், சினிமா, ரிப்பன், டேப், பட்டை
அகிலம்: பிரபஞ்சம்
மாசுபடுத்த: மாசு, பாதிப்பை
கூட்டம்கூடும்: 
அலுமினியம்: அலுமினியம்
அலைவு: ஏற்றஇறக்கம், அதிர்வு
அகரவரிசைப்படி: எழுத்துக்களை
ஜாதகம்: 
தொடுகோடு: 
டால்பின்: 
கொலையாளி: 
அதிர்வு: அதிர்வு
காட்டி: காட்டி, குறியீட்டு, அடிப்படை, ஆள்காட்டிவிரல், பாதை
டைஆக்சைடு: 
அதிகாரத்துவம்: அதிகாரத்துவ
சிதைக்க: தவறாகவழிநடத்த, ஸ்க்ரேம்பில், மோசமடைந்து, பொய்ப்பதிவுரு, வளைவு, விலகல்
விண்மீன்: விண்மீன்
மருத்துவ: 
ரேடியம்: வானொலி
குளிர்சாதனபெட்டி: பிரிஜ்
இசைச்: இசை, இணக்கம்
தொல்பொருள்: தொல்லியல், தொல்லியல், தொல்பொருள்
விவரக்குறிப்பு: விதிமுறை, தரப்படுத்த, விவரம்
இடைச்செருகல்: 
துண்டுப்பிரசுரம்: கையேட்டை, தகவல், துண்டுபிரசுரம், தாள்
முற்றுப்பெறாத: நிறைவற்ற
மானுடவியல்: 
சுவையான: ருசியான
டிரான்சிடிவ்: தவிர்க்கவும்
முடங்கிப்போக: 
உருவகப்படுத்துதல்: உருவகப்படுத்த, பேட்ஜ்
யோனி: வளைகுடா, செல்
அயன்: 
சுற்றுலா: சுற்றுலா, பயண, சுற்றுலா
கோணவியல்: 
கடத்தல்: விமானக்கடத்தல், கடத்தல், பறிக்க
ஒன்றுடன்ஒன்று: தொடர்பு, ஊடாடும்
தேடுங்கள்: 
கைப்பற்றிடவோ: புரட்டுகின்றனர், வெளியேற்ற, வெளியேற்றுவீர்கள், நாடுகடத்துவதற்கு, விரட்டி
சிகையலங்காரநிபுணர்: 
நாடோடிப்பாடலின்படி,: கோதுமை, நாட்டுப்புற
தந்துகி: 
தேசியவாதம்: தேசிய
பிட்டம்: இடுப்பு
பதங்கம்: தூய, சுத்தி
தாங்கல்: 
விரக்தி: விரக்தியிலும், ஏமாற்றம், குழப்பி, ரத்து, தோல்வி, ஏமாற்றம், ஏமாற்றம், ஏமாற்றம்
கோபால்ட்: 
கழித்தல்: கழித்தால்
இயக்கம்upriver: 
ஆய: ஒருங்கிணைத்து, ஒருங்கிணைக்க, ஒருங்கிணைப்பு
ஆசனவாய்: 
பணிநீக்க: நிறைய, எஞ்சிய, அதிகமாக, பதவிநீக்கம், பதவிநீக்கம், விலக்கு, உபரி
காணொளி: 
புறக்கணிப்பு: கவுண்டி, ஒதுக்கப்பட்ட, புறக்கணிப்பு
வினாடிவினா: முயற்சி, பரீட்சை, கேள்வித்தாளை
கொரில்லா: 
மெக்னீசியம்: 
ரேடார்: 
பண்பு: தரமான, பண்பு
நம்பகத்தன்மை: நம்பகத்தன்மை
செவ்வகம்: 
பொதுமைப்படுத்த: பொதுமைப்படுத்தும், உருவாக்க, உருவாக்க, எழுது
இனி: இப்போது, மீண்டும்
ஊரடங்குஉத்தரவு: 
உருவாக்கம்: உருவாக்க, கட்ட, ஆக்கபூர்வமான, வார்த்தைகளை, உருவாக்கம், உருவாக்கம், முறைப்படுத்துதல், ஸ்தாபனத்தின்
மறுபிறவி: மறுபிறப்பு
எரியூட்ட: 
யுரேனியம்: 
வரிப்பண: வரி
ஒருங்கிணைந்த: ஒருங்கிணைந்த
யூகத்தை: பார்வை, கருத்து, கருத்தை
காமா: 
சர்வர்: 
இயக்கம்downriver: 
குணகம்: தர, காரணி, குணகம்
பிஸ்மத்: 
அஞ்சலட்டை: பதவியை, முதுகலை
விலகு: பின்வாங்க, புறப்படு
உருவ: மரபணு, அமைப்பியல்
மதிப்பீடு: மதிப்பீடு, மதிப்பீடு, மதிப்பீடு, விசாரணை, விசாரணை, விசாரணை, விசாரணை, சம
ஜீன்ஸ்: 
தகவல்: 
கால்குலேட்டர்: கம்ப்யூட்டிங்
முதலீட்டாளர்: 
எக்ஸ்-ரே: 
நிகழ்ச்சிநிரல்: திட்டம், திட்டம், பாடத்திட்டத்தை
விசா: 
உள்கட்டமைப்பு: அடிப்படை, அடிப்படை, அடிப்படையில்
கண்டுபிடிப்பான்,: 
கயிற்றின்: இணை, திருத்தும், இணைக்கவும், இணைக்க
புரோமின்: 
சிலிக்கான்: பை
விக்கல்: 
வெளிர்: வெளிர்
பூங்காவில்: 
மையம்: 
யோகா: தொகை
புத்தகக்கடைகளில்: செல்வக்குமார், கடை
விற்பனையாளர்: வியாபாரி, விற்பனையாளர், கடை, அருகிலுள்ள
சிரச்சேதம்: சரியானநேரத்தில்
ஆமாம்: ஆம், யா, நேர்மையான
ஜாஸ்: 
டங்ஸ்டன்: 
பயங்கரவாத: போராளி, பயங்கரவாத, தீவிரவாத
கருத்துரு: ஆடம்பரமான, கருத்து, கருத்து, அனுமானம், முன்னுதாரணம், கருத்துரு, வரைவு
கார்ட்டீசியத்: 
சிறுசிறுதுளிகளாகவிடு: கோழை
ஜீவனாம்சம்: 
புரோகிராமர்: பயன்பாட்டை
உள்ளீடு: 
ஒப்பனை: ஒப்பனை, ஒப்பனை, தந்திரம், ஈடு
தடுப்பூசி: வர்ணனை, பாதுகாப்பு, ஊசி
ஆக்ஸியோமெட்டிக்: 
ஹெராயின்: 
அடைவு: 
கத்தோடு: 
காய்ச்சல்: காய்ச்சல், செல்வாக்கு
சித்தாந்தம்: நினைத்தேன்
பார்க்கிங்: 
நொடிப்பை: 
உயர்ந்தஎண்ணநிலையிலிருந்துஏற்படும்திடீர்வீழ்ச்சி: ஏமாற்றம்
செலினியம்: 
புறணி: பட்டை, ஷெல், தலாம்
சமான: சமத்துவம்
உச்சி: 
விமானநிலைய: 
வெட்டிஎரி: குறுக்கிட
மோசடிக்காரன்: 
குரோமியம்: 
லிட்டர்: லிட்டர்
கட்டுப்பாட்டுஅறை: குழு, கோடு
ஹார்மோன்: 
துளைத்து: துளைத்து
ஆன்மவாதம்: 
கோணம்: கோணம்
பெண்ணிய: 
மூலமொத்தச்: சாய், இணைக்கப்பட்ட, விலகி
யூரோ: 
வழிமுறை: 
லேசர்: 
மருந்துக்கடை: 
மில்லிமீட்டர்: மில்லிமீட்டர்
சாதகமான: வளைவு, வளைந்த, நெகிழ்வான, சாதகமான, கேபிள்
நேர்முனை: 
நுட்பத்தையும்: நிழல்
அணைத்துக்கொள்: தழுவி
பகுதிநேரம்: 
உணர்திறன்: 
மெயின்பிரேம்: 
ஆர்ப்பாட்டக்காரர்: தோற்றம், காட்சி, செயல்திறன், ஆர்ப்பாட்டம், வழங்கல்
ஹீலியம்: 
இருமொழி: 
தொழிற்பெயர்போல்தோன்றும்பெயர்ச்சொல்: 
பிளாஸ்மா: 
குரோமோசோம்: 
முழு: ஐக்கிய, எண்
கிலோமீட்டர்: கிலோமீட்டர்
தொலைநகல்: 
மரபியல்: மரபணு, மரபணு
freckle: 
ப்ரோக்கோலி: 
வரிசைமாற்றம்: வடிவம், வரிசை, அமைப்பு, அருகமைவாக
ஸ்பேம்: 
திசையன்: கேரியர்
தந்திரோபாயம்: சாதனம், அணுகுமுறை, தொழில்நுட்பம், முறை, எடுக்க
சரியாகிவிடும்: மீட்க, சரியாக, கட்டு, செல்லுபடியாகும், சரி
வைட்டமின்: 
கேட்மியம்: 
வரைகலை: கிராபிக், கிராபிக்ஸ்
கைமுறையாக: தன்னை
டைட்டானியம்: 
நினைச்சபோதெல்லாம்கரைக்க: தற்பெருமை
ஹெலிகாப்டர்: 
டெலூரியம்: காந்தியம், லாந்த்தன்ம்
காலக்கெடுவை: கால
வரிசைப்படுத்து: சீரான, வரிசை
அனலாக்: 
சென்டிமீட்டர்: சென்டிமீட்டர்
மாலிப்டினம்: 
லித்தியம்: 
மல்டிமீடியா: 
கலோரி: 
ரோபோ: 
வீட்டுவேலை: பெருமகனார்
மடக்கை: 
instal: மலையின், நிறுவ, தொகுப்பு
கிளிஃப்: நிவாரண
சூழலியல்: சுற்றுசூழல், சுற்றுச்சூழல்
உலகியல்அறிவு: கெடுக்க
டெம்ப்ளேட்: அச்சு
யூக்ளிடியன்: 
கிலோகிராம்: 
overeat: 
வகுத்தி: 
இலவசமென்பொருள்: 
ஒட்டுக்கேட்க: 
ஹேர்கட்: 
இரிடியம்: 
இனவாதம்: இன
அலைவரிசையை: பிராட்பேண்ட்
உகந்த: மேல், உகந்த, சாதகமான, மிகவும்பொருத்தமானது, சரி, ஏற்ப, இணக்கமான, தகவமைப்பு, சரியான, சரியான, விவேகமான
கர்ணம்: நாண், ஸ்லாண்ட்
டெஸ்க்டாப்: 
தலைமையிட: தலைமையகம், இருக்கை
தவறவிட்டு: சங்கடப்பட, இழக்க
சீரியம்: 
தனித்தனியாக,பகுதிபகுதிகளாகப்பிரிக்கஉதவுகிறவழக்கு: 
கேசட்: டேப்
பல்பொருள்அங்காடி: மால்
மனஉறுதியால்: தன்னிச்சையாகசெயலாற்றல், விருப்பம்
பரிமாண: அளவு, வடிவம், பரிமாணத்தை, வெளிசார்ந்த
ஆஃப்லைன்: 
குறியாக்க: குறியாக்கவியல், என்க்ரிப்ட், குறியீட்டு
ஒருங்கிணைக்க: ஒத்திசைக்க, ஒருங்கிணைக்க, சமகால
கருத்தரங்கு: 
பொருள்: பொருள், அளிப்பதை, பொருள், பொருள், பொருள், பொருள், உணர்வு, அர்த்தமுள்ள
டிஸ்கோ: 
நியான்: 
உண்மையானநேரம்: 
ஆஸ்மியம்: 
வாழ்க்கை: உயிர், வாழ்நாள், உயிர், வாழ்க்கை, வாழ்க்கை
ஃபயர்வால்: 
கோசைன்: கணக்கீடு, கணக்கீடு
குளறுபடியாகவும்: 
புளூட்டோனியத்தை: 
பணிநிலையம்: 
திகழியம்: 
மேம்பாடு: 
பயனர்பெயர்: 
வலதுசாரி: 
ஆர்கான்: 
பழக: தொடர்பு, தொடர்பு
உலகமயமாக்கல்: 
வெட்டுக்கோடு: 
அலைநீளம்: அலை
குறியாக்கம்: குறியீடு
மறுசுழற்சிக்கு: 
அணுகுகோட்டிற்கும்: 
குறியீட்டுநீக்க: திருப்தி, தீர்க்க
மறுதுவக்க: மீண்டும்துவக்கவும், செயல்பாட்டு
ஹெபடைடிஸ்: 
புரோட்டான்: 
வட்டை: வட்டு
மில்லிகிராம்: 
பிக்சல்: 
டாண்டாலம்: 
கரைபொருளின்: 
இனப்படுகொலை: 
காலியம்: 
பாப்வரை: 
ஸிர்கோனியம்: 
தொகையற்ற: 
பூச்சிக்கொல்லி: 
பல்லுறுப்புக்கோவை: 
பெரிலியம்: 
நியூரான்: 
பயனிலை: உறுதியான
திசைவி: 
காரணியாலான: ஆசிரிய
விட்ஜெட்டை: ய
நியூட்ரான்: 
நியோபியம்: 
ஜெர்மானியம்: 
உலோகத்தோற்றவடிவமுடைய: அல்லாதஉலோக
prolativeவழக்கு: 
பல்லுயிர்: 
தொழில்: தொழில்மயமாக்கல், தொழில்
ஜாய்ஸ்டிக்: 
ஆண்டிபயாடிக்: 
அத்தினியம்: 
விண்வெளி: விண்வெளி
அகற்றுவதற்குத்: விரிவாக்க, அதிகரிக்க
எக்ட்ராபோலேஷன்: 
வேற்றுகிரக: அன்னிய
எட்டுத்தொகுதி: 
திறந்தமூல: 
மாரத்தான்: 
பிளக்உள்ள: 
கட்டமைப்பியல்: 
ஜிகாபைட்: 
அயனியாக்க: 
Siஅலகுகள்: 
முகாம்: முகாமில்
வரையறுக்கப்பட்டவினை: 
கிரிப்டான்: 
gnomicமனநிலை: 
மாற்றம்முக்கிய: 
சதுரங்கள்: சதுர
விற்பனையாளராக: வியாபாரி, விற்பனையாளர், எழுத்தர்
ரினியம்: 
கைப்பேசி: கைப்பேசி, மொபைல்போன், சிறிய, மடிக்கணினி, செல்
பக்கவாட்டாக: ஒதுக்கி
மாதிரிவழக்கு: 
குப்பைமெயில்: 
railcar: 
கிளிப்கலை: 
புக்மார்க்: 
ஆஃப்னியம்: 
வீட்டில்பக்கம்: 
lativeவழக்கு: 
வானளாவியரூட்: 
பாய்வுப்படம்: 
நடுத்தரகுரல்: 
முதுமை: முதியவர்கள்
வட்டமிடுதல்: வட்டமான
ரோடியம்அணுவின்: டெர்பியம்அணுவின், தூலியம்அணுவின், தோரியம்அணுவின், புளோரின்அணுவின், ரூபிடியம்அணுவின், தெள்ளீயம்அணுவின், வனேடியம்அணுவின், பொலோனியம்அணுவின், ஸ்டுரோன்அணுவின், ருத்தேனியம்அணுவின்
கெட்டமனமுடைய: கடினமான
சாய்ந்தவழக்கு: 
நோயாளிவழக்கு: 
முன்hodiernal: 
வழுக்கை: வெற்று, மூல
இலக்குதூண்டுதல்: 
பிரசியோடைமியம்: 
முடங்கி: 
புகார்: புகார்
செய்யவழக்கு: மணிக்குவழக்கு, தோராயமாக, இருந்துவழக்கு
கதிர்வீச்சு: பளபளப்பு, உமிழ்வு
இண்டியம்: 
நடிகர்பங்கு: 
நன்னிலை: உற்சாகம், வைராக்கியம், திருப்தி, ஒப்புதல், இன்பம், மகிழ்ச்சி, மகிழ்ச்சி, மகிழ்ச்சி
தொப்பிகள்பூட்ட: 
வெள்ளைவிண்வெளி: 
வியத்தகு: வியத்தகு
பேரினவாத: 
வலைத்தளத்தில்: வலைத்தளம், தளத்தில்
வீட்டில்ஆலை: 
சமூகஉரிமைகள்: 
பாகையம்: 
துரித்திக்: 
பைனரிமதிப்பு: 
கோல்கீப்பர்: 
சில்லறைகடை: 
நிலைபட்டியில்: 
ஒலிவாங்கி: மைக்ரோ
மனிதஉடல்: 
சத்தியம்-இல்: 
தபால்எடுத்துவருபவர்: 
மையப்படுத்தியவழக்கு: 
ட்ரோஜன்குதிரை: 
சுருள்பட்டியில்: 
மூன்றுபுள்ளி: 
படிக்கமட்டுமே: 
wisecrack: ஜோக், வாய்வழி
நிலையற்ற: நிலையற்ற, உறுதியற்ற
கவிஞர்: 
பேச்சொலி: 
ஹிப்னாடிசம்: 
விசாரணைஎண்: 
ஏற்பி: வரவேற்பாளர்
வினைபின்னொட்டு: 
அல்லாதமனித: 
ஓட்டம்தற்போதைய: 
என்று-இது: அந்த, எந்த, யாரை, யாருடைய
உட்கூறுவால்: 
தலைகீழாக: தலைகீழ், தலைகீழாக
ஐந்து-உதாரணமாக: 
IPமுகவரி: 
உள்ளமொழி: 
தனித்தனியாக: தனிப்பட்டமுறையில், தனிப்பட்ட, தனிப்பட்ட, தனியாக, தனி, தனித்துவமான, வேறுபடுகின்றன, வித்தியாசமாக, வெளிசார்ந்த
சார்புதண்டனை: சார்புசொற்றொடர்
நோய்த்தொற்றியல்: இயக்கவியல், இயக்கவியல்
சட்டம்இயற்ற: சட்டம், சட்டமன்ற, ஏற்பாடு, ஏற்பாடு
கோடிட்ட: பட்டை, திட்டம், பிளானர், செயல்திட்டமாக
வேலைநிறுத்தத்தை: 
astatine: 
ஏற்றிகூறு: 
வேறுஎன்றால்,: 
கோணங்களில்: கோணம், கூரான
அணிய-அவுட்: 
சான்றுவடிவம்: 
ergativeவழக்கு: 
புறநகர்: குக்கிராமம், பயணிகள், கிராமப்புறங்களில்
பொதுவானபாலினம்: 
சூப்பர்: 
நேரடிபொருள்: மறைமுகபொருள்
ஓட்டிய: இயக்கி
புள்ளிவிவர: புள்ளியியல், எண்
மிளிரியம்: 
பகுத்தறியும்தன்மை: உணர்வு, தர்க்கம்
செயலற்றகுரல்: 
நோய்க்காரணி: 
சீசியம்: 
தேடல்இயந்திரம்: 
டூல்பார்: 
தானாக: தானியங்கி
கலிஃபோர்னியம்: 
மெண்டலேவியம்: 
முகவர்தூண்டுதல்: 
நிறக்குருடு: 
காமிக்துண்டு: 
முனையத்தில்: முனையத்தில்
டாட்அணி: 
சமாரியம்: 
குறைந்தமின்னழுத்தம்: 
தொகுக்க: சேகரிக்க
எழுவாய்வழக்கு: 
விபத்து: விபத்தில், விபத்துக், தற்செயலான, சம்பவம், ரெக்
fractals: 
multalஎண்: 
மூடுவதற்கு: மூடப்பட்டது, மூடப்பட்டது, நெருக்கமான, ஒதுக்கப்பட
பரந்த: பரந்த, விரிவான, பரந்த, பரந்த, பரந்தளவில், போதிய, பரவலாக, பரவலாக, பெரிய, கோணம்
adessiveவழக்கு: 
கூட்டுறவு: சக, ஒத்துழைக்க, சக, இணை
euler's-எண்: 
லேசர்பிரிண்டர்: 
டிரான்ஸ்எண்: 
வலைப்பதிவு: பதிவர்
சேர்க்கை: சேர்வியல்
பிதாகரஸ்: 
ஜப்பானிவழக்கு: 
தேடுகவழக்கு: 
நீச்சல்குளம்: பூல், பேசின்
சைபர்: ஆபத்தான, தீங்கு
தபால்நிலயம்: பதவியை, மின்னஞ்சல்
தீம்பொருள்: 
தடைபடுதல்: நிதானப்படுத்த, கட்டுப்படுத்து, தடுக்கும், தடை, தடுப்பதிகார, பின்வாங்க, காப்பாராக
ஸ்பைவேர்: 
பதிவு: பதிவு, சேர்ப்பதற்காக, பதிவு, பதிவு, நுழைவு, பதிவு
பேட்டியாளர்: பேட்டி
கிளிப்குழு: 
செனான்: 
விரிதாள்: 
வானளாவியசக்தி: 
திரையரங்கம்: சினிமா
இன்பாக்ஸ்: 
சதவீதம்: சதவீதம், சதவீதம்
ஏரோசால்: தெளிப்பு
விநியோகஸ்தராக: 
இயக்கவியல்: இயக்கவியல், இயக்கவியல், மாறும்
ஒருநொடி: 
subtend: அடிக்கோடிடும்
பிரவுன்: 
நட்சத்திரபாலினம்: 
விண்மீன்பாலினம்: 
அட்டை: அட்டை, அட்டைப்பெட்டி
கணிக்கக்கூடிய: 
ஒருமற்றொரு: மற்றொரு, ஒருவருக்கொருவர், வேறு
காவல்அதிகாரி: 
முதன்மைபொருள்: 
உயிருள்ளபாலினம்: 
evitativeவழக்கு: 
வாகனபாலினம்: 
தகவல்கள்சுரங்க: 
கொண்டிருந்தனவழக்கு: 
அமெரிகியம்: 
கனிமபாலினம்: 
டொமைன்பெயர்: 
கற்பனைஅலகு: 
நெருப்பியம்: 
வாய்மொழிபெயர்ச்சொல்: 
கணிதவியலாளர்கள்: 
சொந்தம்வழக்கு: சொந்தம்வழக்கு
மாடலிங்: 
இறுதிதுகள்: 
ஃபிளாஷ்இயக்கி: 
நெகிழ்வட்டு: 
தீயணைக்கும்: 
முக்கியமானபுள்ளி: 
அதேமாதிரிமகிழ்ச்சி: 
வார்த்தைசெயலி: 
பிரதமர்: 
மெய்நிகர்நினைவக: 
வினைதழுவியவழக்கு: 
ethidium: 
குறும்படங்கள்: 
முட்டாளாக்கசுற்றி: 
சமன்பாடுகள்: சமன்பாடு
subessiveவழக்கு: 
பதிவுவெளியே: 
வேண்டாதவர்கள்: 
antessiveவழக்கு: 
கிராஸ்வாக்: வழித்தடம், நடைபாதை
பயனர்இடைமுகம்: 
கோஸ்ட்ரைட்டர்: 
கணினிவைரஸ்: 
அனுசரணையாளர்: தொகுப்பாளர், மதிப்பீட்டாளர்
புனர்வாழ்வு: 
துணைவினை: 
முதல்கை: நேரடி
மதர்போர்டு: என்பதை
நோயாளிதூண்டுதல்: 
இயக்கநேர: 
கூட்டுபெயர்ச்சொல்: 
குரானை: செய்தித்தாள்
வணிகநபர்: வணிகநபர்
டிரான்சிடிவ்வினை: 
மேகம்கம்ப்யூட்டிங்: 
மெய்நிகர்இயந்திரம்: 
absolutiveவழக்கு: 
மெய்நிகர்உண்மையில்: 
கடந்தகுறைவின்மை: 
சார்பற்றதன்மைவினை: 
கிரஸ்டினல்பதட்டமான: 
பின்விளைவுள்ளதுமானகுரல்: 
சுருக்கம்பாலினம்: 
வெவ்வேறுநிகழ்வு: 
புறமையமானவழக்கு: 
இரண்டாவதுமொழி: 
கலைபாலினம்: 
சுயநம்பிக்கை: 
ஆராய்ச்சிபாலினம்: 
மறைமுகபேச்சு: 
வட்டாரத்தின்பாலினம்: 
இயற்பியல்: உடல், உடல்
பிரபஞ்சம்பாலினம்: 
மூடல்: நெருக்கமான, மூடப்பட்டது, மூடப்பட்டது, ஆஃப், போர்நிறுத்தஒப்பந்தம், விட்டுவிட, சப்பாணியாய்
உயர்ந்தவழக்கு: 
பொருத்தம்: போட்டியில், வாக்கு, வாக்குச்சீட்டில், வழக்கு, அதற்கான, ஒப்பந்தம், ஒத்திருக்கிறது, பொருத்தமான, மிகவும்பொருத்தமானது, யதேச்சையாகநடந்தது, மின்னஞ்சல், தொடர்புடைய, இணக்கமான
கணினிதிட்டம்: 
ஆன்டிபாடி: 
முழுநேரம்: 
propositiveமனநிலை: 
துணைவழக்கு: 
உயிரற்றபாலினம்: 
உரைஆசிரியர்: 
கிரகபாலினம்: 
இயக்கஅமைப்பு: 
இலக்கணவழக்கு: 
மின்சாரதற்போதைய: 
தலைகீழ்குரல்: 
flatware: 
கோர்benefactive: 
வலைதொகுப்பாளர்: 
ரேடியன்: 
applicativeகுரல்: 
ஒலியன்: 
அடுத்தடுத்தஉட்கூறு: 
நோட்புக்கணினி: 
எரிவாயுமிதி: 
antipassiveகுரல்: 
நாட்டுப்புறஇசை: 
டெராபைட்: 
சமூகநெட்வொர்க்கிங்: 
பேச்சுவார்த்தை: பேச்சுவார்த்தை, பேச்சு, உரையாடல், அரட்டை, தொடர்பு, தொடர்பு, ஆலோசனை, தொடர்பு, உரையாடல்
noncommittal: பிளாட், தெளிவற்ற, தெளிவற்ற
கட்டுருபன்: 
லிங்கரைக்: இணைப்பு, இணைந்து
இரட்டியம்: 
கதிர்வீச்சுசுகவீனம்: 
தற்போதையபெயரெச்சம்: 
necessitativeமனநிலை: 
இருத்தலியல்உட்கூறு: 
அதிகப்படியானகாலம்: 
செயலற்றபெயரெச்சம்: 
இலக்கண-பொருள்: 
continuativeஅம்சம்: 
singulativeஎண்: 
ஒளிரும்தீவிரம்: 
உயர்ந்தபட்டம்: 
நீல-Jean: 
தேர்தல்அளவீட்டுருவிற்கு: 
உய்யதிரவ: 
epentheticகட்டுருபன்: 
postpositionalவழக்கு: 
மறுக்கிறஅளவீட்டுருவிற்கு: 
இணைப்புதுகள்: 
nerium: 
உலகளாவியஅளவீட்டுருவிற்கு: 
விமானப்படை: 
allocutionஒப்பந்தம்: 
கணினிநிரலாக்க: 
உறுதியானஅளவீட்டுருவிற்கு: 
frequentativeஅம்சம்: 
பங்கீட்டுசுட்டுப்பெயர்: 
மாற்றுஅளவீட்டுருவிற்கு: 
ஃபிஷிங்: 
ஸ்கேலார்: 
மாற்றாலநிபந்தனை: 
