hnit	รูปกริยาในภาษาอังกฤษ
hnak	ประธานของประโยคกรณี
hkak	กรรมการกกรณี
htak	หัวข้อกรณี
hpap	พ่อ
hmam	แม่
hyat	ผู้ปกครอง
hcan	สวัสดี
hwik	การกที่เป็นนามเรียกขานกรณี
hsuc	บรรพบุรุษ
htat	ปู่ย่าตายาย
hcac	หิว
hnik	สัมพันธการกกรณี
hcit	คำคุณศัพท์
hwan	และ
hman	ผม
hnan	คุณ
hwam	พวกเรา
htit	มัน
htac	ปลายทางกรณี
htik	สัมปทานการกกรณี
hyit	REALISอารมณ์
htim	deonticอารมณ์
hcut	เงื่อนไขอารมณ์
hsit	epistemicอารมณ์
hyak	เป็นเครื่องมือกรณี
htan	ภายในบริบท
hpan	คนบริบท
htin	ข้อที่เป็นอิสระ
hyan	ขึ้นอยู่กับประโยค
hfap	เพอร์เฟแง่มุม
hkat	อดีตเครียด
hnin	เพศชายเพศ
hmak	comitativeกรณี
hnat	นำเสนอเครียด
hpak	benefactiveกรณี
swik	essiveกรณี
htut	negatoryปริมาณ
hsan	พื้นผิวบริบท
hpin	adpositionalกรณี
hwin	ที่ตั้งกรณี
hkan	ช่องว่างบริบท
hnac	ทางกรณี
hyut	ปุจฉาอารมณ์
hnam	และหรือ
hkit	แต่เพียงผู้เดียวหรือ
hsuk	แหล่งกรณี
hpik	ระเหยกรณี
hcat	ความใกล้ชิด
hmat	เป็นการสาธิต
hkuk	ข้อหาง
hlan	แต่
hsut	ทั้งหมด
hyin	สากลปริมาณ
hcin	ของผู้หญิงเพศ
hpac	พหูพจน์จำนวน
hyik	หนึ่ง
htic	ของพวกเขา
hkik	ใคร
tcat	อนาคตเครียด
hsin	สังคมบริบท
hkac	เมื่อ
hmip	imperfectiveแง่มุม
klan	ที่นั่น
hlak	ญาติกรณี
hlik	เกี่ยวกับการสรุปกรณี
htam	คำสั่งอารมณ์
hlat	วิชาเลือกปริมาณ
hkam	อะไร
hwat	คำถามคำ
htap	เชื่อม
hpat	คน
nyan	ชาย
hkas	ได้
tcan	อื่นๆ
hnuc	จำนวน
twit	แน่วแน่ปริมาณ
hsak	เวลาบริบท
htuk	ชั่วขณะกรณี
htun	เท่านั้น
htum	เกี่ยวกับการหมุนนำอารมณ์
hyip	มีผลย้อนหลังแง่มุม
hlit	volitiveอารมณ์
pcic	ต้อง
tyut	สอง
hsat	ดู
hkut	ทราบ
hcic	ลง
hcap	หลังจาก
hpam	เป็นครั้งแรก
hlac	โอนกันได้สมบัติ
hkap	ไม่เคย
hnic	เอาไปไม่ได้สมบัติ
tyat	เก่า
tcit	อภิปรายอารมณ์
tcin	วัน
hlam	มา
hwak	สระ
hkin	ไป
lwak	perlativeกรณี
hpip	ความก้าวหน้าแง่มุม
lyan	ยาว
hsac	พูด
kyan	อย่างไร
htas	อีกครั้ง
hsic	ที่นี่
hcik	คิด
hcak	ภายใต้บริบท
hfan	พบ
hsun	มือ
hyac	นอกจากนี้ยังมี
nwan	หนุ่มสาว
tyit	ต่อต้าน
tlan	พระเจ้า
twak	delativeกรณี
hmin	ไม่มีอะไร
hyas	ครั้งหนึ่ง
hlap	semelfactiveแง่มุม
kcac	ซ้าย
hyic	เลื่อย
hcas	บ้าน
hwac	โลก
tyin	สาม
hnun	นีโอ
hcuk	โฟกัส
pyan	ความรัก
hsis	เสมอ
hyam	กลางคืน
hyap	กษัตริย์
hkic	ระหว่าง
hmas	ใจ
cyit	หัวใจ
pluc	paucalจำนวน
kyik	เพราะ
ksak	เกี่ยวกับสาเหตุกรณี
tcun	เสร็จแล้ว
hnim	ชื่อ
tsan	เหมาะสมคำนาม
klac	ประเทศ
hpun	ถาม
cyat	มองเห็นได้ซึ่งเป็นพยานหลักฐาน
pcac	ดีกว่า
hmac	ขณะ
hnas	ไม่ได้
hwic	น้ำ
twim	desiderativeอารมณ์
kwan	เบา
tlat	คำ
tyan	ประตู
hsas	ตอนเช้า
syat	จนกระทั่ง
twik	terminativeกรณี
hpit	ขาว
pcan	เงิน
hyis	น่าสงสาร
mwan	ความตาย
hfam	รูปแบบ
nwik	inessiveกรณี
kcat	ด้วยกัน
tsac	บ่อยครั้ง
pyat	เพื่อน
psan	ครึ่ง
hpim	ความจำเป็นอารมณ์
hyuc	รอบ
hfat	ส่ง
hcis	ภรรยา
kcan	เชื่อ
hsik	สาธารณะ
htus	สถานะบริบท
hpas	บุตรชาย
clat	เด็กๆ
tyak	ดังนั้น
cwan	หวัง
syin	ที่รัก
hkuc	สูง
tyac	อ่าน
syit	เมือง
hlic	แล้ว
hfit	factiveซึ่งเป็นพยานหลักฐาน
tcac	สาว
hcun	ได้ยิน
ksan	น้อยที่สุด
hyaf	บางที
kyat	จริง
tcic	ตัว
hwit	กลับ
cwat	อากาศ
hfaf	กฎหมาย
hput	ช่วยด้วย
lyat	จดหมาย
ksas	สี่
hpic	รูปประโยคประสงค์อารมณ์
hfuk	ไฟ
hcam	ชั่วโมง
twat	สงคราม
kyak	หลาย
tlit	ที่สอง
pcin	หลัง
hmut	สูญหาย
clan	พัน
hfac	ครอบครัว
twan	จิตวิญญาณ
hwas	คำถาม
syan	ความจริง
htis	การทำ
tsat	ที่อาจเกิดขึ้นอารมณ์
lwik	allativeกรณี
nyin	มานุษยวิทยาเพศ
hfak	ห้า
tcak	เหมือนกันเรื่องเครื่องหมาย
htuc	ต่างเรื่อง
hnap	ตอบ
hmit	ทะเล
hcuc	กลัว
pcat	เข้าใจ
syas	ข้อตกลงและเงื่อนไข
hcaf	สงสัย
twut	dubitativeอารมณ์
hkis	สีดำ
tlak	นำมาซึ่ง
hyus	สวย
nyit	ประเภท
htip	สิบ
ksis	เรื่องราว
hpuk	book
hlin	อิเล็กทรอนิกส์
hkun	บัญชี
lyas	ดอกเบี้ย
lyit	เขียน
pwat	เตียง
hnis	อายุ
hnut	counterfactualเงื่อนไข
slas	ศิลปะ
hwis	VIALISกรณี
pyak	พี่ชาย
lyin	สาย
tyas	ตาราง
hyun	แม่น้ำ
kyac	ตา
tfan	ทันใดนั้น
kcin	ลึก
hmuc	วัตถุประสงค์
cyac	เลือด
hmap	ดอกกุหลาบ
tlin	หนาว
hyif	ข้างหน้า
tyam	ปลาย
hnaf	สมมติ
hkip	เกือบ
myan	เหมือง
tsin	ความรู้
hkup	สำเนา
hsam	สามี
hlis	หก
cwit	การดำรงชีวิต
cyan	ความสงบสุข
myat	จำ
tyic	โดยธรรมชาติ
hfut	ตก
swas	บริการ
hsap	ยกเว้น
pcit	ลิขสิทธิ์
hyim	กองทัพบก
kyas	ม้า
plic	อนาคต
pcak	ไปทางทิศตะวันตก
hpis	จ่ายเงิน
hyuk	สีแดง
hwun	ทอง
twin	ปรารถนา
plan	เล่น
hpus	สำนักงาน
syun	รัฐบาล
kyic	โบสถ์
htaf	ความแข็งแรง
hlun	ความยาว
kyin	บริษัท
kyis	กระดาษ
mlan	ความน่าจะเป็น
hcim	โดยเฉพาะอย่างยิ่ง
cyas	หมี
twac	หน้าต่าง
nyat	ความงาม
hcus	ระยะหลัง
htup	หน้าที่
htif	ระยะทาง
pyas	เท้า
hlas	ป่า
ksin	สีเขียว
hmaf	ปัญหา
myac	ยิ้ม
hsim	การนอนหลับ
kyit	ที่ยกมา
kwik	quotativeกรณี
fwan	การเยี่ยมชม
slan	ปฏิบัติตาม
psit	การแสดงตน
hmic	หวาน
hmuf	ปาก
hfin	รวย
tcam	ศัตรู
psuk	แตก
kcap	เรือ
pwan	รวมทั้งคน
hfic	มีอิทธิพล
tcuc	ปรากฏ
hkim	ลับ
pyin	กรุณา
pwit	precativeอารมณ์
pyit	สุภาพการลงทะเบียน
cwak	ชั่วร้าย
myak	มีนาคม
tcas	สถานที่
hlaf	พักอยู่
psat	แทน
nlan	สีน้ำเงิน
psac	เป็นไปไม่ได้
kcuk	โรงเรียน
kcit	แต่งงาน
kcak	อาหาร
syis	ยี่สิบ
tlac	เงียบ
hcip	ที่คาดหวังแง่มุม
kwin	ให้
tsit	หยุด
pyac	ภาษา
hsus	สัปดาห์
hcup	ห้องโถง
cyap	น่าแปลกใจ
tfin	เกิด
fyat	ศาล
hnip	gnomicแง่มุม
tsak	เคารพ
tlas	คุ้มค่า
syuc	ต้นไม้
plat	ผนัง
cyak	สวรรค์
twip	inchoativeแง่มุม
mlat	คำสั่ง
swit	jussiveอารมณ์
mwas	เดือน
hwaf	สมบูรณ์
tyap	ประสบการณ์
ksac	พฤติการณ์
syac	สด
hnuk	ดยุค
kwak	ปกคลุม
tyuk	ทางทิศตะวันออก
pwac	หิน
hkif	โนเบิล
nyac	ทิศทาง
cyis	เก้าอี้
tyuc	ที่รอ
tsun	หมู่บ้าน
tyik	ตกลง
hnum	อนุญาตอารมณ์
slak	ความสำเร็จ
tsic	พยายาม
slat	เนินเขา
hmik	เพลง
hkus	ร้องไห้
hsip	เจ็ด
hpaf	ส่วนตัว
nwas	ข่าว
tfac	ฉาก
fyan	สวน
cwas	เริ่ม
hfik	เกี่ยวกับการจำหน่ายกรณี
lyac	เรียน
syik	ในทางการเมือง
clin	เฮนรี่
cyin	โกหก
tsas	โยน
cyik	อำนาจ
tlap	ชั้น
cyam	ฤดูร้อน
tcut	ศาสนา
tcap	หนี
hlut	ผู้เขียน
pyun	สีน้ำตาล
tcuk	ความเจ็บปวด
swan	ฤดูใบไม้ผลิ
hmun	อ่อน
kyun	มุม
nyak	เครื่องหมายการค้า
tsis	ความยุติธรรม
psas	ผลิต
cyaf	หัวเราะ
hwut	ลืม
hyup	ยุโรป
hwap	แปด
psak	ที่ผ่านไป
kyap	น่ากลัว
pyic	จำเป็นต้องใช้
hmim	กลาง
hsaf	ลมหายใจ
hmis	ฉลาด
hsum	อยู่ในความครอบครองเครื่องหมาย
ksat	น่ารื่นรมย์
ksit	หลุมฝังศพ
tsap	เกาะ
kyam	ค่าย
tcum	แตะ
cyun	โชคลาภ
psic	ฝั่งทะเล
tyun	โดเมน
mwit	commissiveอารมณ์
tlut	ระดับ
myit	ฤดูหนาว
kfan	ความประพฤติ
slac	วิ่ง
myin	นาที
tyip	นำ
klas	กระจก
pfat	คณะกรรมการ
cyic	ไร้สาระ
swam	ธุรกิจ
syam	ปลอดภัย
tsut	คุณหมอ
hlip	completiveแง่มุม
kcas	ความมืด
nyun	อบอุ่น
hpuc	ดื่ม
tlam	ตัวอย่าง
hfun	ความโกรธ
tsik	ทั้งๆ
tsam	โดยตรง
hmup	หมวก
klak	หมา
slin	เงิน
swac	คนรับใช้
kcam	ภูมิใจ
pyik	รถไฟ
myut	ศีลธรรม
syak	เข้าสู่
swat	ดาบ
kyuk	โจมตี
clac	สุขภาพ
tyaf	ย่อหน้า
swic	สังคม
tfit	คืนเงินให้
hkaf	เป็นทางการ
pcas	เหลือบมอง
nyam	ความรุ่งโรจน์
tfat	สิบสอง
pcut	หมั้น
pwin	ไวน์
mwat	ลิ้มรส
fyac	เหล็ก
syap	กระจาย
myap	ค้า
hyum	การใช้
fwak	ผู้พิพากษา
klat	กัปตัน
twap	การเลิกแง่มุม
kcic	อยากรู้อยากเห็น
kwic	ต่างประเทศ
hnif	ยาล้างกระจกเพื่อให้หนาขึ้น
myun	ความสำคัญ
tlic	ในที่สุด
cyuk	คอ
syut	เสรีภาพ
pfan	ด้านข้าง
kyuc	แห้ง
pcap	กัน
tfak	ซึ่งเป็นพยานหลักฐาน
tcik	ซึ่งเป็นพยานหลักฐานกรณี
twun	ไกล
tyis	ความคืบหน้า
nyap	แคบ
plit	อาคาร
hpif	หน้า
pwic	โฮลดิ้ง
syic	ที่น่าเศร้า
tsip	บาป
syim	ป่วย
tcis	ซื่อสัตย์
pcun	ธนาคาร
ksap	ยอมรับ
lyam	กระแส
tcaf	รอบคอบ
kwac	หู
hpup	ขนมปัง
kcut	เลือก
nwam	สัตว์
hsup	Zoicเพศ
nwit	Eventiveอารมณ์
tcim	เหมือนกันเหตุการณ์เครื่องหมาย
tlik	คูณกรณี
kyus	ข้าม
hmus	หนา
kfat	กล้า
nwat	เติบโต
myic	ฝน
hpum	พื้นผิว
swut	ศักดิ์สิทธิ์
clis	กรกฎาคม
mwun	แฟชั่น
hfas	ไฟล์
cwac	ไหล่
kwat	ความสะดวกสบาย
nwac	ทุกคน
tcip	ต้องการ
kfac	หญ้า
hmuk	วาด
plin	การเปิด
kwun	มิถุนายน
mlik	ปลา
klin	เมืองหลวง
pfut	เต้านม
twam	ข้อเรียกร้อง
fyin	ค่าใช้จ่าย
nlit	ของคุณ
mlin	ล้าน
pyut	อธิษฐาน
hluk	เหนื่อย
ksut	ฆ่า
cyut	เงา
psin	น้ำหนัก
kcis	สีเทา
pyam	กล้าหาญ
mwac	พึงพอใจ
klam	บอก
ksam	แห่งชาติ
hfip	อ่อนแอ
klik	หุบเขา
hkum	เกี่ยวกับการพิจารณาอารมณ์
clas	สีเหลือง
cyuc	ความร้อน
mlac	ซากศพ
syip	พอๆกัน
pwak	กล่อง
tcif	แหลม
psip	หลักการ
ksik	ผลพวง
tsim	ฤดู
flan	วิทยาศาสตร์
pcam	เด่นชัด
kcun	เจาะ
ksuk	ลุง
mlit	รายการ
pcik	เป็นอันตราย
kwas	สิงหาคม
hluc	เป็นที่นิยม
klit	ไม่ทราบ
flak	คุ้นเคย
fyit	คุ้นเคยการลงทะเบียน
lwat	ผู้อ่าน
plun	ที่เดิน
twas	สองครั้ง
pcis	พระสงฆ์
fyas	คนบาดเจ็บ
nlat	พระราชวัง
myuk	คนโง่
pfak	ชอบ
tcuf	เก้า
cwap	ความเห็นอกเห็นใจ
plac	ระเบิด
pyap	วาง
lyic	แต่งตัว
hcum	สัญญาณรบกวน
lwit	วรรณกรรม
tsuk	ยศ
hfup	พายุ
kcik	กระเป๋าเสื้อ
nwap	พฤศจิกายน
tyim	ธันวาคม
psaf	ขาด
nlac	ประชากร
kyaf	ขอบคุณ
slis	ชุด
pyaf	นก
mlak	เจ้าของ
kwut	เสื้อโค้ท
hwuc	ความสัมพันธ์
pyis	อย่างรวดเร็ว
twuc	ควัน
nwak	มกราคม
mlic	เครื่อง
tlis	ฟัน
ksun	ร้อน
clam	ความอัปยศ
klaf	คุณภาพ
clit	แหวน
fyak	วลี
fyam	วลีเครื่องหมาย
kwap	สี่เหลี่ยม
hwip	วันอาทิตย์
psis	บทกวี
pwut	ดลบันดาล
kyim	ซื้อ
clic	ทุ่ง
pyip	เมษายน
kfap	ตุลาคม
psut	วัตถุ
kcuc	ขม
nlap	ทาส
hsok	หลวม
htet	ข้อความ
hbat	แย่ที่สุด
hrit	เครดิต
hzit	คุณลักษณะเด่น
hpet	สิบห้า
krac	โหดร้าย
hduc	ฝุ่น
hrik	ประยุกต์
hron	สี
hnus	จมูก
hric	เป็นมิตร
srik	จัดหา
hten	เมื่อวาน
tlet	hesternalเครียด
slap	ล้มเหลว
hban	สวมใส่
hdat	ตาบอด
fran	บิน
hdan	ปีศาจ
htec	ค่อยๆ
hmon	หน้าที่
cran	เสียสละ
hran	มโนธรรม
hmos	รัฐมนตรี
nrit	พลังงาน
hcet	เกลียด
hset	ศูนย์
hrin	มีเหตุผลเพศ
hcot	เพลิดเพลิน
hrip	สั้น
htep	นมัสการ
hcif	ผิว
hrat	หลังคา
kran	มงกุฎ
hkon	ปราสาท
tran	สิ้นหวัง
hmif	ไมล์
trin	วงกลม
hgin	คุก
hkop	ถ้วย
hcen	สมาชิก
swin	พลเรือน
hrac	ทุกที่
hris	กำหนดเอง
hbin	การกลาย
hmot	เนื้อ
hdut	นม
hwen	พืชเพศ
nran	หายาก
hbac	ลูกพี่ลูกน้อง
crut	สะพาน
hsoc	หุ้น
hsom	เกลือ
nris	ผู้บริสุทธิ์
hbit	หลีกเลี่ยง
crin	สิ่งที่น่าชมเชย
rwin	ราชินี
hgut	นับ
hdas	เต้นรำ
hnot	โรงแรม
hdin	เติม
hton	นักโทษ
hdak	ร้านขายของ
hlet	บันได
hson	ให้อภัย
hgek	เกย์
hras	ทราย
hsep	กันยายน
hbic	ทำลาย
hlen	การอนุญาต
hcon	พอ
hgit	พยาน
kfon	ครัว
hbak	ขาย
tlim	การรักษา
hsot	ความเร็ว
kyut	คอมพิวเตอร์
hnen	นิรันดร
htek	ห้องสมุด
hzan	มี
hbis	ฐาน
hbun	ความสับสน
kcus	ปรุงอาหาร
hgat	ทะเลทราย
hwus	จุบ
hbif	น้ำแข็ง
hbot	ลูกบอล
hrut	การโต้เถียง
hdit	พรอารมณ์
hdis	รู้สึกผิด
hjan	การลงโทษ
plis	ตำรวจ
hgan	ซ่อน
hsen	การเดินทาง
nrin	ไม่รู้
hyen	เมฆ
frif	กุมภาพันธ์
hdik	โรค
hnek	ความคิดริเริ่มกรณี
hbam	ป้า
hmen	อ่อนน้อมถ่อมตน
hdip	ล่าช้าความจำเป็น
prat	รายงานซึ่งเป็นพยานหลักฐาน
hdet	เที่ยงคืน
hjit	นิ้ว
hmoc	ที่ไหนสักแห่ง
pran	กด
kcec	ภูมิภาค
hken	เมื่อเร็วๆนี้
hloc	ความเศร้าโศก
hrak	บุคลากร
htes	จ้องมอง
rwan	รางวัล
hdon	บริจาค
htot	หน้าผาก
hnet	นางฟ้า
hdun	เอกพจน์
croc	ความผิดพลาด
hlon	รุ่งอรุณ
hyec	แกะ
hjin	ความอดทน
hrec	อ้างอิง
mran	ข้าวโพด
htos	ส่วนใหญ่
hcos	มาตรการ
hkoc	เป็นครั้งคราว
hlif	กำไร
clak	น้ำตาล
hjat	มนุษยชาติ
tram	กรอบ
hdic	ดิสก์
hkok	เหงา
srat	ศิลปิน
crak	เสน่ห์
hmet	อีเมล
hden	การตัดสิน
gran	ผู้ว่าราชการจังหวัด
crac	สาขา
hjac	ความกระตือรือร้น
hdim	นำเข้ามาอารมณ์
hcok	รีบเร่ง
hyet	น้ำมัน
pwap	ท่อ
trat	พิมพ์
tcot	เรื่องที่เป็นของแข็ง
hdoc	โอ้
hren	สนทนาบริบท
tcon	เที่ยง
krin	กระท่อม
plam	ปลุก
hnes	หงุดหงิด
tcen	การสังเกต
hsek	แง่มุม
plik	เหมาะสม
slik	ไหม
hfen	ร้อย
hgen	ตัวแทน
hnon	สหภาพ
crik	นรก
tcet	บกพร่อง
mrat	ผสม
hdam	การตักเตือนอารมณ์
hgac	ความทะเยอทะยาน
htoc	อย่างใด
hdac	ปรึกษา
nwin	รัฐธรรมนูญ
srit	ตราสาร
hret	แน่นหนา
nlin	ออนไลน์
hzat	น้ำขึ้นน้ำลง
klic	วิทยาลัย
hkek	หาง
nric	รุ่น
hgic	แออัด
hgak	แมว
trit	โดยตรงซึ่งเป็นพยานหลักฐาน
tyot	สนธิสัญญา
hnok	เนื้อหา
crit	ถูกปล่อยปละละเลย
slen	สิบเอ็ด
srin	สัญชาตญาณ
hpok	เผ่า
hyot	เกรงกลัวอารมณ์
cric	ที่พักอาศัย
hruc	หยาบ
cwin	การขี่
hzak	เขย่า
dyit	อุตสาหกรรม
hpec	อาชีพ
nras	พยาบาล
hcec	การสอน
hbut	รองเท้า
hmec	คลุมเครือ
twot	กิจกรรม
crat	วันเสาร์
hkot	ความจุ
hnec	แดด
hwuf	แม่หม้าย
cren	หลั่งน้ำตา
nrat	ดาว
hget	แขก
hbik	ให้ศีลให้พร
brin	ภายใน
hpot	ใช้ได้
trac	ความต้านทาน
prac	ได้รับมา
hcoc	กลวง
hpon	จังหวัด
hwim	อารยธรรม
dwan	แขวน
cwok	ช็อก
hdok	การขับขี่
crun	สมบัติ
hzik	เมล็ดพันธุ์
hrot	เมื่อเร็วๆนี้อดีตเครียด
hket	ตื่นตัว
hcek	เฟอร์นิเจอร์
hrop	เชือก
mrac	การผจญภัย
byit	งานฉลอง
trak	ประจำปี
hzin	ทางใต้
sric	พิธี
clik	การล่าสัตว์
trap	ใจกว้าง
hrim	ศาสนาคริสต์
hrus	เจ้าหญิง
blat	แท่นบูชา
cyon	ขนาดเล็ก
hwep	เว็บ
krat	พระราชาคณะ
tris	สีม่วง
kcot	รวบรวม
hben	การเลือกตั้ง
trik	ดื่ม
kfit	ยก
tcec	แลกเปลี่ยน
nrik	ชัดเจนบทความ
grat	จักรพรรดิ
dran	การบริหาร
hpen	ก่อนหน้านี้
cluk	น่าเกลียด
nrac	ไม่เป็นอันตราย
ryin	การอบรม
hrun	ม้วน
nwic	นิ้ว
slit	ยิง
gzat	หนังสือพิมพ์
krot	ตัด
drit	เครา
hzis	ฉีก
hdap	สิบแปด
sris	ประวัติศาสตร์
mrut	ทั้งหมด
nyik	โคลน
bran	เจ้าสาว
drat	ขึ้นอยู่กับ
djan	ยักษ์
glat	ความง่าย
hpoc	ฤดูใบไม้ร่วง
pras	ผ้าคลุมหน้า
hgot	การชุมนุม
tret	โรงละคร
tras	การเปรียบเทียบ
rwit	คู่แข่ง
hfon	การขึ้นรูป
klot	โค้ช
hmum	อารมณ์ขัน
drac	สนทนา
rwas	นวนิยาย
tset	แก้แค้น
hdot	ปลายเป็นการสาธิต
ryut	อิจฉา
hwon	คำเชิญ
byat	เผา
flac	แฟลช
prot	ภาพเหมือน
crek	แนะนำ
htok	ขัดกัน
htop	คำสาป
prit	imprecatoryอารมณ์
hces	ทำอะไรไม่ถูก
klup	สโมสร
hnos	น้ำท่วม
dwin	ความไม่แยแส
prin	ขอบฟ้า
mrit	assumptiveอารมณ์
tcoc	สูงชัน
hcom	ความสามัคคี
grit	ฟ้าร้อง
tlot	วัยเด็ก
hgik	เข่า
hwes	ไม่ได้สติ
hzac	ซึ่งกันและกัน
hsec	ซอฟต์แวร์
tson	สถาบันการศึกษา
ryit	ใบเสร็จรับเงิน
dlin	วินัย
slip	ลื่น
klon	การปฏิวัติ
hfim	ชาวนา
hpom	แพลตฟอร์ม
cyen	นักเรียน
hgec	ถ้ำ
hroc	ประเพณี
srac	เสนอ
ryat	โศกนาฏกรรม
kcen	บริสุทธิ์
hbap	การอำลา
krik	คำวิจารณ์
krap	ฝ้าย
fwat	โรงพยาบาล
kcet	ให้เช่า
hgas	แก๊ส
pfin	แน่นอน
dlit	ใบไม้
ryan	การแปล
sran	งานศพ
mrin	แป้ง
hram	โรแมนติก
dlan	ดอลลาร์
hzas	ล้อเล่น
hsos	สิบหก
klen	อาณานิคม
gyin	ปีก
hsif	สิงโต
cluc	ฉลาดแกมโกง
prip	การจัดเตรียม
hzut	หมอก
dwat	ยา
krit	พิสูจน์อักษร
sras	รัง
hses	สิบสี่
brat	การคัดค้าน
flat	กรด
hjic	คือ
slic	อาวุธ
hbuc	ผู้ใช้งาน
tron	สีส้ม
byan	การอาบน้ำ
hrif	ดั้งเดิม
tlip	สร้าง
blan	ตะกร้า
kris	เลขานุการ
hyon	ขณะ
tren	ในวันนี้
dlat	hodiernalเครียด
hzic	ยาพิษ
tfic	ปืนยาว
tlen	พรสวรรค์
hlim	ภูมิอากาศ
dyat	เพื่อน
kcon	การเปิดเผย
dlac	ล้าง
krak	คำสารภาพ
hbas	เรื่องไร้สาระ
hkec	ถ่านหิน
hrek	ฟื้นฟู
hkos	เรือแจว
hwif	รอง
tric	ชั่วคราว
hdep	delimitativeแง่มุม
mwak	กอง
ksot	กระดูก
hnoc	วันจันทร์
nlas	วันอังคาร
brac	วันพุธ
frap	รัฐบาลกลาง
pfit	ตัวแทน
pcoc	เสา
lyen	ผ้าลินิน
swak	จม
pcen	ประธานาธิบดี
brit	กระหายเลือด
hwec	การล้อม
hwet	กระเพาะอาหาร
hlos	ชั้นบน
hbon	แตกต่างกัน
pcon	ทองเหลือง
hsem	ประชุมสุดยอด
lwac	ถูก
tsos	การประกวด
kwen	พิเศษคน
trun	ท่าเรือ
trut	รูปปั้น
hrap	ปืนใหญ่
hgap	จับกุม
trot	อุณหภูมิ
grin	ย่าน
hjak	โอบกอด
hpek	ซอง
hlus	กวาง
hwos	ห้องนอน
tsuc	พุ่มไม้
pcuc	ปล่อย
cris	ทายาท
clun	โอ๊ก
hpes	ไม่เป็นที่พอใจ
nlet	ไม่สมบูรณ์
hrom	โครงการ
pyon	เปียโน
swet	ชักชวน
dric	มองไม่เห็น
tyen	ดีที่รู้จักกัน
hruk	ความโหดร้าย
frat	ที่ได้รับมอบหมาย
hyoc	สิ่งล่อใจ
hlep	telicแง่มุม
nrot	ระหว่างประเทศ
nret	อย่างรุนแรง
hfif	นักปรัชญา
pfic	การแสดง
hmek	รู้สึกไว
hfec	สวัสดิการ
myik	ประมง
truc	ขโมย
tcop	ฝีปาก
rwic	เกษียณอายุ
htom	เศรษฐกิจ
glan	เฉลียง
pren	ขนาน
hlek	atelicแง่มุม
nrak	ทวีป
truk	เคาะ
hjim	ซึ่งห้ามปรามอารมณ์
rwat	เน็คไท
hcep	เซลล์
dyan	ไข่
jrat	เทียม
nren	แรงบันดาลใจ
ksic	วิกฤติ
tsoc	ค้นหา
lwan	อาหารกลางวัน
hpos	ต้นสน
hcuf	ดัน
tcus	ฟ้อง
pset	ขยาย
hkep	ทองแดง
swis	กะลาสี
prim	ของจักรพรรดิ
trip	แส้
cras	เสื้อเชิ้ต
swap	กวาด
syet	ร่าง
htof	ขโมย
clen	ช่อง
kwit	บุคลิกภาพ
klok	ส่วนเกิน
hrok	ปฏิรูป
hguc	ความกระหายน้ำ
kcim	คุกคาม
hpem	ปาล์ม
psik	ประธาน
frit	ธรณีประตู
cret	ร่องรอย
mrak	หอก
syen	เซสชั่น
tcup	ชื้น
hyek	นักท่องเที่ยว
trim	ดีบุก
plak	การร้องเรียน
hyok	มุม
hgam	วัว
hmok	โรงสี
jrac	แผนที่
kloc	ปก
gyit	จงใจ
hbip	เบียร์
mlet	กำมะหยี่
lyap	การละเมิด
cwen	ฝูง
bwan	หลานสาว
tses	สิบสาม
jrit	แสดงให้เห็นถึง
nlak	ต้นฉบับ
sron	นักรบ
cruc	วันศุกร์
broc	แปรง
dlot	ดาวน์โหลด
krim	ครีม
pric	ขว้าง
prut	คณะลูกขุน
hgon	แช่แข็ง
sram	อย่างแท้จริง
pfot	หม้อ
hlot	วางแผน
djin	เหรียญ
hlok	เผ่น
hpep	แอปเปิ้ล
hwot	เป๋
dlak	หารือเกี่ยวกับ
brik	สมัครเป็นสมาชิก
nlis	คัดลอก
hbet	เดิมพัน
pris	ไวรัส
hjik	การต้อนรับขับสู้
blit	หน่อมแน้ม
hjap	เสื้อคลุมยาว
tfik	สะท้อน
hdaf	บรรลุ
hpop	อุปรากร
kcaf	การซ่อน
kcoc	ข้อศอก
hrum	ซ่อมแซม
cyim	พิรุธ
dyic	ทางการศึกษา
hgoc	หลุม
drak	ความไม่เป็นระเบียบ
plas	การปรบมือ
byin	เลขฐานสอง
hzap	วัด
nlot	ความจงรักภักดี
mrik	เชิงกล
hsop	ประสบความสำเร็จ
crap	กับดัก
kyek	เค้ก
nrut	ความสนุกสนาน
syes	ท่าน
hjet	สิบเจ็ด
hjen	ของผู้หญิง
hmom	น้ำผึ้ง
hdec	น่าเสียดาย
lwen	ตำนาน
slot	เตา
frac	กบฏ
gwan	บวม
mruk	ปรับปรุง
swot	ปลัก
zlan	ได้รับ
hnem	กระปรี้กระเปร่า
hdes	น้ำสลัด
prak	สั่งสอน
frin	ทัศนียภาพ
hfet	ต่อต้าน
cros	การร้องพร้อมกัน
ryon	มีเหตุผล
tcos	พืชผล
tsen	การประมวลผล
hwek	หมาป่า
nlik	การปฏิเสธ
klap	พรม
dras	ชัง
prop	อุดม
slim	นกหวีด
hgis	ชีส
krut	กัด
srot	คุ้มกัน
bjan	เที่ยว
nwen	กองทัพเรือ
myas	หน้ากาก
kwaf	พัฒนา
twis	แท็กซี่
pcip	ดินสอ
srap	ผัก
sren	จัดแสดง
tlun	กางเกง
hrup	คอรัปชั่น
nrip	คณะรัฐมนตรี
srup	ซุป
jran	ศัลยแพทย์
bjat	เบี้ยเลี้ยง
gyat	สอดแนม
hlem	บ้าบิ่น
srak	นามธรรม
kson	สำเนียง
cwis	วันพฤหัสบดี
sret	อย่างจริงใจ
hraf	การจราจร
hres	สถาปัตยกรรม
hsuf	การกำจัด
rwak	ร้าว
twon	เครื่องประดับ
hfus	การฟื้นตัว
hkom	รหัส
djat	ผู้ล่า
nlut	จดหมายข่าว
hsef	งู
mris	ประชาธิปไตย
bric	แบตเตอรี่
mlam	ขี้ผึ้ง
zran	ใช้งานร่วมกัน
cron	หวาม
hzen	การว่ายน้ำ
traf	เพิก
cwaf	ซองจดหมาย
srip	บุหรี่
mrot	เครื่องยนต์
swon	อาสาสมัคร
ryak	ปฏิกิริยา
pfun	เพียงบางส่วน
blac	กระเป๋าเดินทาง
mret	กระทรวง
hjon	ทางเพศ
kcok	ขวาน
dram	เพชร
kren	สลับกัน
tcek	เสียงสะท้อน
hdif	เอกลักษณ์
tfas	ทูต
hfot	ประกอบด้วย
lwas	สันหลังยาว
hmep	momentaneแง่มุม
kfin	การเข้ารหัส
mwin	สมมุติขึ้น
hrem	รังสี
pram	ปีนเขา
byac	ห้องใต้ดิน
mren	ที่น่าจดจำ
swen	วุฒิสภา
kras	โลง
hgun	กลืน
nlok	ดื่มด่ำ
ryic	การเกษตร
gwin	แกว่ง
srut	ทุ่งหญ้า
hkes	ซับซ้อน
hfis	การลาออก
frak	ซ้ำแล้วซ้ำเล่า
hnom	การกบฏ
hcop	ผับ
hlec	พริกไทย
mlot	ความไพเราะ
zrat	ผู้สมัคร
proc	ผู้อุปถัมภ์
flik	จิ้งจอก
cyet	เสียใจ
hgim	ปล่องไฟ
slet	กั้น
tcok	ความถูกต้อง
bjit	อดีตตาย
brot	ตา
bwat	ผ้าห่ม
hdus	หมู
gwat	งาช้าง
kret	สารสกัด
nwet	ผู้สังเกตการณ์
jwan	ถนน
nwis	เล็บ
mwic	ผึ้ง
bzat	นักแสดงชาย
gyan	เหงื่อ
zyit	ฝ่ายบริหาร
blic	ภาพมายา
pcet	ความไม่แน่นอน
tsot	พับ
bwit	เขตแดน
tres	ความตึงเครียด
hkof	การบริโภค
nyen	คร่ำครวญ
hles	คล้ายคลึงกับ
cyek	ถุง
hjis	เข็ม
gjan	ปรากฏการณ์
prec	ประพฤติ
drot	ถูกควบคุม
kcek	เส้นโค้ง
twic	ไก่
brak	บาร์เรล
zwat	เป็นนิสัย
clap	เป็นนิสัยแง่มุม
tsec	ผู้เชี่ยวชาญ
bwin	ประทับใจ
cwet	ล้อมรอบ
hbek	คนทำขนมปัง
zlin	มะกอก
mron	รถตู้
drin	อุทิศ
psap	เปิดเผย
gjin	วันเกิด
clut	ค้อน
cwun	หอม
twaf	จิ๊บจ๊อย
pcot	สัตว์เลี้ยง
krok	กะโหลกศีรษะ
dlik	สภานิติบัญญัติ
cwic	โชคดี
srun	ขมวดคิ้ว
crec	ทำลาย
jlan	ขอบ
kcip	แชมป์
blin	พันล้าน
ryik	สารเคมี
mlas	ชีพจร
flit	นักบิน
hzet	ปม
cwik	คู่บารมี
twet	กระโปรง
mwik	รายสัปดาห์
tfis	วิชาการ
tlon	ยานพาหนะ
cram	ที่ประจบ
grac	เสริมสร้าง
kraf	อีกา
trup	คุณลักษณะ
hduk	ตะขอ
cruk	เสือ
nrap	แม่บ้าน
crot	ทางหลวง
mlip	กองทหารอาสาสมัคร
hfoc	ถ่ายภาพ
nres	ความสมบูรณ์
plos	บวก
tfam	โปร่งใส
nlic	สิบเก้า
hwok	มีคุณสมบัติ
nlen	เรียงความ
fyic	อย่างมีประสิทธิภาพ
hwuk	เป็นเอกลักษณ์
hgok	อินทรีย์
flic	เทววิทยา
flot	ลอย
hboc	บังคับ
hwoc	แม่มด
syot	สตูดิโอ
cwip	แชมเปญ
hbes	ธง
lwic	หย่า
blot	สายฟ้า
cwot	การถูกจับกุม
cwam	หลอดเลือดดำ
prik	อยู่เฉยๆ
hfum	โฟม
grik	กรวด
zrin	ผ้ากันเปื้อน
gren	ดาวเคราะห์
hfuc	การคืนชีพ
claf	หิ้ง
flas	แฟน
hjot	เขตร้อน
hbim	โดยพลการ
krek	ปรอท
hbec	มีเมตตา
tsaf	การฆ่าตัวตาย
pwas	ความกล้าหาญ
plot	ผู้สื่อข่าว
kfak	ใช้จ่าย
blak	ระเบียง
hdos	คราบ
kwis	คลาสสิก
kcos	กล่าวโทษ
psen	เงินบำนาญ
kres	คำกริยา
hzon	ลิง
srim	ลายเซ็น
glin	ความไม่เต็มใจ
mlut	ฉาวโฉ่
myot	นำเข้า
fwac	ผู้สร้าง
troc	ไฟฉาย
hgaf	ไวยากรณ์
hyop	เรือยอชท์
ksip	สูญพันธุ์
sres	การเที่ยว
hnup	โดม
hzun	ปากแข็ง
mric	กล้ามเนื้อ
gjat	ขนาด
hros	ถู
zrac	ขี้ขลาด
tros	ขนมปังปิ้ง
myus	เม้าส์
dwac	บทสนทนา
byak	แพะ
htef	ช่างตัดเสื้อ
hfek	อวด
dzan	กำหนด
nyon	ไม่ระบุชื่อ
zrit	เป็นทางการการลงทะเบียน
pcos	กีฬา
hjec	ละลาย
dlas	ลบ
mras	ร่ม
mram	แร่
cwut	การพักรบ
hbok	เป็ด
swun	สบู่
dwak	ตุ๊กตา
plif	วิลล่า
slon	เย็บปักถักร้อย
tfut	ขอแสดงความยินดี
djac	คืนดี
hjas	ปราบปราม
kric	กระต่าย
kwot	ตัวนำ
gzan	รับประกัน
clot	ผู้เล่น
ksek	แมลง
psam	ท่า
mwut	นกฮูก
htem	อย่างถาวร
clon	ไวโอลิน
dzin	ผู้อยู่อาศัย
rwim	ตามลำดับ
hyof	เป็นประโยชน์
dron	มังกร
dwit	ห้องประชุมซึ่งเป็นพยานหลักฐาน
sroc	การส่งออก
hzot	การสิ้นสุด
djik	อู้
kfik	ฝา
ryun	การควบคุม
hmes	นายกเทศมนตรี
rwac	ฮาร์ดแวร์
sruk	ละครสัตว์
sros	ชนกลุ่มน้อย
bzan	จลาจล
kset	วงออเคสตรา
bjon	เบคอน
hjut	ไม่จำกัด
tfen	ปกป้อง
zwac	ข้อเสียเปรียบ
dyin	การตรึกตรอง
myis	นักดนตรี
mlis	ทางจิตใจ
pret	ไม่เพียงพอ
tsek	สถาปนิก
hlom	มะนาว
ksos	ไอ
crok	ปวดหัว
flin	ภาวะเจริญพันธุ์
mrun	ช่างไม้
swec	สุ่ม
syuk	ช้อน
blun	ลูกโป่ง
tcep	ชอล์ก
fric	เครื่องดื่ม
rwik	แนวตั้ง
rwen	การป้องกัน
flet	อนุมานซึ่งเป็นพยานหลักฐาน
pfac	สำนักพิมพ์
srek	น้ำส้มสายชู
tfun	อุโมงค์
pwet	ปริศนา
gyik	คณิตศาสตร์
fwot	จาง
lwin	สมดุลย์
jwin	ตับ
bwik	Sublativeกรณี
hdup	จุ่ม
hnop	ผู้ผูกขาด
bwic	เรือดำน้ำ
ryen	ไม่คำนึงถึง
hcem	แผ่นดินไหว
hbos	ห้องปฏิบัติการ
nrek	ผู้ปฏิบัติงาน
ryim	จังหวะ
nyic	ตีความ
dwas	สถานเอกอัครราชทูต
rwok	กระตุ้น
kram	การไร้ความสามารถ
ksim	ที่เปิดเผยอารมณ์
clok	ช็อคโกแลต
pcec	ได้รับการยกเว้น
nyis	ฤาษี
tyoc	ความซ้ำซ้อน
grak	เกา
zlat	ถุงมือ
hjuk	คุกเข่า
trif	ภูมิศาสตร์
djit	เป็นระบบ
pson	อยู่ยงคงกระพัน
mwis	การลงทุน
cwec	วาจา
hdek	ฆราวาส
blik	เหยี่ยว
sloc	จิตวิทยา
brap	เศษ
jlat	โจรสลัด
dros	ปริมาณ
slam	ปลาแซลมอน
pwun	พุดดิ้ง
gwik	แม่เหล็ก
pcop	ปั๊ม
myen	เหมือนกับ
ksen	ออกซิเจน
mrap	หัวหน้าคนงาน
tfot	ใบรับรอง
ksus	กลุ่ม
trok	วาทศาสตร์
tloc	ขั้นบันได้
zyan	พายเรือ
nlun	เข้าสู่ระบบ
hlop	กล้องโทรทรรศน์
jlin	การสะกดคำ
lyut	มีเมฆมาก
hsof	ท่อง
fyik	วิสกี้
klet	สัมพัทธ์
hwof	วิลโลว์
hlum	อูฐ
myet	มือสมัครเล่น
klis	ความเหงา
hbaf	ชีวประวัติ
gwac	ลา
hwum	เล่าลือ
pwik	มุมมอง
pron	มือโปร
myes	รายเดือน
mwen	ภวังค์
kfic	วันหยุด
klek	คลิก
cwon	รูปไข่
lyak	ยืดหยุ่นได้
kwon	พจนานุกรม
hjam	แฮม
rwon	รุ้ง
crip	ด้วยประการฉะนี้
zwan	ที่เกิดขึ้น
srok	บทบรรณาธิการ
craf	สิบโท
tlok	ถัง
brip	ผีเสื้อ
tfap	แผนภูมิ
jwat	คู่
pros	การดำเนินงาน
psun	ลาง
clet	ความทุเรศ
hbus	ไม้ไผ่
dyas	เจ้ามือ
klun	ขุม
jlit	เป็นเอกฉันท์
hdom	ฝันร้าย
kron	คาร์บอน
hzam	แยม
cyot	ผู้ฟัง
hmem	พิพิธภัณฑ์
lwam	ตัวอักษร
fras	กระจัดกระจาย
psoc	หมัด
hgum	เหงือก
brek	เบรค
glit	ความมั่นคง
frun	เน่า
gris	ก้าวร้าว
mroc	แรงเสียดทาน
bzit	แมงมุม
plut	มันฝรั่ง
glac	โลภ
gzac	คูณ
prun	การปั่น
jlet	ปฏิทิน
nyim	การเสนอชื่อ
tlos	ล้านล้าน
slut	สลัด
fwit	ซึ่งยืนยันอารมณ์
pyen	การใช้งาน
nlon	น้อย
dren	สาธิต
drun	ความไม่พอใจ
cyok	ยัก
hfop	ฟุตบอล
ryac	หุ้นส่วน
gzin	ผู้ริเริ่ม
hgip	กะหล่ำปลี
tyet	แข็งแรง
hdof	idiophone
hwup	ล้ำค่า
lwek	คันโยก
syec	วุฒิสมาชิก
jyak	อำนวยความสะดวก
mlim	มด
fwic	มีประสิทธิภาพ
gzit	ตั้งครรภ์
blas	ความเชื่อมั่น
jrin	ทุกวัน
gwak	ข้อเท้า
drik	อย่างผิดปกติ
prif	ตัวแปร
jwit	ความหลากหลาย
krip	การแยกแยะ
ryot	กลัว
nwut	ทางเท้า
kcif	อย่างกระตือรือร้น
jrak	กบ
twek	มากเกินไปกรณี
psot	การชดเชย
pfon	ฟองน้ำ
sluk	กระรอก
nlim	irrealisอารมณ์
ksaf	ความขาดแคลน
glak	ภูเขาไฟ
plen	สมดุล
kfaf	ผ้าพันคอ
kyon	เอาเปรียบ
jlik	ทางธรณีวิทยา
psop	หนังสือเดินทาง
kfis	ตำแหน่งว่าง
fyon	ความเป็นพี่น้องกัน
nram	ผิดศีลธรรม
hbuk	สีน้ำตาลอ่อน
gras	ความมึนงง
hyos	เกรงกลัว
flim	ฟิล์ม
plet	ยาเม็ด
rwam	อะตอม
blis	วานิลลา
zlit	เอดส์
fyut	จุกจิก
crim	ปิรามิด
hjif	ผิดกฎหมาย
crif	ความประหม่า
lwap	เครื่องดนตรีประเภทพิณ
tyon	ดาราศาสตร์
mrim	เขาวงกต
drut	พรรณนา
nrim	ทุนการศึกษา
kruc	เต่า
kwam	ผู้ให้คำปรึกษา
jrik	จิ้งหรีด
dlut	แสดงว่า
pyot	นกพิราบ
dyon	การปรับตัว
prap	ผู้ประกอบการ
bzin	สัญลักษณ์
tyek	สามเหลี่ยม
trec	เหรัญญิก
nron	ไฮโดรเจน
pyet	เครื่องพิมพ์
tsok	ตัน
zyin	เรื้อรัง
slek	รถจักรยาน
jyin	วิศวกรรม
ryas	การส่งผ่าน
zrak	รีเฟรช
nyas	นาฏ
gric	การโยกย้าย
zlak	ละเมิด
tces	เทนนิส
hjun	ลมแรง
twen	สาน
kyet	นักสะสม
gwit	กระดูกสันหลัง
kyot	คอร์ด
fwin	ความถี่
tfuc	กี่ทอผ้า
dlet	ไดเรกทอรี
pfik	นักคิด
bjet	งบ
trek	กลยุทธ์
kros	ผลึก
gjit	กรรไกร
gwic	สวิตซ์
frik	ตามทฤษฎี
tluc	ผ้าขนหนู
pruc	ลาดตระเวน
glic	ธารน้ำแข็ง
krun	ความสมบูรณ์
bjin	คาดการณ์
tlaf	มีส่วนร่วม
tfet	ผู้ผลิต
bras	ด้านข้าง
dwik	จำเลย
clec	ไอเสีย
cres	หมากรุก
tcef	เชอร์รี่
tcom	สะดุด
nyot	นักแปล
tyok	รถบรรทุก
cyip	ที่เหนือกว่า
grot	มัสตาร์ด
bris	ไร้สาย
nlam	ประมูล
slif	กระชอน
hgos	สนิม
swoc	ไม่มั่นคง
jyat	ล้มละลาย
slum	ศาสนาอิสลาม
hjes	การสำรวจสำมะโนประชากร
dzat	เขย่ง
slun	แขวน
nwot	ความต่อเนื่อง
gyic	กีตาร์
pfas	อคติ
zyik	สังกะสี
blen	มันเงา
hyem	ไม้ต้นจำพวกulmus
hnep	การแย่งชิง
nyut	ที่ถัก
ryam	สรรพนามเครื่องหมาย
clim	เครื่องเทศ
jret	ความคม
tfon	แซว
jwac	ชวา
hrep	ตำรับ
dyac	สิทธิพิเศษ
myip	เมตร
rwis	เกี่ยวกับเชื้อชาติ
hkem	ดาวหาง
nwon	นวัตกรรม
zwin	ห้าม
dyis	สมัยกลาง
mrec	กระจอก
fyot	เชิงอรรถ
mlon	การวัด
pfis	สัตยาบัน
rwot	โคจร
hfok	ประหยัด
glof	กอล์ฟ
zron	ศูนย์
hzip	ไปรษณีย์
hwom	ไม่มีที่อยู่อาศัย
bjic	เคี้ยว
pcim	เติมเต็ม
hjip	ชิป
bwac	อ้าปากค้าง
mlos	ตุ่น
mrip	เครื่องดินเผา
bron	เอ็มบริโอ
ksoc	การหัก
cyum	ยีสต์
jyan	ศัพท์แสง
plim	พลัม
mwet	สุสาน
ryet	จบการศึกษา
glik	ชลประทาน
plap	นายทุน
tsif	ความยืดหยุ่น
gyak	ปลาฉลาม
djon	ค่าเริ่มต้น
nwun	ตรงเวลา
cles	สัจนิยม
dris	ขึ้น
hkef	คาเฟ่
blus	รถพยาบาล
blap	กระเป๋าสตางค์
bjak	ซึ่งปีติยินดี
klim	หน้าตาบูดบึ้ง
gyac	นักวิทยาศาสตร์
jyit	ความใจเย็น
dzit	เหมือนจริง
bwak	กลางแจ้ง
dyot	วิทยุ
bwon	ถั่ว
fris	ไม่เป็นทางการ
klut	คาดเดา
tfek	เสต็ก
nrok	ก๊าซไนโตรเจน
zyat	มีดโกน
bram	พูดพึมพำ
ryis	เบื้องต้น
nlip	วิเคราะห์
nros	ตัดกัน
hcof	เปลื้องผ้า
tfif	แรงจูงใจ
kroc	ร่อง
hdum	ศาสนายิว
pses	ผู้รับ
plok	ส่วนประกอบ
lyet	เลนส์
pwek	pegativeกรณี
kfas	โรคมะเร็ง
pwen	จำนำ
nrun	การแจ้งเตือน
clek	รั่ว
pcif	การปลดปล่อย
glas	ความซับซ้อน
zwit	ช่างพูด
kces	ความพอเพียง
crem	ขายปลีก
grap	คว้า
kwip	แทรกแซง
dyut	ส่วนลด
crus	ลำดับชั้น
gyet	หยก
gram	คำราม
kyip	จิ้งจก
nyet	เบาะ
crop	น้ำตก
glon	แกลลอน
mrok	ยุง
fluc	คล่องแคล่ว
dwic	การเบี่ยงเบน
slec	สำรวจ
srec	หมดอายุ
blut	ต่อสู้
myok	โมเสก
tlek	ปลั๊ก
nruk	ติดเชื้อ
nwoc	ตั้งแต่บัดนี้เป็นต้นไป
bjut	หมอบ
hges	การตั้งครรภ์
twoc	ร้านขายของชำ
kyos	คอมมิวนิสต์
mrek	ตะลึงพรึงเพริด
clip	ความโศกเศร้า
pwok	prosecutiveกรณี
dwot	เผด็จการ
zyac	การทำให้เป็นกังวล
jlic	ดาวเทียม
slop	รองเท้าแตะ
ryip	สัดส่วน
psim	ประมาณ
byet	ว่างงาน
cyop	งานอดิเรก
rwun	เกณฑ์
blop	กระเปาะ
syok	ผู้สนับสนุน
klos	คลอรีน
lwot	คลอไรด์
byic	แบคทีเรีย
lyik	เหนียว
blok	ชีวภาพ
jlac	ประดิษฐ์
bret	ไบต์
krif	การหลั่ง
blet	ระบำปลายเท้า
nruc	ปัสสาวะ
tsus	กระเทียม
dyak	กลางชั้น
tcem	แหนบ
cyoc	ท้าทาย
trep	สตรอเบอร์รี่
dlun	มลพิษ
hlup	อัลบั้ม
hbep	กีฬาเบสบอล
praf	การละเมิดลิขสิทธิ์
pwis	คำกริยา
grek	โรงรถ
kruk	ไม้ยันรักแร้
hfof	ฟอสฟอรัส
rwut	โครงสร้าง
myam	โรงยิม
krec	ปั้นจั่น
jras	ผู้รับเหมา
zrik	แจ้ง
blam	ห้องบอลรูม
klip	ช่าง
hwef	ยังไม่ได้ชำระ
zlac	กล้วย
gret	เครื่องกำเนิดไฟฟ้า
lwuk	ซี่โครง
nyek	นิกเกิล
blos	รถบัส
sles	ตรวจข่าว
tlif	กระเบื้อง
kses	ไส้กรอก
mwot	มะเขือเทศ
lyot	รถยนต์
tsom	โพแทสเซียม
brut	เสมือน
djap	พีชคณิต
hjok	ทั่วไป
kfen	แนวคิด
pcok	ออปติคอล
bzut	ขยับเขยื่อน
syek	การว่างงาน
mruc	หนอนผีเสื้อ
bwas	เบราว์เซอร์
klif	แคลเซียม
rwet	รีโมทอดีตเครียด
srif	ประวัติศาสตร์เครียด
hwem	คลื่นความถี่
syom	โซเดียม
tyos	ผู้จัดการมรดกหรือทรัพย์สิน
jyic	ตัวประกัน
hguk	มะระ
dwun	ริ้วรอย
swip	ขัดขวาง
tlec	เห็บ
blaf	ข่มขืน
tsem	ต่ำช้า
mloc	หน้าจอ
gyot	เงื่อนไข
trop	การสอบสวน
rwap	รายไตรมาส
hjep	เพศ
pyim	แพลทินัม
dlon	คู่จำนวน
pcep	ปอด
twuk	กำจัดสิ่งสกปรกบน
tyec	แท็ก
syup	ซุปเปอร์
trom	รถเข็น
nyip	ในท้องถิ่น
glis	น้ำมันเบนซิน
gjik	ไต
hjos	ไม่มีใครช่วยเหลือ
hjuc	ยกเค้า
swek	ทำงานหนักเกินไป
psek	สารหนู
twok	สถิติ
tsep	ตั๊กแตน
slos	นักสังคมนิยม
nwim	ประสาทสัมผัสซึ่งเป็นพยานหลักฐานอารมณ์
tlop	ผ้าปูโต๊ะ
trus	ที่เถียงกัน
pwot	การข่ม
djot	ตะกอน
nloc	ดูแคลน
mwon	ภาษาจีนกลาง
hjek	จ็อคกี้
crom	ร่วมมือกัน
myon	โรคปอดบวม
twec	ตั้งอยู่
ryek	จรวด
dlic	เงินปันผล
kwet	เล่นสเก็ต
bwen	ความคิดครอบงำ
plon	ส่วนแบ่ง
syon	หอบ
djis	ดิจิตอล
byut	ผู้หญิงเลว
hyep	เปลือกตา
dwon	เส้นทแยงมุม
byis	จิตใต้สำนึก
brec	คิ้ว
cyec	จาม
hwop	วัตต์
clus	เฮฮา
kfun	การพักอาศัย
nwum	ศาสนาฮินดู
fyim	ผู้ลี้ภัย
cwos	รถรับส่ง
tfoc	ความเจ็บใจ
pwon	โปรตีน
sraf	ความพึงพอใจในตัวเอง
hbom	อาเจียน
gyen	ยีน
drim	น้องใหม่
trem	สัมภาระ
tsup	ป่นปี้
slok	สังคมวิทยา
kwoc	สควอช
bwam	ผู้เลือกตั้ง
mlok	การเคลื่อนไหว
kyen	ของแคว้น
hmop	การเคลื่อนไหวขึ้นเนิน
rwek	มีผลย้อนหลัง
kfup	ลูกบาศก์
grok	แครอท
drap	ดักจับ
lwis	โมเลกุล
ksuc	นักบัญชี
tsop	กลิ่นเหม็น
kyok	แตงกวา
nroc	สนุกสนานกันอย่างเป็นบ้าเป็นหลัง
jlot	ตัวทำละลาย
psof	ฟอสเฟต
hgif	ตรึงใจ
kfim	เป็นด่าง
psos	พลศึกษา
pfen	การตรวจสอบ
kcom	นักเศรษฐศาสตร์
krom	จุลภาค
tluk	บิดตัวไปมา
hyom	ไอโอดีน
nwuc	การเคลื่อนไหวตกต่ำ
gjac	การคลอดก่อนกำหนด
pcom	รุน
dzic	นักออกแบบ
grun	เป้อเย้อ
dzot	ผู้บริจาค
hzek	แมงกานีส
kfot	แป้นพิมพ์
jlas	ไม่น่าเชื่อถือ
lyim	ผู้ลากมากดี
jyen	เยน
pcaf	วงเล็บ
rwip	รักบี้
blip	คัมภีร์ไบเบิล
kyoc	สาเหตุ
lyon	ฝี
flis	ที่ทำให้โค้ง
nrif	ตอด
kfam	ควอนตัม
swes	เสื้อกันหนาว
lwon	วิวัฒนาการ
drec	การผ่า
gjap	สปา
lyec	เชิงเส้น
tyom	พลวง
pwuk	superessiveกรณี
flaf	แอลฟา
myim	ภูมิคุ้มกัน
pcek	การลักพาตัว
bjac	โรงเบียร์
bzac	ทำให้น้อยลง
bzak	ถุงเท้า
twes	โทรทัศน์
dwut	สารคดี
ksom	จักรวาล
lyis	การป่าไม้
lwim	อลูมิเนียม
ksok	ดวงชะตา
sruc	เร่ง
dlif	ปลาโลมา
byik	นักฆ่า
tfec	เครื่องเขียน
hjaf	เลี้ยงลูกด้วยนม
ryok	โปรโตคอล
dwis	ดีออกไซด์
jlon	ปลายลำไส้ใหญ่
brus	การปกครองระบบเจ้าขุนมูลนาย
gjak	กาแล็คซี่
lyip	ทางคลินิก
ryem	แร่เรเดียม
href	ซึ่งได้ทำให้บริสุทธิ์
prok	ตู้เย็น
slep	เทพารักษ์
dret	การย้ำ
kluk	เกี่ยวกับโบราณคดี
dlis	นิสัยแปลก
kfip	รับไม่ได้
mlec	นวด
pfif	สเปค
nrec	ประสาทสัมผัส
pfet	ใบปลิว
hzoc	รองรับ
dlam	ความนึกคิด
nlec	มานุษยวิทยา
kluc	รสอร่อย
dyet	เสลี่ยง
tyif	เกี่ยวกับสกรรมกริยา
krus	ยืนก้มตัวด้วยความอ่อนน้อมหรือกลัว
nluc	ดอกทานตะวัน
lyun	ไอออน
zrot	ส่งผู้ร้ายข้ามแดน
ksif	ปลอมแปลง
psif	การส่งออก
crup	คาบเกี่ยวกัน
fret	Finder
grut	กลับหัวกลับหาง
ksec	เพื่อนร่วมชั้น
jric	การเดินทาง
mrop	ไมโครเวฟ
srus	ขับไล่
gyas	ช่างทำผม
floc	คติชน
plek	เส้นเลือดฝอย
nwop	ก้น
nrom	ตัวควบคุม
twos	ลัทธิก่อการร้าย
lwok	คำขวัญ
dwet	ล่วงเวลา
slem	ระเหิด
grip	ย่าง
gwas	ว้าว
kwok	โคบอลต์
gwon	ข้าวโอ๊ต
hdop	การเคลื่อนไหวต้นน้ำ
glam	ทวารหนัก
bwot	ดื้อ
bren	ลำไส้
byot	วีดีโอ
bjik	การคว่ำบาตร
kwim	ทดสอบ
cwek	ฮอกกี้
grif	กองโจร
hgem	แมกนีเซียม
hyes	ความตระหนัก
fram	ร้านขายยา
nwos	มักน้อย
ryap	จัดใหม่
cwim	ความเชื่อถือได้
klep	สาหร่ายทะเล
psec	ชำระเงินคืน
djic	ทั่วโลก
kfut	เคอร์ฟิว
crep	แฮมเบอร์เกอร์
frim	ทฤษฎีบท
gjas	จุดชนวน
hdef	หักบัญชี
ryum	ยูเรเนียม
pluk	ประเมินผล
krop	ประสานงาน
nraf	ผู้เสียภาษีอากร
tyes	แบบบูรณาการ
plip	ความเห็น
hgom	แกมมา
hgus	ค่าสัมประสิทธิ์
cwuc	เครื่องทำความร้อน
zret	หัก
nles	นักวิเคราะห์
trof	อกรรมกริยา
hmof	ห้างสรรพสินค้า
hzim	บิสมัท
dzac	เหลา
psok	โปสการ์ด
blon	การลู่เข้า
djet	เชือนแช
ksum	ผู้ถือหุ้น
mrup	เชื้อจุลินทรีย์
clif	ส่วนที่เป็นเกลียว
cloc	ลักษณะทางสัณฐานวิทยา
tfes	คนขายอาหาร
gjis	กางเกงยีนส์
jren	การวางแนว
tlep	ฐานข้อมูล
kcup	คูปอง
glot	แรงดันไฟฟ้า
glut	เครื่องคิดเลข
srep	โลกเทคโนโลยีสารสนเทศ
nwes	นักลงทุน
ksef	xรังสี
bzis	วีซ่า
frut	โครงสร้างพื้นฐาน
nyuk	หิ่งห้อย
dyik	เครื่องตรวจจับ
plec	ประกบกัน
brom	โบรมีน
plop	แพลเลเดียม
zlik	ซิลิคอน
flut	โวลต์
ksop	ประทิ่น
gjun	กรูมมิ่ง
kfok	อาการสะอึก
hpof	ข้าวโพดคั่ว
hzuk	สวนสัตว์
nyoc	ความหมายแฝง
jwak	โยคะ
brim	แบเรียม
kles	ตัดหัว
mwam	ใช่
fwik	ดอกไม้เพลิง
djas	แจ๊ส
dyim	เสียง
tsum	ทังสเตน
drip	เลี้ยงลูก
lyaf	ค่าเลี้ยงดู
prom	โปรแกรมเมอร์
nrup	อินพุต
hfes	สะท้อนกลับ
rwaf	ดอกเบญจมาศ
dlen	เอกสาร
byas	วัคซีน
fron	ผงขาว
dluk	ปลด
dyun	วินิจฉัย
flap	โฟลเดอร์
kfet	แคโทด
dlim	คตินิยม
prek	ที่จอดรถ
syoc	ภาพรวม
slus	การเข้าถึง
nlos	อาการเสื่อม
mlen	ซีลีเนียม
pres	เยื่อหุ้มสมอง
hlof	กำมะถัน
nlek	ปัจจุบันความสัมพันธ์กันเครื่องหมาย
gwot	สนามบิน
mwip	แอบอ้าง
klop	แมลงสาบ
kwom	โครเมียม
hl6t	ลิตร
nwec	กระนั้น
glip	เป็นวงกลม
nrop	บัญชีเงินเดือน
crum	ฮอร์โมน
dlep	ผู้พัฒนา
frot	ปรุ
bwoc	การก่อวินาศกรรม
fwis	เรียกร้องสิทธิสตรี
djok	ผัน
draf	ทันสมัย
trum	หัวรุนแรง
graf	ขั้นตอนวิธี
lwes	เลเซอร์
mlem	มิลลิเมตร
flen	ดิ้น
zlot	ขั้วบวก
swok	คลอเคลีย
klec	สุนัขเหนื่อย
pwim	ส่วนหนึ่งเวลา
htuf	ปลาทูน่า
fyis	โรงกลั่น
lwet	ความไว
mrem	เมนเฟรม
jwic	คืนความอ่อนเยาว์
droc	ผู้สาธิต
clem	ฮีเลียม
dzik	พูดได้สองภาษา
psem	พลาสมา
hjom	โครโมโซม
rwuc	ลำดับ
tyus	จำนวนเต็ม
klom	กิโลเมตร
hfos	แฟกซ์
nwek	พันธุศาสตร์
jrap	ไขควง
zwas	อาหารจานหลัก
bwok	ผักชนิดหนึ่ง
dwap	อะแดปเตอร์
syem	สแปม
blek	เวกเตอร์
tlus	ชั้นเชิง
pyif	ยังไม่ระบุ
cwoc	ไม่เป็นไร
mrep	กระแสไฟ
hbem	วิตามิน
hxan	คนเรียกรถ
hxut	สงเคราะห์เงิน
hk6m	แคดเมียม
hxin	ความพร้อมกัน
txin	ไทเทเนียม
kxin	กิโล
klum	มีเพศสัมพันธ์
xlis	นาฬิกาทราย
hqak	ประโยค
hxat	ความคิดสร้างสรรค์
hxik	หนังสือE
hxas	ที่ทำงาน
bxon	โบรอน
dxin	การเหนี่ยวนำ
hxit	เฮลิคอปเตอร์
tlum	เทลลูเรียม
txit	วันกำหนดส่ง
kxat	รวมตัวกับอ๊อคซิเจน
hvik	เป็นเส้นตรง
nluk	อนาล็อก
nyem	เซนติเมตร
hm6t	โมลิบดีนัม
hl6m	ลิเธียม
ht6t	มัลติมีเดีย
xlit	แคลอรี่
ryop	หุ่นยนต์
pxas	เภสัชกร
hxak	การบ้าน
lwif	เกี่ยวกับตำแหน่ง
grim	ลอการิทึม
hqat	ตั๊กแตนตำข้าว
qlit	นิเวศวิทยา
xlik	ตบตา
mlep	แบบ
hqit	กัมมันตภาพรังสี
kxim	กิโลกรัม
hxen	ผู้เช่า
hxot	กินมากเกินไป
kyif	คนคัดสำเนา
fwet	ฟรีแวร์
txet	เซตย่อย
hs6n	ลำดับ
hxet	ดักฟัง
xrat	การตัดผม
hqan	ยึด
hr6t	อิริเดียม
bxat	แบนด์วิดธ์
dxet	เดสก์ทอป
hxis	ที่ชี้แจง
hxok	สำนักงานใหญ่
hxek	ใส่ผิดที่
srem	ซีเรียม
hp6t	ซึ่งแบ่งแยก
pxik	ซึ่งแบ่งแยกกรณี
kxet	เทปคาสเซ็ท
pruk	ตลาด
hvit	จิตตานุภาพ
xlin	ออฟไลน์
frip	การเข้ารหัสลับ
hvep	จ่ายเงินมากเกินไป
hxon	ประสาน
kxit	เพิ่ม
hqin	สัมมนา
tr6n	ระบบเสียงสเตอริโอ
ht6n	สปริง
hvat	ที่จะเกิดขึ้น
sl6s	เซลเซียส
hn6n	ธาตุนีอ็อน
ts6t	จริงเวลา
hvin	เพรียวลม
pxat	แผงหนังสือ
myoc	โมดูล
ps6s	พาสต้า
bwek	กระเป๋าเอกสาร
dlok	หรูหรา
fraf	ไฟร์วอลล์
hr6k	สิ่งประดิษฐ์
txat	เวลาอาหารกลางวัน
hqon	ออริกาโน
pxun	พลูโตเนียม
ks6n	เวิร์กสเตชัน
slef	บันไดเลื่อน
xrit	ทหารรักษาพระองค์
hvut	หนาแน่น
xrim	อิตเทรียม
hx6t	ซึ่งเพิ่มขึ้น
hqum	ชื่อผู้ใช้
hl6n	พนักงานขาย
gron	อาร์กอน
pxan	โปรโมชั่น
hvac	เครื่องล้างจาน
xlan	โลกาภิวัตน์
txon	ความยาวคลื่น
xrik	รีไซเคิล
hxap	กระเป๋าเป้สะพายหลัง
hxac	เริ่มใหม่
xyat	โรคตับอักเสบ
cwep	เงินเดือน
hxos	ฐานรองดอก
txif	อักษร
qlat	นายหน้า
txot	กลางฤดูใบไม้ร่วง
hxam	มิลลิกรัม
pxis	พิกเซล
pwif	ภาพตัวอย่าง
txam	แทนทาลัม
myek	อุณหพลศาสตร์
hbop	หยุดใน
hqot	ตัวละลาย
xlic	เก้าอี้เข็น
gxit	การทำลายชนชาติ
hvan	ดับเพลิง
glim	แกลเลียม
pfop	ป๊อปขึ้น
hzum	เซอร์โคเนียม
xlon	สายด่วน
qlin	ไม่เชิงเส้น
kxam	แคน
blim	เบริลเลียม
kxik	กำหนดค่า
nr6n	เซลล์ประสาท
hpef	ที่ใช้เป็นส่วนของกริยา
hruf	เราเตอร์
kxan	ปัจจัย
hxic	ข้อแนะนำ
xlip	วอลเลย์บอล
dyek	การแก้ปัญหา
hxop	นาฬิกาข้อมือ
qrot	นิวตรอน
nwip	วัตถุไนไอเบียม
hs6t	ห้องน้ำ
grem	เจอร์เมเนียม
tles	กึ่งโลหะ
hp6k	prolativeกรณี
qyin	ความหลากหลายทางชีวภาพ
txak	ยาปฏิชีวนะ
mlun	ตรึง
txan	แอกทิเนียม
xran	มนุษย์อวกาศ
dres	ขยาย
tr6t	ต่างดาว
hk6t	octet
hxus	เปิดแหล่ง
xlat	สติไม่สมประกอบ
mraf	มาราธอน
ts6n	กลางฤดูใบไม้ผลิ
ht6s	ความหมกหมุ่น
nlif	ทำให้เป็นละออง
txut	ความเด่น
hm6n	เปล่ง
kxis	คลิปศิลปะ
xrin	การผ่าตัด
xren	เปลี่ยนเส้นทาง
bxak	ที่คั่นหนังสือ
pfos	มือโปรวลี
hvis	อุจจาระ
hd6n	ตัวหาร
brum	ห้องประชุมคณะกรรมการ
hqis	รักชาติ
hk6n	รวบรวม
xyit	เปลี่ยนสำคัญ
xyin	หนึ่งวินาที
hxun	subsisting
hvas	บทบาท
glok	บล็อก
hvak	เลี้ยวลด
pxit	IPที่อยู่
hvet	ต่อไปไปยัง
xram	ดอกคำฝอย
hc6n	ความชัดเจน
qran	คัมภีร์โกหร่าน
zyen	ธาตุสีน็อน
hqas	สาบานใน
bzas	หมดอาลัยตายอยาก
hj6n	ไม่เป็นมนุษย์
hnof	อย่างปัดๆ
txas	เครื่องชง
hbum	พุทธศาสนา
ts6s	การทะเลาะ
pxin	ส่วนผสม
hr6n	ปันส่วน
hxim	กลางฤดูร้อน
dxit	ฤดูหนาวกลาง
hxaf	ขุดค้น
nlus	พืชบ้าน
txap	สถานะบาร์
vrit	นักเขียนนิรนาม
kxak	คนโง่รอบ
bxin	เป็นมนุษย์ร่างกาย
hqik	เสื้อกันฝน
hxes	เฮิรตซ์
hxif	สะกดจิต
xras	ทุกๆชั่วโมง
pl6k	ทนาย
dxat	ความหุนหันพลันแล่น
hxip	แอนติบอดี
vrat	กางเกงขาสั้น
hqek	การก่อร่างใหม่
qrit	กระแสไฟฟ้า
pxot	เสาสำนักงาน
hxom	ขยะอีเมล
hqic	ผู้วิจารณ์
lwun	สีน้ำเงินกางเกงยีน
hp6n	การสุก
dxan	การแนบ
xrak	นักแสดงชายบทบาท
dxak	อุบัติเหตุ
hven	ภาชนะบรรจุ
mwap	ตลกเพิก
qlan	สีตาบอด
xros	เสื้อผ้า
srom	โชว์รูม
hc6t	การพูดคุย
qrat	กลับหัวกลับหางลง
hn6t	การยับยั้ง
hqet	เว็บเว็บไซต์
fres	ระดมเงินทุน
froc	การปลอม
xlak	เชื่อมโยงหลายมิติ
vlat	volubility
dvan	ฝั่ง
gxin	การชนะ
ryes	พนักงานต้อนรับ
kxot	การเชื่อมต่อ
xyan	การปักปันเขต
vlan	ผู้ลงโฆษณา
ryom	ทอเรียมอะตอม
hluf	แก่อายุ
hquk	ฉีด
lyum	thuliumอะตอม
tyem	เทอร์เบียมอะตอม
hp6m	praseodymium
txic	บ้านหน้า
mros	คนขับรถยนต์
dyam	โรเดียมอะตอม
pc6n	การทดลองจำนวน
nyos	กล่องจดหมาย
pyek	เครื่องฉาย
kxon	คริปทอน
hxuc	ช่วยเหลือ
qrik	ส่วนกลางกรณี
xwin	การขาดประสบการณ์
kxic	เครื่องดับเพลิง
hvot	ผัง
dxot	โยเกิร์ต
hqut	เข้าสู่ระบบออก
pxen	แผนก
drok	เป้าหมายไก
flon	โทรศัพท์มือถือโทรศัพท์
txos	กลางเสียงพูด
hqok	เอียงกรณี
xwik	ผู้ป่วยกรณี
hx6n	hodiernalก่อน
txik	ดัชนีนิ้ว
hqen	ผู้ส่ง
mlap	มัลแวร์
hvun	suasion
hvon	สวมใส่ออก
vran	อีเมลผู้ให้บริการ
pfes	ศาสตราจารย์
pwip	กวี
hqam	งานออก
gxat	ถูกต้องตามกฎหมาย
ks6t	เป็นเหตุแห่ง
vrin	ผู้รับคนใหม่
kxip	คลิปคณะกรรมการ
sr6n	ซึ่งไม่พอใจ
vlit	ประเมิน
tyup	ชานเมือง
mrom	หน่วยคำ
xron	หูโทรศัพท์
gxak	แพง
hrof	โทรจันม้า
xlas	เป็นอัมพาต
dzet	ประดับใหม่
txac	ยอมจำนน
xrot	ไม่ได้ใช้
txis	จุดมดลูก
syif	ศรีหน่วย
xrac	อย่างแปลกใจ
brif	ค่าไบนารี
dlos	เป็นกิริยาช่วยกรณี
txun	คุณลักษณะ
dvat	ไม่ดีบรรเทา
psom	เป็นครั้งแรกมือ
gjek	ถ้าที่อื่น
nlem	หน่วยของมวล
qret	ขายปลีกเก็บ
txip	สามจุด
dlek	เป็นรายบุคคล
lwut	การไหลหมุนเวียน
dxis	เป็นคุ้งเป็นแคว
hs6m	ซีเซียม
vlak	รถไฟฟ้า
hn6m	Nerium
kxap	กระดาษแข็ง
bxan	แยกย้ายกันไป
myem	เดือนพฤษภาคม
gxik	พลเรือนสิทธิมนุษยชน
hxoc	อากาศบังคับ
xrok	เพื่อนร่วมงาน
kr6t	ภาพหน้าจอ
txok	อัตโนมัติ
hxep	สเกตบอร์ด
srop	มาร์ทโฟน
pxak	หมวกล็อค
hk6k	พื้นบ้านเพลง
hl6k	ออยเลอร์จำนวน
pyom	พอโลเนียมอะตอม
xyam	แทลเลียมอะตอม
hvic	ที่บุกรุก
lyok	เกี่ยวกับตำแหน่งกรณี
xlot	แฟลต
txen	ปรับย้อนหลัง
kxac	ตอบโต้
qrak	ผู้ทำลายการหยุดงานประท้วง
hbup	ว่ายน้ำสระ
txuk	สั้นวงจรไฟฟ้า
tsef	เรียว
bxit	เว็บเจ้าภาพ
ksem	อ่านเท่านั้น
byim	รูบิเดียมอะตอม
hvam	วานาเดียมอะตอม
lw6n	แลนทานัม
frum	ฟลูออรีนอะตอม
nyom	นีโอดิเมียม
mlom	multalจำนวน
kxas	ปรับแต่ง
xret	เทราไบต์
hs6k	ค้นหาเครื่องยนต์
frus	กัดกร่อน
gxan	กาแล็กซีเพศ
vlas	การเปล่งเสียง
glet	แก๊สที่เหยียบ
hvim	Runtime
bxip	บิตแมป
qrin	ดาวเพศ
bvak	abessiveกรณี
pxon	ใช้งานไม่ได้
dvik	adessiveกรณี
dvek	agentiveกรณี
hlef	ตัวแทนไก
kwek	ไปยังกรณี
kxen	ร่วมกันเพศ
ht6m	การอ้างอิงฟอร์ม
tsuf	ทรานส์ตัวเลข
hf6n	ใสสะอาด
tc6t	โดยตรงวัตถุ
gvik	ergativeกรณี
gxon	การกระจายตัวของ
ksep	ตัวรับ
vyin	หนังโรงละคร
pyos	อยู่เฉยๆเสียงพูด
hnef	จำกัดคำกริยา
xwit	ประถมวัตถุ
hqim	gnomicอารมณ์
jlak	ลักษณะทั่วไป
vrik	สุดท้ายอนุภาค
qyan	หน่วยจินตนาการ
kxaf	ความเร็วของแสง
xyic	ฟิชชิ่ง
qyit	ที่สำคัญอีกจุดหนึ่ง
hvek	evitativeกรณี
bvik	subessiveกรณี
hzes	ผีสิงกรณี
prus	คอมพิวเตอร์ไวรัส
ples	หน่วยประมวลผล
pxif	ตำรวจเจ้าหน้าที่
dvak	lativeกรณี
brun	การท่องเที่ยว
tsi_k	antessiveกรณี
tyum	รูทีเนียมอะตอม
vyak	เกี่ยวกับกริยาวิเศษณ์กรณี
pxim	สำคัญรัฐมนตรี
syum	ธาตุโลหะชนิดหนึ่งอะตอม
sy6n	ความมีพิรุธ
hy6n	มีชีวิตเพศ
pxac	ความเห็นอกเห็นใจความปิติยินดี
vlin	พาหนะเพศ
qwin	แร่เพศ
hr6s	การอ้างอิง
tf6n	หมึกพิมพ์
xris	ผู้ใช้งานอินเตอร์เฟซ
hw6n	การสาบาน
xlen	วาจาคำนาม
pyec	สเปรดชีต
vlim	เสมือนหน่วยความจำ
bres	คำหน่วยประมวลผล
hqip	เมฆการคำนวณ
vlic	เสมือนเครื่อง
pfam	สแปมเมอร์
dyap	ที่สองภาษา
txek	รากที่n-
dxen	ข้อมูลการทำเหมืองแร่
byip	ธุรกิจคน
hs6c	ตนเองความมั่นใจ
txim	หมาย
hb6t	เปลี่ยนแปลงของเหตุการณ์
hdem	โดเมนชื่อ
dxon	ต่างเหตุการณ์
lwaf	แฟลชขับรถ
sl6t	crastinalเครียด
xyik	ห้อยดิสก์
fyif	สะท้อนกลับเสียงพูด
bvin	จักรวาลเพศ
hm6p	เมนบอร์ด
tfip	เกี่ยวกับสกรรมกริยาคำกริยา
jlen	ท้องถิ่นเพศ
xrap	ลาย
tc6n	การวิจัยเพศ
sl6n	ศิลปะเพศ
xrek	ผู้ป่วยไก
xwan	นามธรรมเพศ
dxif	การประชุมทางไกลผ่านระบบวิดีโอ
dyip	ทางอ้อมการพูด
zrek	exocentricกรณี
hvuk	ความรู้สึก
xwat	อดีตเพอร์เฟ
hr6m	รีเนียม
txaf	ทริกเกอร์
hmef	ไม่มีตัวตนคำกริยา
tx6t	ข้อความบรรณาธิการ
txes	โดยรวมคำนาม
bvat	mistreating
bvuk	absolutiveกรณี
ry6t	เรเดียน
vlis	เสมือนความจริง
qren	ของดาวเคราะห์เพศ
gvak	ไวยากรณ์กรณี
bxok	หัวโล้น
mrum	คอมพิวเตอร์โครงการ
ps6t	การดำเนินงานระบบ
hfom	ฟอนิม
tlem	อ่านเท่านั้นหน่วยความจำ
pwam	สปายแวร์
kfif	แกนbenefactive
qwit	ความมีเหตุผล
nlaf	การติดตั้ง
nwok	ที่สมาคมกรณี
dzas	ขัดใจ
swuk	สุดยอดกรณี
syos	ที่สรุป
kr6n	ไฟฟ้าปัจจุบัน
dvin	ไม่มีชีวิตเพศ
pxom	propositiveอารมณ์
vris	ซึ่งกันและกันเสียงพูด
rwos	ละอองในอากาศ
dr6t	รำคาญ
ht6k	การสื่อสารโทรคมนาคม
slaf	สังคมเครือข่าย
lyuk	ต่อเนื่องประโยค
qras	ผู้บังคับบัญชา
ty6n	สถานีปลายทาง
gwet	ในไม่ช้าอนาคตเครียด
hp6s	ปรับใช้เสียงพูด
tsof	antipassiveเสียงพูด
ht6p	continuativeแง่มุม
hn6f	necessitativeอารมณ์
pfip	อยู่เฉยๆคำกริยา
glap	แถบเครื่องมือ
sy6k	อัตถิภาวนิยมประโยค
qyat	เรืองแสงความรุนแรง
hy6t	วัตถุไวยากรณ์
vyan	การออกเสียง
sluf	singulativeจำนวน
dvit	มากเกินไประยะเวลา
qyak	เดียวการกระทำคำกริยา
bzik	ฟิสิกส์
xlet	สุดยอดระดับ
hqap	นำเสนอคำกริยา
qwat	จำนวนของสสาร
qyik	เกี่ยวพันอนุภาค
sr6t	supercriticalของเหลว
hfem	epentheticหน่วยคำ
tl6t	รีโมทอนาคตเครียด
mrif	ไมโครโฟน
pcuk	postpositionalกรณี
tfim	สุ่มทางเข้าหน่วยความจำ
fwim	ethidium
ly6t	allocutionข้อตกลง
hvap	เลื่อนบาร์
hfep	frequentativeแง่มุม
bvan	เกี่ยวกับการจำหน่ายสรรพนาม
fyun	ลอยจุดจำนวน
xyas	การลบออก
hvif	กริยาต่อท้าย
xyis	อดีตอยู่เฉยๆคำกริยา
tl6n	ศูนย์กลางการประมวลผลหน่วย
tfok	เกี่ยวกับตำแหน่งทิศทางกรณี
qwan	บ่อยๆถามคำถาม
