hnit	інфінітив
hnak	називнийвідмінок
hkak	Асі
htak	темавипадок
hpap	Папа
hmam	мама
hyat	батьківський
hcan	Здравствуйте
hwik	вокативвипадок
hsuc	предок
htat	бабусячидідусь
hcac	голодний
hnik	родовийвідмінок
hcit	прикметник
hwan	і
hman	мені
hnan	ви
hwam	нас
htit	це
htac	випадокпризначення
htik	відмінок
hyit	REALiSнастрій
htim	деонтіческіенастрій
hcut	умовнийспосіб
hsit	епістеміческінастрій
hyak	оруднийвідмінок
htan	контекстінтер&#39;єру
hpan	контекстлюдина
htin	незалежнийпункт
hyan	підряднеречення
hfap	досконалийвид
hkat	Минулийчас
hnin	чоловічийрід
hmak	комітатів
hnat	теперішнійчас
hpak	благословляєвипадок
swik	ессів
htut	квантіфікаторнегативний
hsan	контекстповерхню
hpin	adpositionalвипадок
hwin	випадкурозташування
hkan	контекстпростору
hnac	спосібкейс
hyut	питальненастрій
hnam	ічи
hkit	Щовиключаєабо
hsuk	джереловипадок
hpik	аблатів
hcat	близькість
hmat	демонстративний
hkuk	пунктхвіст
hlan	але
hsut	всі
hyin	квантор
hcin	жіночийрід
hpac	множина
hyik	один
htic	їх
hkik	хто
tcat	майбутнійчас
hsin	соціальнийконтекст
hkac	коли
hmip	недосконалогоаспект
klan	там
hlak	Елат
hlik	іллатів
htam	директиванастрій
hlat	факультативнийквантіфікатор
hkam	що
hwat	питальнеслово
htap	амбоцептор
hpat	людина
nyan	чоловік
hkas	може
tcan	інший
hnuc	номер
twit	напористоюквантіфікатор
hsak	контекстчасу
htuk	скроневоївипадок
htun	тільки
htum	повчальнийнастрій
hyip	ретроспективнийаспект
hlit	вольовихнастрій
pcic	повинен
tyut	два
hsat	побачити
hkut	знати
hcic	вниз
hcap	після
hpam	перший
hlac	відчужуванимволодіння
hkap	ніколи
hnic	невід&#39;ємнимиволодіння
tyat	старий
tcit	дорадчимнастрій
tcin	день
hlam	прийти
hwak	голосний
hkin	йти
lwak	perlativeвипадок
hpip	прогресивнийаспект
lyan	довго
hsac	казати
kyan	як
htas	знову
hsic	тут
hcik	думати
hcak	підконтексті
hfan	знайдений
hsun	рука
hyac	також
nwan	молодий
tyit	проти
tlan	бог
twak	delativeвипадок
hmin	нічого
hyas	одинраз
hlap	semelfactiveаспект
kcac	лівий
hyic	бачив
hcas	будинок
hwac	світ
tyin	три
hnun	нео
hcuk	фокус
pyan	любов
hsis	завжди
hyam	ніч
hyap	король
hkic	між
hmas	розум
cyit	серце
pluc	paucalномер
kyik	оскільки
ksak	причиннийвипадок
tcun	зроблено
hnim	ім&#39;я
tsan	ім&#39;явласне
klac	країна
hpun	запитав
cyat	видимимдоказательственная
pcac	краще
hmac	момент
hnas	неможе
hwic	вода
twim	дезідератівнийнастрій
kwan	світло
tlat	слово
tyan	двері
hsas	ранок
syat	до
twik	terminativeвипадок
hpit	білий
pcan	гроші
hyis	бідних
mwan	смерть
hfam	форма
nwik	Інеса
kcat	разом
tsac	часто
pyat	один
psan	половина
hpim	наказовийспосіб
hyuc	круглий
hfat	надісланий
hcis	дружина
kcan	вірити
hsik	громадськості
htus	станконтексту
hpas	син
clat	діти
tyak	такимчином
cwan	надія
syin	дорогий
hkuc	висока
tyac	зчитування
syit	місто
hlic	вже
hfit	фактітівнийдоказательственная
tcac	дівчина
hcun	заслуховувати
ksan	якмінімум
hyaf	можливо
kyat	дійсно
tcic	тіло
hwit	повернення
cwat	повітря
hfaf	закон
hput	допомога
lyat	лист
ksas	чотири
hpic	оптатив
hfuk	вогонь
hcam	годину
twat	війна
kyak	кілька
tlit	другий
pcin	ззаду
hmut	втрачений
clan	тисяча
hfac	сім&#39;я
twan	душа
hwas	питання
syan	правда
htis	виготовлення
tsat	потенціалнастрою
lwik	Аллат
nyin	антропнийпідлогу
hfak	п&#39;ять
tcak	тойжесуб&#39;єктмаркер
htuc	іншатема
hnap	відповідь
hmit	море
hcuc	страх
pcat	розуміти
syas	терміни
hcaf	сумнів
twut	dubitativeнастрій
hkis	чорний
tlak	приносити
hyus	гарний
nyit	сортувати
htip	десять
ksis	історія
hpuk	книга
hlin	електронний
hkun	рахунок
lyas	інтерес
lyit	запис
pwat	ліжко
hnis	вік
hnut	контрфактіческіхумовне
slas	мистецтво
hwis	випадокVialis
pyak	брат
lyin	лінія
tyas	таблиця
hyun	річка
kyac	очей
tfan	раптом
kcin	глибоко
hmuc	мета
cyac	кров
hmap	троянда
tlin	холодний
hyif	вперед
tyam	пізно
hnaf	припускати
hkip	майже
myan	Шахта
tsin	знання
hkup	копія
hsam	чоловік
hlis	шість
cwit	живої
cyan	мир
myat	запам&#39;ятати
tyic	натуральний
hfut	падіння
swas	обслуговування
hsap	крім
pcit	авторськеправо
hyim	армія
kyas	кінь
plic	майбутнє
pcak	захід
hpis	платити
hyuk	червоний
hwun	золото
twin	бажання
plan	грати
hpus	офіс
syun	уряд
kyic	церква
htaf	сила
hlun	довжина
kyin	компанія
kyis	папір
mlan	ймовірність
hcim	особливо
cyas	нести
twac	вікно
nyat	краса
hcus	останній
htup	обов&#39;язок
htif	відстань
pyas	фут
hlas	дикий
ksin	зелений
hmaf	занепокоєння
myac	посмішка
hsim	сон
kyit	процитував
kwik	квотатіввипадок
fwan	візит
slan	слідувати
psit	наявність
hmic	солодкий
hmuf	рот
hfin	багаті
tcam	ворог
psuk	зламаний
kcap	корабель
pwan	включнолюдина
hfic	вплив
tcuc	з&#39;явитися
hkim	секрет
pyin	будьласка
pwit	прохальнийнастрій
pyit	ввічливірегістр
cwak	зло
myak	марш
tcas	місця
hlaf	залишитися
psat	замість
nlan	синій
psac	неможливо
kcuk	школа
kcit	одружений
kcak	харчування
syis	двадцять
tlac	спокійно
hcip	перспективнийаспект
kwin	дає
tsit	зупинився
pyac	мова
hsus	тиждень
hcup	зал
cyap	здивування
tfin	природжений
fyat	суд
hnip	гномічноїаспект
tsak	повага
tlas	вартість
syuc	дерево
plat	стіна
cyak	небо
twip	начінательнийаспект
mlat	команда
swit	юссів
mwas	місяць
hwaf	досконалий
tyap	досвід
ksac	обставини
syac	свіжий
hnuk	герцог
kwak	покритий
tyuk	схід
pwac	камінь
hkif	благородний
nyac	напрямок
cyis	стілець
tyuc	очікування
tsun	село
tyik	згодні
hnum	перміссів
slak	успіх
tsic	намагаючись
slat	пагорб
hmik	музика
hkus	крик
hsip	сім
hpaf	приватний
nwas	новини
tfac	сцена
fyan	сад
cwas	почати
hfik	дистрибутивнийвипадок
lyac	вчитися
syik	політична
clin	генрі
cyin	брехня
tsas	відливати
cyik	авторитет
tlap	пол
cyam	літо
tcut	релігія
tcap	Втеча
hlut	автор
pyun	коричневий
tcuk	біль
swan	весна
hmun	м&#39;який
kyun	кут
nyak	товарнийзнак
tsis	справедливість
psas	виробляти
cyaf	сміх
hwut	забувати
hyup	Європа
hwap	вісім
psak	проходження
kyap	жахливий
pyic	вимагається
hmim	середа
hsaf	дихання
hmis	мудрий
hsum	присвійниймаркер
ksat	приємний
ksit	могила
tsap	острів
kyam	табір
tcum	чіпати
cyun	стан
psic	берег
tyun	домен
mwit	commissiveнастрій
tlut	ступінь
myit	зима
kfan	поведінку
slac	біг
myin	хвилин
tyip	вести
klas	скло
pfat	дошка
cyic	марнославний
swam	справи
syam	безпечний
tsut	лікар
hlip	закінчуєаспект
kcas	темрява
nyun	теплий
hpuc	напій
tlam	приклад
hfun	гнів
tsik	озлобленість
tsam	безпосередньо
hmup	капелюх
klak	пес
slin	срібний
swac	службовець
kcam	гордість
pyik	поїзд
myut	моральний
syak	входити
swat	меч
kyuk	атака
clac	здоров&#39;я
tyaf	пункт
swic	соціальна
tfit	повернення
hkaf	офіційний
pcas	погляд
nyam	слава
tfat	дванадцять
pcut	зайнято
pwin	вино
mwat	смак
fyac	залізо
syap	поширювати
myap	торгівля
hyum	використання
fwak	суддя
klat	капітан
twap	cessativeаспект
kcic	цікавий
kwic	іноземні
hnif	интенсификатор
myun	важливість
tlic	вкінцікінців
cyuk	шия
syut	свобода
pfan	боку
kyuc	сухий
pcap	всторону
tfak	доказовий
tcik	доказательственнаявипадок
twun	віддалений
tyis	прогрес
nyap	вузький
plit	будівлю
hpif	сторінка
pwic	проведення
syic	сумний
tsip	гріх
syim	хворий
tcis	чесний
pcun	банк
ksap	приймати
lyam	потік
tcaf	ретельно
kwac	вухо
hpup	хліб
kcut	вибирати
nwam	тварина
hsup	скам&#39;янілостіпідлогу
nwit	подієвийнастрій
tcim	такийжемаркерподії
tlik	мультиплікативнийвипадок
kyus	перетинати
hmus	товстий
kfat	сміти
nwat	рости
myic	дощ
hpum	поверхню
swut	святий
clis	липень
mwun	мода
hfas	файл
cwac	плече
kwat	комфорт
nwac	хтось
tcip	бажано
kfac	трава
hmuk	малювати
plin	відкриття
kwun	червень
mlik	риба
klin	капітал
pfut	груди
twam	вимога
fyin	витрата
nlit	ваш
mlin	мільйона
pyut	молитися
hluk	стомлений
ksut	вбити
cyut	тінь
psin	вага
kcis	сірий
pyam	відважний
mwac	задоволений
klam	кажучи
ksam	національний
hfip	слабкий
klik	долина
hkum	спекулятивнінастрої
clas	жовтий
cyuc	тепла
mlac	залишки
syip	врівніймірі
pwak	коробка
tcif	загострений
psip	принцип
ksik	наслідок
tsim	сезон
flan	наука
pcam	мабуть
kcun	розточування
ksuk	дядько
mlit	список
pcik	небезпечно
kwas	серпня
hluc	популярний
klit	невідомий
flak	знайомий
fyit	знайомийрегістр
lwat	читач
plun	ходьба
twas	двічі
pcis	священик
fyas	поранений
nlat	палац
myuk	дурити
pfak	сприяти
tcuf	дев&#39;ять
cwap	співчуття
plac	вибух
pyap	здачі
lyic	заправлений
hcum	шум
lwit	література
tsuk	ранг
hfup	шторм
kcik	кишеню
nwap	Листопад
tyim	Грудень
psaf	відсутність
nlac	населення
kyaf	спасибі
slis	серія
pyaf	птах
mlak	власник
kwut	пальто
hwuc	відносини
pyis	швидко
twuc	дим
nwak	січень
mlic	машина
tlis	зуби
ksun	спалювання
clam	ганьба
klaf	якість
clit	каблучка
fyak	фраза
fyam	фразамаркер
kwap	Майдан
hwip	Неділя
psis	поезія
pwut	зумовлений
kyim	купити
clic	поля
pyip	квітня
kfap	жовтень
psut	об&#39;єкти
kcuc	гіркий
nlap	раб
hsok	вільний
htet	текст
hbat	найгірше
hrit	кредит
hzit	риси
hpet	п&#39;ятнадцять
krac	жорстокий
hduc	пилу
hrik	практичне
hron	колір
hnus	ніс
hric	доброзичливий
srik	поставка
hten	вчора
tlet	hesternalнапруженої
slap	терпітиневдачу
hban	носити
hdat	сліпий
fran	літати
hdan	диявол
htec	поступово
hmon	місія
cran	жертва
hran	совість
hmos	міністр
nrit	енергія
hcet	ненавидіти
hset	центр
hrin	раціональнепідлогу
hcot	насолоджуватися
hrip	короткий
htep	поклоніння
hcif	шкіра
hrat	дах
kran	корона
hkon	замок
tran	відчай
hmif	милі
trin	коло
hgin	в&#39;язниця
hkop	чашка
hcen	член
swin	цивільного
hrac	всюди
hris	виготовленийназамовлення
hbin	становлення
hmot	м&#39;ясо
hdut	молоко
hwen	рослиннапідлогу
nran	рідкісний
hbac	двоюріднийбрат
crut	міст
hsoc	акції
hsom	сіль
nris	невинний
hbit	уникнути
crin	схиляння
rwin	королева
hgut	рахувати
hdas	танець
hnot	готель
hdin	заповнити
hton	укладений
hdak	магазин
hlet	сходи
hson	помилування
hgek	гей
hras	пісок
hsep	Вересень
hbic	розорення
hlen	ліцензія
hcon	досить
hgit	свідок
kfon	кухня
hbak	продавати
tlim	лікування
hsot	швидкість
kyut	комп&#39;ютер
hnen	вічний
htek	бібліотека
hzan	щомістить
hbis	база
hbun	плутанина
kcus	повар
hgat	пустеля
hwus	поцілунок
hbif	лід
hbot	м&#39;яч
hrut	аргумент
hdit	benedictiveнастрій
hdis	винний
hjan	покарання
plis	поліція
hgan	приховувати
hsen	експедиція
nrin	неосвічений
hyen	хмара
frif	лютого
hdik	хвороба
hnek	ініціативавипадок
hbam	тітка
hmen	смиренний
hdip	відстроченеімператив
prat	повідомляєдоказательственная
hdet	опівночі
hjit	палець
hmoc	десь
pran	прес
kcec	регіон
hken	заостаннійчас
hloc	меланхолія
hrak	персонал
htes	вдивлятися
rwan	нагорода
hdon	жертвувати
htot	лоб
hnet	ангел
hdun	однина
croc	помилка
hlon	світанок
hyec	овець
hjin	терпіння
hrec	довідковий
mran	кукурудза
htos	більшість
hcos	заходи
hkoc	іноді
hlif	прибуток
clak	цукор
hjat	людство
tram	рамка
hdic	диск
hkok	самотньо
srat	художник
crak	чарівність
hmet	електроннапошта
hden	рішення
gran	губернатор
crac	філія
hjac	ентузіазм
hdim	індуктивнийнастрій
hcok	квапити
hyet	масло
pwap	труба
trat	друк
tcot	твердаречовина
hdoc	ой
hren	дискурсконтекст
tcon	опівдні
krin	кабіна
plam	сигналтривоги
hnes	нервовий
tcen	спостереження
hsek	аспект
plik	якийможназастосовувати
slik	шовк
hfen	цент
hgen	агент
hnon	союз
crik	ад
tcet	дефектний
mrat	змішаний
hdam	admonitiveнастрій
hgac	честолюбство
htoc	якось
hdac	адвокат
nwin	конституція
srit	інструмент
hret	твердо
nlin	онлайн
hzat	хвиля
klic	коледж
hkek	хвіст
nric	покоління
hgic	переповнений
hgak	кіт
trit	прямийдоказову
tyot	договір
hnok	зміст
crit	занедбаний
slen	одинадцять
srin	інстинкт
hpok	плем&#39;я
hyot	побоюєтьсянастрій
cric	укриття
hruc	грубий
cwin	верховаїзда
hzak	похитнути
dyit	промисловість
hpec	професія
nras	медсестра
hcec	навчання
hbut	взуття
hmec	розпливчастий
twot	діяльність
crat	субота
hkot	ємність
hnec	сонячнесвітло
hwuf	вдова
cren	пролити
nrat	зірка
hget	гість
hbik	благословити
brin	внутрішній
hpot	доступний
trac	опір
prac	виводити
hcoc	порожнистий
hpon	провінція
hwim	цивілізація
dwan	вішати
cwok	шок
hdok	водіння
crun	скарб
hzik	насіння
hrot	Недавнєминулечас
hket	бодрствующий
hcek	меблі
hrop	канат
mrac	пригода
byit	свято
trak	річний
hzin	південний
sric	церемонія
clik	полювання
trap	ліберальний
hrim	християнство
hrus	принцеса
blat	вівтар
cyon	крихітний
hwep	Web
krat	кардинальний
tris	фіолетовий
kcot	збирати
hben	вибори
trik	п&#39;яний
kfit	ліфт
tcec	обмін
nrik	визначенийартикль
grat	імператор
dran	адміністрація
hpen	попередньо
cluk	потворний
nrac	нешкідливий
ryin	навчання
hrun	рулон
nwic	дюймовий
slit	стріляти
gzat	газета
krot	різання
drit	борода
hzis	відривати
hdap	вісімнадцять
sris	історичний
mrut	брутто
nyik	бруду
bran	наречена
drat	залежати
djan	гігант
glat	простота
hpoc	осінь
pras	вуаль
hgot	збір
tret	театр
tras	порівняння
rwit	суперник
hfon	формування
klot	тренер
hmum	юмор
drac	мова
rwas	Роман
tset	помста
hdot	дистальнийдемонстративне
ryut	ревнивий
hwon	запрошення
byat	спалений
flac	спалах
prot	портрет
crek	пропонувати
htok	конфлікт
htop	прокляття
prit	imprecativeнастрій
hces	безпорадний
klup	клуб
hnos	повінь
dwin	байдужість
prin	горизонт
mrit	гаданийнастрій
tcoc	крутий
hcom	гармонія
grit	грім
tlot	дитинство
hgik	коліно
hwes	несвідомий
hzac	взаємне
hsec	програмнезабезпечення
tson	установи
ryit	отримання
dlin	дисципліна
slip	сліп
klon	революція
hfim	фермер
hpom	платформа
cyen	студент
hgec	печера
hroc	традиція
srac	уявити
ryat	трагедія
kcen	незаймана
hbap	прощальний
krik	критика
krap	бавовна
fwat	лікарня
kcet	оренда
hgas	газ
pfin	неминучий
dlit	лист
ryan	переклад
sran	похорон
mrin	борошно
hram	романтичний
dlan	долар
hzas	насміхатися
hsos	шістнадцять
klen	колонія
gyin	крило
hsif	лев
cluc	хитрість
prip	підготовка
hzut	туман
dwat	медицина
krit	читатикоректуру
sras	гніздо
hses	чотирнадцять
brat	заперечення
flat	кислота
hjic	асаме
slic	зброю
hbuc	користувач
tron	помаранчевий
byan	ванна
hrif	примітивний
tlip	встановити
blan	корзина
kris	секретар
hyon	тимчасом
tren	сьогодні
dlat	напруженоїсьогоднішній
hzic	отрута
tfic	гвинтівка
tlen	талант
hlim	клімат
dyat	мате
kcon	одкровення
dlac	мити
krak	визнання
hbas	дурниця
hkec	вугілля
hrek	відновлення
hkos	човник
hwif	віце
tric	тимчасовий
hdep	delimitativeаспект
mwak	паля
ksot	кістка
hnoc	понеділок
nlas	Вівторок
brac	середа
frap	федеральний
pfit	представник
pcoc	полюс
lyen	білизна
swak	раковина
pcen	президент
brit	кривавий
hwec	облога
hwet	шлунок
hlos	вгорупосходах
hbon	різноманітний
pcon	латунь
hsem	зустрічнавищомурівні
lwac	дешево
tsos	конкурс
kwen	ексклюзивнийлюдина
trun	посадка
trut	статуя
hrap	артилерія
hgap	заарештувати
trot	температура
grin	сусідство
hjak	охоплювати
hpek	пакет
hlus	олень
hwos	спальня
tsuc	кущ
pcuc	розряд
cris	спадкоємець
clun	дуб
hpes	неприємний
nlet	неповний
hrom	програма
pyon	піаніно
swet	умовляти
dric	невидимий
tyen	добревідомі
hruk	жорстокість
frat	призначений
hyoc	спокуса
hlep	цілеспрямованийаспект
nrot	міжнародний
nret	люто
hfif	філософ
pfic	уявлення
hmek	чутливий
hfec	добробут
myik	рибалка
truc	вкрасти
tcop	губа
rwic	йтиувідставку
htom	економіка
glan	галерея
pren	паралельно
hlek	atelicаспект
nrak	континент
truk	постукати
hjim	заборонниминастрій
rwat	галстук
hcep	клітина
dyan	яйце
jrat	штучний
nren	натхнення
ksic	криза
tsoc	пошук
lwan	обід
hpos	сосна
hcuf	поштовх
tcus	порушуватисправу
pset	продовжити
hkep	мідь
swis	матрос
prim	імперський
trip	батіг
cras	сорочка
swap	розгортка
syet	ескіз
htof	злодій
clen	канал
kwit	особистість
klok	надлишок
hrok	реформа
hguc	спрага
kcim	загрозливий
hpem	пальма
psik	динамік
frit	поріг
cret	сліди
mrak	спис
syen	сесія
tcup	вогкість
hyek	мандрівник
trim	олово
plak	скарга
hyok	кут
hgam	корова
hmok	млин
jrac	карта
kloc	комір
gyit	свідомо
hbip	пиво
mlet	оксамит
lyap	зловживання
cwen	стадо
bwan	племінниця
tses	тринадцять
jrit	обґрунтовувати
nlak	рукопис
sron	воїн
cruc	п&#39;ятниця
broc	щітка
dlot	скачати
krim	крем
pric	крок
prut	присяжні
hgon	заморожені
sram	буквально
pfot	горщик
hlot	планований
djin	монета
hlok	стрибок
hpep	яблуко
hwot	скручений
dlak	обговорювати
brik	підписуватися
nlis	транскрибувати
hbet	ставка
pris	вірус
hjik	гостинність
blit	дитячий
hjap	халат
tfik	відображати
hdaf	досягати
hpop	опера
kcaf	приховування
kcoc	лікоть
hrum	ремонт
cyim	підозрілий
dyic	освітніх
hgoc	яма
drak	розлад
plas	оплески
byin	двійковий
hzap	абатство
nlot	лояльність
mrik	механічний
hsop	успішно
crap	пастка
kyek	торт
nrut	розважати
syes	сер
hjet	сімнадцять
hjen	жіночний
hmom	мед
hdec	нажаль
lwen	легенда
slot	плита
frac	бунтувати
gwan	опуклість
mruk	поліпшувати
swot	болотний
zlan	заробляти
hnem	анімаційний
hdes	перев&#39;язувальний
prak	повчати
frin	декорації
hfet	виступатипроти
cros	хор
ryon	раціональний
tcos	урожай
tsen	обробка
hwek	вовк
nlik	відмова
klap	килим
dras	зневажати
prop	родючий
slim	свисток
hgis	сир
krut	вкусити
srot	супровід
bjan	блукати
nwen	військово-морськийфлот
myas	маска
kwaf	розвивати
twis	таксі
pcip	олівець
srap	овочевий
sren	експонат
tlun	Брюки
hrup	корупція
nrip	кабінет
srup	суп
jran	хірург
bjat	посібник
gyat	шпигун
hlem	необачний
srak	анотація
kson	акцент
cwis	четвер
sret	щиро
hraf	трафік
hres	архітектура
hsuf	видалення
rwak	тріщина
twon	орнамент
hfus	відновлення
hkom	код
djat	мисливець
nlut	бюлетень
hsef	змія
mris	демократія
bric	акумулятор
mlam	віск
zran	поділ
cron	трепет
hzen	плавати
traf	смуга
cwaf	конверт
srip	сигарета
mrot	двигун
swon	доброволець
ryak	реакція
pfun	частково
blac	багаж
mret	міністерство
hjon	сексуальне
kcok	сокиру
dram	діамант
kren	заступник
tcek	відлуння
hdif	ідентичність
tfas	посол
hfot	складатися
lwas	ледачий
hmep	momentaneаспект
kfin	кодування
mwin	уявний
hrem	промінь
pram	сходження
byac	підвал
mren	пам&#39;ятний
swen	сенат
kras	труну
hgun	ковтати
nlok	балувати
ryic	сільськогосподарське
gwin	свінг
srut	луг
hkes	комплекс
hfis	відставка
frak	неодноразово
hnom	змова
hcop	паб
hlec	перець
mlot	мелодія
zrat	кандидат
proc	покровитель
flik	лисиця
cyet	пошкодував
hgim	димохід
slet	хеджування
tcok	точність
bjit	колишнійпомерлий
brot	бутон
bwat	ковдра
hdus	свиня
gwat	кольоруслоновоїкістки
kret	екстракт
nwet	спостерігач
jwan	проспект
nwis	нігті
mwic	бджола
bzat	актор
gyan	піт
zyit	виконавчий
blic	ілюзія
pcet	невизначеність
tsot	скласти
bwit	межа
tres	стрес
hkof	споживання
nyen	кряхтеть
hles	походити
cyek	мішок
hjis	голка
gjan	явище
prec	вести
drot	контрольований
kcek	крива
twic	курка
brak	бочка
zwat	звичний
clap	хабітуаліс
tsec	експерт
bwin	враження
cwet	обмежений
hbek	пекар
zlin	оливковий
mron	фургон
drin	присвячувати
psap	викривати
gjin	деньнародження
clut	молоток
cwun	запашний
twaf	тривіальний
pcot	домашнятварина
krok	череп
dlik	законодавчавлада
cwic	нащастя
srun	насупитися
crec	руйнує
jlan	маржа
kcip	чемпіон
blin	мільярд
ryik	хімічна
mlas	пульс
flit	пілот
hzet	вузол
cwik	величний
twet	спідниця
mwik	щотижня
tfis	технічний
tlon	транспортнийзасіб
cram	утішний
grac	зміцнювати
kraf	ворона
trup	атрибут
hduk	гак
cruk	тигр
nrap	економка
crot	шосе
mlip	міліція
hfoc	фотографія
nres	цілісність
plos	плюс
tfam	прозорий
nlic	дев&#39;ятнадцять
hwok	кваліфікований
nlen	есе
fyic	коефіцієнткорисноїдії
hwuk	унікальний
hgok	органічний
flic	теологія
flot	поплавок
hboc	зобов&#39;язати
hwoc	відьма
syot	студія
cwip	шампанське
hbes	банер
lwic	розлучення
blot	болт
cwot	неволя
cwam	вена
prik	пасивна
hfum	піна
grik	гравій
zrin	фартух
gren	планета
hfuc	воскресіння
claf	полиця
flas	вентилятор
hjot	тропічний
hbim	довільний
krek	ртуті
hbec	доброзичливий
tsaf	самогубство
pwas	зривати
plot	репортер
kfak	витратити
blak	балкон
hdos	пляма
kwis	класичний
kcos	звинувачувати
psen	пенсія
kres	дієслово
hzon	мавпа
srim	підпис
glin	небажання
mlut	горезвісний
myot	імпорт
fwac	засновник
troc	факел
hgaf	граматика
hyop	яхта
ksip	вимерлий
sres	екскурсія
hnup	купол
hzun	впертий
mric	м&#39;яз
gjat	величина
hros	руб
zrac	боягузливий
tros	тост
myus	миша
dwac	діалог
byak	коза
htef	кравець
hfek	процвітати
dzan	накладати
nyon	анонімний
zrit	формальнийрегістр
pcos	спортивний
hjec	розплав
dlas	видаляти
mras	парасолька
mram	мінерал
cwut	перепочинок
hbok	качка
swun	мило
dwak	лялька
plif	вілла
slon	шиття
tfut	вітати
djac	мирити
hjas	пригнічувати
kric	кролик
kwot	провідник
gzan	гарантія
clot	гравець
ksek	комаха
psam	поза
mwut	сова
htem	постійно
clon	скрипка
dzin	резидент
rwim	відповідно
hyof	вигідний
dron	дракон
dwit	слуховідоказательственная
sroc	експорт
hzot	припинення
djik	затримуватися
kfik	кришка
ryun	регулювання
hmes	мер
rwac	апаратнізасоби
sruk	цирк
sros	меншість
bzan	бунт
kset	оркестр
bjon	бекон
hjut	необмежений
tfen	захисту
zwac	незручність
dyin	обдумування
myis	музикант
mlis	подумки
pret	неадекватний
tsek	архітектор
hlom	лимон
ksos	кашель
crok	головнийбіль
flin	фертильність
mrun	столяр
swec	випадковий
syuk	ложка
blun	повітрянакуля
tcep	крейда
fric	відпочинок
rwik	вертикальний
rwen	запобігання
flet	виведенийдоказательственная
pfac	видавець
srek	оцет
tfun	тунель
pwet	головоломка
gyik	математика
fwot	в&#39;янути
lwin	збалансований
jwin	печінку
bwik	сублатів
hdup	падіння
hnop	монополія
bwic	підводнийчовен
ryen	незважаючина
hcem	землетрус
hbos	лабораторія
nrek	працівник
ryim	ритм
nyic	інтерпретувати
dwas	посольство
rwok	провокувати
kram	нездатність
ksim	декларативнийнастрій
clok	шоколад
pcec	привілейований
nyis	відлюдник
tyoc	збіг
grak	подряпина
zlat	рукавичка
hjuk	стоятинаколінах
trif	географія
djit	систематична
pson	непереможний
mwis	інвестиції
cwec	словесний
hdek	світський
blik	яструб
sloc	психологія
brap	лом
jlat	пірат
dros	дозувати
slam	лосось
pwun	пудинг
gwik	магнітні
pcop	насос
myen	аналогічнимчином
ksen	кисень
mrap	виконроб
tfot	сертифікат
ksus	кластер
trok	риторика
tloc	сходинка
zyan	весло
nlun	Ввійти
hlop	телескоп
jlin	написання
lyut	хмарний
hsof	прибій
fyik	віскі
klet	щодо
hwof	верба
hlum	верблюд
myet	любитель
klis	ізоляція
hbaf	біографія
gwac	осів
hwum	слух
pwik	перспективний
pron	професіонал
myes	щомісяця
mwen	мрійливість
kfic	відпустка
klek	клацання
cwon	овальний
lyak	еластичний
kwon	словник
hjam	шинка
rwon	веселка
crip	справжнім
zwan	щовідбувається
srok	редакційний
craf	тілесний
tlok	бак
brip	метелик
tfap	діаграма
jwat	близнюк
pros	операційна
psun	ознаку
clet	нещасний
hbus	бамбук
dyas	дилер
klun	накопичення
jlit	одностайне
hdom	кошмар
kron	вуглець
hzam	джем
cyot	слухач
hmem	музей
lwam	алфавіт
fras	розкид
psoc	перфоратор
hgum	жувальнагумка
brek	гальмо
glit	стабільність
frun	гниль
gris	агресивний
mroc	тертя
bzit	павук
plut	картопля
glac	жадібність
gzac	множити
prun	спин
jlet	календар
nyim	висування
tlos	трильйон
slut	салат
fwit	стверднунастрій
pyen	додатків
nlon	номінальний
dren	демонструвати
drun	незадоволеність
cyok	знизуванняплечима
hfop	футбол
ryac	партнерство
gzin	піонер
hgip	капуста
tyet	спортивний
hdof	ідеофон
hwup	неоціненний
lwek	важіль
syec	сенатор
jyak	вміщати
mlim	мураха
fwic	фактично
gzit	вагітна
blas	опора
jrin	повсякденний
gwak	кісточка
drik	дивно
prif	змінна
jwit	різноманітність
krip	дискримінація
ryot	благоговіння
nwut	тротуар
kcif	активно
jrak	жаба
twek	exessiveвипадок
psot	розплата
pfon	губка
sluk	білка
nlim	ірреаліс
ksaf	дефіцит
glak	вулкан
plen	рівновагу
kfaf	шарф
kyon	експлуатувати
jlik	геологічний
psop	паспорт
kfis	вакансія
fyon	спорідненість
nram	аморальний
hbuk	сухепечиво
gras	транс
hyos	побоюється
flim	фільм
plet	таблетка
rwam	атом
blis	ваніль
zlit	СНІД
fyut	вибагливий
crim	піраміда
hjif	незаконний
crif	сором&#39;язливість
lwap	лютня
tyon	астрономія
mrim	лабіринт
drut	описовий
nrim	стипендія
kruc	черепаха
kwam	консультант
jrik	крикет
dlut	позначати
pyot	голубиний
dyon	адаптація
prap	оператор
bzin	значок
tyek	трикутник
trec	скарбник
nron	водень
pyet	принтер
tsok	удушення
zyin	хронічний
slek	велосипед
jyin	інжиніринг
ryas	передача
zrak	оновлення
nyas	танцюрист
gric	міграція
zlak	порушувати
tces	теніс
hjun	вітряний
twen	ткати
kyet	колектор
gwit	хребет
kyot	акорд
fwin	частота
tfuc	ткацькийверстат
dlet	каталог
pfik	мислитель
bjet	бюджет
trek	стратегія
kros	кварц
gjit	ножиці
gwic	перемикач
frik	теоретичний
tluc	рушник
pruc	патруль
glic	льодовик
krun	повнота
bjin	прогнозування
tlaf	братиучасть
tfet	виробник
bras	бічна
dwik	підсудний
clec	вихлопнігази
cres	шахи
tcef	вишневий
tcom	спотикатися
nyot	перекладач
tyok	вантажівка
cyip	переважаючі
grot	гірчичний
bris	бездротової
nlam	аукціон
slif	решето
hgos	іржа
swoc	нестійкий
jyat	банкрут
slum	мусульманство
hjes	перепис
dzat	навшпиньки
slun	призупинити
nwot	безперервність
gyic	гітара
pfas	зміщення
zyik	цинк
blen	блискучий
hyem	в&#39;яз
hnep	звалище
nyut	в&#39;язаний
ryam	займенникмаркер
clim	пряність
jret	чіткість
tfon	дражнити
jwac	Ява
hrep	рецепт
dyac	франшиза
myip	метр
rwis	расової
hkem	комета
nwon	інновація
zwin	заборона
dyis	середньовічний
mrec	горобець
fyot	виноска
mlon	вимір
pfis	ратифікація
rwot	орбіта
hfok	убогий
glof	гольф
zron	нуль
hzip	застібка-блискавка
hwom	бездомний
bjic	жування
pcim	виконувати
hjip	чіп
bwac	позіхати
mlos	моль
mrip	кераміка
bron	ембріон
ksoc	відрахування
cyum	дріжджі
jyan	жаргон
plim	зливу
mwet	кладовищі
ryet	випускник
glik	зрошення
plap	капіталістичний
tsif	еластичність
gyak	акула
djon	дефолт
nwun	пунктуальний
cles	реалізм
dris	всебільшеібільше
hkef	кафе
blus	швидкадопомога
blap	гаманець
bjak	екстатичний
klim	гримаса
gyac	вчений
jyit	незворушність
dzit	реалістичний
bwak	навідкритомуповітрі
dyot	радіо
bwon	квасоля
fris	неофіційний
klut	спекулювати
tfek	стейк
nrok	азот
zyat	бритва
bram	бурмотіння
ryis	вступний
nlip	аналізувати
nros	контрастні
hcof	роздягати
tfif	стимул
kroc	борозна
hdum	іудейство
pses	одержувач
plok	доповнення
lyet	об&#39;єктив
pwek	pegativeвипадок
kfas	рак
pwen	пішак
nrun	нагадування
clek	витік
pcif	витребування
glas	складність
zwit	говіркий
kces	достатність
crem	роздрібнаторгівля
grap	грейфер
kwip	втручатися
dyut	знижка
crus	ієрархія
gyet	нефрит
gram	гарчання
kyip	ящірка
nyet	подушечка
crop	водоспад
glon	галон
mrok	комар
fluc	побіжний
dwic	відхилення
slec	дослідник
srec	закінчується
blut	завзятаборотьба
myok	мозаїка
tlek	штекер
nruk	інфекційний
nwoc	зцьогочасу
bjut	присадкуватий
hges	вагітність
twoc	продуктовий
kyos	комуніст
mrek	вражати
clip	каяття
pwok	обвинувальнийвипадок
dwot	диктатор
zyac	заклопотаність
jlic	супутник
slop	Гапочка
ryip	пропорційний
psim	приблизний
byet	безробітний
cyop	хобі
rwun	критерій
blop	колба
syok	прихильник
klos	хлор
lwot	хлорид
byic	бактерії
lyik	липкий
blok	біологічна
jlac	симулювати
bret	байт
krif	секреція
blet	балет
nruc	сеча
tsus	часник
dyak	середнійклас
tcem	щипці
cyoc	стимулюючий
trep	полуничний
dlun	забруднення
hlup	альбом
hbep	бейсбол
praf	піратство
pwis	дієприкметник
grek	гараж
kruk	милицю
hfof	фосфор
rwut	структурний
myam	гімнастичнийзал
krec	кран
jras	підрядник
zrik	повідомляти
blam	бальназала
klip	ремісник
hwef	неоплачений
zlac	банан
gret	генератор
lwuk	ребро
nyek	нікель
blos	автобус
sles	цензор
tlif	плитка
kses	ковбаса
mwot	помідор
lyot	автоматичний
tsom	калій
brut	віртуальний
djap	алгебра
hjok	загальний
kfen	поняття
pcok	оптичний
bzut	зрушитизмісця
syek	безробіття
mruc	гусениця
bwas	браузер
klif	кальцій
rwet	дистанційногоминулогочасу
srif	історичнийнапруженої
hwem	спектр
syom	натрій
tyos	довіренаособа
jyic	заручник
hguk	гарбуз
dwun	зморшка
swip	шип
tlec	кліщ
blaf	згвалтування
tsem	атеїзм
mloc	монітор
gyot	умовний
trop	зонд
rwap	квартальний
hjep	Стать
pyim	платина
dlon	подвійнечисло
pcep	легеня
twuk	очистка
tyec	тег
syup	супер
trom	візок
nyip	вмісцевомумасштабі
glis	бензин
gjik	нирка
hjos	безнагляду
hjuc	награбоване
swek	перевантаженіроботою
psek	миш&#39;як
twok	статистичний
tsep	коник
slos	соціаліст
nwim	сенсорнодоказательственнаянастрій
tlop	скатертину
trus	спірне
pwot	прив&#39;язь
djot	відстій
nloc	кирпатий
mwon	мандарин
hjek	жокей
crom	співпрацювати
myon	пневмонія
twec	розташовувати
ryek	ракета
dlic	дивіденд
kwet	кататисянаковзанах
bwen	одержимість
plon	виділення
syon	важкедихання
djis	цифровий
byut	сука
hyep	повіку
dwon	діагональний
byis	підсвідомий
brec	брову
cyec	чхати
hwop	ват
clus	веселий
kfun	розміщення
nwum	індуїзм
fyim	біженець
cwos	човник
tfoc	нападболю
pwon	білок
sraf	самостійнозадовольняє
hbom	блювотний
gyen	ген
drim	першокурсник
trem	особистеспорядження
tsup	роздрібнити
slok	соціологія
kwoc	сквош
bwam	виборець
mlok	мобільність
kyen	регіональний
hmop	рухвгору
rwek	ретроспективний
kfup	куб
grok	морква
drap	заявляючи
lwis	молекулярна
ksuc	бухгалтер
tsop	сморід
kyok	огірок
nroc	оргія
jlot	розчинник
psof	фосфат
hgif	зачаровувати
kfim	лужної
psos	гімнастика
pfen	перевірка
kcom	економіст
krom	кома
tluk	звиватися
hyom	йод
nwuc	рухвнизпосхилу
gjac	викидень
pcom	стручок
dzic	дизайнер
grun	хвастощі
dzot	донор
hzek	марганець
kfot	клавіатура
jlas	ненадійний
lyim	еліта
jyen	ієна
pcaf	кругладужка
rwip	регбі
blip	біблія
kyoc	причиннийзв&#39;язок
lyon	виразка
flis	змінну
nrif	клювання
kfam	квант
swes	светр
lwon	еволюційний
drec	розсічення
gjap	спа
lyec	лінійний
tyom	сурма
pwuk	superessiveвипадок
flaf	альфа
myim	імунний
pcek	викраденнялюдей
bjac	пивоварнийзавод
bzac	обмежувати
bzak	носок
twes	телебачення
dwut	документальний
ksom	космос
lyis	лісівництво
lwim	алюміній
ksok	гороскоп
sruc	прискорювати
dlif	дельфін
byik	вбивця
tfec	канцелярськітовари
hjaf	ссавець
ryok	протокол
dwis	діоксид
jlon	двокрапка
brus	бюрократія
gjak	галактика
lyip	клінічна
ryem	радій
href	розріджений
prok	холодильник
slep	сатир
dret	ітерація
kluk	археологічний
dlis	ідіосинкразія
kfip	неприйнятний
mlec	масаж
pfif	специфікація
nrec	сенсорний
pfet	листівка
hzoc	лежативоснові
dlam	ідеально
nlec	антропологія
kluc	смачний
dyet	седан
tyif	перехідний
krus	присідати
nluc	соняшник
lyun	іон
zrot	видача
ksif	фальсифікувати
psif	випромінювання
crup	перекриття
fret	шукач
grut	инвертировать
ksec	однокласник
jric	маршрут
mrop	мікрохвильовапіч
srus	витісняти
gyas	перукар
floc	фольклор
plek	капілярний
nwop	сідниці
nrom	контролер
twos	тероризм
lwok	гасло
dwet	черездеякийчас
slem	сублімувати
grip	гриль
gwas	Ого
kwok	кобальт
gwon	вівсяної
hdop	рухвгорузатечією
glam	анус
bwot	бичачий
bren	кишечник
byot	відео
bjik	бойкотувати
kwim	вікторина
cwek	хокей
grif	партизанський
hgem	магній
hyes	обізнаність
fram	АПТЕКА
nwos	неамбіційний
ryap	перебудовувати
cwim	надійність
klep	ламінарія
psec	відшкодовувати
djic	світовий
kfut	комендантськагодина
crep	гамбургер
frim	теорема
gjas	запалюватися
hdef	дебет
ryum	уран
pluk	оцінити
krop	координувати
nraf	платникподатків
tyes	інтегрований
plip	висловлюватися
hgom	гамма
hgus	коефіцієнт
cwuc	обігрівач
zret	віднімати
nles	аналітик
trof	неперехідний
hmof	торговийцентр
hzim	вісмут
dzac	обідає
psok	листівка
blon	збіжність
djet	відступати
ksum	акціонер
mrup	мікроб
clif	спіраль
cloc	морфологічний
tfes	постачальникпровізії
gjis	джинси
jren	вирівнювання
tlep	базаданих
kcup	купон
glot	Напруга
glut	калькулятор
srep	кіберпростір
nwes	інвестор
ksef	рентгенівський
bzis	віза
frut	інфраструктура
nyuk	світляк
dyik	детектор
plec	зрощування
brom	бром
plop	паладій
zlik	кремній
flut	вольт
ksop	косметичний
gjun	грумінг
kfok	гикавка
hpof	попкорн
hzuk	зоопарк
nyoc	конотація
jwak	йога
brim	барій
kles	обезголовити
mwam	да
fwik	салют
djas	джаз
dyim	аудіо
tsum	вольфрам
drip	капати
lyaf	аліменти
prom	програміст
nrup	вхід
hfes	поворотний
rwaf	хризантема
dlen	документація
byas	вакцина
fron	героїн
dluk	відключати
dyun	діагностувати
flap	папка
kfet	катод
dlim	ідеологія
prek	парковка
syoc	знімок
slus	доступність
nlos	Антиклімакс
mlen	селен
pres	кораголовногомозку
hlof	сірка
nlek	поточназначимістьмаркера
gwot	аеропорт
mwip	самозванець
klop	тарган
kwom	хром
hl6t	літр
nwec	проте
glip	циклічний
nrop	платіжнавідомість
crum	гормон
dlep	розробник
frot	пробийте
bwoc	саботаж
fwis	феміністка
djok	пов&#39;язаний
draf	модернізувати
trum	екстреміст
graf	алгоритм
lwes	лазер
mlem	міліметр
flen	згинати
zlot	анод
swok	пригорнутися
klec	собакавтомилася
pwim	неповнийробочийдень
htuf	тунець
fyis	очиснийзавод
lwet	чутливість
mrem	мейнфреймів
jwic	омолодження
droc	демонстратор
clem	гелій
dzik	двомовний
psem	плазма
hjom	хромосома
rwuc	порядковий
tyus	цілечисло
klom	кілометр
hfos	факс
nwek	генетика
jrap	викрутка
zwas	закуска
bwok	брокколі
dwap	адаптер
syem	спам
blek	вектор
tlus	тактика
pyif	невизначене
cwoc	добре
mrep	ампер
hbem	вітамін
hxan	швейцар
hxut	субсидувати
hk6m	кадмій
hxin	одночасність
txin	титан
kxin	кіло
klum	займатисясексом
xlis	пісочнийгодинник
hqak	синтаксичний
hxat	креативність
hxik	електроннакнига
hxas	робочемісце
bxon	бор
dxin	індуктивність
hxit	вертоліт
tlum	телур
txit	крайнійтермін
kxat	окисляти
hvik	вирівнювати
nluk	аналоговий
nyem	сантиметр
hm6t	молібден
hl6m	літій
ht6t	мультимедіа
xlit	калорія
ryop	робот
pxas	фармацевт
hxak	домашнєзавдання
lwif	місцевийвідмінок
grim	логарифм
hqat	богомол
qlit	екологія
xlik	підробляти
mlep	шаблон
hqit	радіоактивність
kxim	кілограм
hxen	наймодавець
hxot	переїдати
kyif	копіювальнийпристрій
fwet	безкоштовнепрограмнезабезпечення
txet	підмножина
hs6n	послідовний
hxet	підслуховувати
xrat	стрижка
hqan	замикати
hr6t	іридій
bxat	ширинасмуги
dxet	робочийстіл
hxis	експонентний
hxok	штаб-квартира
hxek	кластиненамісце
srem	церій
hp6t	розділовий
pxik	партітіва
kxet	касета
pruk	супермаркет
hvit	силаволі
xlin	відсутня
frip	шифрування
hvep	переплачувати
hxon	синхронізувати
kxit	максимізувати
hqin	семінар
tr6n	стерео
ht6n	застібка
hvat	майбутній
sl6s	Цельсієм
hn6n	неон
ts6t	реальнийчас
hvin	раціоналізувати
pxat	газетнийкіоск
myoc	модуль
ps6s	макароннівироби
bwek	портфель
dlok	розкішний
fraf	брандмауер
hr6k	артефакт
txat	обіднійчас
hqon	орегано
pxun	плутоній
ks6n	робочастанція
slef	ескалатор
xrit	рятувальник
hvut	переповнювати
xrim	ітрій
hx6t	збільшувальний
hqum	ім&#39;якористувача
hl6n	продавці
gron	аргон
pxan	рекламний
hvac	посудомийнамашина
xlan	глобалізація
txon	довжинахвилі
xrik	реціркуліровать
hxap	рюкзак
hxac	перезапуск
xyat	гепатит
cwep	зарплати
hxos	торус
txif	накреслення
qlat	агентзпродажунерухомості
txot	серединіосінь
hxam	міліграм
pxis	піксель
pwif	попереднійперегляд
txam	тантал
myek	термодинамічний
hbop	зламувати
hqot	розчиненаречовина
xlic	інваліднекрісло
gxit	геноцид
hvan	вогнеборство
glim	галій
pfop	вискочити
hzum	цирконій
xlon	гарячалінія
qlin	нелінійний
kxam	скандій
blim	берилій
kxik	конфігурувати
nr6n	нейрон
hpef	предикативний
hruf	маршрутизатор
kxan	факторіал
hxic	директива
xlip	волейбол
dyek	відлагоджувати
hxop	наручнийгодинник
qrot	нейтрон
nwip	ніобій
hs6t	вбиральня
grem	германій
tles	металоїд
hp6k	пролатів
qyin	біорізноманіття
txak	антибіотик
mlun	іммобілізація
txan	актиній
xran	астронавт
dres	розпаковувати
tr6t	інопланетянин
hk6t	октет
hxus	відкритеджерело
xlat	ненормальний
mraf	марафон
ts6n	серединавесни
ht6s	аутизм
nlif	іонізувати
txut	значущість
hm6n	випромінює
kxis	Картинки
xrin	зазнає
xren	перенаправлення
bxak	закладка
pfos	профразу
hvis	фекалії
hd6n	знаменник
brum	залзасіданьрадидиректорів
hqis	шовініст
hk6n	компілювати
xyit	змінаключа
xyin	однасекунда
hxun	харчуючись
hvas	ролі
glok	блог
hvak	звивистий
pxit	IP-адреса
hvet	поручз
xram	сафлорова
hc6n	очевидність
qran	Коран
zyen	ксенон
hqas	лаятися
bzas	пересичений
hj6n	нелюдина
hnof	nonremittal
txas	виробники
hbum	буддизм
ts6s	прискіпливий
pxin	інгредієнти
hr6n	раціон
hxim	всерединіліта
dxit	серединізими
hxaf	рити
nlus	кімнатнарослина
txap	Рядокстану
vrit	привидписьменника
kxak	дуріти
bxin	Тілолюдини
hqik	дощовик
hxes	герц
hxif	hypnothize
xras	погодинної
pl6k	параюрідіческой
dxat	необачність
hxip	антитіло
vrat	шорти
hqek	змінаформи
qrit	полярність
pxot	Пошта
hxom	небажанапошта
hqic	рецензент
lwun	синійдемікотон
hp6n	дозрівання
dxan	є
xrak	акторроль
dxak	аварія
hven	контейнери
mwap	комікс
qlan	дальтонік
xros	роздягаючись
srom	демонстраційнийзал
hc6t	вчаті
qrat	догориногами
hn6t	гальмування
hqet	веб-сайт
fres	мобілізовуватикошти
froc	кувальний
xlak	гіперпосилання
vlat	балакучість
dvan	вивантаження
gxin	завойовуючи
ryes	секретарвприймальні
kxot	з&#39;єднувачі
xyan	розмежування
vlan	рекламодавець
ryom	атомторію
hluf	похилийвік
hquk	впорскувати
lyum	Туліяатом
tyem	атомтербія
hp6m	празеодимом
txic	домашнясторінка
mros	автомобіліст
dyam	атомродію
pc6n	пробнийномер
nyos	входять
pyek	проектор
kxon	криптон
hxuc	рятує
qrik	орієнтованихнавипадок
xwin	недосвідченість
kxic	вогнегасник
hvot	блок-схема
dxot	йогурт
hqut	вийти
pxen	відомчий
drok	тригероммета
flon	мобільнийтелефон
txos	середнійзаставу
hqok	непрямийвідмінок
xwik	випадокпацієнта
hx6n	prehodiernal
txik	вказівнийпалець
hqen	відправник
mlap	шкідливихпрограм
hvun	умовляння
hvon	зношуватись
vran	листоноша
pfes	професор
pwip	поет
hqam	тренування
gxat	легальність
ks6t	причинний
vrin	вербувальник
kxip	кліпдошка
sr6n	несхвально
vlit	оцінний
tyup	передмістя
mrom	морфема
xron	навушники
gxak	дорогий
hrof	троянськийкінь
xlas	паралізований
dzet	косметичнийремонт
txac	капітуляція
xrot	невикористаний
txis	матричний
syif	одиниціСІ
xrac	дивно
brif	двоичноезначення
dlos	випадокмодальний
txun	атрибути
dvat	поганозагартоване
psom	зпершихрук
gjek	інакшеякщо
nlem	одиницямаси
qret	роздрібниймагазин
txip	потрійнаточка
dlek	вокремо
lwut	ток
dxis	драматично
hs6m	цезій
vlak	дрезина
hn6m	netium
kxap	картон
bxan	вилітають
myem	місяцьтравень
gxik	Громадянськіправа
hxoc	Авіація
xrok	колега
kr6t	Скріншот
txok	автоматично
hxep	скейтборд
srop	смартфон
pxak	блокуваннякришки
hk6k	фольклор
hl6k	eulersномер
pyom	атомполонія
xyam	атомталію
hvic	вторгся
lyok	відмінок
xlot	квартири
txen	перекладення
kxac	контратака
qrak	штрейкбрехер
hbup	басейн
txuk	короткезамикання
tsef	конічний
bxit	веб-хостингу
ksem	лишедлячитання
byim	атомрубідію
hvam	атомванадію
lw6n	лантан
frum	атомфтору
nyom	неодим
mlom	multalномер
kxas	уособлювати
xret	терабайт
hs6k	пошуковасистема
frus	роз&#39;їдає
gxan	галактикапідлогу
vlas	вокалізації
glet	педальгазу
hvim	часвиконання
bxip	бітовакарта
qrin	зіркапідлогу
bvak	Абесс
pxon	недоступний
dvik	Адесси
dvek	агентивноговипадок
hlef	тригеромагент
kwek	вразі
kxen	загальнийрід
ht6m	формацитування
tsuf	транспозици
hf6n	рафінування
tc6t	безпосереднійоб&#39;єкт
gvik	ергатівнаявипадок
gxon	фрагментація
ksep	рецептор
vyin	кінотеатр
pyos	пасивнийстан
hnef	дієсловом
xwit	Основнимзавданням
hqim	гномічноїнастрій
jlak	узагальнення
vrik	кінцевачастка
qyan	уявнаодиниця
kxaf	швидкістьсвітла
xyic	фішинг
qyit	критичнаточка
hvek	evitativeвипадок
bvik	subessiveвипадок
hzes	мавнагоду
prus	комп&#39;ютернийвірус
ples	процесор
pxif	офіцерполіції
dvak	нігіляціоннимівипадок
brun	туризм
tsi_k	antessiveвипадок
tyum	атомрутеній
vyak	обставинавипадок
pxim	прем&#39;єр-міністр
syum	атомстронцію
sy6n	підозрілість
hy6n	анімуватипідлогу
pxac	чуйнимирадість
vlin	машинапідлогу
qwin	мінеральнупідлогу
hr6s	напрямок
tf6n	тонер
xris	користувацькийінтерфейс
hw6n	лайка
xlen	віддієслівнийіменник
pyec	таблиця
vlim	віртуальнапам&#39;ять
bres	текстовийпроцесор
hqip	хмарніобчислення
vlic	віртуальнамашина
pfam	спамер
dyap	другамова
txek	коріньступеняп
dxen	видобутокданих
byip	Діловалюдина
hs6c	самовпевненість
txim	посилаючись
hb6t	змінаподії
hdem	Доменнеім&#39;я
dxon	іншаподія
lwaf	флеш-накопичувач
sl6t	crastinalнапруженої
xyik	дискета
fyif	рефлексивнийголос
bvin	всесвітпідлогу
hm6p	материнськаплата
tfip	перехіднийдієслово
jlen	місцезнаходженняпідлогу
xrap	смугастий
tc6n	дослідженнягендерних
sl6n	художнійпідлогу
xrek	тригерпацієнта
xwan	абстрактнийпідлогу
dxif	відеоконференція
dyip	непрямамова
zrek	екзоцентрічнийвипадок
hvuk	пробуджуючи
xwat	повздосконалого
hr6m	реній
txaf	спрацьовує
hmef	безособовийдієслово
tx6t	редактортексту
txes	іменникзбірне
bvat	жорстокеповодження
bvuk	відмінку
ry6t	радіан
vlis	віртуальнареальність
qren	планетарнапідлогу
gvak	відмінку
bxok	лисий
mrum	комп&#39;ютернапрограма
ps6t	операційнасистема
hfom	фонема
tlem	постійнийзапам&#39;ятовуючийпристрій
pwam	шпигунськихпрограм
kfif	ядроблагословляє
qwit	раціональність
nlaf	установка
nwok	асоціативнийвипадок
dzas	викликатиневдоволення
swuk	найвищомуступенівипадок
syos	підведення
kr6n	електричнийструм
dvin	неживийпідлогу
pxom	propositiveнастрій
vris	взаємнимиголос
rwos	аерозоль
dr6t	дистрактор
ht6k	телекомунікація
slaf	соціальнамережа
lyuk	наступнийрозділ
qras	начальство
ty6n	teminal
gwet	найближчимчасомвмайбутньомучасі
hp6s	аплікат
tsof	антіпассів
ht6p	continutiveаспект
hn6f	necessitativeнастрій
pfip	пасивнепричастя
glap	панельінструментів
sy6k	екзистенціальнапункт
qyat	силасвітла
hy6t	граматичнийоб&#39;єкт
vyan	проголошення
sluf	singulativeномер
dvit	надмірнатривалість
qyak	Дієсловоодинарноїдії
bzik	фізика
xlet	найвищийступінь
hqap	дієприкметниктеперішньогочасу
qwat	кількістьречовини
qyik	сполучночастинок
sr6t	сверхкритическойрідини
hfem	вставноюморфеми
tl6t	віддаленогомайбутньогочасу
mrif	мікрофон
pcuk	постфіксіввипадок
tfim	оперативнапам&#39;ять
fwim	ethium
ly6t	allocutiveугоду
hvap	смугапрокрутки
hfep	багаторазовийаспект
bvan	дистрибутивнийзайменник
fyun	числозплаваючоюточкою
xyas	стирання
hvif	дієсловоафікс
xyis	минулепасивнепричастя
tl6n	центральнийпроцесор
tfok	локатівСпрямованийвипадок
qwan	Питаннящочастозадаються
