hnit	kwekusebentisa
hnak	icalanominative
hkak	icalaumenziwawesenzo
htak	isihlokoicala
hpap	Ubaba
hmam	umama
hyat	kwabazali
hcan	Sawubona
hwik	icalayokubiza
hsuc	amadlozi
htat	umkhulu
hcac	ulambile
hnik	icalagenitive
hcit	Isiphawulo
hwan	futhi
hman	me
hnan	wena
hwam	nathi
htit	it
htac	destinationicala
htik	icalaumenziwaongaqondenengqonomlandi
hyit	kwemizwarealis
htim	kwemizwadeontic
hcut	kwemizwaokunemibandela
hsit	kwemizwaepistemic
hyak	icalainstrumental
htan	ingaphakathiumongo
hpan	umuntuumongo
htin	umshwanaezimele
hyan	umshwanaMondliwa
hfap	isiciperfective
hkat	sikhatsilesengcile
hnin	ubulilibesilisa
hmak	icalacomitative
hnat	Inkathiyamanje
hpak	icalabenefactive
swik	icalaessive
htut	Umphelelisinegatory
hsan	surfaceumongo
hpin	icalaadpositional
hwin	icalaindawo
hkan	isikhalaumongo
hnac	indlelaicala
hyut	kwemizwainterrogative
hnam	futhinoma
hkit	okukhethekilenoma
hsuk	umthomboicala
hpik	icalaablative
hcat	ukusondela
hmat	tekukhomba
hkuk	umshwanaumsila
hlan	kodwa
hsut	konke
hyin	Umphelelisiuniversal
hcin	ubulilinjengabesifazane
hpac	inomboloplural
hyik	one
htic	zabo
hkik	ngubani
tcat	lesitako
hsin	umongosocial
hkac	nini
hmip	isiciimperfective
klan	Lapho
hlak	icalaelative
hlik	icalaillative
htam	kwemizwaumyalelo
hlat	Umphelelisilezindikimba
hkam	ini
hwat	umbuzoizwi
htap	copula
hpat	umuntu
nyan	wesilisa
hkas	ayengakwenza
tcan	nezinye
hnuc	inombolo
twit	Umphelelisiqina
hsak	isikhathiumongo
htuk	icalatemporal
htun	kuphela
htum	kwemizwahortative
hyip	isicizokuhlola
hlit	kwemizwavolitive
pcic	kumele
tyut	ezimbili
hsat	bheka
hkut	ukwazi
hcic	phansi
hcap	ngemuva
hpam	kuqala
hlac	yifaalienable
hkap	never
hnic	yifainalienable
tyat	old
tcit	kwemizwaelifanele
tcin	usuku
hlam	woza
hwak	unkamisa
hkin	hamba
lwak	icalaperlative
hpip	isicilesichubekako
lyan	eside
hsac	uthi
kyan	Kanjani
htas	aphinde
hsic	lapha
hcik	cabanga
hcak	ngaphansiumongo
hfan	ezitholakele
hsun	isandla
hyac	futhi
nwan	young
tyit	ngokumelene
tlan	unkulunkulu
twak	icaladelative
hmin	lutho
hyas	once
hlap	isicisemelfactive
kcac	kwesokunxele
hyic	isaha
hcas	indlu
hwac	izwe
tyin	ezintathu
hnun	neo
hcuk	Ukugxila
pyan	ukuthanda
hsis	njalo
hyam	ebusuku
hyap	inkosi
hkic	phakathi
hmas	ingqondo
cyit	inhliziyo
pluc	inombolopaucal
kyik	ngoba
ksak	icalaesiyimbangela
tcun	kwenziwe
hnim	Igama
tsan	ibizoefanele
klac	izwe
hpun	kubuza
cyat	ebufakaziniebonakalayo
pcac	kangcono
hmac	mzuzu
hnas	bengayi
hwic	amanzi
twim	kwemizwadesiderative
kwan	ukukhanya
tlat	izwi
tyan	umnyango
hsas	ekuseni
syat	kuze
twik	icalaterminative
hpit	white
pcan	imali
hyis	abampofu
mwan	ukufa
hfam	ifomu
nwik	icalainessive
kcat	ndawonye
tsac	ngokuvamile
pyat	umngane
psan	isigamu
hpim	kwemizwakuphoqelekile
hyuc	round
hfat	wathumela
hcis	unkosikazi
kcan	bakholelwa
hsik	umphakathi
htus	umongostate
hpas	indodana
clat	izingane
tyak	Ngaleyondlela
cwan	Sethemba
syin	othandekayo
hkuc	high
tyac	funda
syit	idolobha
hlic	kakade
hfit	ebufakazinifactive
tcac	intombazane
hcun	zizwe
ksan	okungenani
hyaf	mhlawumbe
kyat	ngempela
tcic	umzimba
hwit	ukubuya
cwat	air
hfaf	umthetho
hput	Usizo
lyat	incwadi
ksas	ezine
hpic	kwemizwaoptative
hfuk	umlilo
hcam	ihora
twat	impi
kyak	eziningana
tlit	yesibili
pcin	ngemuva
hmut	lost
clan	ayizinkulungwane
hfac	umndeni
twan	umphefumulo
hwas	umbuzo
syan	iqiniso
htis	making
tsat	amabizoahlukeneanomqondoohambisanayo
lwik	icalaallative
nyin	ubuliliAnthropic
hfak	ezinhlanu
tcak	efanayondabamarker
htuc	kuncikeezahlukene
hnap	impendulo
hmit	sea
hcuc	ukwesaba
pcat	ukuqonda
syas	ngokwemibandela
hcaf	Ngokungangabazeki
twut	kwemizwadubitative
hkis	black
tlak	ukuletha
hyus	enhle
nyit	inhlobo
htip	eziyishumi
ksis	indaba
hpuk	ibhuku
hlin	electronic
hkun	i-akhawunti
lyas	intshisekelo
lyit	bhala
pwat	Embhedeni
hnis	age
hnut	counterfactualokunemibandela
slas	art
hwis	vialisicala
pyak	umzalwane
lyin	umugqa
tyas	ithebula
hyun	emfuleni
kyac	iso
tfan	kungazelelwe
kcin	deep
hmuc	inhloso
cyac	igazi
hmap	rose
tlin	amakhaza
hyif	phambili
tyam	sekwephuzile
hnaf	akesithi
hkip	ecisheibe
myan	imayini
tsin	ulwazi
hkup	ikhophi
hsam	umyeni
hlis	eziyisithupha
cwit	ephilayo
cyan	ukuthula
myat	khumbula
tyic	zemvelo
hfut	fall
swas	service
hsap	ngaphandle
pcit	copyright
hyim	ibutho
kyas	ihhashi
plic	Ngokuzayo
pcak	west
hpis	ukhokhe
hyuk	red
hwun	igolide
twin	isifiso
plan	ukudlala
hpus	ihhovisi
syun	uhulumeni
kyic	esontweni
htaf	amandla
hlun	ubude
kyin	inkampani
kyis	iphepha
mlan	ematfuba
hcim	ikakhulukazi
cyas	athwale
twac	ifasitela
nyat	ubuhle
hcus	sakamuva
htup	duty
htif	ibanga
pyas	foot
hlas	wild
ksin	green
hmaf	enkingeni
myac	smile
hsim	ubuthongo
kyit	undefined
kwik	icalaquotative
fwan	Ukuvakashela
slan	landela
psit	ubukhona
hmic	sweet
hmuf	umlomo
hfin	ocebile
tcam	isitha
psuk	ephukile
kcap	umkhumbi
pwan	umuntuobandakanyawonkeumuntu
hfic	ithonya
tcuc	avele
hkim	secret
pyin	Ngiyacela
pwit	kwemizwaprecative
pyit	irejistaesinenhlonipho
cwak	okubi
myak	mashi
tcas	izindawo
hlaf	uhlale
psat	esikhundleni
nlan	blue
psac	engenakwenzeka
kcuk	esikoleni
kcit	washada
kcak	ukudla
syis	mabini
tlac	ethule
hcip	isiciabazoba
kwin	enikeza
tsit	kumisiwe
pyac	ulimi
hsus	ngesonto
hcup	ehholo
cyap	bayazibuza
tfin	Born
fyat	inkantolo
hnip	isicignomic
tsak	inhlonipho
tlas	kuwufanele
syuc	isihlahla
plat	wall
cyak	izulu
twip	isiciinchoative
mlat	umyalo
swit	kwemizwajussive
mwas	inyanga
hwaf	ephelele
tyap	Okuhlangenwenakho
ksac	izimo
syac	fresh
hnuk	Duke
kwak	embozwe
tyuk	empumalanga
pwac	itshe
hkif	noble
nyac	isiqondiso
cyis	isitulo
tyuc	ukulinda
tsun	dolobhana
tyik	ziyavuma
hnum	kwemizwazokuyekelela
slak	impumelelo
tsic	ezama
slat	hill
hmik	umculo
hkus	ukukhala
hsip	Isikhombisa
hpaf	yangasese
nwas	izindaba
tfac	scene
fyan	ingadi
cwas	uqale
hfik	icalawokusakaza
lyac	funda
syik	ezombusazwe
clin	henry
cyin	amanga
tsas	waphonsa
cyik	igunya
tlap	floor
cyam	ihlobo
tcut	inkolo
tcap	Ukuphunyuka
hlut	umbhali
pyun	brown
tcuk	ubuhlungu
swan	spring
hmun	soft
kyun	ekhoneni
nyak	lokuhweba
tsis	ubulungiswa
psas	khiqiza
cyaf	laugh
hwut	ukhohlwe
hyup	europe
hwap	eziyisishiyagalombili
psak	Ukudlula
kyap	esabekayo
pyic	edingekayo
hmim	medium
hsaf	breath
hmis	ohlakaniphile
hsum	sebuniyomarker
ksat	emnandi
ksit	ithuna
tsap	island
kyam	ikamu
tcum	uthinte
cyun	fortune
psic	shore
tyun	domain
mwit	kwemizwacommissive
tlut	degree
myit	ebusika
kfan	ukuziphatha
slac	nokugijima
myin	iminithi
tyip	kuholele
klas	ingilazi
pfat	ibhodi
cyic	ngeze
swam	izindaba
syam	ephephile
tsut	udokotela
hlip	isicicompletive
kcas	ubumnyama
nyun	afudumele
hpuc	isiphuzo
tlam	isibonelo
hfun	intukuthelo
tsik	Naphezu
tsam	ngqo
hmup	hat
klak	inja
slin	silver
swac	inceku
kcam	ukuqhosha
pyik	isitimela
myut	zokuziphatha
syak	faka
swat	inkemba
kyuk	ukuhlasela
clac	impilo
tyaf	isigaba
swic	social
tfit	refund
hkaf	olusemthethweni
pcas	Amabalengwe
nyam	inkazimulo
tfat	eziyishuminambili
pcut	wahlanganyela
pwin	iwayini
mwat	ukunambitheka
fyac	iron
syap	ukusabalalisa
myap	ezohwebo
hyum	usebenzisa
fwak	ijaji
klat	captain
twap	isicicessative
kcic	curious
kwic	angaphandle
hnif	intensifier
myun	ukubaluleka
tlic	ekugcineni
cyuk	intamo
syut	inkululeko
pfan	izinhlangothi
kyuc	owomile
pcap	eceleni
tfak	ebufakazini
tcik	icalaebufakazini
twun	ezikude
tyis	inqubekela
nyap	emincane
plit	isakhiwo
hpif	ikhasi
pwic	ubambe
syic	sad
tsip	isono
syim	abagulayo
tcis	qotho
pcun	ibhange
ksap	ukwamukela
lyam	stream
tcaf	ngokucophelela
kwac	indlebe
hpup	isinkwa
kcut	khetha
nwam	animal
hsup	zoicubulili
nwit	eventivekwemizwa
tcim	esifanayoisehlakalomarker
tlik	icalaokuguquliwe
kyus	ukuwela
hmus	obukhulu
kfat	alinge
nwat	ikhule
myic	imvula
hpum	surface
swut	ongcwele
clis	July
mwun	fashion
hfas	ifayela
cwac	ehlombe
kwat	induduzo
nwac	ubani
tcip	wayefisa
kfac	utshani
hmuk	ukudweba
plin	ukuvulwa
kwun	June
mlik	inhlanzi
klin	capital
pfut	webele
twam	Fakaisicelo
fyin	ngezindleko
nlit	eyakho
mlin	million
pyut	Khulekani
hluk	ukhathele
ksut	ukubulala
cyut	shadow
psin	isisindo
kcis	grey
pyam	abanesibindi
mwac	wanelisekile
klam	kokutshela
ksam	kazwelonke
hfip	ebuthakathaka
klik	isigodi
hkum	kwemizwazokucabangela
clas	yellow
cyuc	ukushisa
mlac	izinsalela
syip	ngokulinganayo
pwak	ibhokisi
tcif	engagwegwesi
psip	isimiso
ksik	umphumela
tsim	isizini
flan	isayensi
pcam	ngokusobala
kcun	kwathela
ksuk	uncle
mlit	uhlu
pcik	esiyingozi
kwas	Agasti
hluc	ethandwa
klit	engaziwa
flak	ajwayelekile
fyit	irejistaajwayelekile
lwat	umfundi
plun	ehamba
twas	kabili
pcis	umpristi
fyas	alimele
nlat	palace
myuk	fool
pfak	siza
tcuf	eyisishiyagalolunye
cwap	ukuzwelwa
plac	kuqhuma
pyap	ngokubeka
lyic	begqoke
hcum	nomsindo
lwit	izincwadi
tsuk	rank
hfup	isivunguvungu
kcik	pocket
nwap	november
tyim	december
psaf	ukungabikho
nlac	labantu
kyaf	ngiyabonga
slis	uchungechunge
pyaf	bird
mlak	umnikazi
kwut	coat
hwuc	ubudlelwane
pyis	ngokushesha
twuc	intuthu
nwak	January
mlic	umshini
tlis	amazinyo
ksun	esivuthayo
clam	ihlazo
klaf	izinga
clit	ring
fyak	ibinzana
fyam	ibinzanamarker
kwap	isikwele
hwip	sunday
psis	izinkondlo
pwut	undefined
kyim	buy
clic	amasimu
pyip	april
kfap	October
psut	lezinto
kcuc	okumunyu
nlap	nceku
hsok	okuxekethile
htet	umbhalo
hbat	Okubikakhulu
hrit	credit
hzit	izici
hpet	ishuminesihlanu
krac	unonya
hduc	uthuli
hrik	esiwusizo
hron	umbala
hnus	ekhaleni
hric	friendly
srik	supply
hten	izolo
tlet	hesternalesishubile
slap	fail
hban	bagqoke
hdat	blind
fran	fly
hdan	devil
htec	kancanekancane
hmon	mission
cran	umhlatshelo
hran	unembeza
hmos	ungqongqoshe
nrit	amandla
hcet	zonda
hset	isikhungo
hrin	ubuliliokunengqondo
hcot	ukujabulela
hrip	kafushane
htep	ukukhulekela
hcif	isikhumba
hrat	uphahla
kran	umqhele
hkon	castle
tran	uphelelwayithemba
hmif	Kwakuwuhambolwamakhilomitha
trin	umbuthano
hgin	ejele
hkop	cup
hcen	ilungu
swin	civil
hrac	yonkeindawo
hris	inkambiso
hbin	ekubeni
hmot	inyama
hdut	ubisi
hwen	ubulilivegetal
nran	ezingavamile
hbac	umzala
crut	bridge
hsoc	isitokwe
hsom	usawoti
nris	abangenacala
hbit	gwema
crin	ngokumthanda
rwin	indlovukazi
hgut	ukubala
hdas	dance
hnot	hotel
hdin	ugcwalise
hton	isiboshwa
hdak	shop
hlet	izitebhisi
hson	baxolelwe
hgek	gay
hras	isihlabathi
hsep	september
hbic	incithakalo
hlen	ilayisensi
hcon	ngokwanele
hgit	ufakazi
kfon	ikhishi
hbak	ukuthengisa
tlim	ukwelashwa
hsot	isivinini
kyut	ikhompyutha
hnen	kwaphakade
htek	umtapo
hzan	equkethe
hbis	base
hbun	ukudideka
kcus	cook
hgat	desert
hwus	kiss
hbif	ice
hbot	ball
hrut	i-agumenti
hdit	kwemizwabenedictive
hdis	unecala
hjan	ukujeziswa
plis	amaphoyisa
hgan	fihla
hsen	ngokushesha
nrin	ngenalwazi
hyen	ifu
frif	February
hdik	isifo
hnek	isinyatheloicala
hbam	U-anti
hmen	ithobekile
hdip	ilibelekuphoqelekile
prat	ebufakazinilibike
hdet	phakathikwamabili
hjit	umunwe
hmoc	endaweniethile
pran	cindezela
kcec	esifundeni
hken	muvanje
hloc	melancholy
hrak	abasebenzi
htes	ukubukisisa
rwan	umvuzo
hdon	nginikele
htot	ebunzini
hnet	angel
hdun	elisebunyeni
croc	iphutha
hlon	dawn
hyec	izimvu
hjin	ukubekezela
hrec	Ticukatsilwati
mran	ukolweni
htos	iningi
hcos	izinyathelo
hkoc	ngezikhathiezithile
hlif	inzuzo
clak	ushukela
hjat	esintwini
tram	Uhlaka
hdic	disk
hkok	lonely
srat	umculi
crak	charm
hmet	imeyili
hden	isinqumo
gran	umbusi
crac	igatsha
hjac	nomdlandla
hdim	kwemizwaexhasa
hcok	shesha
hyet	amafutha
pwap	pipe
trat	ukuphrinta
tcot	udabaesiqinile
hdoc	oh
hren	umongoinkulumo
tcon	ngasemini
krin	gumbi
plam	alamu
hnes	kwemizwa
tcen	observation
hsek	isici
plik	kusebenza
slik	lwesicabucabu
hfen	cent
hgen	agent
hnon	inyunyana
crik	isihogo
tcet	aphundlekile
mrat	exubile
hdam	kwemizwaadmonitive
hgac	Isifisosokuvelelasalezize-
htoc	Ngandlela-thile
hdac	iseluleko
nwin	umthethosisekelo
srit	instrument
hret	ngokuqinile
nlin	online
hzat	tide
klic	college
hkek	umsila
nric	isizukulwane
hgic	ophithizelayo
hgak	cat
trit	ebufakaziningqo
tyot	vumelwane
hnok	okuqukethwe
crit	ishiywe
slen	alitshumilanye
srin	isazela
hpok	esizweni
hyot	kwemizwanexhala
cric	yokukhosela
hruc	bangahloniphi
cwin	ogibele
hzak	shake
dyit	umkhakha
hpec	ubungcweti
nras	umhlengikazi
hcec	okufundisa
hbut	izicathulo
hmec	ezingacacile
twot	umsebenzi
crat	saturday
hkot	umthamo
hnec	kwelanga
hwuf	umfelokazi
cren	elachithwa
nrat	inkanyezi
hget	guest
hbik	bless
brin	kwangaphakathi
hpot	kuyatholakala
trac	ukumelana
prac	athola
hcoc	eziyize
hpon	isifundazwe
hwim	impucuko
dwan	hang
cwok	shock
hdok	ukushayela
crun	umcebo
hzik	imbewu
hrot	yamuvasikhatsilesengcile
hket	uphapheme
hcek	ifenisha
hrop	indophi
mrac	adventure
byit	idili
trak	yonyaka
hzin	southern
sric	mkhosi
clik	ukuzingela
trap	liberali
hrim	ubuKristu
hrus	princess
blat	altare
cyon	tiny
hwep	web
krat	cardinal
tris	purple
kcot	ukubutha
hben	ukhetho
trik	udakwe
kfit	lift
tcec	exchange
nrik	eliwumunci
grat	emperor
dran	nokuphathwa
hpen	ngaphambilini
cluk	ugly
nrac	okungenangozi
ryin	ukuqeqeshwa
hrun	roll
nwic	ye-intshi
slit	adubule
gzat	iphephandaba
krot	cutting
drit	intshebe
hzis	likhiphe
hdap	ishuminesishiyagalombili
sris	zomlando
mrut	okwedlulele
nyik	udaka
bran	umakoti
drat	esithembele
djan	giant
glat	ngobulula
hpoc	autumn
pras	umgubuzelo
hgot	ukubuthana
tret	yaseshashalazini
tras	comparison
rwit	imbangi
hfon	obumba
klot	umqeqeshi
hmum	amahlaya
drac	inkulumo
rwas	inoveli
tset	revenge
hdot	distalsekukhomba
ryut	nomhawu
hwon	isimemo
byat	wasishisa
flac	flash
prot	portrait
crek	asikisela
htok	ukungqubuzana
htop	isiqalekiso
prit	kwemizwaimprecative
hces	olungenakuzisiza
klup	club
hnos	isikhukhula
dwin	nandaba
prin	umkhathizwe
mrit	kwemizwaassumptive
tcoc	emaweni
hcom	ngokuvumelana
grit	ukuduma
tlot	ebuntwaneni
hgik	knee
hwes	equlekile
hzac	mutual
hsec	isofthiwe
tson	izikhungo
ryit	irisidi
dlin	isiyalo
slip	ukushelela
klon	revolution
hfim	umlimi
hpom	platform
cyen	umfundi
hgec	emhumeni
hroc	isiko
srac	uhambise
ryat	tragedy
kcen	virgin
hbap	yokuvalelisa
krik	ukugxekwa
krap	cotton
fwat	esibhedlela
kcet	yerenti
hgas	gas
pfin	ngenakugwemeka
dlit	leaf
ryan	translation
sran	emngcwabeni
mrin	ufulawa
hram	romantic
dlan	dollar
hzas	jest
hsos	ayishuminesithupha
klen	koloni
gyin	iphiko
hsif	lion
cluc	ngobuqili
prip	ukulungiselela
hzut	inkungu
dwat	imithi
krit	umbhalo
sras	isidleke
hses	eziyishuminane
brat	ukuphikisananalokhu
flat	acid
hjic	okungukuthi
slic	isikhali
hbuc	umsebenzisi
tron	iwolintshi
byan	okugeza
hrif	bakudala
tlip	ukusungula
blan	basket
kris	uNobhala
hyon	Okwamanje
tren	namuhla
dlat	hodiernalesishubile
hzic	isihlungu
tfic	sokuzingela
tlen	talent
hlim	Isimosezulu
dyat	mate
kcon	isambulo
dlac	ukugeza
krak	Ukuvumaizonongokukhululekanangokusuka
hbas	umbhedo
hkec	amalahle
hrek	buyisela
hkos	isikebhe
hwif	vice
tric	yesikhashana
hdep	isicidelimitative
mwak	inqwaba
ksot	bone
hnoc	monday
nlas	ngoLwesibili
brac	ibhukhumakiencane
frap	federal
pfit	omele
pcoc	isigxobo
lyen	yelineni
swak	nosinki
pcen	umongameli
brit	bloody
hwec	lokuvimbezela
hwet	isisu
hlos	upstairs
hbon	zihlukahlukene
pcon	zethusi
hsem	summit
lwac	ezishibhile
tsos	Emncintiswaneni
kwen	umuntuokukhethekile
trun	kokwehla
trut	esifanekisweni
hrap	wezikhali
hgap	ziyobopha
trot	lokushisa
grin	ezingomakhelwane
hjak	emukeleinkholo
hpek	pack
hlus	deer
hwos	lokulala
tsuc	amahlathi
pcuc	discharge
cris	yindlalifa
clun	esihlahlenise-okhi
hpes	ezingemnandi
nlet	akuphelele
hrom	uhlelo
pyon	upiyano
swet	ukukholisa
dric	angabonakali
tyen	eyaziwayo
hruk	isihlukuesitheukuphucuzeka
frat	ayabelwe
hyoc	isilingo
hlep	isicitelic
nrot	international
nret	ngobudlova
hfif	Isazisefilosofi
pfic	ukumelwa
hmek	sensitive
hfec	inhlalakahle
myik	ukudoba
truc	ukweba
tcop	lip
rwic	umhlalaphansi
htom	umnotho
glan	gallery
pren	parallel
hlek	isiciatelic
nrak	izwekazi
truk	knock
hjim	kwemizwaezimba
rwat	tie
hcep	iseli
dyan	iqanda
jrat	yokufakelwa
nren	ugqozi
ksic	esibucayi
tsoc	ucwaninga
lwan	kwasemini
hpos	pine
hcuf	Phusha
tcus	Sue
pset	ungezelele
hkep	ithusi
swis	itilosi
prim	imperial
trip	isitswebhu
cras	shirt
swap	shanela
syet	indabaemfushane
htof	isela
clen	isiteshi
kwit	ubuntu
klok	ngokweqile
hrok	•Izinguqukokwezomhlaba
hguc	ukoma
kcim	babasongeli
hpem	palm
psik	isikhulumi
frit	umbundu
cret	iminonjana
mrak	umkhonto
syen	session
tcup	emanzi
hyek	traveler
trim	tin
plak	isikhalazo
hyok	angle
hgam	cow
hmok	mill
jrac	imephu
kloc	collar
gyit	ngamabomu
hbip	ubhiya
mlet	velvet
lyap	ukuhlukunyezwa
cwen	umhlambi
bwan	umshana
tses	thirteen
jrit	abuyeasekele
nlak	mbhalowesandla
sron	warrior
cruc	Lwesihlanu
broc	ibhulashi
dlot	thwebula
krim	ukhilimu
pric	pitch
prut	amajaji
hgon	frozen
sram	ngokoqobo
pfot	ebhodweni
hlot	kuhlelwe
djin	coin
hlok	eqa
hpep	i-apula
hwot	elisontiwe
dlak	xoxa
brik	ubhalise
nlis	kutsatsela
hbet	ukubheja
pris	igciwane
hjik	izihambi
blit	uyingane
hjap	isembatho
tfik	sibonakalise
hdaf	attain
hpop	opera
kcaf	kufihlwa
kcoc	ingcoza
hrum	ukukhanda
cyim	osolisayo
dyic	ezemfundo
hgoc	umgodi
drak	disorder
plas	applause
byin	kanambambili
hzap	Abbey
nlot	ukwethembeka
mrik	mechanical
hsop	ngempumelelo
crap	isicupho
kyek	ikhekhe
nrut	jabulisa
syes	sir
hjet	seventeen
hjen	feminine
hmom	honey
hdec	ngeshwa
lwen	legend
slot	isitofu
frac	sihlubuki
gwan	sikhukhumale
mruk	ngcono
swot	ixhaphozi
zlan	uthole
hnem	animated
hdes	sigqoka
prak	nishumayele
frin	scenery
hfet	abaphikisa
cros	ngoma
ryon	okunengqondo
tcos	isitshalo
tsen	processing
hwek	wolf
nlik	zokwenqaba
klap	carpet
dras	uyidelele
prop	evundile
slim	ikhwela
hgis	ushizi
krut	ukuluma
srot	hlenga
bjan	azulazule
nwen	lasemanzini
myas	imaski
kwaf	ukuthuthukisa
twis	cab
pcip	ipensela
srap	yemifino
sren	umbukiso
tlun	ibhulukwe
hrup	inkohlakalo
nrip	iKhabhinethi
srup	isobho
jran	udokotelaohlinzayo
bjat	imvume
gyat	hlola
hlem	budedengu
srak	abstract
kson	accent
cwis	OkukapakaKweqeIsihenqo
sret	ngobuqotho
hraf	traffic
hres	bokwakha
hsuf	kulahlwa
rwak	crack
twon	umhlobiso
hfus	alulame
hkom	ikhodi
djat	umzingeli
nlut	newsletter
hsef	snake
mris	intandoyeningi
bric	ibhethri
mlam	wax
zran	ukwabelana
cron	wamangaza
hzen	ukubhukuda
traf	strip
cwaf	imvilophi
srip	ugwayi
mrot	motor
swon	sokuzithandela
ryak	yokusabela
pfun	ingxenyeyomzimba
blac	Umthwalo
mret	inkonzo
hjon	ngokocansi
kcok	ngembazo
dram	diamond
kren	alternate
tcek	echo
hdif	identity
tfas	oyinxusa
hfot	Usihlele
lwas	lazy
hmep	isicimomentane
kfin	ukuyiqondanokuyikhumbula
mwin	imaginary
hrem	ray
pram	ekhuphuka
byac	sela
mren	zakhumbulekakalula
swen	iSigelesimisa
kras	lomngcwabo
hgun	ukugwinya
nlok	bazitike
ryic	wezolimo
gwin	swing
srut	umshiya
hkes	eziyinkimbinkimbi
hfis	Isizathusokwesula
frak	ngokuphindaphindiwe
hnom	ukwakhaitulo
hcop	pub
hlec	upelepele
mlot	melody
zrat	ikhandidethi
proc	abavikela
flik	fox
cyet	undefined
hgim	ngefasitele
slet	uthango
tcok	ukunemba
bjit	zangaphambilioshonile
brot	ihlumela
bwat	kwenguboyokulala
hdus	pig
gwat	izinyolendlovu
kret	akhiphe
nwet	owayebukele
jwan	avenue
nwis	izinzipho
mwic	bee
bzat	umlingisi
gyan	izithukuthuku
zyit	executive
blic	illusion
pcet	ukungaqiniseki
tsot	phinda
bwit	umngcele
tres	ukucindezeleka
hkof	ukusetshenziswa
nyen	ukububula
hles	angafana
cyek	esakeni
hjis	inaliti
gjan	mkhuba
prec	baziphathe
drot	elawulwa
kcek	ijika
twic	inyamayenkukhu
brak	emgqonyeni
zwat	obuvamile
clap	isiciobuvamile
tsec	isazi
bwin	zisacindezela
cwet	iphahlwe
hbek	baker
zlin	omnqumo
mron	van
drin	uyoyinikela
psap	adalule
gjin	usukulokuzalwa
clut	isando
cwun	elimnandi
twaf	eziwubala
pcot	ukuphulula
krok	skull
dlik	isishayamthetho
cwic	ngenhlanhla
srun	ukuhwaqabala
crec	ekubhubhiseni
jlan	wekhasi
kcip	iqhawe
blin	billion
ryik	chemical
mlas	ishayela
flit	pilot
hzet	ifindo
cwik	ngokubabazekayo
twet	isiketi
mwik	masontoonke
tfis	lobuchwepheshe
tlon	imoto
cram	undefined
grac	ukuqinisa
kraf	crow
trup	sibaluli
hduk	hook
cruk	tiger
nrap	sasendlini
crot	onguthelawayeka
mlip	abezempi
hfoc	isithombe
nres	ubuqotho
plos	plus
tfam	esobala
nlic	nesishiyagalolunye
hwok	afanelekayo
nlen	indzabambhalo
fyic	ukuqeqesheka
hwuk	esiyingqayizivele
hgok	organic
flic	theology
flot	iflothi
hboc	sizokwenza
hwoc	uyathakatha
syot	studio
cwip	I-Champagne
hbes	banner
lwic	isehlukaniso
blot	umshudo
cwot	ekuthunjweni
cwam	vein
prik	yekwentiwa
hfum	foam
grik	ngohlalwane
zrin	iphinifa
gren	planet
hfuc	uvuko
claf	eshalofini
flas	fan
hjot	tropical
hbim	ngaphandlekokubonisananomkayo
krek	mercury
hbec	undefined
tsaf	ukuzibulala
pwas	yikhaizithelo
plot	IsikhombiSokuhlelaUkusebenza
kfak	ezinikela
blak	kuvulandi
hdos	ibala
kwis	Classic
kcos	ukugxekana
psen	impesheni
kres	Isenzoesihlobene
hzon	monkey
srim	isiginesha
glin	ukwenqena
mlut	notorious
myot	ukungenisa
fwac	umsunguli
troc	ithoshi
hgaf	lolimi
hyop	yacht
ksip	ezingasekho
sres	uhambo
hnup	Dome
hzun	esizweniesinenkani
mric	kwemisipha
gjat	magnitude
hros	deda
zrac	ngobugwala
tros	ubhontshisi
myus	igundane
dwac	inkhulumomphendvulwano
byak	imbuzi
htef	umthungi
hfek	ichume
dzan	ukuphoqelela
nyon	engaziwa
zrit	irejista
pcos	ezemidlalo
hjec	ncibilika
dlas	susa
mras	isambulela
mram	amaminerali
cwut	kuthula
hbok	idada
swun	insipho
dwak	doll
plif	villa
slon	lokuthunga
tfut	ukuhalalisela
djac	buyisana
hjas	yokulicindezela
kric	unogwaja
kwot	umqhubi
gzan	isiqinisekiso
clot	isidlali
ksek	insect
psam	ukuma
mwut	owl
htem	unomphela
clon	violin
dzin	umhlali
rwim	ngokulandelana
hyof	ezuzisayo
dron	dragon
dwit	ebufakazinisokuzwa
sroc	timbiwa
hzot	ekunqanyulwenikwe
djik	bayasala
kfik	lid
ryun	umthethonqubo
hmes	imeya
rwac	hardware
sruk	circus
sros	amancaneezinhlanga
bzan	isiphithiphithi
kset	orchestra
bjon	i-Bacon
hjut	unlimited
tfen	sivikele
zwac	kusimo
dyin	nokucabangisisa
myis	musician
mlis	ngokwengqondo
pret	singenele
tsek	UhleloLokufakaLwe-
hlom	ilamuna
ksos	ukhwehlela
crok	bekhanda
flin	okuzala
mrun	umbazi
swec	okungahleliwe
syuk	spoon
blun	ibhaluni
tcep	umcako
fric	ukuqabuleka
rwik	mpo
rwen	ekuvimbeleni
flet	ebufakazinikucabangalokungahlekwenteke
pfac	umshicileli
srek	uviniga
tfun	Umhubhe
pwet	puzzle
gyik	mathematics
fwot	fade
lwin	olinganiselayo
jwin	kwesibindi
bwik	icalasublative
hdup	cwilisa
hnop	monopoly
bwic	submarine
ryen	kungakhathaliseki
hcem	ukuzamazamakomhlaba
hbos	laboratory
nrek	isisebenzi
ryim	isigqi
nyic	humusha
dwas	embassy
rwok	okuchukuluza
kram	ukungakwazi
ksim	kwemizwadeclarative
clok	chocolate
pcec	nelungelolokuzibonela
nyis	unkom&#39;idlayodwa
tyoc	Kwaziqondanelanjeukuba
grak	bhala
zlat	igilavu
hjuk	siguqe
trif	geography
djit	ehlelekile
pson	undefined
mwis	ukutshalwakwezimali
cwec	lwamazwi
hdek	wokuziphilisa
blik	hawk
sloc	Psychology
brap	scrap
jlat	pirate
dros	ulapha
slam	uhlobolwenhlanzi
pwun	Pudding
gwik	magnetic
pcop	pump
myen	ngokufanayo
ksen	oxygen
mrap	induna
tfot	isitifiketi
ksus	cluster
trok	mpendulo
tloc	rừng
zyan	oar
nlun	Ngenangemvume
hlop	isibonakude
jlin	isipelingi
lyut	ezinamafu
hsof	Surf
fyik	whiskey
klet	kuqhathaniswa
hwof	willow
hlum	ikamela
myet	amateur
klis	atihambitodvwa
hbaf	biography
gwac	imbongolo
hwum	amahemuhemu
pwik	ngombono
pron	pro
myes	nyangazonke
mwen	undefined
kfic	eholidini
klek	ukuchofoza
cwon	eyisiyingi
lyak	nokunwebeka
kwon	isichazamazwi
hjam	itshweba
rwon	rainbow
crip	ngalokhu
zwan	sokwenzeka
srok	womhleli
craf	ukhoporali
tlok	tank
brip	butterfly
tfap	ishadi
jwat	twin
pros	yokusebenza
psun	bika
clet	undefined
hbus	bamboo
dyas	nomthengisi
klun	yokuzuza
jlit	sithathwengokuhlanganyelwa
hdom	nightmare
kron	carbon
hzam	jam
cyot	umlaleli
hmem	Museum
lwam	alphabet
fras	chitha
psoc	Punch
hgum	gum
brek	ukubopha
glit	ukuzinza
frun	bola
gris	nolaka
mroc	friction
bzit	spider
plut	izambane
glac	ukuhaha
gzac	nande
prun	spin
jlet	ikhalenda
nyim	lokuphakamisa
tlos	trillion
slut	isaladi
fwit	kwemizwangoyebo
pyen	izicelo
nlon	okuzisholo
dren	khombisa
drun	ukungeneliseki
cyok	Ingaseiphendulengokungabinasithakazelo
hfop	football
ryac	ubambiswano
gzin	iphayona
hgip	iklabishi
tyet	wezemidlalo
hdof	ideophone
hwup	olungenakuqhathaniswa
lwek	isigwedlo
syec	Senator
jyak	angazamukela
mlim	ant
fwic	ngempumelelo
gzit	abakhulelwe
blas	ukuncikakokuthile
jrin	nsukuzonke
gwak	iqakala
drik	Okumangazayo
prif	variable
jwit	ukwehluka
krip	ukucwaswa
ryot	undefined
nwut	khonaemgwaqweni
kcif	ngenkuthalo
jrak	frog
twek	icalaexessive
psot	isihlawulelo
pfon	sponge
sluk	squirrel
nlim	kwemizwairrealis
ksaf	ukusweleka
glak	Volcano
plen	zilingana
kfaf	isikhafu
kyon	ukuxhaphaza
jlik	geological
psop	passport
kfis	lesosikhala
fyon	ziyezwana
nram	abaziphethekabi
hbuk	bhisikidi
gras	ngehlelwayisiyezi,
hyos	nexhala
flim	ifilimu
plet	tablet
rwam	atom
blis	vanilla
zlit	aids
fyut	fastidious
crim	pyramid
hjif	ngalokungekhoemtsetfweni
crif	amahloni
lwap	lute
tyon	isayensiyezinkanyezi
mrim	Maze
drut	okuchazayo
nrim	scholarship
kruc	ufudu
kwam	umeluleki
jrik	cricket
dlut	lumelela
pyot	ijuba
dyon	lithathelwe
prap	opharetha
bzin	ibheji
tyek	triangle
trec	umphathisikhwama
nron	hydrogen
pyet	iphrinta
tsok	binda
zyin	chronic
slek	ibhayisikili
jyin	engineering
ryas	yokudlulisela
zrak	Ukuvuselela
nyas	dancer
gric	ukufuduka
zlak	dluzula
tces	tennis
hjun	ezinomoya
twen	aluka
kyet	ngalendoda
gwit	emgogodleni
kyot	kuzithinta
fwin	imvamisa
tfuc	kuwusongo
dlet	isiqondisi
pfik	sazi
bjet	isabelomali
trek	isu
kros	asebenzangebhethri
gjit	sikelo
gwic	switch
frik	theory
tluc	ithawula
pruc	patrol
glic	yeqhwa
krun	ukuphelela
bjin	sibikezelo
tlaf	iqhaza
tfet	nomakhi
bras	lateral
dwik	ummangalelwa
clec	qeda
cres	chess
tcef	okusamathunduluka
tcom	siyakhubeka
nyot	umhumushi
tyok	iloli
cyip	odlulele
grot	lwesinaphi
bris	wireless
nlam	endalini
slif	ngesisefo
hgos	ukugqwala
swoc	umtapowezihlanganisi
jyat	ayinamali
slum	islam
hjes	Ukubalwakwezilwaneokwenziwa
dzat	tiptoe
slun	limise
nwot	inqubekelaphambili
gyic	ukulele
pfas	nomaukuchemakuzo
zyik	zinc
blen	shiny
hyem	Elm
hnep	kuncibilika
nyut	wathungela
ryam	isabizwanamarker
clim	spice
jret	nokucija
tfon	bakugcone
jwac	java
hrep	iresiphi
dyac	franchise
myip	imitha
rwis	kwemingceleyobuhlanga
hkem	inkanyezienomsila
nwon	innovation
zwin	ban
dyis	medieval
mrec	undlunkulu
fyot	umbhalowaphansi
mlon	nesilinganiso
pfis	kokuqiniswa
rwot	orbit
hfok	ukonga
glof	igalofu
zron	zero
hzip	zip
hwom	engenakhaya
bjic	ukuhlafuna
pcim	ukugcwalisa
hjip	chip
bwac	ukuzamula
mlos	imvukuzane
mrip	ukhamba
bron	embryo
ksoc	imaliebanjwayo
cyum	nemvubelo
jyan	ijagoni
plim	ipulamu
mwet	emathuneni
ryet	graduate
glik	uchelela
plap	Capitalist
tsif	kuyaqina
gyak	ushaka
djon	ezenzakalelayo
nwun	ogcina
cles	Namaqiniso
dris	ngokuya
hkef	cafe
blus	ambulance
blap	wallet
bjak	undefined
klim	umhlibitho
gyac	usosayensi
jyit	equanimity
dzit	namaqiniso
bwak	ongaphandle
dyot	radio
bwon	emabhontjisi
fris	informal
klut	zicabangela
tfek	Steak
nrok	nitrogen
zyat	nsingo
bram	banyenyeze
ryis	ezethula
nlip	hlaziya
nros	eqhathanisa
hcof	khumulaizingubo
tfif	incentive
kroc	furrow
hdum	baphumaebuJudeni
pses	umamukeli
plok	umphelelisi
lyet	lens
pwek	icalapegative
kfas	umdlavuza
pwen	pawn
nrun	isikhumbuzi
clek	ukuvuza
pcif	ukulwelwa
glas	yinkimbinkimbi
zwit	ikhuluma
kces	nokwaneliswa
crem	tekutsengisa
grap	grab
kwip	angenele
dyut	Isaphulelo
crus	isigabasabaphathi
gyet	jade
gram	snarl
kyip	isibankwa
nyet	pad
crop	waterfall
glon	engamalitha
mrok	umiyane
fluc	eziqephuzayo
dwic	ukuphambuka
slec	wamazwe
srec	undefined
blut	zibanga
myok	KaMose
tlek	ipulaki
nruk	ezithathelwanayo
nwoc	undefined
bjut	ezimfushane
hges	ukukhulelwa
twoc	zokudla
kyos	lamaKhomanisi
mrek	mangaza
clip	yokuzisola
pwok	icalaprosecutive
dwot	umashiqela
zyac	eqine
jlic	satellite
slop	slipper
ryip	ezilinganiselweze
psim	cisheukephi
byet	abangasebenzi
cyop	umdlalo
rwun	umbandela
blop	isibani
syok	umsekeli
klos	chlorine
lwot	chloride
byic	amabhaktheriya
lyik	okunamathelayo
blok	begazi
jlac	azenze
bret	ibhayithi
krif	uketshezi
blet	ballet
nruc	umchamo
tsus	ugaliki
dyak	abasesigabeniesiphakathi
tcem	nezizenze
cyoc	eziyinselele
trep	ijikijolo
dlun	ukungcoliswa
hlup	i-albhamu
hbep	baseball
praf	ukudunwa
pwis	esithi
grek	egalaji
kruk	ukuzikhohlisa
hfof	phosphorus
rwut	ezihlelekile
myam	sokuzivocavoca
krec	crane
jras	usonkontileka
zrik	azise
blam	ballroom
klip	ingcweti
hwef	ezingakhokhiwe
zlac	ibhanana
gret	generator
lwuk	ubambo
nyek	nickel
blos	ibhasi
sles	ngomshinikumhloliwezincwadika-
tlif	Tile
kses	isoseji
mwot	utamatisi
lyot	auto
tsom	potassium
brut	virtual
djap	algebra
hjok	abajwayelekile
kfen	imiqondo
pcok	optical
bzut	ukuwushintsha
syek	ukutlhogekakwemisebenzi
mruc	isibungu
bwas	isiphequluli
klif	calcium
rwet	akudesikhatsilesengcile
srif	mlandoesishubile
hwem	spectrum
syom	sodium
tyos	trustee
jyic	kalowo
hguk	uhawukele
dwun	umbimbi
swip	spike
tlec	umkhaza
blaf	ukudlwengula
tsem	ukungakholelwakuNkulunkulu
mloc	qapha
gyot	okunemibandela
trop	probe
rwap	njalongekota
hjep	ubulili
pyim	platinum
dlon	inomboloombaxambili
pcep	iphaphu
twuk	scouring
tyec	ithegi
syup	super
trom	Sibona
nyip	bangakini
glis	uphethiloli
gjik	sezinso
hjos	zingagadiwe
hjuc	ngempango
swek	undefined
psek	arsenic
twok	kwezibalo
tsep	intethe
slos	sezenhlalo
nwim	sezinzwakwemizwaebufakazini
tlop	kwendwangu
trus	impikiswano
pwot	leash
djot	lwenzika
nloc	elimile
mwon	Mandarin
hjek	jockey
crom	abambisane
myon	inyumoniya
twec	likhona
ryek	rocket
dlic	idividendi
kwet	isikeyiti
bwen	kukhathazeka
plon	nesiqephusezweesisodwa
syon	ngikhefuzele
djis	digital
byut	unondindwa
hyep	leso
dwon	idayagonali
byis	esesimwenisokungaphili
brec	ubudlelwanephakathikokukodwanokuningi
cyec	thimula
hwop	watt
clus	hilarious
kfun	kuhlale
nwum	Idndizamshini
fyim	umbaleki
cwos	Shuttle
tfoc	undefined
pwon	amaprotheni
sraf	undefined
hbom	ebuhlanzweni
gyen	isakhisofuzo
drim	freshman
trem	accoutrements
tsup	chitha
slok	kwabantu
kwoc	Ugalonci
bwam	Umvoti
mlok	ukuhamba
kyen	zesifunda
hmop	motionekukhuphukeni
rwek	zokuhlola
kfup	cube
grok	isaqathe
drap	undefined
lwis	yamangqamuzana
ksuc	iMenejaexhumanisayo
tsop	ziyanuka
kyok	ikhukhamba
nroc	orgy
jlot	kuphela
psof	phosphate
hgif	umxhwele
kfim	ane-alikhali
psos	yokuzijwayeza
pfen	yokuqinisekisa
kcom	sezomnotho
krom	ukhefana
tluk	wriggle
hyom	iodine
nwuc	motionekwehleni
gjac	yisisu
pcom	pod
dzic	umklami
grun	ukuqhosha
dzot	donor
hzek	manganese
kfot	ikhibhodi
jlas	alithembekile
lyim	elite
jyen	yen
pcaf	abakaki
rwip	lombhoxo
blip	bible
kyoc	causation
lyon	isilonda
flis	inflected
nrif	zidla
kfam	quantum
swes	ijezi
lwon	ezikholelwaekuziphendukelenikwemvelo
drec	asikeizidumbuzabantu
gjap	spa
lyec	lwento
tyom	antimony
pwuk	icalasuperessive
flaf	alpha
myim	mzimba
pcek	ukuthumba
bjac	laphokudayiswakhonautshwala
bzac	unciphise
bzak	Sock
twes	ithelevishini
dwut	documentary
ksom	yonke
lyis	namahlathi
lwim	aluminium
ksok	nezinkanyeziezihambelananosukulomuntu
sruc	zihambisane
dlif	dolphin
byik	killer
tfec	zokubhala
hjaf	silwaneesincelisayo
ryok	protocol
dwis	dioxide
jlon	ikholoni
brus	ubushiqela
gjak	galaxy
lyip	emitholampilo
ryem	Radium
href	rarefied
prok	esiqandisini
slep	undefined
dret	kuphindelelwa
kluk	bemivubukulo
dlis	idiosyncrasy
kfip	engamukeleki
mlec	massage
pfif	sebhithi
nrec	sezinzwa
pfet	Ipheshana
hzoc	umsuka
dlam	kuhle
nlec	Ukufundwa
kluc	esihlwabusayo
dyet	sedan
tyif	umenziwa
krus	ngathothobala
nluc	UhleloOluvumelanaNesixazululinkinga
lyun	ion
zrot	ayiswe
ksif	amanga
psif	ekushayweni
crup	ukugqagqana
fret	othole
grut	phendukezela
ksec	afundanaboesikolweni
jric	uhambo
mrop	microwave
srus	wokukhipha
gyas	wezinwele
floc	temdzabu
plek	capillary
nwop	izibunu
nrom	isilawuli
twos	ubuphekula
lwok	isiqubulo
dwet	ngokuhambakwesikhathi
slem	sublimate
grip	hlupha
gwas	Hewu
kwok	ayibe
gwon	oat
hdop	motionumfula
glam	ingquza
bwot	sezinkomo
bren	wamathumbu
byot	video
bjik	yokuduba
kwim	Imibuzo
cwek	hockey
grif	abashokobezi
hgem	magnesium
hyes	ukuqwashisa
fram	ekhemisi
nwos	undefined
ryap	uhlelekabusha
cwim	nokwethenjelwa
klep	kelp
psec	buyisela
djic	emhlabeniwonke
kfut	ingabuyangangesikhathiesibekiwe
crep	hamburger
frim	ifayelaechazaifomu
gjas	okhela
hdef	debit
ryum	uranium
pluk	ukuhlola
krop	Ukudidiyela
nraf	abakhokhibentela
tyes	edidiyele
plip	opine
hgom	gamma
hgus	Coefficient
cwuc	heater
zret	susa
nles	umhlaziyi
trof	ngadingiumenziwa
hmof	mall
hzim	bismuth
dzac	Diner
psok	iposikhadi
blon	convergence
djet	digress
ksum	shareholder
mrup	bacterium
clif	Helix
cloc	morphological
tfes	Umpheki
gjis	jeans
jren	ukulumbana
tlep	database
kcup	isigqebhezana
glot	voltage
glut	wokubala
srep	zingosi
nwes	Abatshalibemali
ksef	xray
bzis	visa
frut	ingqalasizinda
nyuk	Firefly
dyik	detector
plec	Splice
brom	uxhumanolokudlulisa
plop	palladium
zlik	silicon
flut	volt
ksop	yezimonyo
gjun	Ukucijaingane
kfok	ingwici
hpof	I-Popcorn
hzuk	zoo
nyoc	linikezaumqondo
jwak	yoga
brim	bariumyombala
kles	ikhanda
mwam	yeah
fwik	firework
djas	jazz
dyim	audio
tsum	tungsten
drip	dribble
lyaf	ukondlaobushadenayeemuvakwesehlukaniso
prom	uMklami
nrup	okokufaka
hfes	kunengi
rwaf	Chrysanthemum
dlen	imibhalo
byas	wokugoma
fron	i-heroin
dluk	unqamulekwi
dyun	ukuxilonga
flap	ifolda
kfet	cathode
dlim	imibonoyabantu
prek	yokupaka
syoc	isifinyezo
slus	lungeneke
nlos	lupholavutfondzaba
mlen	selenium
pres	cortex
hlof	isibabule
nlek	zamanjeukuqondanamarker
gwot	sezindiza
mwip	imposter
klop	iphela
kwom	chromium
hl6t	ilitha
nwec	Nomakunjalo
glip	eyindilinga
nrop	kwabasebenzi
crum	i-hormone
dlep	Umthuthukisi
frot	perforate
bwoc	ukuketula
fwis	besifazane
djok	conjugate
draf	ngeyesimanjemanje
trum	ziyingozi
graf	algorithm
lwes	laser
mlem	milimitha
flen	flex
zlot	anode
swok	Snuggle
klec	undefined
pwim	okwesikhashana
htuf	tuna
fyis	refinery
lwet	uzwela
mrem	mainframe
jwic	rejuvenation
droc	yokubonisa
clem	helium
dzik	ngezilimiezimbili
psem	plasma
hjom	chromosome
rwuc	kuhlelekakwetinombolo
tyus	lwenombolo
klom	ikhilomitha
hfos	ifeksi
nwek	ngezakhizofuzo
jrap	ukufakwakokumqokakuphela
zwas	appetizer
bwok	i-broccoli
dwap	-adaptha
syem	ugaxekile
blek	vector
tlus	iqhinga
pyif	okungacacisiwe
cwoc	alright
mrep	ampere
hbem	vitamin
hxan	mnyango
hxut	xhasa
hk6m	cadmium
hxin	simultaneity
txin	titanium
kxin	undefined
klum	copulate
xlis	hourglass
hqak	syntactic
hxat	lokusungula
hxik	ibhukue
hxas	emsebenzini
bxon	boron
dxin	undefined
hxit	helicopter
tlum	tellurium
txit	Umnqamulajuquwama
kxat	oxidize
hvik	ngivumelanise
nluk	analog
nyem	isentimitha
hm6t	molybdenum
hl6m	lithium
ht6t	multimedia
xlit	calorie
ryop	robot
pxas	wemithi
hxak	umsebenziwesikole
lwif	locative
grim	logarithm
hqat	Mantis
qlit	bonhlobo
xlik	sophisticate
mlep	ithempulethi
hqit	radioactivity
kxim	kilogram
hxen	renter
hxot	udla
kyif	imishiniyokukopisha
fwet	freeware
txet	subset
hs6n	ezilandelanayo
hxet	eavesdrop
xrat	ukugundaizinwele
hqan	impound
hr6t	Iridium
bxat	bandwidth
dxet	ideskithophu
hxis	lomchazi
hxok	headquarter
hxek	dukisa
srem	cerium
hp6t	partitive
pxik	icalapartitive
kxet	cassette
pruk	Isuphamakethe
hvit	amandla
xlin	okungaxhunyiweku-intanethi
frip	ukubethela
hvep	overpay
hxon	ukuvumelanisa
kxit	wandise
hqin	seminar
tr6n	stereo
ht6n	fastener
hvat	oluzayo
sl6s	Celsius
hn6n	neon
ts6t	isikhathisangempela
hvin	lula
pxat	newsstand
myoc	module
ps6s	pasta
bwek	lalesosikhwama
dlok	Deluxe
fraf	firewall
hr6k	mshini
txat	sekhefu
hqon	oregano
pxun	plutonium
ks6n	workstation
slef	izitebhisiezihambayo
xrit	Umtakuliwokubhukuda
hvut	overcrowd
xrim	yttrium
hx6t	augmentative
hqum	igamalomsebenzisi
hl6n	abadayisi
gron	argon
pxan	asetshenzisiwe
hvac	Umshiniwokuwashaizitsha
xlan	ngokuhwebelanakwembulungayonke
txon	nombono
xrik	recycle
hxap	ubhaka
hxac	ukuqalisaphansi
xyat	ukushakwesibindikohlobo
cwep	Iholo
hxos	Torus
txif	typeface
qlat	Realtor
txot	Maphakathinawoekwindla
hxam	milligram
pxis	pixelelingu
pwif	preview
txam	tantalum
myek	thermodynamic
hbop	Ngena
hqot	solute
xlic	ohambangesihlaloesinamasondo
gxit	Ukuqothulwakohlanga
hvan	nemililo
glim	gallium
pfop	vela
hzum	zirconium
xlon	hotline
qlin	nonlinear
kxam	scandium
blim	beryllium
kxik	ulungiselele
nr6n	namangqamuzanaezinzwa
hpef	yekwenta
hruf	router
kxan	ngokwesimo
hxic	siqondiso
xlip	volleyball
dyek	debug
hxop	Iwashi
qrot	neutron
nwip	niobium
hs6t	lwegumbi
grem	germanium
tles	metalloid
hp6k	icalaprolative
qyin	izinhlobonhlobozezintoeziphilayo
txak	antibiotic
mlun	immobilization
txan	actinium
xran	astronaut
dres	decompress
tr6t	ezisemkhathini
hk6t	OCTET
hxus	umthomboovulekile
xlat	crackpot
mraf	marathon
ts6n	springmaphakathino
ht6s	autism
nlif	ionize
txut	notability
hm6n	likhipha
kxis	ukwakhiwakwesizawulwa
xrin	othola
xren	kabusha
bxak	ibhukhumaka
pfos	ibinzanapro
hvis	endleni
hd6n	Iningi
brum	eboardroom
hqis	chauvinist
hk6n	atakheleluhlu
xyit	ukhiyeshift
xyin	yesibilieyodwa
hxun	imbuyangothi
hvas	izindima
glok	ibhulogi
hvak	uhambahamba
pxit	ikheliip
hvet	eduzene
xram	safflower
hc6n	obviousness
qran	iKoran
zyen	Xenon
hqas	nifunge
bzas	blase
hj6n	nonwomuntu
hnof	nonremittal
txas	abenzi
hbum	Buddhism
ts6s	nokuxabana
pxin	izithako
hr6n	isabelo
hxim	kwaphakathiehlobo
dxit	Maphakathinawoebusika
hxaf	gubha
nlus	unesitshalo
txap	umudwaochazangesimo
vrit	ghostwriter
kxak	foolaround
bxin	umzimbawomuntu
hqik	raincoat
hxes	hertz
hxif	hypnothize
xras	ngehora
pl6k	yezomthetho
dxat	rashness
hxip	lwamasoshaomzimbaoluvame
vrat	izikhindi
hqek	reshaping
qrit	polarity
pxot	ehhovisileposi
hxom	iposielingahlonziwe
hqic	umbuyekezi
lwun	bluejean
hp6n	nokuvuthwa
dxan	axube
xrak	indimaumlingisi
dxak	engozini
hven	iziqukathi
mwap	stripyamahlaya
qlan	umbalablind
xros	undressing
srom	showroom
hc6t	chatting
qrat	kubhekephansi
hn6t	okusithiyayo
hqet	website
fres	imali
froc	UKWAKHA
xlak	oxhumano
vlat	volubility
dvan	ngehleesitimeleni
gxin	enqoba
ryes	receptionist
kxot	izixhumi
xyan	ukurhunyezwa
vlan	umkhangisi
ryom	cindezelanjaloatom
hluf	ukuguga
hquk	ukujova
lyum	thuliumatom
tyem	terbiumatom
hp6m	praseodymium
txic	ikhasilesikhwamasasekhaya
mros	umshayeli
dyam	steelatom
pc6n	inombolokwecala
nyos	ibhokisilokungenayo
pyek	wokudlala
kxon	Krypton
hxuc	Ngokukhulula
qrik	icalacentric
xwin	nalwazi
kxic	isicisha-mlilo
hvot	ukusebenzangempambano
dxot	yogurt
hqut	Phuma
pxen	yomnyango
drok	umgomoinhlamvu
flon	umakhalaekhukhwini
txos	izwimiddle
hqok	icalaetshekile
xwik	icalaisiguli
hx6n	prehodiernal
txik	umunwewokukhomba
hqen	umthumi
mlap	malware
hvun	suasion
hvon	uzokhathala
vran	okuthwalaimeyili
pfes	uprofesa
pwip	imbongi
hqam	Zivocavoce
gxat	semthethweni
ks6t	causative
vrin	recruiter
kxip	isiqeshanaibhodi
sr6n	disapproving
vlit	kuhlola
tyup	suburb
mrom	morpheme
xron	embobeni
gxak	ebizayo
hrof	iThrojanihorse
xlas	ikhubazeke
dzet	redecorate
txac	ukuzinikela
xrot	engasetshenziswanga
txis	dotmatrix
syif	siamayunithi
xrac	Akumangazi
brif	Inanikanambambili
dlos	simokwentaicala
txun	izichasiso
dvat	nesififane
psom	isandlakuqala
gjek	futhiuma
nlem	iyunithiofmass
qret	isitolo
txip	iphuzukathathu
dlek	ngabanye
lwut	flowzamanje
dxis	ephawulekayo
hs6m	cesium
vlak	railcar
hn6m	netium
kxap	amakhadibhodi
bxan	Esemuka
myem	ngenyangakaMeyi
gxik	amalungeloezakhamuzi
hxoc	airforce
xrok	engangisebenzanaye
kr6t	skrini
txok	ngokuzenzakalelayo
hxep	skateboard
srop	smartphone
pxak	i-CAPSLock
hk6k	Folkumculo
hl6k	eulersinombolo
pyom	poloniumatom
xyam	thalliumatom
hvic	elihlasele
lyok	icalalocative
xlot	amafulethi
txen	umkhuba
kxac	balwe
qrak	strikebreaker
hbup	Indawoyokubhukuda
txuk	shortcircuit
tsef	tapered
bxit	hostweb
ksem	Fundakuphela
byim	rubidiumatom
hvam	vanadiumatom
lw6n	lanthanum
frum	sasekhaya-athomu
nyom	neodymium
mlom	inombolomultal
kxas	ngezifisoi-
xret	itherabhayithi
hs6k	searchengine
frus	nemibieyonakalisa
gxan	galaxyubulili
vlas	ngokukhala
glet	gasisinyathelo
hvim	isikhathisokusebenza
bxip	bitmap
qrin	inkanyeziubulili
bvak	icalaabessive
pxon	akutholakali
dvik	icalaadessive
dvek	icalaagentive
hlef	ejentiinhlamvu
kwek	icala
kxen	ubuliliezivamile
ht6m	ifomuukulandisa
tsuf	inanitrans
hf6n	fining
tc6t	intfongqo
gvik	icalaergative
gxon	kwehlukana
ksep	yokwamukela
vyin	I-movietheater
pyos	izwiyekwentiwa
hnef	Isenzoesihlobenesenhloko
xwit	Inhloso
hqim	kwemizwagnomic
jlak	njeokungaqondile
vrik	kuyizinhlayiyanafinal
qyan	iyunithiimaginary
kxaf	ijubanelokukhanya
xyic	ubugebengubokwebaimininingwaneebucayi
qyit	sikhathiesibucayi
hvek	icalaevitative
bvik	icalasubessive
hzes	icalawayenazo
prus	computervirus
ples	processor
pxif	iphoyisa
dvak	icalalative
brun	babuka
tsi_k	icalaantessive
tyum	rutheniumatom
vyak	icalatandziso
pxim	Ungqongqoshe
syum	Sesithombeatom
sy6n	suspiciousness
hy6n	vusaubulili
pxac	injabulonozwela
vlin	imotoubulili
qwin	amamineraliubulili
hr6s	yokudluliselwa
tf6n	toner
xris	interfaceyomsebenzisi
hw6n	ukuthukana
xlen	ibizolwamazwi
pyec	spreadsheet
vlim	inkumbulovirtual
bres	ukusebenzaamagama
hqip	ngamafu
vlic	ewumshini
pfam	spammer
dyap	ulimilwesibili
txek	izimpandeNth
dxen	yezimayiniidatha
byip	ibhizinisiumuntu
hs6c	ukusiqhenya
txim	ebhekisela
hb6t	ushintshoizinkundla
hdem	igamalesizinda
dxon	isenzakaloesihluke
lwaf	flashdrive
sl6t	crastinalesishubile
xyik	iflophidiski
fyif	izwikunengi
bvin	umkhathiubulili
hm6p	umbadlana
tfip	umenziwanesenzoesithi
jlen	yakithiubulili
xrap	ezimthende
tc6n	ucwaningoubulili
sl6n	ubuliliwobuciko
xrek	inhlamvuisiguli
xwan	ubuliliabstract
dxif	videoconference
dyip	inkhulumongconenkhulumombiko
zrek	icalaexocentric
hvuk	okususa
xwat	perfectiveesidlule
hr6m	rhenium
txaf	libangelwa
hmef	Isenzoesihlobeneengenabuntu
tx6t	umhleliwombhalo
txes	ibizocollective
bvat	Ukuphathakabi
bvuk	icalaabsolutive
ry6t	radian
vlis	esingokoqobovirtual
qren	ubuliliamaplanethi
gvak	icalaphakathikwezakhizolimi
bxok	Bald
mrum	uhlelolwekhompyutha
ps6t	isistimuesebenzayo
hfom	phoneme
tlem	fundainkumbulokuphela
pwam	spyware
kfif	benefactivecore
qwit	rationality
nlaf	ukufaka
nwok	icalaassociative
dzas	dissatisfy
swuk	icalaokungekhomuntuongalifinyelela
syos	kufinyeta
kr6n	Amandlakagesi
dvin	ubuliliezingaphili
pxom	kwemizwapropositive
vris	izwiokuhambisanayo
rwos	sezilonda
dr6t	distractor
ht6k	ezokuxhumana
slaf	socialnetworking
lyuk	umshwanangokulandelanakwazo
qras	abaziphethe
ty6n	teminal
gwet	Ngokusheshalesitako
hp6s	izwiapplicative
tsof	izwiantipassive
ht6p	isicicontinutive
hn6f	kwemizwanecessitative
pfip	esithiyekwentiwa
glap	indawoyamathuluzi
sy6k	umshwanaekuphileni
qyat	ngegaleloelikhanyayo
hy6t	intfolwetakhitelulwimi
vyan	ukuphinyiselwa
sluf	inombolosingulative
dvit	ubudebesikhathingokweqile
qyak	singleisenzoeliyisenzo
bzik	physics
xlet	ngezingaokungekhomuntuongalifinyelela
hqap	samanjeesithi
qwat	liphansi
qyik	kuyizinhlayiyanazezinzwa
sr6t	uketshezisupercritical
hfem	morphemeepenthetic
tl6t	Ngokuzayoakudeesishubile
mrif	microphone
pcuk	icalapostpositional
tfim	uHleloLwesiqondisiKungenaEsilula
fwim	ethium
ly6t	isivumelwanoallocutive
hvap	ibhaumqulu
hfep	isicifrequentative
bvan	isabizwanawokusakaza
fyun	ezintantayoInombolophuzu
xyas	lokusula
hvif	Isenzoesihlobenebethela
xyis	esithiyekwentiwaesidlule
tl6n	centralprocessingunit
tfok	locativeicalaohlangothini
qwan	imibuzoejwayelekileukubuzwa
