hnit	infinitive
hnak	nominative_case
hkak	accusative_case
htak	topic_case
hpap	dad
hmam	mom
hyat	parental
hcan	hello
hwik	vocative_case
hsuc	ancestor
htat	grandparent
hcac	hungry
hnik	genitive_case
hcit	adjective
hwan	and
hman	me
hnan	you
hwam	us
htit	it
htac	destination_case
htik	dative_case
hyit	realis_mood
htim	deontic_mood
hcut	conditional_mood
hsit	epistemic_mood
hyak	instrumental_case
htan	interior_context
hpan	person_context
htin	independent_clause
hyan	dependent_clause
hfap	perfective_aspect
hkat	past_tense
hnin	masculine_gender
hmak	comitative_case
hnat	present_tense
hpak	benefactive_case
swik	essive_case
htut	negatory_quantifier
hsan	surface_context
hpin	adpositional_case
hwin	location_case
hkan	space_context
hnac	way_case
hyut	interrogative_mood
hnam	and_or
hkit	exclusive_or
hsuk	source_case
hpik	ablative_case
hcat	proximity
hmat	demonstrative
hkuk	clause_tail
hlan	but
hsut	all
hyin	universal_quantifier
hcin	feminine_gender
hpac	plural_number
hyik	one
htic	their
hkik	who
tcat	future_tense
hsin	social_context
hkac	when
hmip	imperfective_aspect
klan	there
hlak	elative_case
hlik	illative_case
htam	directive_mood
hlat	elective_quantifier
hkam	what
hwat	question_word
htap	copula
hpat	person
nyan	male
hkas	could
tcan	other
hnuc	number
twit	assertive_quantifier
hsak	time_context
htuk	temporal_case
htun	only
htum	hortative_mood
hyip	retrospective_aspect
hlit	volitive_mood
pcic	must
tyut	two
hsat	see
hkut	know
hcic	down
hcap	after
hpam	first
hlac	alienable_possession
hkap	never
hnic	inalienable_possession
tyat	old
tcit	deliberative_mood
tcin	day
hlam	come
hwak	vowel
hkin	go
lwak	perlative_case
hpip	progressive_aspect
lyan	long
hsac	say
kyan	how
htas	again
hsic	here
hcik	think
hcak	under_context
hfan	found
hsun	hand
hyac	also
nwan	young
tyit	against
tlan	god
twak	delative_case
hmin	nothing
hyas	once
hlap	semelfactive_aspect
kcac	left
hyic	saw
hcas	house
hwac	world
tyin	three
hnun	neo
hcuk	focus
pyan	love
hsis	always
hyam	night
hyap	king
hkic	between
hmas	mind
cyit	heart
pluc	paucal_number
kyik	because
ksak	causal_case
tcun	done
hnim	name
tsan	proper_noun
klac	country
hpun	asked
cyat	visible_evidential
pcac	better
hmac	moment
hnas	cannot
hwic	water
twim	desiderative_mood
kwan	light
tlat	word
tyan	door
hsas	morning
syat	until
twik	terminative_case
hpit	white
pcan	money
hyis	poor
mwan	death
hfam	form
nwik	inessive_case
kcat	together
tsac	often
pyat	friend
psan	half
hpim	imperative_mood
hyuc	round
hfat	sent
hcis	wife
kcan	believe
hsik	public
htus	state_context
hpas	son
clat	children
tyak	thus
cwan	hope
syin	dear
hkuc	high
tyac	read
syit	city
hlic	already
hfit	factive_evidential
tcac	girl
hcun	hear
ksan	least
hyaf	perhaps
kyat	indeed
tcic	body
hwit	return
cwat	air
hfaf	law
hput	help
lyat	letter
ksas	four
hpic	optative_mood
hfuk	fire
hcam	hour
twat	war
kyak	several
tlit	second
pcin	behind
hmut	lost
clan	thousand
hfac	family
twan	soul
hwas	question
syan	truth
htis	making
tsat	potential_mood
lwik	allative_case
nyin	anthropic_gender
hfak	five
tcak	same_subject_marker
htuc	different_subject
hnap	answer
hmit	sea
hcuc	fear
pcat	understand
syas	terms
hcaf	doubt
twut	dubitative_mood
hkis	black
tlak	bring
hyus	beautiful
nyit	sort
htip	ten
ksis	story
hpuk	book
hlin	electronic
hkun	account
lyas	interest
lyit	write
pwat	bed
hnis	age
hnut	counterfactual_conditional
slas	art
hwis	vialis_case
pyak	brother
lyin	line
tyas	table
hyun	river
kyac	eye
tfan	suddenly
kcin	deep
hmuc	purpose
cyac	blood
hmap	rose
tlin	cold
hyif	forward
tyam	late
hnaf	suppose
hkip	nearly
myan	mine
tsin	knowledge
hkup	copy
hsam	husband
hlis	six
cwit	living
cyan	peace
myat	remember
tyic	natural
hfut	fall
swas	service
hsap	except
pcit	copyright
hyim	army
kyas	horse
plic	future
pcak	west
hpis	pay
hyuk	red
hwun	gold
twin	desire
plan	play
hpus	office
syun	government
kyic	church
htaf	strength
hlun	length
kyin	company
kyis	paper
mlan	probability
hcim	especially
cyas	bear
twac	window
nyat	beauty
hcus	latter
htup	duty
htif	distance
pyas	foot
hlas	wild
ksin	green
hmaf	trouble
myac	smile
hsim	sleep
kyit	quoted
kwik	quotative_case
fwan	visit
slan	follow
psit	presence
hmic	sweet
hmuf	mouth
hfin	rich
tcam	enemy
psuk	broken
kcap	ship
pwan	inclusive_person
hfic	influence
tcuc	appear
hkim	secret
pyin	please
pwit	precative_mood
pyit	polite_register
cwak	evil
myak	march
tcas	places
hlaf	stay
psat	instead
nlan	blue
psac	impossible
kcuk	school
kcit	married
kcak	food
syis	twenty
tlac	quiet
hcip	prospective_aspect
kwin	giving
tsit	stopped
pyac	language
hsus	week
hcup	hall
cyap	wonder
tfin	born
fyat	court
hnip	gnomic_aspect
tsak	respect
tlas	worth
syuc	tree
plat	wall
cyak	heaven
twip	inchoative_aspect
mlat	command
swit	jussive_mood
mwas	month
hwaf	perfect
tyap	experience
ksac	circumstances
syac	fresh
hnuk	duke
kwak	covered
tyuk	east
pwac	stone
hkif	noble
nyac	direction
cyis	chair
tyuc	waiting
tsun	village
tyik	agree
hnum	permissive_mood
slak	success
tsic	trying
slat	hill
hmik	music
hkus	cry
hsip	seven
hpaf	private
nwas	news
tfac	scene
fyan	garden
cwas	begin
hfik	distributive_case
lyac	learn
syik	political
clin	henry
cyin	lie
tsas	cast
cyik	authority
tlap	floor
cyam	summer
tcut	religion
tcap	escape
hlut	author
pyun	brown
tcuk	pain
swan	spring
hmun	soft
kyun	corner
nyak	trademark
tsis	justice
psas	produce
cyaf	laugh
hwut	forget
hyup	europe
hwap	eight
psak	passing
kyap	terrible
pyic	required
hmim	medium
hsaf	breath
hmis	wise
hsum	possessive_marker
ksat	pleasant
ksit	grave
tsap	island
kyam	camp
tcum	touch
cyun	fortune
psic	shore
tyun	domain
mwit	commissive_mood
tlut	degree
myit	winter
kfan	conduct
slac	running
myin	minute
tyip	lead
klas	glass
pfat	board
cyic	vain
swam	affairs
syam	safe
tsut	doctor
hlip	completive_aspect
kcas	darkness
nyun	warm
hpuc	drink
tlam	example
hfun	anger
tsik	spite
tsam	directly
hmup	hat
klak	dog
slin	silver
swac	servant
kcam	pride
pyik	train
myut	moral
syak	enter
swat	sword
kyuk	attack
clac	health
tyaf	paragraph
swic	social
tfit	refund
hkaf	official
pcas	glance
nyam	glory
tfat	twelve
pcut	engaged
pwin	wine
mwat	taste
fyac	iron
syap	distribute
myap	trade
hyum	using
fwak	judge
klat	captain
twap	cessative_aspect
kcic	curious
kwic	foreign
hnif	intensifier
myun	importance
tlic	finally
cyuk	neck
syut	liberty
pfan	sides
kyuc	dry
pcap	aside
tfak	evidential
tcik	evidential_case
twun	distant
tyis	progress
nyap	narrow
plit	building
hpif	page
pwic	holding
syic	sad
tsip	sin
syim	sick
tcis	honest
pcun	bank
ksap	accept
lyam	stream
tcaf	carefully
kwac	ear
hpup	bread
kcut	choose
nwam	animal
hsup	zoic_gender
nwit	eventive_mood
tcim	same_event_marker
tlik	multiplicative_case
kyus	cross
hmus	thick
kfat	dare
nwat	grow
myic	rain
hpum	surface
swut	holy
clis	july
mwun	fashion
hfas	file
cwac	shoulder
kwat	comfort
nwac	anyone
tcip	desired
kfac	grass
hmuk	draw
plin	opening
kwun	june
mlik	fish
klin	capital
pfut	breast
twam	claim
fyin	expense
nlit	yours
mlin	million
pyut	pray
hluk	tired
ksut	kill
cyut	shadow
psin	weight
kcis	gray
pyam	brave
mwac	satisfied
klam	telling
ksam	national
hfip	weak
klik	valley
hkum	speculative_mood
clas	yellow
cyuc	heat
mlac	remains
syip	equally
pwak	box
tcif	pointed
psip	principle
ksik	consequence
tsim	season
flan	science
pcam	apparently
kcun	bore
ksuk	uncle
mlit	list
pcik	dangerous
kwas	august
hluc	popular
klit	unknown
flak	familiar
fyit	familiar_register
lwat	reader
plun	walking
twas	twice
pcis	priest
fyas	wounded
nlat	palace
myuk	fool
pfak	favour
tcuf	nine
cwap	sympathy
plac	burst
pyap	putting
lyic	dressed
hcum	noise
lwit	literature
tsuk	rank
hfup	storm
kcik	pocket
nwap	november
tyim	december
psaf	absence
nlac	population
kyaf	thank
slis	series
pyaf	bird
mlak	owner
kwut	coat
hwuc	relations
pyis	rapidly
twuc	smoke
nwak	january
mlic	machine
tlis	teeth
ksun	burning
clam	shame
klaf	quality
clit	ring
fyak	phrase
fyam	phrase_marker
kwap	square
hwip	sunday
psis	poetry
pwut	preordained
kyim	buy
clic	fields
pyip	april
kfap	october
psut	objects
kcuc	bitter
nlap	slave
hsok	loose
htet	text
hbat	worst
hrit	credit
hzit	features
hpet	fifteen
krac	cruel
hduc	dust
hrik	practical
hron	colour
hnus	nose
hric	friendly
srik	supply
hten	yesterday
tlet	hesternal_tense
slap	fail
hban	wear
hdat	blind
fran	fly
hdan	devil
htec	gradually
hmon	mission
cran	sacrifice
hran	conscience
hmos	minister
nrit	energy
hcet	hate
hset	centre
hrin	rational_gender
hcot	enjoy
hrip	brief
htep	worship
hcif	skin
hrat	roof
kran	crown
hkon	castle
tran	despair
hmif	mile
trin	circle
hgin	prison
hkop	cup
hcen	member
swin	civil
hrac	everywhere
hris	custom
hbin	becoming
hmot	meat
hdut	milk
hwen	vegetal_gender
nran	rare
hbac	cousin
crut	bridge
hsoc	stock
hsom	salt
nris	innocent
hbit	avoid
crin	admiration
rwin	queen
hgut	count
hdas	dance
hnot	hotel
hdin	fill
hton	prisoner
hdak	shop
hlet	stairs
hson	pardon
hgek	gay
hras	sand
hsep	september
hbic	ruin
hlen	license
hcon	sufficiently
hgit	witness
kfon	kitchen
hbak	sell
tlim	treatment
hsot	speed
kyut	computer
hnen	eternal
htek	library
hzan	containing
hbis	base
hbun	confusion
kcus	cook
hgat	desert
hwus	kiss
hbif	ice
hbot	ball
hrut	argument
hdit	benedictive_mood
hdis	guilty
hjan	punishment
plis	police
hgan	hide
hsen	expedition
nrin	ignorant
hyen	cloud
frif	february
hdik	disease
hnek	initiative_case
hbam	aunt
hmen	humble
hdip	delayed_imperative
prat	reported_evidential
hdet	midnight
hjit	finger
hmoc	somewhere
pran	press
kcec	region
hken	lately
hloc	melancholy
hrak	staff
htes	gaze
rwan	reward
hdon	donate
htot	forehead
hnet	angel
hdun	singular
croc	error
hlon	dawn
hyec	sheep
hjin	patience
hrec	referential
mran	corn
htos	majority
hcos	measures
hkoc	occasionally
hlif	profit
clak	sugar
hjat	humanity
tram	frame
hdic	disk
hkok	lonely
srat	artist
crak	charm
hmet	email
hden	decision
gran	governor
crac	branch
hjac	enthusiasm
hdim	inductive_mood
hcok	hurry
hyet	oil
pwap	pipe
trat	print
tcot	solid_matter
hdoc	oh
hren	discourse_context
tcon	noon
krin	cabin
plam	alarm
hnes	nervous
tcen	observation
hsek	aspect
plik	applicable
slik	silk
hfen	cent
hgen	agent
hnon	union
crik	hell
tcet	defective
mrat	mixed
hdam	admonitive_mood
hgac	ambition
htoc	somehow
hdac	counsel
nwin	constitution
srit	instrument
hret	firmly
nlin	online
hzat	tide
klic	college
hkek	tail
nric	generation
hgic	crowded
hgak	cat
trit	direct_evidential
tyot	treaty
hnok	contents
crit	abandoned
slen	eleven
srin	instinct
hpok	tribe
hyot	apprehensive_mood
cric	shelter
hruc	rude
cwin	riding
hzak	shake
dyit	industry
hpec	profession
nras	nurse
hcec	teaching
hbut	shoes
hmec	vague
twot	activity
crat	saturday
hkot	capacity
hnec	sunshine
hwuf	widow
cren	shed
nrat	star
hget	guest
hbik	bless
brin	inner
hpot	available
trac	resistance
prac	derive
hcoc	hollow
hpon	province
hwim	civilization
dwan	hang
cwok	shock
hdok	driving
crun	treasure
hzik	seed
hrot	recent_past_tense
hket	awake
hcek	furniture
hrop	rope
mrac	adventure
byit	feast
trak	annual
hzin	southern
sric	ceremony
clik	hunting
trap	liberal
hrim	christianity
hrus	princess
blat	altar
cyon	tiny
hwep	web
krat	cardinal
tris	purple
kcot	gather
hben	election
trik	drunk
kfit	lift
tcec	exchange
nrik	definite_article
grat	emperor
dran	administration
hpen	previously
cluk	ugly
nrac	harmless
ryin	training
hrun	roll
nwic	inch
slit	shoot
gzat	newspaper
krot	cutting
drit	beard
hzis	tear
hdap	eighteen
sris	historical
mrut	gross
nyik	mud
bran	bride
drat	depend
djan	giant
glat	simplicity
hpoc	autumn
pras	veil
hgot	gathering
tret	theatre
tras	comparison
rwit	rival
hfon	forming
klot	coach
hmum	humour
drac	discourse
rwas	novel
tset	revenge
hdot	distal_demonstrative
ryut	jealous
hwon	invitation
byat	burnt
flac	flash
prot	portrait
crek	suggest
htok	conflict
htop	curse
prit	imprecative_mood
hces	helpless
klup	club
hnos	flood
dwin	indifference
prin	horizon
mrit	assumptive_mood
tcoc	steep
hcom	harmony
grit	thunder
tlot	childhood
hgik	knee
hwes	unconscious
hzac	mutual
hsec	software
tson	institutions
ryit	receipt
dlin	discipline
slip	slip
klon	revolution
hfim	farmer
hpom	platform
cyen	student
hgec	cave
hroc	tradition
srac	submit
ryat	tragedy
kcen	virgin
hbap	farewell
krik	criticism
krap	cotton
fwat	hospital
kcet	rent
hgas	gas
pfin	inevitable
dlit	leaf
ryan	translation
sran	funeral
mrin	flour
hram	romantic
dlan	dollar
hzas	jest
hsos	sixteen
klen	colony
gyin	wing
hsif	lion
cluc	cunning
prip	preparation
hzut	mist
dwat	medicine
krit	proofread
sras	nest
hses	fourteen
brat	objection
flat	acid
hjic	namely
slic	weapon
hbuc	user
tron	orange
byan	bath
hrif	primitive
tlip	establish
blan	basket
kris	secretary
hyon	meantime
tren	today
dlat	hodiernal_tense
hzic	poison
tfic	rifle
tlen	talent
hlim	climate
dyat	mate
kcon	revelation
dlac	wash
krak	confession
hbas	nonsense
hkec	coal
hrek	restore
hkos	canoe
hwif	vice
tric	temporary
hdep	delimitative_aspect
mwak	pile
ksot	bone
hnoc	monday
nlas	tuesday
brac	wednesday
frap	federal
pfit	representative
pcoc	pole
lyen	linen
swak	sink
pcen	president
brit	bloody
hwec	siege
hwet	stomach
hlos	upstairs
hbon	varied
pcon	brass
hsem	summit
lwac	cheap
tsos	contest
kwen	exclusive_person
trun	landing
trut	statue
hrap	artillery
hgap	arrest
trot	temperature
grin	neighborhood
hjak	embrace
hpek	pack
hlus	deer
hwos	bedroom
tsuc	bush
pcuc	discharge
cris	heir
clun	oak
hpes	unpleasant
nlet	incomplete
hrom	program
pyon	piano
swet	persuade
dric	invisible
tyen	well_known
hruk	cruelty
frat	assigned
hyoc	temptation
hlep	telic_aspect
nrot	international
nret	violently
hfif	philosopher
pfic	representation
hmek	sensitive
hfec	welfare
myik	fishing
truc	steal
tcop	lip
rwic	retire
htom	economy
glan	gallery
pren	parallel
hlek	atelic_aspect
nrak	continent
truk	knock
hjim	prohibitive_mood
rwat	tie
hcep	cell
dyan	egg
jrat	artificial
nren	inspiration
ksic	crisis
tsoc	searching
lwan	lunch
hpos	pine
hcuf	push
tcus	sue
pset	extend
hkep	copper
swis	sailor
prim	imperial
trip	whip
cras	shirt
swap	sweep
syet	sketch
htof	thief
clen	channel
kwit	personality
klok	excess
hrok	reform
hguc	thirst
kcim	threatening
hpem	palm
psik	speaker
frit	threshold
cret	traces
mrak	spear
syen	session
tcup	damp
hyek	traveller
trim	tin
plak	complaint
hyok	angle
hgam	cow
hmok	mill
jrac	map
kloc	collar
gyit	deliberately
hbip	beer
mlet	velvet
lyap	abuse
cwen	flock
bwan	niece
tses	thirteen
jrit	justify
nlak	manuscript
sron	warrior
cruc	friday
broc	brush
dlot	download
krim	cream
pric	pitch
prut	jury
hgon	frozen
sram	literally
pfot	pot
hlot	planned
djin	coin
hlok	leap
hpep	apple
hwot	twisted
dlak	discuss
brik	subscribe
nlis	transcribe
hbet	bet
pris	virus
hjik	hospitality
blit	childish
hjap	robe
tfik	reflect
hdaf	attain
hpop	opera
kcaf	hiding
kcoc	elbow
hrum	repair
cyim	suspicious
dyic	educational
hgoc	pit
drak	disorder
plas	applause
byin	binary
hzap	abbey
nlot	loyalty
mrik	mechanical
hsop	successfully
crap	trap
kyek	cake
nrut	entertain
syes	sir
hjet	seventeen
hjen	feminine
hmom	honey
hdec	unfortunately
lwen	legend
slot	stove
frac	rebel
gwan	swell
mruk	improve
swot	swamp
zlan	earn
hnem	animated
hdes	dressing
prak	preach
frin	scenery
hfet	oppose
cros	chorus
ryon	rational
tcos	crop
tsen	processing
hwek	wolf
nlik	refusal
klap	carpet
dras	despise
prop	fertile
slim	whistle
hgis	cheese
krut	bite
srot	escort
bjan	wander
nwen	navy
myas	mask
kwaf	develop
twis	cab
pcip	pencil
srap	vegetable
sren	exhibit
tlun	trousers
hrup	corruption
nrip	cabinet
srup	soup
jran	surgeon
bjat	allowance
gyat	spy
hlem	reckless
srak	abstract
kson	accent
cwis	thursday
sret	sincerely
hraf	traffic
hres	architecture
hsuf	disposal
rwak	crack
twon	ornament
hfus	recovery
hkom	code
djat	hunter
nlut	newsletter
hsef	snake
mris	democracy
bric	battery
mlam	wax
zran	sharing
cron	thrill
hzen	swim
traf	strip
cwaf	envelope
srip	cigarette
mrot	motor
swon	volunteer
ryak	reaction
pfun	partially
blac	baggage
mret	ministry
hjon	sexual
kcok	axe
dram	diamond
kren	alternate
tcek	echo
hdif	identity
tfas	ambassador
hfot	consist
lwas	lazy
hmep	momentane_aspect
kfin	encoding
mwin	imaginary
hrem	ray
pram	climbing
byac	cellar
mren	memorable
swen	senate
kras	coffin
hgun	swallow
nlok	indulge
ryic	agricultural
gwin	swing
srut	meadow
hkes	complex
hfis	resignation
frak	repeatedly
hnom	conspiracy
hcop	pub
hlec	pepper
mlot	melody
zrat	candidate
proc	patron
flik	fox
cyet	regretted
hgim	chimney
slet	hedge
tcok	accuracy
bjit	former_deceased
brot	bud
bwat	blanket
hdus	pig
gwat	ivory
kret	extract
nwet	observer
jwan	avenue
nwis	nails
mwic	bee
bzat	actor
gyan	sweat
zyit	executive
blic	illusion
pcet	uncertainty
tsot	fold
bwit	boundary
tres	stress
hkof	consumption
nyen	groan
hles	resemble
cyek	sack
hjis	needle
gjan	phenomenon
prec	behave
drot	controlled
kcek	curve
twic	chicken
brak	barrel
zwat	habitual
clap	habitual_aspect
tsec	expert
bwin	impress
cwet	bounded
hbek	baker
zlin	olive
mron	van
drin	devote
psap	expose
gjin	birthday
clut	hammer
cwun	fragrant
twaf	trivial
pcot	pet
krok	skull
dlik	legislature
cwic	fortunately
srun	frown
crec	destroying
jlan	margin
kcip	champion
blin	billion
ryik	chemical
mlas	pulse
flit	pilot
hzet	knot
cwik	majestic
twet	skirt
mwik	weekly
tfis	technical
tlon	vehicle
cram	flattering
grac	strengthen
kraf	crow
trup	attribute
hduk	hook
cruk	tiger
nrap	housekeeper
crot	highway
mlip	militia
hfoc	photograph
nres	integrity
plos	plus
tfam	transparent
nlic	nineteen
hwok	qualified
nlen	essay
fyic	efficiency
hwuk	unique
hgok	organic
flic	theology
flot	float
hboc	oblige
hwoc	witch
syot	studio
cwip	champagne
hbes	banner
lwic	divorce
blot	bolt
cwot	captivity
cwam	vein
prik	passive
hfum	foam
grik	gravel
zrin	apron
gren	planet
hfuc	resurrection
claf	shelf
flas	fan
hjot	tropical
hbim	arbitrary
krek	mercury
hbec	benevolent
tsaf	suicide
pwas	pluck
plot	reporter
kfak	expend
blak	balcony
hdos	stain
kwis	classic
kcos	accuse
psen	pension
kres	verb
hzon	monkey
srim	signature
glin	reluctance
mlut	notorious
myot	import
fwac	founder
troc	torch
hgaf	grammar
hyop	yacht
ksip	extinct
sres	excursion
hnup	dome
hzun	stubborn
mric	muscle
gjat	magnitude
hros	rub
zrac	cowardly
tros	toast
myus	mouse
dwac	dialogue
byak	goat
htef	tailor
hfek	flourish
dzan	impose
nyon	anonymous
zrit	formal_register
pcos	sports
hjec	melt
dlas	delete
mras	umbrella
mram	mineral
cwut	truce
hbok	duck
swun	soap
dwak	doll
plif	villa
slon	sewing
tfut	congratulate
djac	reconcile
hjas	suppress
kric	rabbit
kwot	conductor
gzan	guarantee
clot	player
ksek	insect
psam	posture
mwut	owl
htem	permanently
clon	violin
dzin	resident
rwim	respectively
hyof	beneficial
dron	dragon
dwit	auditory_evidential
sroc	exporting
hzot	termination
djik	linger
kfik	lid
ryun	regulation
hmes	mayor
rwac	hardware
sruk	circus
sros	minority
bzan	riot
kset	orchestra
bjon	bacon
hjut	unlimited
tfen	defending
zwac	disadvantage
dyin	deliberation
myis	musician
mlis	mentally
pret	inadequate
tsek	architect
hlom	lemon
ksos	cough
crok	headache
flin	fertility
mrun	carpenter
swec	random
syuk	spoon
blun	balloon
tcep	chalk
fric	refreshment
rwik	vertical
rwen	preventing
flet	inferential_evidential
pfac	publisher
srek	vinegar
tfun	tunnel
pwet	puzzle
gyik	mathematics
fwot	fade
lwin	balanced
jwin	liver
bwik	sublative_case
hdup	dip
hnop	monopoly
bwic	submarine
ryen	regardless
hcem	earthquake
hbos	laboratory
nrek	worker
ryim	rhythm
nyic	interpret
dwas	embassy
rwok	provoke
kram	inability
ksim	declarative_mood
clok	chocolate
pcec	privileged
nyis	hermit
tyoc	coincidence
grak	scratch
zlat	glove
hjuk	kneel
trif	geography
djit	systematic
pson	invincible
mwis	investment
cwec	verbal
hdek	secular
blik	hawk
sloc	psychology
brap	scrap
jlat	pirate
dros	dose
slam	salmon
pwun	pudding
gwik	magnetic
pcop	pump
myen	similarly
ksen	oxygen
mrap	foreman
tfot	certificate
ksus	cluster
trok	rhetoric
tloc	rung
zyan	oar
nlun	login
hlop	telescope
jlin	spelling
lyut	cloudy
hsof	surf
fyik	whiskey
klet	relatively
hwof	willow
hlum	camel
myet	amateur
klis	isolation
hbaf	biography
gwac	donkey
hwum	rumour
pwik	perspective
pron	pro
myes	monthly
mwen	reverie
kfic	vacation
klek	click
cwon	oval
lyak	elastic
kwon	dictionary
hjam	ham
rwon	rainbow
crip	hereby
zwan	occurring
srok	editorial
craf	corporal
tlok	tank
brip	butterfly
tfap	chart
jwat	twin
pros	operating
psun	omen
clet	wretchedness
hbus	bamboo
dyas	dealer
klun	accumulation
jlit	unanimous
hdom	nightmare
kron	carbon
hzam	jam
cyot	listener
hmem	museum
lwam	alphabet
fras	scatter
psoc	punch
hgum	gum
brek	brake
glit	stability
frun	rot
gris	aggressive
mroc	friction
bzit	spider
plut	potato
glac	greed
gzac	multiply
prun	spin
jlet	calendar
nyim	nomination
tlos	trillion
slut	salad
fwit	affirmative_mood
pyen	applications
nlon	nominal
dren	demonstrate
drun	dissatisfaction
cyok	shrug
hfop	football
ryac	partnership
gzin	pioneer
hgip	cabbage
tyet	athletic
hdof	ideophone
hwup	invaluable
lwek	lever
syec	senator
jyak	accommodate
mlim	ant
fwic	effectively
gzit	pregnant
blas	reliance
jrin	everyday
gwak	ankle
drik	oddly
prif	variable
jwit	diversity
krip	discrimination
ryot	awed
nwut	sidewalk
kcif	actively
jrak	frog
twek	exessive_case
psot	atonement
pfon	sponge
sluk	squirrel
nlim	irrealis_mood
ksaf	scarcity
glak	volcano
plen	equilibrium
kfaf	scarf
kyon	exploit
jlik	geological
psop	passport
kfis	vacancy
fyon	affinity
nram	immoral
hbuk	biscuit
gras	trance
hyos	apprehensive
flim	film
plet	tablet
rwam	atom
blis	vanilla
zlit	aids
fyut	fastidious
crim	pyramid
hjif	unlawful
crif	shyness
lwap	lute
tyon	astronomy
mrim	maze
drut	descriptive
nrim	scholarship
kruc	turtle
kwam	adviser
jrik	cricket
dlut	denote
pyot	pigeon
dyon	adaptation
prap	operator
bzin	badge
tyek	triangle
trec	treasurer
nron	hydrogen
pyet	printer
tsok	choke
zyin	chronic
slek	bicycle
jyin	engineering
ryas	transmission
zrak	refresh
nyas	dancer
gric	migration
zlak	violate
tces	tennis
hjun	windy
twen	weave
kyet	collector
gwit	spine
kyot	chord
fwin	frequency
tfuc	loom
dlet	directory
pfik	thinker
bjet	budget
trek	strategy
kros	quartz
gjit	scissors
gwic	switch
frik	theoretical
tluc	towel
pruc	patrol
glic	glacier
krun	completeness
bjin	prediction
tlaf	participate
tfet	manufacturer
bras	lateral
dwik	defendant
clec	exhaust
cres	chess
tcef	cherry
tcom	stumble
nyot	translator
tyok	truck
cyip	surpassing
grot	mustard
bris	wireless
nlam	auction
slif	sieve
hgos	rust
swoc	unsteady
jyat	bankrupt
slum	islam
hjes	census
dzat	tiptoe
slun	suspend
nwot	continuity
gyic	guitar
pfas	bias
zyik	zinc
blen	shiny
hyem	elm
hnep	scramble
nyut	knitted
ryam	pronoun_marker
clim	spice
jret	sharpness
tfon	tease
jwac	java
hrep	recipe
dyac	franchise
myip	metre
rwis	racial
hkem	comet
nwon	innovation
zwin	ban
dyis	medieval
mrec	sparrow
fyot	footnote
mlon	measurement
pfis	ratification
rwot	orbit
hfok	frugal
glof	golf
zron	zero
hzip	zip
hwom	homeless
bjic	chewing
pcim	fulfill
hjip	chip
bwac	yawn
mlos	mole
mrip	pottery
bron	embryo
ksoc	deduction
cyum	yeast
jyan	jargon
plim	plum
mwet	graveyard
ryet	graduate
glik	irrigation
plap	capitalist
tsif	elasticity
gyak	shark
djon	default
nwun	punctual
cles	realism
dris	increasingly
hkef	cafe
blus	ambulance
blap	wallet
bjak	ecstatic
klim	grimace
gyac	scientist
jyit	equanimity
dzit	realistic
bwak	outdoor
dyot	radio
bwon	bean
fris	informal
klut	speculate
tfek	steak
nrok	nitrogen
zyat	razor
bram	mutter
ryis	introductory
nlip	analyze
nros	contrasting
hcof	undress
tfif	incentive
kroc	furrow
hdum	judaism
pses	recipient
plok	complement
lyet	lens
pwek	pegative_case
kfas	cancer
pwen	pawn
nrun	reminder
clek	leak
pcif	vindication
glas	complexity
zwit	talkative
kces	sufficiency
crem	retail
grap	grab
kwip	intervene
dyut	discount
crus	hierarchy
gyet	jade
gram	snarl
kyip	lizard
nyet	pad
crop	waterfall
glon	gallon
mrok	mosquito
fluc	fluent
dwic	deviation
slec	explorer
srec	expiring
blut	wrestle
myok	mosaic
tlek	plug
nruk	infectious
nwoc	henceforward
bjut	squat
hges	pregnancy
twoc	grocery
kyos	communist
mrek	amaze
clip	contrition
pwok	prosecutive_case
dwot	dictator
zyac	preoccupation
jlic	satellite
slop	slipper
ryip	proportional
psim	approximate
byet	unemployed
cyop	hobby
rwun	criterion
blop	bulb
syok	supporter
klos	chlorine
lwot	chloride
byic	bacteria
lyik	sticky
blok	biological
jlac	feign
bret	byte
krif	secretion
blet	ballet
nruc	urine
tsus	garlic
dyak	middle_class
tcem	tongs
cyoc	challenging
trep	strawberry
dlun	pollution
hlup	album
hbep	baseball
praf	piracy
pwis	participle
grek	garage
kruk	crutch
hfof	phosphorus
rwut	structural
myam	gymnasium
krec	crane
jras	contractor
zrik	notify
blam	ballroom
klip	artisan
hwef	unpaid
zlac	banana
gret	generator
lwuk	rib
nyek	nickel
blos	bus
sles	censor
tlif	tile
kses	sausage
mwot	tomato
lyot	auto
tsom	potassium
brut	virtual
djap	algebra
hjok	generic
kfen	concepts
pcok	optical
bzut	budge
syek	unemployment
mruc	caterpillar
bwas	browser
klif	calcium
rwet	remote_past_tense
srif	historic_tense
hwem	spectrum
syom	sodium
tyos	trustee
jyic	hostage
hguk	gourd
dwun	wrinkle
swip	spike
tlec	tick
blaf	rape
tsem	atheism
mloc	monitor
gyot	conditional
trop	probe
rwap	quarterly
hjep	gender
pyim	platinum
dlon	dual_number
pcep	lung
twuk	scouring
tyec	tag
syup	super
trom	trolley
nyip	locally
glis	gasoline
gjik	kidney
hjos	unattended
hjuc	loot
swek	overworked
psek	arsenic
twok	statistical
tsep	grasshopper
slos	socialist
nwim	sensory_evidential_mood
tlop	tablecloth
trus	controversial
pwot	leash
djot	sediment
nloc	snub
mwon	mandarin
hjek	jockey
crom	cooperate
myon	pneumonia
twec	situate
ryek	rocket
dlic	dividend
kwet	skate
bwen	obsession
plon	allotment
syon	pant
djis	digital
byut	bitch
hyep	eyelid
dwon	diagonal
byis	subconscious
brec	eyebrow
cyec	sneeze
hwop	watt
clus	hilarious
kfun	occupancy
nwum	hinduism
fyim	refugee
cwos	shuttle
tfoc	twinge
pwon	protein
sraf	self_satisfied
hbom	vomit
gyen	gene
drim	freshman
trem	accoutrements
tsup	shatter
slok	sociology
kwoc	squash
bwam	voter
mlok	mobility
kyen	regional
hmop	motion_uphill
rwek	retrospective
kfup	cube
grok	carrot
drap	entrap
lwis	molecular
ksuc	accountant
tsop	stink
kyok	cucumber
nroc	orgy
jlot	solvent
psof	phosphate
hgif	fascinate
kfim	alkaline
psos	gymnastics
pfen	verification
kcom	economist
krom	comma
tluk	wriggle
hyom	iodine
nwuc	motion_downhill
gjac	miscarriage
pcom	pod
dzic	designer
grun	bragging
dzot	donor
hzek	manganese
kfot	keyboard
jlas	unreliable
lyim	elite
jyen	yen
pcaf	parenthesis
rwip	rugby
blip	bible
kyoc	causation
lyon	ulcer
flis	inflected
nrif	nibble
kfam	quantum
swes	sweater
lwon	evolutionary
drec	dissection
gjap	spa
lyec	linear
tyom	antimony
pwuk	superessive_case
flaf	alpha
myim	immune
pcek	kidnapping
bjac	brewery
bzac	abridge
bzak	sock
twes	television
dwut	documentary
ksom	cosmos
lyis	forestry
lwim	aluminum
ksok	horoscope
sruc	expedite
dlif	dolphin
byik	killer
tfec	stationery
hjaf	mammal
ryok	protocol
dwis	dioxide
jlon	colon
brus	bureaucracy
gjak	galaxy
lyip	clinical
ryem	radium
href	rarefied
prok	refrigerator
slep	satyr
dret	iteration
kluk	archaeological
dlis	idiosyncrasy
kfip	unacceptable
mlec	massage
pfif	specification
nrec	sensory
pfet	leaflet
hzoc	underlie
dlam	ideally
nlec	anthropology
kluc	tasty
dyet	sedan
tyif	transitive
krus	cower
nluc	sunflower
lyun	ion
zrot	extradition
ksif	falsify
psif	emission
crup	overlap
fret	finder
grut	invert
ksec	classmate
jric	itinerary
mrop	microwave
srus	oust
gyas	hairdresser
floc	folklore
plek	capillary
nwop	buttocks
nrom	controller
twos	terrorism
lwok	slogan
dwet	overtime
slem	sublimate
grip	grill
gwas	wow
kwok	cobalt
gwon	oat
hdop	motion_upriver
glam	anus
bwot	bovine
bren	bowel
byot	video
bjik	boycott
kwim	quiz
cwek	hockey
grif	guerrilla
hgem	magnesium
hyes	awareness
fram	pharmacy
nwos	unambitious
ryap	rearrange
cwim	reliability
klep	kelp
psec	reimburse
djic	worldwide
kfut	curfew
crep	hamburger
frim	theorem
gjas	ignite
hdef	debit
ryum	uranium
pluk	assess
krop	coordinate
nraf	taxpayer
tyes	integrated
plip	opine
hgom	gamma
hgus	coefficient
cwuc	heater
zret	subtract
nles	analyst
trof	intransitive
hmof	mall
hzim	bismuth
dzac	diner
psok	postcard
blon	convergence
djet	digress
ksum	shareholder
mrup	microbe
clif	helix
cloc	morphological
tfes	caterer
gjis	jeans
jren	alignment
tlep	database
kcup	coupon
glot	voltage
glut	calculator
srep	cyberspace
nwes	investor
ksef	x_ray
bzis	visa
frut	infrastructure
nyuk	firefly
dyik	detector
plec	splice
brom	bromine
plop	palladium
zlik	silicon
flut	volt
ksop	cosmetic
gjun	grooming
kfok	hiccup
hpof	popcorn
hzuk	zoo
nyoc	connotation
jwak	yoga
brim	barium
kles	behead
mwam	yeah
fwik	firework
djas	jazz
dyim	audio
tsum	tungsten
drip	dribble
lyaf	alimony
prom	programmer
nrup	input
hfes	reflexive
rwaf	chrysanthemum
dlen	documentation
byas	vaccine
fron	heroin
dluk	disconnect
dyun	diagnose
flap	folder
kfet	cathode
dlim	ideology
prek	parking
syoc	snapshot
slus	accessibility
nlos	anticlimax
mlen	selenium
pres	cortex
hlof	sulfur
nlek	current_relevance_marker
gwot	airport
mwip	imposter
klop	cockroach
kwom	chromium
hl6t	litre
nwec	nonetheless
glip	cyclic
nrop	payroll
crum	hormone
dlep	developer
frot	perforate
bwoc	sabotage
fwis	feminist
djok	conjugate
draf	modernize
trum	extremist
graf	algorithm
lwes	laser
mlem	millimeter
flen	flex
zlot	anode
swok	snuggle
klec	dog_tired
pwim	part_time
htuf	tuna
fyis	refinery
lwet	sensitivity
mrem	mainframe
jwic	rejuvenation
droc	demonstrator
clem	helium
dzik	bilingual
psem	plasma
hjom	chromosome
rwuc	ordinal
tyus	integer
klom	kilometre
hfos	fax
nwek	genetics
jrap	screwdriver
zwas	appetizer
bwok	broccoli
dwap	adapter
syem	spam
blek	vector
tlus	tactic
pyif	unspecified
cwoc	alright
mrep	ampere
hbem	vitamin
hxan	doorman
hxut	subsidize
hk6m	cadmium
hxin	simultaneity
txin	titanium
kxin	kilo
klum	copulate
xlis	hourglass
hqak	syntactic
hxat	creativity
hxik	e_book
hxas	workplace
bxon	boron
dxin	inductance
hxit	helicopter
tlum	tellurium
txit	deadline
kxat	oxidize
hvik	align
nluk	analog
nyem	centimetre
hm6t	molybdenum
hl6m	lithium
ht6t	multimedia
xlit	calorie
ryop	robot
pxas	pharmacist
hxak	homework
lwif	locative
grim	logarithm
hqat	mantis
qlit	ecology
xlik	sophisticate
mlep	template
hqit	radioactivity
kxim	kilogram
hxen	renter
hxot	overeat
kyif	copier
fwet	freeware
txet	subset
hs6n	sequential
hxet	eavesdrop
xrat	haircut
hqan	impound
hr6t	iridium
bxat	bandwidth
dxet	desktop
hxis	exponential
hxok	headquarter
hxek	misplace
srem	cerium
hp6t	partitive
pxik	partitive_case
kxet	cassette
pruk	supermarket
hvit	willpower
xlin	offline
frip	encryption
hvep	overpay
hxon	synchronize
kxit	maximize
hqin	seminar
tr6n	stereo
ht6n	fastener
hvat	upcoming
sl6s	celsius
hn6n	neon
ts6t	real_time
hvin	streamline
pxat	newsstand
myoc	module
ps6s	pasta
bwek	briefcase
dlok	deluxe
fraf	firewall
hr6k	artifact
txat	lunchtime
hqon	oregano
pxun	plutonium
ks6n	workstation
slef	escalator
xrit	lifeguard
hvut	overcrowd
xrim	yttrium
hx6t	augmentative
hqum	username
hl6n	salespeople
gron	argon
pxan	promotional
hvac	dishwasher
xlan	globalization
txon	wavelength
xrik	recycle
hxap	backpack
hxac	restart
xyat	hepatitis
cwep	paycheck
hxos	torus
txif	typeface
qlat	realtor
txot	mid_autumn
hxam	milligram
pxis	pixel
pwif	preview
txam	tantalum
myek	thermodynamic
hbop	break_in
hqot	solute
xlic	wheelchair
gxit	genocide
hvan	firefighting
glim	gallium
pfop	pop_up
hzum	zirconium
xlon	hotline
qlin	nonlinear
kxam	scandium
blim	beryllium
kxik	configure
nr6n	neuron
hpef	predicative
hruf	router
kxan	factorial
hxic	guideline
xlip	volleyball
dyek	debug
hxop	wristwatch
qrot	neutron
nwip	niobium
hs6t	restroom
grem	germanium
tles	metalloid
hp6k	prolative_case
qyin	biodiversity
txak	antibiotic
mlun	immobilization
txan	actinium
xran	astronaut
dres	decompress
tr6t	extraterrestrial
hk6t	octet
hxus	open_source
xlat	crackpot
mraf	marathon
ts6n	mid_spring
ht6s	autism
nlif	ionize
txen	restatement
xrap	striped
hvun	evoking
xrin	redirecting
pwam	spyware
hxes	hertz
hvet	next_to
hd6n	denominator
pxit	ip_address
hk6n	compile
qran	koran
hnef	nth_root
dzet	redecorate
hvis	verb_affix
hqis	chauvinist
tsef	tapered
hc6n	obviousness
hxep	skateboard
hvak	accident
ty6n	teminal
vrit	distractor
txas	installing
dzas	dissatisfy
kxis	personalize
rwos	aerosol
syif	si_units
hnof	nonremittal
gxat	rashness
kxas	at_case
glap	toolbar
pxin	ingredients
hqep	webpage
hqam	work_out
mros	feces
mr6t	motorist
qrit	ghostwriter
kxak	fool_around
xyas	erasing
qrin	star_gender
bxak	bald
hk6k	folk_music
bzik	physics
hqok	one_another
pxon	unavailable
hvon	wear_out
nyos	inbox
hqap	antibody
dlos	modal_case
mrom	morpheme
txom	first_hand
pxot	post_office
fwas	swear_in
vlak	railcar
xlac	legality
hfom	phoneme
vyat	evaluative
hr6m	rhenium
kxip	clip_board
mlap	malware
mwap	comic_strip
qlan	color_blind
srop	smartphone
hqas	upside_down
glok	blog
dxan	disembarking
pfos	professor
vyan	advertiser
ryes	receptionist
xyan	delimitation
xrok	coworker
ryom	thorium_atom
lyum	thulium_atom
tyem	terbium_atom
hp6m	praseodymium
dyam	rhodium_atom
vlit	volubility
ryos	roles
hp6n	trial_number
nrem	actor_role
hy6m	runtime
bzas	blase
hd6t	mid_winter
bxit	web_host
hm6m	mid_summer
xret	terabyte
qrik	centric_case
xyin	inexperience
kxic	extinguisher
hcef	finite_verb
brun	touring
txap	status_bar
pxen	departmental
drok	goal_trigger
ksep	receptor
flon	mobile_phone
xwit	subsisting
zras	makers
txos	middle_voice
hzok	oblique_case
xrak	patient_case
hx6n	prehodiernal
vran	meandering
txik	index_finger
qrat	mail_carrier
hqic	phishing
txun	attributes
kxot	gnomic_mood
txis	referring
pra7s	pro_phrase
hci_n	undergoing
txut	notability
xwan	suasion
hw6n	swearing
dvan	disapproving
xros	undressing
mrif	microphone
hxuc	rescuing
dvak	lative_case
kyi7n	conferring
hrof	trojan_horse
tyup	suburb
hbi7s	subordinates
hvap	scroll_bar
kxap	cardboard
xrac	surprisingly
brif	binary_value
hqet	connectors
dxat	bad_tempered
hqen	sender
frus	corroding
nlem	unit_of_mass
nyom	neodymium
qret	retail_store
txip	triple_point
dlek	individually
dxit	dramatically
lw6n	lanthanum
lwut	flow_current
myem	month_of_may
zyen	xenon
gxik	civil_rights
bxan	departing
xyon	verbal_noun
vrin	recruiter
mwa7n	emitting
ks6t	causative
kyes	clip_art
pyec	spreadsheet
txok	automatically
bxam	bookmark
jrut	log_out
vrat	shorts
pwip	poet
pyek	projector
hl6k	eulers_number
pyom	polonium_atom
xyam	thallium_atom
lyok	locative_case
hxun	blue_jean
dxun	data_mining
pl6k	paralegal
gxak	counterattack
hm6n	non_human
hbup	swimming_pool
hxim	ethium
hdem	domain_name
qrak	strikebreaker
xram	safflower
lwaf	flash_drive
xyik	floppy_disk
txuk	short_circuit
hm6p	motherboard
hqek	else_if
byim	rubidium_atom
hn6t	inhibition
hvam	vanadium_atom
kxop	krypton
frum	fluorine_atom
tx6t	text_editor
mlom	multal_number
dvat	mistreating
ry6t	radian
hs6k	search_engine
hxoc	air_force
gxan	galaxy_gender
vlas	vocalizations
glet	gas_pedal
psom	read_only
ts6s	quarreling
bvak	abessive_case
pxak	caps_lock
txic	invading
dvik	adessive_case
dvek	agentive_case
hre_k	reshaping
hlef	agent_trigger
hven	containers
kxen	common_gender
ht6m	citation_form
tsuf	trans_numeral
tc6t	direct_object
gvik	ergative_case
gxon	fragmentation
xren	headphone
hvot	flowchart
xyit	home_page
hvim	movie_theater
xlak	hyperlink
pyos	passive_voice
fres	fundraise
hluf	old_age
sr6n	maturation
dyap	world_wide_web
hxip	primary_object
qwit	rationality
txes	dot_matrix
hbum	buddhism
hxom	junk_mail
jlak	generalization
vrik	final_particle
qyan	imaginary_unit
kxaf	speed_of_light
ples	processor
tf6n	toner
vyit	critical_point
hvek	evitative_case
bvik	subessive_case
hzes	possessed_case
syos	summarizing
prus	computer_virus
kr6t	screenshot
pxif	police_officer
xyic	shift_key
tsi_k	antessive_case
tyum	ruthenium_atom
vyak	adverbial_case
pxim	prime_minister
hxaf	excavate
syum	strontium_atom
hn6m	netium
vyin	suspiciousness
hy6n	animate_gender
pxac	empathetic_joy
hr6c	ration
vlin	vehicle_gender
xwin	mineral_gender
txaf	triggered
xris	user_interface
hqut	unused
froc	forging
hquk	inject
dxak	costly
qyit	raincoat
vlim	virtual_memory
bres	word_processor
hqip	cloud_computing
hvic	virtual_machine
dyip	second_language
hxif	hypnothize
hb6t	change_of_event
hs6c	self_confidence
dxon	different_event
vlat	flats
sl6t	crastinal_tense
fyif	reflexive_voice
bvin	universe_gender
tfip	transitive_verb
jlen	locality_gender
tc6n	research_gender
sl6n	artistic_gender
pr6t	polarity
xrek	patient_trigger
xron	abstract_gender
byip	business_person
dxen	videoconference
nyop	indirect_speech
bvan	pronouncing
zrek	exocentric_case
xwat	past_perfective
hmef	impersonal_verb
hqik	reviewer
tx6n	collective_noun
bvuk	absolutive_case
dxot	yogurt
vlis	virtual_reality
qren	planetary_gender
gvak	grammatical_case
mrum	computer_program
ps6t	operating_system
tlem	read_only_memory
qras	superiors
kfif	core_benefactive
hs6m	cesium
nwok	associative_case
swuk	superlative_case
bxin	human_body
txim	electric_current
hj6n	inanimate_gender
pxom	propositive_mood
bxip	bitmap
vris	reciprocal_voice
hf6n	fining
vlan	attaching
ht6k	telecommunication
srom	showroom
slaf	social_networking
brum	boardroom
lyuk	successive_clause
gwet	soon_future_tense
hp6s	applicative_voice
tsof	antipassive_voice
ht6p	continutive_aspect
hn6f	necessitative_mood
pfip	passive_participle
xras	hourly
sy6k	existential_clause
qyat	luminous_intensity
hy6t	grammatical_object
sluf	singulative_number
nlus	houseplant
dvit	excessive_duration
qyak	single_action_verb
xlet	superlative_degree
qrap	present_participle
qwat	amount_of_substance
hr6n	referral
qyik	connective_particle
hfem	epenthetic_morpheme
sr6t	supercritical_fluid
xlas	paralyzed
tl6t	remote_future_tense
pfam	spammer
pcuk	postpositional_case
tfim	random_access_memory
ly6t	allocutive_agreement
hfep	frequentative_aspect
hb6n	distributive_pronoun
fyun	floating_point_number
xyis	past_passive_participle
tl6n	central_processing_unit
txek	locative_directional_case
qwan	frequently_asked_questions
qris	literal
ny6n	years
dvin	given
qlis	english
fren	french
hm6k	american
srum	trees
mwok	minutes
dxap	raised
ryif	christian
hjem	german
nr6t	indian
rwom	roman
bvit	built
glif	greek
hxem	members
djak	jack
xrip	genius
ps6n	spanish
vlik	italy
gvan	reasons
ny6t	india
bxen	clouds
hvos	volunteers
pxam	plants
gjip	egypt
zris	israel
hj6t	earnest
qric	irish
nl6n	ireland
lyes	latin
hf6t	fatal
tw6n	chinese
kxok	catholic
kxos	bones
zren	centuries
vyas	eggs
ryus	russia
hr6s	christmas
hqac	falls
syop	hundreds
hg6t	elements
fruk	africa
dloc	dutch
swim	supreme
hjum	jerusalem
kxek	mexico
xlut	wilt
byap	bob
flam	legally
hs6s	resources
hgup	groups
hc6k	canada
gyis	greece
hg6n	saddle
kr6n	roots
vlon	rolling
kxac	commander
hd6m	adam
zyas	asia
vric	austria
xlot	sunset
pfuk	wrapped
swaf	handkerchief
tl6k	atlantic
fyet	fragments
jy6n	japanese
pxic	prohibition
qlak	anchor
xrut	purity
krem	acres
pr6s	persian
vlot	conspicuous
hx6k	ha
hyuf	jew
dvis	divisions
dxik	cigar
groc	georgia
kxut	latitude
bxim	bloom
xrun	barren
hr6p	arab
dxas	compass
vras	australia
hbuf	boiled
xwot	so_called
jron	genus
pces	ascetic
bxap	rod
bxas	vegetables
pyuk	plague
kx6n	exclamation
hxuk	insects
xyak	pouring
ks6k	mexican
pwaf	prevail
ts6m	systems
hl6s	symptoms
pxuk	ass
vret	inherited
myec	missionary
bwet	brandy
glun	grove
tfaf	telegraph
gvat	handful
kcum	wells
dyen	mediterranean
kxuk	choked
gwen	granite
xlif	rates
sr6s	syria
djut	conjecture
hxec	plunge
pxet	rash
pxok	portugal
jris	switzerland
qlam	salute
bxik	brigade
vrak	spark
hvip	jupiter
gvin	fascinating
hvaf	navigation
xrot	ingenuity
ploc	poland
kc6n	luminous
dxis	daisy
myaf	synonymous
xlam	bridle
gxok	gothic
bvat	whipped
hw6t	sweden
pl6n	republican
psuc	easter
zlis	sicily
blem	belgium
vrap	coral
kxun	lime
hves	venetian
nrof	norway
jrot	jordan
drek	denmark
gwos	goose
hgep	groves
hq6t	aristotle
kyup	cuba
vwat	litter
jlis	achilles
gyap	vanish
pfok	pastoral
xwas	roast
hqif	hungary
ryaf	reef
mlif	fisherman
gr6t	girdle
bjis	basil
txof	stuffed
xrif	geographical
hqos	ounce
hqom	rum
myos	comments
bxot	self_control
prup	peru
hw6k	whisky
txec	teddy
dl6n	dissolution
bzic	brazil
vlun	volcanic
dlom	diplomacy
vyik	wig
tr6m	thermometer
dxac	drawers
hn6s	renaissance
hkuf	butcher
bxis	inhabit
gxut	grate
rwif	receiver
braf	barber
hqun	germ
swep	slate
dxam	digestion
kxif	cleaning
tlef	trailer
jyik	jamaica
xlos	volley
zrut	emerald
nyaf	snuff
kl6n	chestnut
xric	rigging
syaf	sandstone
gyif	guinea
ht6c	stalk
bxic	subterranean
nrep	northwest
mr6n	meridian
sy6n	cement
xruk	jug
qwin	whirlwind
bwut	birch
bx6n	lining
flip	philippines
cwes	southwest
xyet	degenerate
hvok	northeast
kxoc	cutter
klof	clover
sr6p	cyprus
nwom	anatomy
hxef	heather
txus	stew
vwin	commissioner
ts6k	terrestrial
xwap	runaway
bwuk	bouquet
twif	tributary
bzam	balm
gvit	persistence
vlac	slang
hn6k	intact
gxen	inanimate
qrut	parrot
mw6n	macedonia
bven	lebanon
plaf	pollen
psus	parsley
dwim	defile
hxof	moat
pxec	peach
bxun	unprecedented
zrip	syrup
brep	siberia
pxut	feathered
xlap	pulp
kwuk	congo
prem	petroleum
gxis	oyster
fyec	ferment
hb6s	buzz
mles	simultaneous
xwen	neptune
brok	morocco
qlik	cinnamon
hg6m	organisms
hl6p	luxembourg
krep	crab
gxot	walnut
dr6t	democrat
gven	eaves
txep	treble
hq6n	decomposition
ty6t	chad
ry6n	irrational
my6n	armenia
blif	bulgaria
xyut	accounting
gxet	geometry
dxok	dominican
cl6t	steeple
kyom	crocodile
vram	veal
bruk	barricade
pxip	spleen
xlek	sneak
xwet	equator
hp6c	defender
bxok	cocoa
bles	bracelet
kl6t	sacrilege
pyok	projectile
xraf	astronomer
byaf	blond
zrun	sardinia
xyun	saturn
nyok	nutmeg
prep	pear
txup	quail
bxet	barometer
dzon	amazon
sl6k	physiology
pxoc	opaque
pfap	spectral
kfus	diffuse
vrac	varnish
vren	evergreen
cr6t	shutter
hy6k	suburban
glen	greenland
pxek	prehistoric
bxek	beetles
vrok	korea
bl6t	ballast
pfaf	sapphire
gvic	gravitation
flok	foil
gxas	lighthouse
krof	corsica
vwan	carbonate
xwak	bladder
ps6k	piston
dxek	dating
pxap	poplar
zyak	synagogue
pxaf	evaporation
lwos	lotus
xres	transverse
hvus	oasis
hnuf	venezuela
bwip	botany
kref	carnival
hf6s	afghanistan
bjim	simmer
tyop	ethiopia
px6t	peat
fl6n	finland
zlic	chile
clep	sleet
dwes	eddies
jlut	loam
gxic	prickly
hv6n	avalanche
xr6n	heterogeneous
tf6t	transcendental
nr6k	nicaragua
bvet	undeveloped
hn6c	andes
nyec	niger
dxim	piedmont
xyuk	prosecutor
mres	compression
xlun	insoluble
hfuf	bran
pyus	fuse
xlaf	shallows
xr6t	chaotic
byon	fallow
ht6f	ventilation
tfos	outpost
hk6c	canary
hgop	guild
gjon	homogeneous
nrus	rhinoceros
hzaf	impede
bxuk	convex
kfuk	kangaroo
ksem	painstaking
xwac	alkali
vwit	liquids
mlek	meteor
ml6n	sealing
hm6s	madagascar
bjas	arbiter
kyep	skating
tref	turpentine
hqop	singapore
flun	buoyancy
dvas	adhesion
hxuf	alluvial
lwun	pluto
hk6p	colombia
vyip	libya
tr6c	stretcher
xwis	frieze
pl6s	protoplasm
qyip	rip
pr6k	paraguay
tlup	turnip
bxac	blizzard
pxes	metamorphosis
bj6t	almond
hqoc	nausea
nwuk	yolk
kr6p	caribbean
hxup	bedclothes
kxes	currant
mlum	muslim
hgef	girth
xlim	polygamy
gzet	pheasant
qlek	relay
pcus	poppy
gxac	inertia
hk6s	cactus
gyun	guiana
kxus	acacia
gjic	algeria
xwut	playground
kfof	cuff
zram	nitrate
xwic	rill
tfok	mince
bvap	albania
ts6c	thistle
srof	sorrel
my6k	mica
jlek	geologist
tc6k	czech
gros	gorilla
qrip	crypt
bxut	obtuse
dxut	versatile
bvun	auburn
flif	fillet
kxuc	cramp
sref	stenographer
mrus	mauritius
nlaf	pomegranate
pxop	opal
dxip	sedentary
xl6n	filament
qlet	weld
pl6t	palette
qrac	plowing
ks6p	crucible
jruk	cartilage
tcof	archery
fros	turquoise
sruf	scarecrow
mlaf	mongolia
kx6t	combustible
lyep	liberia
nlep	nape
hj6m	yemen
qlot	thimble
gxam	guatemala
dxaf	midwife
xyen	nurture
tyep	tripod
xroc	potter
bloc	bowling
mlop	melon
bzot	bottled
byen	bosnia
krum	mackerel
tr6f	topography
qram	props
bzon	bison
dwip	auditory
gjen	argentina
kr6k	scorpion
xlok	woodpecker
kf6n	oxidation
xyom	hippopotamus
kwus	capsule
xwon	stork
nyep	nepal
tl6p	tulip
hb6p	bumper
xyap	affidavit
pr6n	iran
gvis	carnivorous
hv6t	ironing
hqus	radiate
qruk	superstructure
dzis	drizzle
dwaf	diver
xwik	hydraulic
fr6t	fahrenheit
blof	bolivia
vwak	vodka
rwem	retina
lyek	lichen
qwen	penguin
dxic	fiji
mwus	limousine
xyot	creeper
vlut	articulated
gyip	gambia
hw6s	puddles
kl6k	calyx
tfuk	livestock
xles	himalayas
drif	diurnal
kw6t	squatter
plus	pineapple
kcop	coop
dlip	battleship
kxec	cocktail
gxun	uganda
tyef	skein
gy6t	grenada
hzus	sudan
vrot	lunge
xyes	haiti
qlas	cinder
hm6c	monaco
rwuk	uruguay
gloc	zoology
qlon	coupling
lyif	lithuania
dzam	asthma
gyok	jogging
djek	hedgehog
bwec	breakwater
lwip	lymph
hz6n	tasmania
plom	postmark
hqaf	grafting
nw6n	interrogate
vyam	vietnam
gwok	joker
cl6n	childbirth
qron	larynx
tc6c	tangent
xyim	nettle
bjip	blackberry
br6t	baste
txoc	foal
ml6t	omelette
dx6n	dominoes
kwof	ecuador
hzop	mozambique
hzef	zephyr
kr6c	corkscrew
hzom	nomad
dvon	tambourine
tr6s	thyroid
qwet	antiseptic
kruf	ukraine
dyok	dominica
nw6t	newborn
ryec	rosemary
dxuc	curd
vron	vertebrate
mlus	modulation
hra_k	iraq
xrop	harmonic
ryoc	orchid
tfep	teacup
hd6k	domestication
tl6s	interpolation
qlun	incompleteness
vrip	apricot
tx6s	tights
kr6s	coconut
xrec	heirloom
bluk	slug
qyot	solstice
ks6s	pakistan
twus	altruism
txem	rectum
vlic	analytic
fles	feldspar
xrep	heliotrope
lyoc	larch
txuc	protuberance
jraf	giraffe
hy6s	romania
pxus	pestle
bvam	backgammon
dvic	duality
gyut	educator
kxom	oman
zlap	zebra
bjot	somersault
klus	eucalyptus
dlaf	wildfire
kxof	quince
tlom	trigonometry
pc6t	prompter
vrun	mauritania
qyic	radial
qyen	germination
dyec	indonesia
gjet	electrode
gzon	casino
mwes	mayonnaise
pyem	epidermis
dven	dandelion
kfes	clematis
dvac	ovary
nr6c	nigeria
ml6c	malaysia
dzim	treadmill
bx6m	bahamas
plef	pelvis
glaf	yugoslavia
xyek	emotionally
plof	propulsion
xwip	hyperbole
mluk	mink
sw6t	saudi
ky6n	cocaine
kx6k	rococo
xwif	herzegovina
krup	coordinates
gjut	turgid
pyes	pancake
bvon	horticulture
qyas	alchemist
vwac	hanger
myom	microcosm
qrun	alliteration
cyes	checkers
xwaf	taiwan
drop	hydrocarbon
zyon	ozone
dlap	plumbing
mluc	emulsion
gyon	goldfish
ryep	cranberry
pyup	papua
xl6t	thailand
pr6m	permian
tf6k	stratification
ty6k	octagon
jrus	jurassic
bxaf	rafter
dvut	uproot
jroc	capricorn
flos	florist
nref	reincarnation
px6k	punk
jrun	cameroon
twuf	tunisia
br6n	hornet
kw6n	clarinet
px6n	placenta
vlok	shuttlecock
twop	trombone
hbof	bombing
psum	pumice
zlim	eyelash
txop	chessboard
fyen	fennel
tr6k	starter
myum	marjoram
hqef	relativity
vwut	kuwait
nl6t	deforestation
sw6n	seminal
ty6p	octopus
xl6s	parallax
gres	cress
xluk	icicle
gzis	geyser
qyac	biennial
kyec	kenya
kxup	scraper
swif	sundial
bvic	omnivorous
kxuf	curator
gzen	grange
gxip	biceps
kxem	clement
qwik	pneumatic
ryuk	raccoon
hb6k	buttercup
hzep	zimbabwe
mref	architrave
grom	cornea
mrof	molar
kcep	centipede
gxim	monogamy
bzen	benzene
ly6n	palestinian
fr6n	weathering
gx6n	ghana
kwop	tadpole
qlac	bangladesh
xyok	duckling
qlic	malachite
tf6s	tanzania
py6n	peony
hqes	euphemism
gxap	scallop
xloc	nostalgia
bzap	bassoon
gwut	djibouti
lw6k	slovakia
hxum	femur
slup	scalpel
sy6t	swaziland
slom	somalia
kf6t	coaster
zyap	zambia
vrut	urethra
gxif	graphite
xyac	artichoke
gwap	gabon
hx6c	horseradish
bvac	starfish
psuf	plasticity
bvis	sleeveless
hn6p	namibia
xrus	hydroxide
twof	botswana
qyon	pentagon
tx6k	stethoscope
zric	azerbaijan
kcem	ketchup
tc6s	liechtenstein
gyim	lignite
kwif	caraway
qros	humerus
nr6m	scrotum
mwif	malawi
dzak	tractor
hguf	grapefruit
bxif	carbohydrate
hx6s	collide
vrek	invertebrate
vlet	wallpaper
kr6m	caramel
gzik	rink
rw6t	rwanda
tl6c	entomologist
kx6s	cartesian
nyuc	manicure
jr6n	margarine
bvut	beetroot
nlef	negligee
bwun	bhutan
ryof	radioactive
my6t	ramadan
brem	bream
zrim	suriname
lwof	latvia
swof	slovenia
sr6k	centigrade
kluf	clef
dyes	diabetes
cl6k	inoculate
dvun	discontinuous
mlef	maldives
bros	baroque
hzos	kazakhstan
bl6n	brunei
lw6t	lesotho
hqim	axiomatic
frok	cockerel
brup	burundi
hl6c	leach
gvet	glider
ml6k	teleological
hc6c	chicory
qlen	fishmonger
dlus	belarus
dr6n	endocrine
tfop	toothbrush
kc6t	clitoris
dxes	delicatessen
jros	comoros
zlon	flamingo
swos	estonia
hvec	vertex
zrif	chlorophyll
bxus	uzbekistan
hs6p	psychiatry
zlas	steeplechase
vres	electrolysis
zrok	handcuff
tr6p	electromagnetic
mlof	moldova
qwak	acoustics
nlop	ornithology
djen	duodenum
jlap	sandpaper
qr6n	refrigeration
myep	amoeba
dvot	conductivity
xrem	fairway
hp6p	penumbra
hqec	asexual
ty6s	turkmenistan
txum	ulna
gzas	kyrgyzstan
ny6m	animism
xrom	concordant
ky6t	eritrea
byok	achromatic
hpuf	piccolo
nlom	monolith
nyes	antenna
pwos	passageways
ksof	saxophone
flus	fluorine
pxup	foreskin
jyas	gymnast
gzak	tarragon
ps6m	persimmon
qwot	andorra
jwut	short_term
qlap	grater
jyis	tajikistan
xyaf	anther
hd6p	diaper
nr6s	anthropomorphism
pfek	patella
gjam	harassment
gxek	high_tech
dwok	modifier
fwen	phylogenetic
vyis	incisor
pw6t	pulsate
swem	sprinkler
zloc	cosmology
zroc	accelerator
bref	boreal
dlop	undulate
kxep	skyscraper
rw6n	protean
hc6s	parasitism
dxos	lodestone
hjop	gyroscope
sr6f	sterilize
bxom	okra
bwap	haberdashery
py6t	unpredictable
qyut	tundra
xruc	putter
dv6n	savanna
fyap	amphibian
cw6t	spotlight
gyus	cumulus
cwup	shampoo
zlet	interplanetary
pyef	permutation
twup	tourmaline
hyef	recessive
zrap	metacarpal
vr6n	viviparous
fluk	follicle
hbef	hibernation
dyos	dinosaur
hx6p	herbal
vwot	viscosity
hvif	swordfish
kyop	cotter
dzen	hexagon
xwun	mutant
hvef	vermiform
qyam	anemometer
tx6m	catamaran
zyis	insulator
mwef	methane
gyam	seagull
pf6t	sprinter
cyif	chives
lyos	pleonasm
xlec	halloween
pxep	pecan
psep	permeable
sy6s	ester
cr6n	titration
xlop	homeopathy
glek	epiglottis
xwok	torque
sluc	toxicology
zwik	skiing
dvet	doormat
vyon	eon
vyet	workbench
bxes	backhand
qlut	denude
mwek	emirates
xluc	whiplash
mlup	molt
kwek	convection
xyip	hummingbird
hz6t	zygote
prof	pejorative
gvun	galvanize
clop	shallot
bvas	subspecies
fl6t	euclidean
nyif	intercostal
qy6n	apiary
dyaf	outfield
twef	ultraviolet
bwis	divisor
dvap	dibble
gzap	outboard
drof	doctorate
mwim	metonymy
pwep	pipette
byek	bisect
lyop	olympics
tc6m	trapezium
xy6t	contraceptive
qrem	abrade
qlok	ichthyology
tlof	stratosphere
hf6c	finial
pf6n	pollination
rwof	runoff
gjot	orangeade
vwok	avocado
pxof	polymorphic
tx6c	chard
vlip	psychotherapy
hvop	clipboard
nr6p	onomatopoeia
zros	osmosis
klef	kilowatt
bzaf	hybridization
jlok	cola
hk6f	conifer
gwam	gamete
dxom	odometer
dxif	dragonfly
djem	edema
gzim	rhizome
bzet	semiconductor
pyoc	suppository
dlof	radiology
ts6f	synthesize
ks6m	taxidermy
tw6t	thermostat
frek	ashtray
tx6p	osteopathy
clos	cytoplasm
kwos	clockwise
dwek	hydroelectric
py6k	papaya
pw6n	plankton
zlut	sultanate
xl6k	halogen
qr6t	protractor
nyup	incubate
ksup	cosine
myif	massif
hs6f	surfing
dles	hydrolysis
bjap	backboard
hd6s	dichotomous
qrek	sexy
xlep	hailstone
ql6t	paleontologist
dr6k	pediatrics
zwon	sonar
tyof	activation
flec	fibrillation
qlip	lollipop
fwap	plywood
ky6m	condom
swus	scooter
zruk	taproot
qyis	commercialization
xyop	hemoglobin
ryup	rhombus
gvot	droplets
dl6t	piglet
dwen	desalination
xyos	recombination
syof	ceo
psup	lipstick
zwot	rotor
pfim	half_life
nrum	intrauterine
rwes	tracer
frec	infrared
slof	seafloor
twom	intercom
bx6k	blinker
bzos	boson
mwos	symbiosis
zrec	synergy
dwif	woodwind
gvon	oxymoron
hvup	vacuole
nwep	anaerobic
flek	fenugreek
vlen	valency
sl6p	disequilibrium
hg6k	agonistic
dzes	diesel
mwaf	mechanize
plep	playpen
swop	stopwatch
mwuk	microbiology
blom	bollard
bx6t	blender
vwen	headwind
fl6k	ophthalmology
brop	aerobic
drep	entropy
kl6c	collagen
zwim	isomer
xlom	polynomial
zlek	exoskeleton
ts6p	cholesterol
hx6m	homonym
my6m	myanmar
zlen	aileron
byoc	biotechnology
klem	ectoplasm
zlun	insulin
hqem	isotherm
plem	polymer
hdo_t	deodorant
tli_n	translocation
hsa_n	fossilization
hxa7k	oceanography
hro7t	premolar
hti7t	transistor
hka7t	exfoliate
hra7n	fairground
zwak	hacksaw
hki7n	iconic
hni_k	kinetics
hta_k	toothpaste
hfi_t	fungicide
hso_p	isotope
hta7t	blackout
hlu7t	luge
hki_t	capacitor
ksu7s	couscous
kra_n	extrapolation
gles	megalith
hta7n	toenail
plup	topology
hxi7n	herbivore
kra7t	karate
hlo7t	looter
hmi_p	microchip
nwif	aquifer
hdi7k	pedicure
hzem	exothermic
hti_t	neutralist
psi7p	angiosperm
tfup	reusable
kru7t	eukaryotes
hni7t	unselected
djim	dimorphism
kfos	composting
hni_n	inbreeding
hpe7n	epigenetic
hra7t	transducer
hni7p	phenotypic
hni_s	nontoxic
hba7n	beachfront
klu7t	nucleotide
hli_t	lipid
hta_t	field_crop
hsa7p	isobar
hko_k	tectonic
hdi7n	hydroponic
hpa7s	pythagoras
hpa7p	petals
flem	phloem
sri7s	cirrus
hto_n	automation
hta7s	weeds
bla7k	balearic
hna7n	non_carbon
dref	bedcover
hsi7n	cytosine
tre7n	estrogen
pri_n	copernicus
hti7k	geophysics
hri7t	projective
htu_k	chequebook
hdi7t	diode
hfo7t	photon
hsi_n	seismology
dwos	bodywork
hda7t	dopant
hki7t	crystals
hpi7p	impassable
hke7t	convergent
hma7s	metals
kl6s	occluded
hf6k	fractals
hto7s	buttress
hnu_t	undertow
byom	biome
hba_n	brownian
hda_t	driveshaft
mli_n	modeling
drom	endothermic
hta_s	formalwear
hsi7k	all_organic
hwa7k	watercolor
hme7m	mm_hmm
hni_t	involuntary
hko7t	zealot
fr6s	thermals
vrif	vibraphone
nl6k	gynecology
hri_n	reptiles
hmo7k	molluscs
hsa_t	world_class
tli7t	stabilizer
xrof	hovercraft
hni7n	over_breed
hso7t	speedometer
dli_n	doorbell
hxi_n	humanoid
hve7n	versions
nlof	ionosphere
hda7p	dumbbell
hka7s	quasar
bjen	eggplant
nyum	emus
jwot	judo
sre_s	espresso
hra_n	radiocarbon
hra_t	rheostat
hpo_n	waveform
hli7p	blimp
fla_n	falkland
hta_n	farmyard
mli_t	milliliter
hni7s	neoclassic
pso_s	postbox
hka_s	cuttings
hna_s	nightdress
ksi7n	caspian
hsi_t	genitals
hpa_t	parterre
tfi7t	two_thirds
hmi7t	no_till
gl6t	goalpost
kli_n	coevolution
hdi7f	hydrosphere
hxe_t	headrest
hxi7t	hematite
hpa7n	panels
htu_t	pearls
hne_n	nameless
hpu7t	pillowcase
hri7n	ironically
kla7s	calcite
kra7c	acupressure
pli_c	typological
kli7p	kohlrabi
hru7t	thruster
hna7k	brain_child
hsi7s	synapse
nlup	needlepoint
hye_n	reverential
nri7k	centrifugal
hsi7t	desiccant
tsa_n	self_esteem
hma7n	mainsail
tli7k	tailgate
pla7n	paragliding
nro7t	monorail
hra7s	rower
pca7n	parachuting
tfof	roto_tiller
hlo_t	velvet_worm
hto_s	troposphere
hpa7t	pistachio
hna_c	pancreas
hli7n	sledding
hpi7k	skincare
hki_n	crafts
hxi7k	turkeys
hra7m	perfumery
qyap	zero_impact
hca7t	shipyard
sli7n	semolina
hba7t	baltic
hsa7t	sculptor
hpe_t	ponytail
hbi7n	bikini
gl6n	quilting
pri7n	purine
hpi_c	rearview
hmi7s	meiosis
hba7s	boxers
sla_n	scalar
jyok	geo_science
hla7p	alveoli
hra7f	groundcover
hl6f	lithosphere
hte7s	stainless
mwuc	mouthwash
mra7s	armrest
hna7t	dramatize
hyi7t	inhibitor
hti_n	antigen
tso_f	thermosphere
hxa_t	air_pressure
hdi7p	dumping
xwep	hypnotherapy
hsa7n	sandpit
tra7t	ostriches
hce7t	jackets
nla_n	zealand
pli_n	powerline
tla_k	photovoltaic
hso7n	constriction
sli_p	oscilloscope
hla_n	fluorescence
hma_n	impermanence
hgi_p	gimbals
kri7t	skimmed
hri_t	chiropractic
tra_n	itemize
hto7t	hotspot
dwep	decibel
hma7t	montage
sra7n	hoarfrost
hmi_n	inscriptions
hna_t	incubator
crof	sharecropper
hda_n	adenine
nro_k	snorkel
ml6s	mutualism
dri7f	hydrofoil
hwi_t	waders
hga7n	guanine
hla7n	slow_release
hsa_s	over_harvest
hfa_t	one_third
hfi_n	resuscitation
hbo7t	consumers
fyip	physiotherapy
hsa7s	self_watering
hmi7p	minibus
hma7p	minibar
hno7t	cyanobacteria
jyip	genotypic
hro7n	crossbreeding
hti7n	turbine
hnu7t	subsoil
hxo7k	horsehoe_crab
hka7n	sunburn
nruf	sunroof
clu_t	absolute_zero
kwes	congressional
hli_s	gladiolus
glos	tremors
hli7k	allelic
jram	macrame
kli_t	curler
hpo7t	protons
mra7t	ammeter
tli_t	photoelectric
psi7n	epicenter
hku7t	computability
hle7t	platelet
jrok	wave_particle
hmo7t	combinatorics
tso_s	photosynthesis
hmi_t	mathematicians
ksa_s	coaxial
hne_s	gneiss
hto7k	consumer_focus
hto7n	brain_storming
hlo7n	fallopian
hti_s	tweezer
tfuf	truffle
hta7k	slash_and_burn
tla7k	talcum
hsi_k	spatio_temporal
hni7k	nth_power
tsa7k	ultrasonography
hte7p	staples
hdi_k	dynamical
cli7t	chairlift
hdi_t	eiderdown
dxop	dustcloth
hfa_n	frying
hka_n	equations
hda7n	drainpipe
dxus	dollhouse
hri7k	african_american
hpi7t	topsoil
pyop	playoff
hka_t	cross_validation
nli7t	inhaler
hke7n	condensed
nri_t	nonprofit
hto_t	shuffle
tsi_n	interdisciplinary
hte7t	etc
hta7p	start_ups
dxuk	said
hla_t	came
hya7n	eyes
sri_t	seemed
xyus	heard
hla7t	words
tsa7t	felt
hka7k	began
sra_t	stood
hpa7k	feet
hga_t	answered
jwon	john
hma_t	met
hpi_n	appeared
hte_t	reached
hmi7f	miles
hlo_n	london
hpo_t	laid
hli7t	led
hxa7t	makes
hli7s	lips
drus	drew
hca7n	donations
hme7n	months
pri_s	paris
tro_n	filled
qroc	george
hyi7s	tears
tra_t	caught
mri7m	mary
hma7k	moved
hya7t	laughed
hwi_m	william
hri7s	christ
hto7m	tom
hwa7t	observed
hso_t	sitting
hda7k	officers
hpi_t	leaves
kxa_t	killed
hro7m	rome
hko_n	ears
hsa_c	smiled
xra7t	hart
hsa_k	shook
dla7n	dollars
hpe7t	peter
hci_t	decided
hjus	jesus
sla7n	gentlemen
psu7n	possessed
hca_t	dropped
hso7s	fingers
tci_n	events
cla7t	shoulders
hxo_n	hung
cra_t	streets
hte_n	presently
tya_t	taught
hpa_n	pounds
kra_t	characters
hpo7p	paul
tsi_t	whispered
hpa7c	published
hca_n	joined
hji_n	appointed
hse7t	subjects
hro_t	rode
hse_t	accompanied
tla_t	treated
hta_c	stars
fli7p	philip
hci7t	knees
htu7t	sold
hpa_s	pressed
kfom	rooms
hsi_m	smith
nri7n	citizens
zwut	surrounded
hya_t	yards
swi7n	voices
hvi7n	virginia
hpi7n	represented
hki7s	kissed
hra7k	branches
sra_n	scattered
hke_t	whence
hxa7n	wings
blef	blessed
mri_t	mankind
pra_t	reported
dxa7t	doth
pla_n	waves
htu_n	bowed
hli_p	elizabeth
hgi7t	guests
hfa7t	lighted
hdo_n	movements
txe_t	begged
xle7n	helen
hva7t	invited
tra_s	quarters
rya_t	rolled
tsi7t	stared
hwa7n	managed
kxa7t	burned
hre7n	britain
kla7n	compared
nri7t	daughters
xli_n	leaned
hso_n	sank
klo7n	scotland
hwi7t	threatened
gxaf	sang
hle_t	alexander
nra7t	parted
hyu_t	jews
hwa7s	princes
syep	oath
mra_t	muttered
vlap	cavalry
hyi7n	acting
tru_t	landed
hci7n	poets
hba_t	depends
hyi_t	hesitated
hmo7s	moses
ht6_t	startled
txa_n	wrought
slo7t	torn
ksi7s	caesar
tru7t	dragged
hzi7t	pointing
kri7n	considering
tso_n	obedience
hsi7p	mississippi
hsu_n	sources
pra7n	perfection
pwi7t	providence
hji7n	jean
hbi7t	virtues
hvuk	eaten
fro_n	florence
bli7t	billy
hxa_n	ranks
hna7p	prophet
hna_k	knocked
tri7k	intervals
twa_n	summoned
hme7t	fed
hre7t	crept
hja_t	jumped
tri7t	converted
txa7t	trembled
hru_t	ruth
tla7t	blows
hpe_n	plains
hli7c	flashed
hwa_t	wandered
hxi_t	betrayed
tci7t	elected
hsi7c	twenty_five
kso7t	absorbed
hwi7s	warriors
hda7c	washed
hti7s	disclaimers
gxus	opportunities
byuk	accused
kla_t	climbed
hyi7k	n1st
hs67t	planted
hsi_s	easier
nla7n	moonlight
hli_n	california
hwi7n	promises
grus	bushes
tsa7n	students
vles	venice
hka7c	gratefully
sli7s	sailors
hko_t	comrades
hxa7s	alas
hme_t	faced
hse_n	saints
hli_k	leagues
fwut	faded
hne7t	andrew
hri7c	retained
sla_t	wheels
tro7t	drops
tsi7c	thyself
hfa7n	madam
klo_m	columns
xro7n	heroes
hya_k	jacob
xli7t	withdrew
hko7n	commons
hga_n	madness
hwa_n	willingly
hti_c	dates
hqa7t	spared
sra_k	passengers
rwoc	roger
hyi7c	savages
hla7s	eloquence
myup	temples
hla_s	lawyers
hno_n	norman
mri_k	marquis
cri7t	immortal
hna_n	impatience
psa_n	fanny
hra_s	crimes
sla7t	greeted
hte7n	athens
hde7t	lent
hxe_k	header
dra7n	boldly
cla_n	shells
hse7n	seconds
hno_t	injustice
hbi_n	boiling
hti7m	sweetness
hvi7t	victor
hri_s	twenty_four
cyus	teachers
hfi7t	infantry
hdi7s	addresses
flef	philadelphia
bli_n	berlin
hga_s	guards
hno7n	convent
hpo7n	unjust
hlu_t	clung
bra7m	abraham
hle7n	chains
byif	bills
xla7n	dined
cla_t	charlotte
xri7t	victims
hle_n	lieutenant
bxa_t	bands
sra7s	prose
kxo7t	codes
tci_t	districts
hni7c	wretch
pli7n	pennsylvania
hsa7k	estates
hwi_n	widest
syus	innumerable
tra7n	curtains
hso_c	scotch
sl6m	solomon
txa7n	tents
qlim	disclaims
hga7t	gasped
hdi_n	indemnify
hmo_c	muscles
nli_m	filename
dy6t	duly
nli7s	nicholas
vyen	vienna
hpu7k	portuguese
jres	jersey
kxum	carved
hgi7n	glancing
tsa_s	n4th
fyek	gospel
tya7t	potatoes
hva7n	warranties
hwe7s	wales
bri7t	bits
tyi_t	heathen
gxes	whereupon
gla7t	melted
hr67t	radiant
hpi7s	prussia
hs67n	saxon
tla7n	supposing
tca7t	manhood
hde7p	edinburgh
tca_t	shouts
hca_s	lads
hk6_t	occasioned
hmo7n	monks
tru7k	turkish
hko7p	columbia
hca7k	woke
cw6n	adorned
tfa7t	opens
hqa7n	lantern
nl6s	naples
hru_n	re_use
hda_s	diamonds
bxo7n	blush
hca7c	shew
byun	echoed
sli7t	thoughtfully
hbi_t	inhabited
hra_p	rubbed
hni_c	negroes
hji7m	jimmy
dri7t	suppressed
rwa_n	reigned
hbo7n	buffalo
hki_c	keys
hja7n	vexed
mri_n	superstition
pla_t	lingered
ksi7t	rests
pso7t	posts
hmi7n	murderer
hco7t	saviour
hku7k	locks
hwe_s	whereof
mli7n	miller
hdo7t	donors
hna7s	intolerable
kl6p	columbus
hta7c	unnatural
hjuf	jove
dxa7n	dean
hlu7k	luke
psa7s	fancies
vlof	revolver
hpa_k	paces
plo7t	plato
hde7n	middle_aged
hxo7m	homer
hre_n	regiments
hni7m	benjamin
nli_n	nile
hta_p	tops
hpo7s	proportions
hqa_t	headed
gro7t	roared
twi7n	n5th
hti7p	constantinople
hfi7n	inflicted
qwac	lined
sro7t	shrugged
hmu7t	matthew
tre7s	patriotism
tca_n	stations
hza_t	traitor
cyos	associations
txi7t	stamped
hci7k	beggar
hca7s	oars
hyi_n	prophecy
kca7n	spectacles
hxu7n	hostess
pro7t	ports
ryi7n	rhine
hbi_m	beams
pfa7n	northward
bla7n	babylon
hbi7p	bishops
pli7t	stripped
pyep	lungs
sla7p	smote
dja_n	edges
hvi_t	invested
hre_t	chariot
hxi_k	indulged
kci7t	indebted
xle_t	hurled
hxa_s	canst
kc6c	effectually
hri_k	reins
hg6s	exertions
hci7s	universally
pwec	sinner
hko7k	yoke
nwi7t	kindled
hma7m	mare
hme_n	mason
tli7n	dominions
sra7t	skirts
kra7n	lectures
hbu7t	ghosts
flup	fuller
ksa7p	asp
bl6k	blocks
sli_t	n6th
tsi_s	n10th
tfus	stationed
mra_n	admiral
hro_k	rags
sro7k	hoarse
tra_c	trenches
hca_c	shawl
cra7n	sergeant
hqa7s	airs
sre7t	socrates
qla7n	dazzling
nli_t	novelty
hco_t	homeward
tfa_n	elephants
sla7s	elders
jlun	julian
dzap	sect
hti7c	withal
hdo7n	fundraising
tro_t	troy
hju_t	judah
hxo7n	hymn
hmo_t	communities
hpa_m	pomp
plo_n	apollo
hku7n	countess
kra7k	carter
txe_m	lame
hg6p	gallop
hda7s	dagger
tsa_t	thrice
hsi_c	n7th
tsi7s	selfishness
tri_n	tolerably
hmu7n	doe
tsa7s	beads
hsa_p	ascribed
hpa_c	n8th
mla7n	milan
hno7c	n9th
hxo7t	pleading
gya7t	guides
tse_t	statesmen
hwe7t	waistcoat
hgi_n	solemnity
hka_m	cum
hpi7c	patches
txa_t	devout
kxa7n	schooner
cref	sheriff
hmo_k	impulses
hwa_s	dynasty
hki7p	dove
tri_t	n12th
hduf	duel
gxi7n	reluctantly
hya_n	ridden
hgi_t	gilded
sya_n	satin
hfe_t	feudal
mla_n	excused
nri_n	transported
mla7t	gotten
tla_n	headlong
hka7m	arches
hje_n	jenny
hza7n	idleness
hmi_s	miraculous
hla_p	alps
qraf	ungrateful
hye7s	insensible
mri7t	madrid
hfa7s	flanders
hyo7t	involuntarily
hli_c	locality
hru7s	brussels
kci7n	commissioners
kci_t	cordially
sra7k	historians
hsa7c	watches
xla_n	howling
hta7f	trifles
pra_n	criminals
sri_n	leisurely
hxi7p	audible
tlo7t	tilde
hte_s	thames
sri7t	satire
hgi7s	ignored
pra7t	patriot
dra7t	pirates
hbo7k	buttons
tra7s	extravagance
hxe7t	aforesaid
hya7k	yankee
hja7t	lets
hwo_k	walker
twi7t	dripping
hbi7m	baptism
xlus	hercules
bra_n	baron
tle7t	resolutely
hle7p	overboard
hfe7t	fondly
nla7t	unsolicited
hmi_k	mike
mwo7k	moscow
bra7n	brother_in_law
hti7f	son_in_law
hna_f	groom
txi_t	noticing
psi7s	particles
tsi7n	n3rd
myi_n	fishermen
pye7t	proverb
xra_n	nursing
dre7t	degraded
hx67n	hum
hri_c	ridges
hka_c	cairo
rwi7n	twenty_one
hve7t	inventor
xyoc	hushed
gvap	dipped
tca7n	woven
hne7n	dwarf
tro7n	turner
hsu7t	astray
hma_k	bustle
bli_t	twenty_two
pri7t	patty
psa7t	apostle
ryef	preface
cyep	precipice
hru7n	whirling
kya7n	pecuniary
pri_t	puritan
tsu_t	enmity
nyi7n	heroine
hsu_t	ransom
kxi7t	solicitude
hpi_k	epic
nli7n	consulting
hmi7k	manila
hxa_k	massacre
hku_n	cushions
hba7k	markets
djun	humane
htu7s	tremulous
hba7c	bachelor
hzi_t	pinch
dya7t	dawned
two_t	otto
syi7t	lifeless
nra_t	orphan
xla7t	mightily
xyi7t	peculiarity
hde_n	deities
hqi7t	twins
hde_t	despotism
dri7k	directors
swi7t	substituted
txo_t	bricks
psi7t	palestine
hxi_c	sloping
hbu_t	whiteness
hti_k	tickets
ksi_t	sagacity
hki_s	inquisition
nya_t	anecdote
nla_s	annals
swa_t	soda
hsa7m	idly
lwi_n	oblivion
sr67t	carelessness
twep	antwerp
xla_t	plight
nya7t	monotony
nra7n	indescribable
hra7c	archbishop
kro7t	carts
hga7c	exultation
txi_n	implements
hma_c	shepherds
hli7m	lilies
hjef	geneva
txe_n	tenor
hqi7n	unclean
kri_k	caprice
fyom	opium
hvi_n	pavilion
hxe7c	strait
kli7t	celtic
hpe_p	impenetrable
slu_n	sultan
blec	bailey
jyon	genoa
qlos	anglo_saxon
hga7s	singers
pxi7t	tested
hda_k	damascus
mla_t	originality
hc6f	confide
dxof	jehovah
kla7t	calcutta
xra7n	drying
hri7p	forty_five
hwo7t	peas
psa_t	twisting
kwa7n	canon
dla_n	delirium
gla_n	advent
bxa7n	wares
myop	lumber
dyif	mediaeval
pca7t	impudence
ksa7t	scout
nwi_n	nun
fri_t	frigate
hta7m	atoms
fri7n	fairies
hse7c	sledge
pyi7n	pins
nyus	drowsy
gwis	engineers
mra7m	amsterdam
hti_f	timothy
cra_n	charging
hne_t	inferred
hyu7t	jesuit
hpa7m	palmer
vwis	twenty_three
kla_n	casually
hbi_s	baptist
ksi_n	extant
bxem	bohemia
hle7m	misunderstanding
vyut	universities
sli_s	thirty_six
kfuf	crouching
byu_t	buddhist
txo_n	varies
hya_m	oats
hba_k	bengal
tyi7t	timidity
hke_k	quaker
hci_s	masterpiece
xlof	wholesale
frem	ephraim
kra7m	caress
hfe7s	thebes
hci7p	inexhaustible
bvot	blocked
hk67t	commodore
ryu_n	tribune
kla7m	exclaim
tri7n	neutrality
tri7s	mirrors
my6s	muse
hsi7m	ishmael
ksa7s	rustle
hse7s	senators
hma_p	ills
hla_k	lark
kfek	conventions
tyo7n	stumbling
sye7n	seine
dyup	danube
tsi7p	seventy_five
sli7p	syllables
hya7s	isaiah
dri7p	derby
dli_t	adelaide
hwu_t	witchcraft
hba7p	bombay
bruc	hairy
hxa_c	surveying
bri_t	thirty_two
hxi7s	desertion
sri7n	sentry
mwi7n	millionaire
fwon	unwonted
mra_s	empress
hgof	gout
blup	ebb
hma_s	marseilles
hno7s	unarmed
tso7t	wast
hti_p	twenty_eight
lyi7t	iliad
tri_k	territorial
jrim	jeremiah
hpu7n	disobedience
pxa7t	tapestry
hri_p	twenty_six
bwaf	acquitted
hdu7t	therefrom
bves	bavaria
syu_n	purer
sya_p	sap
ht67t	stealthily
bra7t	gunpowder
tci7n	township
hmo_n	acquiescence
kwo7n	cornwall
ryu_t	crumbling
twa_t	three_quarters
bvip	beaver
hwu_n	woollen
hbo7m	bohemian
hxe7n	farthing
jlip	gdp
ryi_n	greasy
nwaf	hanover
hqi_n	inexperienced
hla7k	lamentations
ml6m	moslem
hba7m	calves
pro_t	throb
jli7t	ardently
hko7f	cove
kri_n	corinth
swi_t	twenty_seven
hbe7t	abated
fra7t	euphrates
bla_t	gibraltar
ht6_n	steaming
xlem	shameless
hsu7n	superman
txuf	submissive
hbe7n	breton
dxef	faithless
hbo7s	blockade
djam	scold
hro7s	rhodes
hxo_t	herodotus
kca7t	actuated
ksa_n	courtier
twa7t	shaved
hsa7f	savoy
txi7n	kinsmen
sya7t	spartan
kse7s	excel
byam	hapless
dxi7n	dowry
hba_p	abbot
rwep	forty_eight
hgi7p	gypsy
vraf	viceroy
kwuc	compulsion
hna7f	nave
tre_t	midway
tru7n	undertone
pci7t	hypocrite
ksa7n	expulsion
hye7t	gall
hxu7t	intruder
tlu7n	pounded
hlo7p	lisbon
gra7t	magnanimity
nri_s	uninteresting
tya_n	tottering
tso_t	forsooth
hto_k	tug
psi_n	porcelain
hva_t	vie
lya7t	decorum
dra_t	loading
tri7m	terry
pro7k	perforce
kwa_n	outwardly
hku_t	cupid
lyup	sloop
mr6m	mormon
tla_s	atlas
hle_m	flemish
hse7p	sable
hjoc	well_bred
syi7n	acetylene
cra7t	voters
nwi_t	windward
bjuc	bourgeois
xra7s	resting_place
fli7n	finn
hko7s	convulsive
hki7k	crackling
xya_n	suns
hza7t	latch
hro_c	red_hot
hta_m	untimely
mla7s	malay
nra_n	shipwreck
sro_n	starboard
tya7n	astounding
htu_s	vicissitudes
tri_s	naturalist
hmu_n	munich
fri7t	inferiority
kya7t	conjure
hca7m	chapman
dxi_n	diction
nlo7t	upturned
hba_s	babes
rwus	routes
hr6_t	braced
nla_t	adultery
hku7s	clown
ht67n	generated
bvaf	boudoir
pla7t	exalt
txa_p	stamps
sro7n	discordant
hfa7p	forecastle
mli7t	agility
hro_n	trojan
xre7n	foreground
nle_n	nightingale
xwa_n	halo
kyo7n	commune
hga7k	awkwardness
bjun	bookseller
truf	levy
mri7n	mother_in_law
sl6f	subtlety
hge7t	ghent
swuc	swoon
hri7m	presentiment
fri_n	ethereal
qla7t	iceland
xla7s	well_to_do
sye_n	sonnet
hla7c	lodges
tfi_k	metaphysics
hco7n	condescend
tfa_t	trample
cri_t	fraternity
hqa7m	dreamer
sru7t	saturated
hci7c	sucked
hka7p	immeasurable
blo_n	bologna
hta_f	adrift
hyo7n	right_hand
hka_k	intoxicating
vra_t	vulgarity
pra7k	partook
hli7f	loth
hwa_k	stocking
kla_s	cholera
hbe7s	baseness
hma_m	midsummer
xla_s	waltz
pc6n	laudable
hsi_f	seville
tra7p	crags
hlu7p	sleeper
kri_t	inconsistency
hbu7k	bugle
ksa7k	chancellor
hra_c	arbitration
gli7t	bristling
twum	woo
hnu7n	newfoundland
dvaf	divan
tra7k	starlight
ksa_t	cataract
nro_n	reconstruction
hxi_s	knightly
hpa_p	paralysis
hne7k	benedict
pwef	leeward
hji7t	confidant
kfa7n	undeniable
txo7t	tomatoes
qrim	inlaid
kfa7t	crammed
hyi_k	allegory
tyi7k	tic
hfi7p	airship
psa7n	parsonage
hja_n	infatuation
gzot	unborn
jlim	jasmine
tri_c	trio
hgi7k	gig
hda7m	old_time
pri_c	patrician
hbu7n	ebony
hn67t	grandchildren
hci_p	well_dressed
hgo7t	thud
hmu7s	mosquitoes
nya7k	ajar
dlo7t	doublet
dla_k	dialects
hbe_t	burly
hge_t	doggedly
hca7p	brevity
hbu7c	bushel
qlaf	hive
dla_t	dont
bri7k	laboriously
dy6n	deafening
pla7k	prague
hyi_s	jailer
hfi7k	fatigues
hte_c	interposition
xle7t	ails
xra_t	charger
pxa7k	cleave
sra7m	samaria
tso7n	tuscany
xyum	honeymoon
hna7m	natal
rwi_n	requisition
hsu7s	noisily
pxi7n	nickname
hci_k	shrewdly
ql6n	sling
sri_k	mythical
hvi7s	vizier
hqup	stupidly
byes	whales
bxos	grocer
xya7t	bastard
hqa_n	harangue
hlu_n	tinkling
tru_n	turin
pxi_n	sphinx
dyi7t	giver
hxe_n	disdainful
mle_t	enamoured
tfi7s	thirty_three
mya7t	amphitheatre
pri7s	pyrenees
txe7t	nods
hpe7k	peking
hyo_n	jonah
kxo7s	drudgery
twe_t	taketh
pxa_n	passers_by
hka7f	scandinavian
hwu7t	woody
nro_t	conservatory
twa7n	fawn
nwa_t	sanskrit
vros	warsaw
psa_s	paroxysm
pse7t	sixty_five
kce7t	clipped
kro7p	uncontrollable
kre7t	crete
xra_p	philanthropy
mya7n	ammonia
mro7t	lombardy
nr6f	nazareth
hce_n	shapely
hnu_n	unitarian
kro_t	portrayed
bra_t	disheartened
tra7c	patriarchal
nyi7t	snorted
sye7t	testament
pro_s	piers
hgo_t	ode
kro7n	coroner
nra7k	daughter_in_law
pxa_t	platter
dr6s	decorous
pfuf	bats
mr6s	madras
txu_t	matted
syi_n	seminary
myi7t	acquiesce
fwun	bellows
gxa7t	birthright
bza7n	byzantine
pci_t	imperceptibly
hy67n	belligerent
hfu7k	conjugal
hfi7c	phoenician
hra_f	relapse
zra7n	usurpation
hxu_n	portmanteau
tfi_n	definitions
hxe7k	hackers
dli7n	godlike
ts67t	fittest
hp6f	plentifully
gyi7t	vigil
kso_t	oxide
pxo7n	copenhagen
qwap	cans
tfef	self_defence
tro_p	torpedo
tfa7n	tanned
htu7n	tunis
kxi_t	candlestick
bro7n	baroness
hla_c	algiers
zyek	ezekiel
hpu_t	crumbled
hpo_s	prometheus
tre7k	terrier
hwi7k	willy
pfa7t	potash
hgu7s	thumbs
zyet	girt
bxa7t	left_hand
xlef	heralds
mwa_n	tingling
hwo7n	omnipotent
hna7c	annuity
kxa_n	astride
ryi_t	forty_two
dxa_n	paddy
xwa7n	havana
pca7s	bananas
hbo_t	baghdad
xli7n	feasible
hyi7p	innkeeper
hru_k	brittle
cli_t	world_wide
xra_c	thrush
hsa_m	thatch
hte_p	tapers
hlo7c	lottery
hdi_s	damask
dzun	dunno
txa_k	firewood
hda_f	godfather
mwa_t	memoir
cya7t	jot
dzos	doze
kli7n	castilian
hxa7c	hermitage
mre7t	myrtle
tya7k	antidote
nra_k	antarctic
vyic	enviable
tre7t	centered
gri7t	ague
syi7s	self_conscious
pso_t	postman
ryi7t	gratuitous
dzut	adduced
hlo7k	locket
hke_n	scythe
nra7s	anvil
rya7n	aryan
xri7k	homesick
gvaf	hovel
kse_t	sexton
bra7k	brock
rya7t	archer
gli_t	guillotine
twi_t	thirty_four
mra7n	motherhood
dli7t	diplomatist
htu7k	fatherland
hmu7m	muhammad
hza_n	loitering
hlu7n	lutheran
nyi7k	undivided
ky6s	cruiser
hse_p	tenfold
hke7k	kennel
klo_t	couplet
hse_s	ostentatious
kra_p	carbide
tfi7n	edifying
fri7s	jurisprudence
pxi_t	purgatory
kli7f	caliph
psi_t	thirty_seven
pyi7t	impiety
pla7p	unalterable
hmo7m	mesopotamia
hdi7c	domesticated
nri7s	narcissus
xri_n	flirtation
hso7m	socialism
hvuc	vishnu
hfa7k	thrashing
hno_k	unconnected
hmi_f	mystified
hyu_s	yew
myi7n	soot
fwif	fife
hri_m	prim
bla_k	balkan
tlo_n	intolerance
mru7n	manger
hqa7k	tacked
bwa7n	boatswain
hpe_k	semicircle
kci_n	unconstitutional
sli7c	twenty_nine
pfi7n	fifty_five
rwi7t	thirty_eight
sra7p	serbia
tyi_n	undefined
zli7t	islet
kxe_n	workhouse
hme7p	amiably
hlo_k	locusts
hnu7c	vintage
syi_t	self_evident
hka_f	leprosy
hyo7s	self_possessed
hle7k	lye
hgo7n	comer
gwun	lukewarm
kca_n	coasting
ple7k	sepulchral
vyot	victorian
mla_c	mulatto
tya_s	catechism
tce7t	worshipper
pce7t	beholds
byi_t	billiards
tra_m	torpor
hla7m	alabaster
hso_s	musk
dl6k	tithe
tse7t	retard
hfi7s	officious
tro7s	tyrol
rwa7t	narrator
xri7n	inaudible
dre_t	drawbridge
hno_s	clumsily
fla7t	weaver
bro_n	brawny
mya7s	measles
kc6s	currants
xwam	one_sided
kl6f	calvary
hka_p	cobbler
mri7s	materialism
nwa_n	pantheon
pya7t	footstool
gzic	bloodthirsty
nri_k	cylindrical
dvif	declivity
kse7t	vestry
tse7s	bedtime
hdu_t	distended
pca_n	gushing
sle7t	atheist
fla7n	phalanx
pri7k	figuratively
hvi_s	vitals
kxa_k	khaki
bri_n	aborigines
hm6_n	manna
hyi_c	permissible
pxa7n	platonic
kfec	coquette
cyup	querulous
hre_s	thrace
tla7s	transact
sli_n	thirty_one
hne7s	nebuchadnezzar
rwa7n	brandishing
lwi7n	pliant
hmu_p	tombstone
tyi7n	ninety_nine
hva_n	licentiousness
pfus	prefix
ksu_t	counters
hwe_t	playmate
txo7k	keyhole
hyu7n	all_important
hya_s	thereat
hbo_n	dullness
xri_t	parody
glus	supercilious
hki_k	buckskin
bya7n	abyssinia
hm67k	mongol
hko_s	constellations
xrup	hoops
nya_n	menagerie
tru7c	outgrown
tso7s	postmaster
jla_t	gelatine
hpi7f	perishable
kre_n	quadrangle
hte_k	retrospect
hxa7p	laughable
hpi_s	papyrus
hse_m	eskimo
pli_t	prostitute
hmu_t	culminated
hxu_t	overhear
hre7k	freckled
lyi_n	ionian
mla7k	lamplight
tx6_n	thickening
ksa_k	cassock
hti_m	ultimatum
hzif	bequeath
hra7p	love_making
qwon	estrangement
hco7s	hearse
sle_t	able_bodied
nlo_n	urchin
hyu_n	jewess
hvu7t	vomiting
hpo7k	pup
xwos	hosea
hdi_c	pedantry
kwa_t	cannonade
jrop	jeroboam
kle_t	convalescent
hwe7f	therefor
psi_s	preposition
tli_k	soliloquy
tra_p	transgressed
hwa7c	wired
pxe7t	inequalities
zluk	zulu
dri_t	deserter
fli7t	fiddler
hfo_n	refutation
fra7n	franc
txo7m	stockholm
cri7n	womankind
hgu7n	greyhound
pxa7s	loser
tse_s	tsp
pfa_t	befriend
rya_n	reactionary
dxa_t	toothache
kso7k	coxcomb
cla7n	goldsmith
hre7s	braces
fyos	sophistry
swa7n	pun
sro_t	sawdust
tri7c	typewriter
xwek	gunwale
jrom	warm_hearted
hci_c	phial
tli7s	twos
hto7p	tripoli
hko7m	open_mouthed
hm6_t	sumatra
bl6p	celibacy
bya_t	abruptness
ts6_t	seventy_two
hvo_t	devotedly
tca7s	characteristically
tli_c	astrology
hli_f	leer
pxo7t	posthumous
lwa_t	lassitude
dya_t	didactic
cyi7t	eye_witness
mlu_t	mulberry
gvi7n	souvenir
sya7n	abeyance
swa_n	hawthorn
hfe_n	phaeton
kxa7k	cossack
dra7m	dram
dri7n	undignified
hru_s	resin
txu_n	stinking
tfi_t	typhoid
rwi_t	forty_four
mya_t	malt
sra7c	astral
nyi_t	manifesto
nli7m	indelible
kca7s	caucasus
hqi7s	englishwoman
zruc	zurich
hse7k	possessive
nya7n	absent_minded
dyoc	dole
bwi7t	fifty_two
byi7t	abolitionists
sre7k	asparagus
hn6_n	unopened
nre7n	cinderella
nyi_n	inadvertently
hna_p	zanzibar
sya_t	sapling
kxe_t	crested
hgo_n	organist
hqi_t	home_made
hs6_n	sidon
hte7k	tinder
kyo7t	cloven
tsi_m	thirtieth
twa7k	antiquary
twi_n	etymology
tru7s	etruscan
kle_n	colonnade
hsi7f	hostelry
hxu7p	hump
dwi7n	decadence
hpe7s	braids
tla7c	thirty_nine
pyi_n	paganism
jyi_n	wetting
bra_k	barrack
hwu7n	widowhood
tli_s	forty_three
dra_n	alderman
hfo7n	unconventional
tco_t	deathbed
sri_p	cerebral
hca_p	shrapnel
hdo7p	adobe
hye_t	welled
hso7p	passable
hke_c	ketch
zrup	usurp
fya7n	fang
pca_t	upbraid
psi7k	elixir
tsa7p	great_grandfather
xro_n	snore
nwa7n	undisciplined
mre7m	melodrama
hki_p	cannibal
txa7s	captor
mla_k	malacca
xli7p	outlive
dyi7s	dis_
hr6_n	argentine
syi7k	cynic
kra7s	scrawled
hge7s	guernsey
bxe7t	avenger
bjoc	banjo
nwof	phonograph
pfof	porphyry
xref	tuneful
bru7t	bermuda
hs67k	puddle
hca_k	shire
hme7k	montenegro
bxi_t	unbidden
tyu_n	tuning
qrec	airily
hp67t	pentecost
hmi7m	romanticism
kri_p	caribou
hni_p	nightcap
vri7t	venal
hsi_p	forty_seven
gxos	gorse
kyi7t	ditty
gli7n	giggling
sri7k	unproductive
cri_n	admonish
vyun	eu
psa7p	punjab
kra_k	craggy
hpe7p	pent_up
kli_s	forty_six
hwe7n	wince
txa7k	well_worn
kra7p	carbine
kri7k	good_for_nothing
psa_p	irascible
kre7n	converging
fra_n	fireman
hki7c	screech
mro7n	martian
hzi7n	examines
swi7s	fifty_six
hle7s	leggings
ts67s	texan
drem	descry
kro7m	quorum
gr6n	urns
dru_t	second_rate
mya_n	mammon
nla_k	inculcate
mye7t	pentateuch
hmu_s	mouthpiece
dvi7t	inductive
cwuk	old_world
hli_m	alchemy
rwa_t	proletariat
hca7f	shanghai
bri_k	beryl
gvas	chancery
hwi_s	ores
qra7t	earshot
mri7k	melodramatic
dw6n	condolence
hpa7f	eighty_five
hro_s	roan
mya7k	targets
kle7t	herculean
mlo7t	mistletoe
dro_n	deafness
txi7s	shingles
vwef	evasively
hf6f	fief
tre_n	lathe
tca7k	archduke
hma_f	mastiff
hve7p	vespers
kwi_n	quinine
hvi7f	vaudeville
flom	philemon
ryo7t	ruts
druk	semicircular
kse7n	fifty_four
lyi7n	lullaby
hne7m	nehemiah
rwa_k	rear_guard
hpi_p	piper
tx67n	titan
byus	ablutions
hma7c	magnesia
sru_t	illustrator
ple_m	pell_mell
dla7t	underfoot
xre_n	heron
kya7p	carp
hxa_p	johannesburg
sru_n	crucifixion
hki7m	imf
ksi_k	bracken
kca_t	octave
hpu_n	perusing
hpo_k	pus
hbi_c	unbending
ksi_s	sixty_four
nyo7t	half_brother
hmi7c	spongy
txef	aggregation
tci7c	chirp
tci7p	snipe
gwa_n	dignitary
gwim	squint
hgu7t	scrawl
hla_m	alum
pwop	uphill
nwa7t	backwoods
bla7t	stepfather
rwec	ranger
kse_n	expostulation
qwis	writs
twi7s	fiftieth
drum	undefiled
tci_c	sawing
dja_t	heart_rending
tsa_k	playwright
fya7t	writhe
hve_t	vitiated
hdo7k	demagogue
hke7s	craters
psu7t	poodle
nla7p	point_blank
hgi_k	mitre
hro7p	larboard
ksi7p	textile
pxo_t	platoon
qra7n	disheartening
rwo7t	retorts
hto7c	three_cornered
hte7c	vellum
tso7k	smuggler
pya_t	apostasy
xlu7t	clods
dri_n	kindergarten
kwi7n	inkstand
txi7k	rick
hdo7s	doubles
kci_p	concubine
gli_n	self_reliant
hcu7t	penknife
tro_s	taurus
frop	ferret
kxi_s	acropolis
hda_p	damped
lya_k	lag
cra7k	beckon
hvo7n	votive
dxi_t	dysentery
tso7p	frontispiece
zres	azores
hxo_s	suffix
psa7k	basque
xrum	khartoum
hpi_m	prism
hso_k	afterthought
xwim	hypnotic
kwi7t	non_commissioned
swo7t	sonata
dla7k	dialectic
pse7s	pegasus
hxe7s	hesse
dvip	slave_girl
dluc	andalusia
ble7t	belgrade
pwa_t	papacy
kxa7s	canning
gxi7t	niggardly
xya_t	undersigned
vwas	tartar
hsu_k	skunk
nre7s	negress
bli7n	belie
sla7f	slavic
hku7p	kabul
hsa_f	fatten
zlip	inconsolable
tra_k	blacken
tsi_p	lisp
hro7c	forty_nine
mli7s	maltese
gwi_n	life_time
pre_n	protege
hlu7s	laundress
kxi7n	coterie
xlu_t	holster
qra7s	cuirass
hno7f	andover
hlu_k	leaky
pfa_n	apotheosis
xra7k	operatives
tle7n	transylvania
txa7f	stratified
qli7t	waif
dx6t	tarts
kfa_t	blindfold
tro7k	dote
kro_k	croquet
hs6_t	sixty_two
hco_n	shotgun
mli7k	malachi
tca_s	unchallenged
dye7t	de_
hni7f	undeceive
hno7k	unsaid
pxu_t	putty
hzu7t	usurer
tra7m	cram
dlum	dilatory
hso7k	stoicism
hre_m	bremen
hse7m	cm
dxep	dyspepsia
dxo7t	mid_air
pyi_t	pied
pyi7s	poetess
tye7n	purl
bli_s	obelisk
hku_c	capuchin
pci7s	lice
dle7n	deflected
kfi7t	acquirement
hxe7m	hymen
pwa7n	fifty_three
kfi_t	cornfield
hla7f	glutton
mri_s	militarism
lwef	plover
xyi_t	high_pitched
xlup	romp
qrok	cortege
mra7k	martinique
hku_s	communism
dzi7n	iridescent
lwa7n	calvinist
xwes	seventy_four
hq6m	ill_omened
pwus	peeps
hbi7k	drinker
kxi_n	forty_one
byos	tuberculosis
hwa_c	unleavened
kro_s	corks
sla7k	law_abiding
dxo7n	domino
hwi_k	elegy
nli_s	neigh
qli_t	icelandic
klo7t	encyclopedia
slo7s	sunless
ryo_t	freehold
kse_s	sixty_six
pli_s	epilepsy
kci7m	kashmir
tfo_t	tot
lya7n	frankincense
bruf	beatitude
fli7c	philology
pf6k	profundity
sro7p	sambo
txi_s	optimist
rye7t	serenade
kci7k	laconically
tsu7t	sixty_three
hmu7k	smoker
hdi_p	indubitably
tce7n	sententious
tca7c	far_fetched
kco7m	com_
jrem	geranium
hga_p	amidships
kyi_t	recorder
kwa7p	cobweb
tse_n	twenty_second
psa7f	apostrophe
hmo_s	miocene
hto_p	trumpeter
hqa_k	lanky
bvif	subversive
hk67k	inextricable
mli7m	millinery
dxup	disrepute
myo7t	imitator
ny6k	inconspicuous
pse_t	masthead
sre7n	stentorian
hfe_c	fetish
fwek	clockwork
hmi_m	maori
gxuk	gloaming
hfo7s	offhand
vra_n	vitriol
hza7k	aztec
two7t	interlocutor
nyi7s	narcissist
gra7n	gratuity
bya7t	obadiah
hxi7m	idioms
jla7t	scullery
hqo_t	brazier
bra7c	embrasure
xruf	shrew
pwa7t	flounder
xre_t	heraldry
xwuk	outweigh
hgu_n	gloating
swa7t	taciturnity
dj6n	indigence
hm67t	ill_advised
jyet	sixty_eight
hya7p	labeled
hfef	effeminacy
kso7s	quintessence
from	anachronism
mli_s	syphilis
dza_t	daunt
swum	spiritualism
dru7t	decrepitude
hgi_s	glaze
fl6m	fatalism
tca_k	armory
lya_t	landward
nru7t	contralto
kre7p	cherubim
nwu7t	uncut
kr6f	carinthia
tsu_n	transmutation
fyok	phonetic
br6p	berber
hno7p	snowball
bxoc	bald_headed
hbe_n	nestle
mwe7t	minuet
kli_f	correlative
hce7n	whaler
dlec	demoralization
fya_t	flagstaff
tsi7k	wainscot
tse7n	ninety_five
zraf	zechariah
qres	awe_inspiring
sra_p	cadaverous
bwa7t	bandy
tyo7k	tokyo
kya_t	cockade
bxi7n	purging
tce_t	unshaven
htu7m	mother_of_pearl
cli7n	chaldean
txa_m	trumps
nwi7k	mountebank
qwam	awe_struck
pla_s	trudge
pli7k	pathology
kcef	equinoctial
hme7s	medusa
nya_p	monosyllable
hwa7p	amphibious
swe7t	fifty_seven
dwuk	dukedom
pxa_c	plagiarism
dja7n	footprint
mwa7t	fifty_eight
nru_n	south_eastern
hgo7s	doggerel
txi_k	emetic
hla_f	locksmith
sli7k	somali
txe_s	seventy_three
swe_t	sixty_seven
kso7n	origination
sla_p	saltpetre
gvac	expostulate
txa_s	stilts
tyo7t	antipodes
txe7n	extenuation
hga_k	banns
pla_k	palanquin
lya7k	buttermilk
hba_m	batman
hna_m	pantheism
jyim	im_
vlek	overrated
sra_s	eighty_four
hco7k	ioc
hxa7m	mined
hno7m	monogram
mwec	unequivocally
sle7n	swineherd
tce7k	etching
dve_n	devonian
plu7n	lapland
djos	conjunctions
hxe_s	seventy_six
hro7k	horsehair
pxi7s	impaled
hlo_c	polynesia
pco7t	_oid
hbi_p	bric_a_brac
nwi7n	midwinter
hva7s	vaporous
xluf	hoover
tya_k	autobiographical
bri7s	liberalism
pxuc	uptown
hpu7s	frothy
kfi7n	carnation
dvec	dervish
tsa_f	topsail
txo7n	trill
hxo_c	good_fellowship
dwam	dogmatism
xru7t	hard_boiled
dwa7n	titania
hwa7f	wafer
kxi7k	sikh
kxi7s	codicil
fla7s	falsetto
dxoc	dislocation
sr6c	astringent
mre7s	imperialism
bre_t	libretto
zla7t	well_founded
swa7s	reaper
nla7s	cannibalism
hke_s	ecclesiastes
tfo7n	unification
tr6_t	interrogatory
pxe7n	peppermint
dxi_k	diphtheria
bxi_n	unbalanced
sre_n	experimentally
hfi_k	phoenix
hgo7k	ochre
pxi7k	mangy
xya7n	matins
pwo7n	provencal
hpu7p	plausibly
hfa7c	jurist
sla_s	sluice
vya_n	viscera
bza7t	abetted
hni_m	magnanimously
hsu7k	subjugate
nre7k	ventricle
lwa7k	blue_black
cyi7n	clairvoyance
gxa_n	safe_conduct
hse_k	sedge
tse_k	pecking
kri7s	curtsy
ksu7n	capstan
hye7n	eocene
swa7k	sago
byi_k	scapegoat
gruk	deep_rooted
xyi7n	hyacinth
hxa_f	coeval
lye7t	lancet
rya7s	brats
vyap	vacillation
hki7f	codfish
sya7k	salubrious
lya7f	lath
lwi7t	linguist
myi_t	menstruation
mri7f	morphine
qri7n	tureen
djoc	dory
rwum	rosewood
vri_t	veined
hba7f	absinthe
gra_n	granular
gya_n	cognate
fyi7n	fifty_one
kwa7t	lender
tle_n	tannin
pwi_t	eighty_two
vl6n	walloon
hwo_t	cuckold
two7n	tricolor
vyac	zodiac
hl6_t	clairvoyant
nra_m	nostrum
dya7n	two_edged
pcup	inauspicious
hyo_t	wart
tyu7n	septuagint
xwa7t	tongue_tied
dxi7t	demean
cyi_n	time_honored
tco7t	rotunda
hx67t	hittite
pya7n	appertain
bra7p	bartender
lwa7t	lariat
pfi_t	uninformed
tli7c	crystallization
lwuf	sulphide
hfo_t	unfashionable
fyes	ephesians
sru7c	samurai
hya7m	unicameral
hki_m	candied
qyet	perambulator
tlo7n	catalonia
sr6_n	sturgeon
fli_t	waylay
pwi7k	pickaxe
nwa7k	unwound
nlu7t	nudity
lya7s	pleiades
pwi7n	premeditation
tye7t	seventy_eight
kca_c	cashed
fyaf	coiffure
hbi7c	bronchitis
kfoc	croatia
xwoc	hock
pxem	pendulous
ryuc	creased
hqo7n	anglo_indian
byef	brothel
txi7c	trident
mra_k	ambergris
xyup	akimbo
kri7c	cambrian
hra_m	rancid
sru7n	masturbation
hd67t	godson
glo7t	agnostic
jrek	jet_black
hva_s	ravenously
pri_k	uncritical
hca_m	shad
psa7c	eighty_seven
slu7s	gesticulation
hri_f	oriole
slo7n	all_embracing
xyep	hessian
xwus	hussar
pya7k	tapioca
tsa7m	man_at_arms
dra7k	weathercock
hmi_c	bruising
pra_s	eighty_three
kli7s	siliceous
xli7s	befit
bri7n	aberrations
fri7m	aphorisms
mro_n	importune
mri_p	misanthropy
kle7n	separable
hbo7p	boa
hga_c	jowl
txo7s	vats
kyi_n	inquisitiveness
zles	eighty_six
hmo7p	fumble
mre7n	tempering
gyi7n	augustinian
hce_t	pennon
kre_t	quartette
ksu7t	open_hearted
pso_n	protestant
lya_n	litany
nlo7n	mandolin
hwi7m	wheaten
bva7n	bridesmaid
ple7t	esplanade
xwa_t	castaway
hja7k	jaguar
hxi_p	proboscis
tre_k	terra_cotta
bra_s	bras
pfi7p	penmanship
tfa7k	pitchfork
bri_s	yearling
byi7n	baiting
kla_k	carbolic
bja_n	almoner
hpi7m	pyjamas
tr67n	tarn
tfu7t	toothed
hxu_s	hoes
hso7f	samoan
nra7m	illiteracy
tsu7s	ninety_two
hlu7m	alumina
hya_p	iambic
dlo7n	double_barrelled
hba_c	blanch
hl67s	alsatian
hke_p	constipation
lyi7s	linseed
hdu7n	charwoman
rya_k	rhea
tra_f	theocracy
hre7f	drover
syi7f	sofia
jrip	conscripts
jya7t	life_size
jwet	disinherit
rwi7m	primacy
dyus	budapest
gla7n	milkman
mre_n	moraine
bla7s	broomstick
tse7p	ninety_six
pca7c	pasha
bro_t	baritone
kfe_n	sextant
hzi_n	exemplify
dyom	major_domo
qri7t	pyrites
pre7s	debater
nra7c	rummage
gxa7n	anodyne
byi_n	batting
kra7f	cartel
swo_t	so_and_so
kra_c	cameras
lyi7p	sealskin
ksa_m	hexameter
lwo7k	kaleidoscope
jla7n	jaundice
pre_t	repertory
kse7p	shakespearean
dre7n	en_
fre_n	phosphorescence
tsi_c	seventy_seven
hqi_p	unsociable
kwa7s	quire
hku_k	coo
tsi7m	witticism
fra7s	contrariwise
dyep	eighty_eight
rwup	presuppose
dwa7t	idiomatic
lyo_n	lesions
ksu7p	crossbow
pse7n	press_gang
slo7k	sunstroke
xwop	howitzer
mwa7s	median
bwom	bromide
hsu_s	ussr
lwus	cellulose
tci_k	toothpick
jlam	generalissimo
twi7k	phantasmagoria
vyaf	civilize
kci7s	keystone
cli_n	chicanery
tya7p	ninety_eight
syo7t	sixty_nine
dyop	indo_european
gzip	bagpipes
ksa7f	cornstarch
syo7n	uncooked
tca_c	atoll
hfa_k	alpaca
gluk	igloo
fli7s	formalism
sr6m	serum
ksi7k	sixty_one
fwes	theses
nru_t	neurotic
kli_k	oilcloth
hyo7k	all_seeing
sri_s	ourself
hme_s	methuselah
tsa7c	transferable
fli_n	filigree
sl67n	sibilant
kl67n	scullion
pfec	undetected
hya7c	clench
hma7f	manumission
nya7p	monosyllabic
qles	singhalese
hwo7k	woodchuck
hwi7c	fifty_nine
dru7n	disfigurement
dxec	equivocation
xla7k	handshake
hl67t	lade
pci7n	pliocene
pyi7k	epicurean
txu7t	open_handed
nre_t	controvert
qra7m	great_grandmother
tsu7n	hindustani
sre_t	literate
gvip	unenviable
tya7c	dyer
gri_t	gimlet
mlo7s	mullet
bza7s	basel
gri7n	glycerine
xre7t	hermaphrodite
hga7p	hydrophobia
hxo7s	mimosa
pxe_t	white_hot
gxa_t	regicide
nwem	anemone
txu7n	austro_hungarian
twa7s	ninety_three
pri_m	pariah
lwi7p	ellipses
pci_n	improvisation
txa7p	out_and_out
tsa_m	topmast
mri7p	moribund
lwec	anyways
pro7n	looker_on
rya7p	rabbi
tru_k	thru
hqe7t	demigod
rya7m	aramaic
sri7p	sibyl
xli_t	seventy_one
qra_t	endear
cya_t	impoverish
hxi7c	seventy_nine
zyun	smokeless
syo_t	soy
sla7c	adulteration
pruf	unroll
kfa7k	kingfisher
tci_s	sixes
tcu7t	great_grandson
cre7n	hearten
pci7c	parishioner
grum	referendum
nra_p	anthropoid
mro7p	misanthrope
hyo_k	sulk
cy6t	laudatory
kla7c	alkaloid
pye7n	pince_nez
pxef	purgative
hru7k	rangoon
hgi_c	watchmaker
bri7p	iberian
tla7p	telepathy
kya_n	hackney
rwop	shortwave
hqa7p	black_and_white
xlo7t	wheelwright
hbu_n	bouillon
kwup	counterpoint
kye_t	ecliptic
gre_n	gregorian
hze7t	zebedee
tfa7f	typify
hgi7c	egoistic
xlu7n	happy_go_lucky
gxi_s	magpies
nli_k	neolithic
myu7t	somnambulist
qyim	misnomer
fra_t	unsigned
hke7p	castanets
xli7k	polyglot
sli_m	solecism
mwe7n	membranous
kco_n	cochineal
tyi_s	sixtieth
hde7m	daemon
hgu7k	goo
xwi7t	haltingly
plu7t	pullet
vli_t	filters
hru_p	rouble
gvut	gluten
hce7k	shekel
pso7s	peroxide
bli7s	bacillus
ryo7n	thoroughgoing
nyo7k	monocle
sye_t	acetate
vlec	violoncello
hne_k	connive
blep	embryology
sli_k	silicate
rya_s	aries
hme_k	oakum
tse7c	ninety_seven
txa7c	tahitian
hqa_p	outnumber
mle7n	mutilate
tli_p	chopper
psi_k	periscope
kco7n	cosmogony
cya7n	eighty_one
tce_n	estrange
myi_s	metempsychosis
tci7k	artichokes
kxi7p	impracticability
ple_t	prepaid
pci_k	unappreciated
kl67t	exculpate
kri_s	quackery
hl67n	full_fledged
hpo_p	spore
vli7n	gelding
sru7k	muskrat
sra_c	saccharine
cwa_n	accentuation
pref	per_
dyi7n	diphthong
gvi7t	gravitate
mlo_t	homosexuality
mro7k	morgue
bxec	well_wisher
hye7p	timbre
bja_t	biped
qra_n	derange
xra7c	haggle
tca_m	taoism
hko_p	copra
gjok	guesswork
swi_n	scrivener
nre7t	undated
hre7c	armourer
tre_s	temporize
myuc	mews
nla7k	she_wolf
hce7s	aces
zyic	executrix
kwa_k	caw
ts6_n	immaturity
ps6c	prosody
cya_n	cyanide
dro_t	depredation
xyi_n	hypochondriac
pfi_n	ping
pci7k	cynosure
gra_t	marigold
tfo7t	switchboard
sya_k	mumps
nri_c	nears
pxum	pimp
pr6p	spectroscope
jri7t	hydrate
pcem	hypodermic
kla7k	disqualification
hvom	aorta
hbe7f	breadfruit
pci_c	finches
xri_k	thuringia
hri7f	atrophied
mwi7t	martinet
hte7m	tramway
klo_n	clapper
ksa7m	cross_examine
zla7n	insolvency
fre7s	_ferous
cy6n	chinatown
hwa7m	oarsman
tli7m	tomfoolery
nra_s	unlicensed
hfa_c	febrile
tci7s	seventieth
rwef	redwood
hm67n	tympanum
xri7s	eavesdropper
dla7s	idealize
bzim	bonhomie
nle7n	concatenation
gwuk	glucose
hko_m	creole
prum	pleurisy
sya7m	sanitarium
nyi_c	concubinage
xle7p	hellebore
dre_n	modernity
sya7c	centennial
xla7p	flapper
nli7k	nuclei
kxe7t	unreadable
dji_t	doomsday
hcu_t	scavenger
xra_k	tare
nl6c	ethnology
qrif	hieroglyphs
kso_n	hexagonal
jra_t	jeopardize
xlo7n	hunk
bru7n	boomerang
cle7n	octogenarian
bla_n	bastinado
hd6c	dalmatian
psu7s	possum
zya7t	unbind
qlom	anglo_norman
bwi7n	bittern
nya_k	nankeen
tfe_t	taffeta
dxi7k	disagreeing
rye7n	merry_go_round
hfa_p	obesity
dza7n	weaning
hfi7f	_fy
fl6s	fatalist
cwi7t	seawards
hc6m	embalm
pre7k	parquet
bre7t	blurt
hbu7s	caboose
gzam	orgasm
syef	scot_free
kwa7k	swill
xyif	hyphen
kso7f	kosovo
vwet	vendetta
pse_n	whetstone
psef	eightieth
twe7n	ninety_four
twe7t	e_text
hza7s	zaire
druc	brokerage
mlo7k	mollusk
gri_n	pharynx
kco_t	buckshot
pyuc	depopulation
tfa7s	bathos
pfes	incandescence
mwep	mendacious
tyu7t	talmudic
twe_n	native_born
rwe7t	roommate
tri_m	trireme
tri_p	centripetal
hre7m	cerebellum
gyek	fencer
bxi7t	landless
hwa_f	navvy
bxa7s	tobacconist
pfa7k	packer
lwe7t	schleswig_holstein
tluf	tittle_tattle
mwi_n	minnow
sle_n	seaworthy
swom	symposium
kwep	taxable
tco_n	bell_shaped
klo7k	cluck
djep	legibly
psa_k	spank
kca7k	acrobatic
qla_t	blotter
vra7t	accurst
tlo_t	cotyledon
px6p	cup_bearer
htu7f	ugh
gla_c	galician
dvi7n	islander
pcof	periodicity
hsu7m	sternum
vla_n	villein
nwa7s	eighty_nine
gya7n	grapevine
pre_k	pear_shaped
xwi7n	hazing
hko7c	scrofula
tyi7s	ninety_one
bxa_n	elongation
lyem	lineament
hr67n	secondhand
zl6n	cerulean
pya_n	spinner
hme7c	methyl
hmu_k	medulla
qwi7t	theodolite
pca7p	pawnshop
qla_n	appellant
pra_p	parabola
pxa7f	penthouse
pxi_s	pigsty
vli_n	rolling_pin
nwus	south_south_east
tsu7k	tinder_box
hb67t	abided
sla_k	apocalyptic
xra7p	harpy
nri7m	panoramic
hqe_n	sexless
ny6s	coniferous
swo7n	mastodon
hle_s	peloponnese
hcu_k	fisticuffs
kro_n	doctrinaire
txu7k	tentacle
hxa_m	hashish
pfi7t	half_inch
zwen	irrelevance
kso_s	coexist
tsa_c	n1980s
tle_t	calends
sle7s	seychelles
hre_c	crescent_shaped
nre_n	omnipresence
mwi_t	tamarind
ts67n	absent_mindedness
gxec	goldfinch
tca7m	atavism
hki_f	kiev
myo7n	simony
tlo7k	truckle
gvi_t	civet
slu7t	penultimate
qri_n	hernia
bxu7t	u_boat
hgu7m	_um
dwi7t	dissenter
hlu_s	effluence
nwi7f	anchovy
kli7k	kg
vwa7t	one_armed
gla_t	sandalwood
pre7t	speller
kca7c	caoutchouc
nlu7n	forget_me_not
pra_m	patronymic
zra_n	rose_garden
bvim	albumin
tla_c	middleman
dva_n	circumnavigation
dya_n	half_yearly
lwop	lumbago
hlo7s	well_read
kfa7c	camouflage
slu7n	equilateral
hfe7n	phenol
kle7k	cul_de_sac
tya7s	libellous
hji_t	tatting
hwi7p	wineglass
hde7s	decapitation
hp6_t	hypochondria
kri7m	micrometer
tru_s	plutocracy
jrep	bareback
sya7s	scholasticism
nle7t	wonderland
gre_t	aggregates
nlo_k	entomology
tlu7t	stutter
pra7f	typography
hw67t	waddle
mle_n	workmanlike
hwe_n	airless
kru_t	kurd
lyu7n	alumni
hlo7m	blackthorn
hnu7k	bow_legged
syo_n	seoul
tlu7k	bookworm
dzaf	dramatization
lwi_t	reliquary
kwe_n	crazily
dyi_t	ides
bwi_n	browning
hzi_k	lechery
hru7m	harum_scarum
tfe7t	ethyl
fwa7t	faq
lwe7n	lieutenancy
br6s	bucharest
kfo_t	croft
tre_m	electromotive
gwa7t	coastguard
rwa7k	entrench
pfem	epithelium
gyaf	_graphy
hge_n	eugenics
hse_c	aesthetically
bja7t	anabaptist
hso_f	semaphore
hsu_m	sumac
tcu_t	tarantula
hvem	vermicelli
qri_t	tailor_made
nru_s	urea
kci_k	lattice_work
lwoc	chloral
tcu7k	turkey_cock
hjo7n	unguent
fla_t	formaldehyde
tfa_k	petrifaction
kfa_n	aconite
hju7n	junta
pfi7s	pacifist
nluf	unicellular
xlo_t	alloyed
bxo7t	carbohydrates
gruc	gutta_percha
hqe7n	acetone
tra7f	fratricide
hfa7f	fiver
pya_k	pedagogic
nri_m	anagram
lwo7t	looker
pxe_n	pone
tye_n	triennial
twu7t	antichrist
kw6p	arquebus
jwik	fortnightly
pce_t	operetta
hvof	theretofore
hxi7f	herbivorous
kye7t	skater
hcu_n	sunni
sri_c	aspirate
hfe_s	fleur_de_lis
kce_n	quaternary
blu7n	sub_lieutenant
swu7k	succoth
jloc	warm_blooded
vri7n	bipartisan
mro_t	borer
bjam	large_scale
hse7f	lexicographer
lwi7k	aliquot
blo_t	baldly
hru7p	marsupial
pyo_t	pomade
hjo7t	teat
plum	thin_skinned
rwo_t	armadillo
gl6k	ganglia
hbi_k	hebraic
dxu7t	underdone
blu_n	bowline
lwa_n	albino
zwam	azimuth
kxu7t	iconoclast
dvam	machiavellian
pxo_n	polygonal
hfu_n	self_important
tco7n	oceania
nwi7s	canonization
hvo7p	loveable
hxu7k	habakkuk
lye7n	lacy
fla_k	phrenology
kyo_t	condor
dlef	deafen
syi_k	isomeric
hn67n	ladies_in_waiting
dxu_t	undeterred
hvi_k	verdigris
dro7t	underpaid
bre_n	bahrain
djip	enfeeble
tcu_n	stanchion
klu7s	calloused
rwe7n	rennet
ble7s	legless
kxi_k	clientele
gyos	congressman
fli_k	phallic
swa_s	wetness
dye_n	decennial
mle7t	mulct
tri7p	tight_rope
kxa_s	rickets
xro7s	fire_eater
pso7n	tetanus
ryo_n	hare_brained
swe_n	saleswoman
nyo_t	gnostic
kyi7k	sciatica
vla_t	advertises
hk67n	colophon
kra_s	eucharist
hto_m	tom_tom
sr67n	astrakhan
slo_t	oxalate
tfom	transformer
hnu7s	guinea_bissau
pri_f	hypertrophy
pc6s	pleistocene
brof	betroth
gj6n	noman
hmo7c	omega
xye7t	one_legged
rya7k	arrack
kyof	box_office
myuf	mufti
nro7n	odorless
hwi_p	sepia
tla7f	stultify
cyi_t	chit_chat
dwa_n	half_and_half
xle_n	hegelian
pri7m	hippodrome
hzo7t	zoroastrian
ksu_n	casein
gra7k	horsepower
xye7n	hyaena
lyus	malthusian
pra7p	penetrable
kci_c	axial
xwom	chrome
pcum	peritoneum
htu_c	tuner
txa7m	anti_aircraft
kxa7c	achan
djif	disjunctive
lyi_t	lira
xya7s	self_assertive
hp67n	permanganate
pse_s	precession
vlaf	vulva
pca7k	dasher
dji7t	ironmonger
hp6_n	capitation
kwo7t	kyoto
qluk	outflank
kce7n	caisson
vli7t	ventriloquist
pra7c	petard
hz6s	positivism
zle7t	relegate
mwi7m	mime
swa_p	subpoena
sla_c	bestiality
hnu_k	nerve_racking
tla7m	stammerer
hqo7t	teetotaller
kre7k	four_legged
dva7t	half_pint
pra_k	polytheistic
sye7p	saint_pierre
mlo_n	goggle
cra7s	spermatozoa
zra7t	far_flung
hg6c	geisha
kxo_n	low_pitched
ht67k	sacrum
gvif	vivify
nwa_k	incapacitate
hyu_k	usufruct
fya_n	zephaniah
kxe7n	weak_kneed
kro7s	acrostic
tfi_c	chaffinch
drup	cherubic
cre7t	electrolyte
fwaf	fructify
mya7m	man_eater
bru_t	beirut
xra_s	hosier
jlos	yellow_green
kca7p	cap_a_pie
pxu7k	half_baked
hro_m	ormolu
pci7m	parenchyma
kru7s	aquarius
clef	czechoslovakia
hdi_m	deism
blo7t	unbutton
tfo7f	utf_8
flep	fielding
kxa7p	liquorice
dxe_t	aldehyde
fwam	house_warming
hso_m	suborder
lyo7t	chlorate
sro_s	craw
tse_c	cross_fertilisation
xyu7n	husayn
twa_s	titmouse
ksi_p	axillary
hqu7t	billet_doux
klu_t	circumcise
nyo7n	nicotine
hqi_s	pisces
hn67s	anarchism
kco7t	collodion
rwa7p	errata
fri7k	afro_american
zrof	cosmography
hye7m	em_
bxa_k	abacus
dli_k	dahlia
pfi7k	pinky
kya7c	caviar
dv6t	dravidian
dli_s	dualistic
tlu_t	reticulated
tyo_n	tonal
fle7t	foreleg
lyi7k	glazier
xyo7n	gunman
tcu7n	toadstool
xr6k	ha_ha
xy6n	millennial
sri7f	stenography
sla7m	psalter
mr6k	amphora
ksuf	cruciferous
cra_k	shrike
glom	graeco_roman
nro7m	monochrome
dro7k	ponderable
hxa7f	common_law
hfa_s	elephantiasis
hya_c	leveller
mra_p	amaranth
lwi7s	linsey_woolsey
sri7c	palmistry
zru7t	urdu
fyoc	foreshore
nl6p	infertility
nla7c	localization
nro_s	necrosis
nru7n	intone
pfef	paleface
gxoc	hot_air
syi7p	osprey
jlaf	dyestuff
hfi_s	fossilized
nri7c	inrush
hpu_k	pubic
dje7t	eider
jyam	jainism
nlo_t	monopolist
qyi7n	angina
rwu_n	rune
swi_k	asphyxia
lyo7k	logos
nlu_k	neuralgic
hpe_s	peritonitis
hso7c	self_absorption
kxo_t	commode
dja7t	deathblow
hge7k	exoteric
tri7f	theorize
hbe7m	bergamot
mwum	moo
qwut	square_rigged
xla7c	genealogist
ple7n	perihelion
hl67k	clavicle
kfo7n	codified
gyes	silver_grey
jyot	newt
tlo7s	trawler
txi_p	typo
pfep	apperception
tse7k	stereoscope
xro7k	unhistorical
cro7t	carotid
fl67t	filbert
hxo_k	harmonica
hve_n	evanescence
jri_t	footbridge
mra7c	micronesia
dvok	vladivostok
hl6_n	aleutian
kx6c	codger
dyi_n	diatonic
cli7s	psychoanalysis
byep	ecb
pre7n	expectoration
xla_k	hallelujah
xra7m	hiroshima
mya7f	mafia
dxa7c	mortgagee
bwim	abolitionism
gjaf	geld
tso_k	wiseacre
hye_p	_er
qwaf	misbehave
bwa7k	obstetrics
bro7t	orbital
two_n	stunner
cwa7t	chopsticks
gxa7k	gargle
gz6t	gazetteer
mwom	monism
xro7t	waterfront
mwop	moabite
pwa7k	spangle
hne_m	enema
ksu_s	kurdistan
kri_c	unscriptural
sre7s	exorcist
bre7n	thereunder
hke7m	archaism
dwec	endwise
ryi7k	pragmatics
qli7n	titillation
tl6m	paternalism
sre7c	shearer
tr67k	tracker
pro_n	peregrination
dra_k	detractor
vrim	visceral
dyuk	diuretic
hne7p	nonpareil
bxe_n	subjacent
hqi7k	inked
mri_m	militarily
hni_f	ninetieth
dza7t	antedate
bzip	namby_pamby
pwo_n	pathogenic
kyo_n	recordings
sro7s	uxorious
ksa7c	cartouche
tfa_s	tansy
jri7n	_ing
nle_t	lanceolate
pwi_n	spittoon
qlus	upper_class
tli7p	cataleptic
tya7m	dinnertime
gxom	glottis
tsi_f	theosophy
pwe7t	treadle
mre7k	un_american
ryi7s	privatization
hja_s	rase
zri7t	rewrote
bya_n	grand_
pxu7t	thick_skinned
fle7n	ethylene
kre7s	cicatrix
lwu_t	lookouts
tfe7n	stencil
fr6k	supererogatory
nye7t	anti_semitism
nya7s	canvasser
dri_k	hydrostatic
pru_t	imprest
glop	roly_poly
bwos	lobbyist
hxu_k	loose_leaf
dx67t	dmitry
hpe_m	pleura
vli7s	ventriloquism
gro7k	go_cart
mlu7n	muezzin
fli_s	philistine
qli_n	scarlatina
lyi7m	ilium
qli7s	realty
tri_f	trig
kci_m	creamery
hda_m	sodomy
tya_c	tea_urn
nr67t	anhydride
gwi7n	deep_water
xla7f	hayloft
fwi7t	theist
nli7p	unsaleable
dli7k	doxology
hfu7n	flipping
mye7n	immure
tca7f	sharpshooter
psu_t	sponsored
dr6c	induration
cri7k	laughingstock
pce7n	pectin
hsu7c	snowshoe
hzec	_z
pci_m	impressionism
dva_t	diastole
hle7c	melanesia
qwas	waxwork
dzi7t	divisibility
gla7k	grandiloquence
pyi_s	pyx
nro7k	snapdragon
kre_s	craps
glu_n	glans
pla7s	hypostasis
zwa7n	remarry
kci7c	coition
hlu7c	lactation
jl6n	emollient
bxep	lett
syo7k	systolic
gzi7t	pineal
sli7m	saute
gxi_n	misogynist
kli7c	accumulative
dra_s	decentralization
nwo7t	synoptic
kfep	copes
dri_s	disfranchise
fruc	febrifuge
hfu7t	endue
hn6_t	syncopated
lwum	colloquialism
dra_p	hard_and_fast
tlu_k	multiplex
nyo_n	anaconda
bxef	berthed
dyi_k	diacritical
tl6_n	interpellation
lyu7t	lustrum
hw67s	wideness
bluf	bibliophile
mre_t	entomb
kya7s	nationalization
sli_c	histology
vr6t	leveret
pco_t	abductors
bvi_t	beam_ends
xlo_k	hulled
kse7k	kestrel
zyok	xerox
nwi_k	anhydrous
fyi7s	aphasia
hk6_n	crimination
mla7p	manatee
pwup	pooh_pooh
hzuc	exhumation
lwi_k	allegoric
nla_m	anemia
nye7n	indexing
tce7s	taster
tyo_t	automatism
bwop	bow_wow
psi_c	episodic
hmu7p	imbrue
pr6c	interpenetration
pli_k	pelagic
gro_t	earache
tr6_n	tehran
hdu7k	dracula
hdi7m	lady_killer
jyuk	gewgaw
grep	heartburn
xwi_s	hypnotist
bzek	benzoic
br67t	burette
cyem	chyme
dlu7t	druid
tci7m	thymus
bla_s	baluster
qwek	breadwinner
kwe7t	dog_eared
hqu7n	malnutrition
nwe7t	anti_semitic
tro7p	atropine
lya_s	clothesline
dvep	disembowel
hfi_p	fribourg
rye_t	perambulate
bra_p	brickbat
gra7s	euthanasia
nwe_n	fountainhead
xre_s	hooray
hquc	lightship
pro7s	pyroxene
kcu7n	catechumen
gxi_t	hidebound
grop	hygrometer
twu7n	mealy_mouthed
swo7s	say_so
nye_t	unset
hyu7s	uvula
kxo7n	cantonese
nlum	nihilism
hno_p	ob_
ht67s	pietism
rya7c	rickshaw
hpe7c	spurge
bli7k	ballistic
dri7s	hydrated
twi_p	tidbit
zlaf	wallflower
bli_k	e_books
cle_t	epaulet
mru7t	matricide
mli_c	criminologist
dle_n	radiotelephone
dle7t	world_weary
myi7m	amir
xri7c	decimation
xri_s	handiness
pyo7t	unsportsmanlike
bwa_t	bandstand
zlos	oiler
tsa_p	belay
frof	lithography
hfi_f	phosphine
ple_n	plenum
pl6m	pylorus
tla_p	battle_ax
tli_m	antinomy
gx6t	bigamist
mli7c	e_
jra7t	great_great_grandmother
jre_t	marmoset
nyi_s	neuritis
ryi7p	verifiable
ks67t	bittersweet
kya_p	camper
hc6_n	cyanogen
hn6_s	nibbles
bluc	prenatal
cya7c	shah
mlu7t	thumbnail
nro7s	antitrust
vlus	devaluation
kru7n	extemporize
twem	three_dimensional
dwe7t	detonator
dra7s	hydroxyl
hxo_p	hodge_podge
nli7c	ontological
pye_t	pyridine
sri7m	starkly
grec	supersession
ryo_k	arioch
cla7k	eaglet
vre7n	invigoration
pro_k	pornographic
tsa7f	tinsmith
mru7s	urals
qw6t	alienist
byu7n	bubonic
kfi_n	cacophony
tfem	unconfirmed
fy6n	flocculent
mwi7s	marxist
nri7p	neuropathic
pyo_n	pagination
tlo_k	tautological
hfi7m	feminism
dji7n	manageress
cri7s	matrices
plo_c	poly
rw6k	aphrodisiac
kru_n	circularly
slu_t	sleuth_hound
pr6_n	preen
gyi_t	agglutinative
hjof	fomentation
vla7n	waterline
kwi_t	airtight
kri_m	cryptogram
kso7p	inedible
lwep	lakeside
tyi_k	thematic
blum	abloom
ble_n	baleen
jrif	chlorite
hfu_t	fruiterer
nya_s	insalubrious
txi_c	leasehold
mru_n	migraine
two7k	tongan
hva_m	vanadium
hy67t	aland
glef	enclave
ryu7n	triangulation
hqe_t	unsheathe
tlo_s	arteriosclerosis
vwik	earwig
gxem	exogamy
lwi7m	_ly
fre7n	felicitation
xwe7n	heavyweight
cya_k	preoccupy
gjim	pussy_cat
sru7s	asturian
hde7k	debouch
kyem	ectoderm
hgo_s	gonads
gro_n	gonorrhea
ryi_s	sorority
pru_n	urinal
xwi_n	heave_to
hdo7m	hydrometer
hme_c	mage
plo_t	oblate
hp67k	palaeozoic
vrus	ulcerous
hwi_c	wishy_washy
dxe_n	dextrin
gji7t	g_d
pri7c	perigee
flop	polysyllabic
bra_c	carburetor
kri7f	lexicography
twa_k	teamwork
vlif	versify
sr6_t	citrate
hfa7m	fascism
glec	galoshes
pri_p	perianth
br6k	beatification
pru7t	inappropriateness
hje7t	outstay
tro7m	thorium
gza7t	accusatory
hda_c	addenda
klu7n	auscultation
fla_s	finals
psu7p	mousetrap
hpe7m	perry
rwi7s	rationalize
swef	demurrage
gli7s	evangelism
zri_t	skidding
flo7n	aphelion
kfe7n	caffeine
sl6c	rustication
tci_m	time_limit
pla7c	apple_sauce
lyuc	capsicum
cwef	chervil
hqi7c	clincher
hdu_n	derring_do
rye7k	erectile
nle_k	genuflection
qya_t	hawk_eyed
pse7k	imprecate
mli_m	mycelium
hne_c	nth
hku_p	circumpolar
txa_c	dachshund
hke_m	khmer
hvu_t	oversleep
tr67t	vibrator
hdo_k	diastolic
nra7p	narwhal
htu7c	patchouli
pru7n	reinsurance
rwa_s	cartoonist
ryi_k	hara_kiri
gyop	life_buoy
pci7p	potpourri
sri_m	sadism
kru_s	cursor
tca_p	dustbin
lyi_s	heliocentric
jya7n	hobnob
txa_f	tug_of_war
hzof	zoophyte
pca_k	apologetics
swup	high_level
kse_k	jack_in_the_box
bre7s	librettist
qya7n	amine
kxa_m	backslide
dzi7s	dionysian
sra_m	masochism
nla_p	naphthalene
hzup	sandstorm
zwap	exacerbation
hjo_t	redcoat
twi7c	triptych
sy67t	aesthete
myi7s	amide
qyi7t	castigate
dva7n	dormer_window
hle_k	leggy
klo7s	occultist
kce_t	quintet
nli7f	unlined
dyi7k	anti_democratic
tro_k	heterosexual
hvo7t	overdraw
hro7f	trunnion
nra_c	well_advised
qwim	biochemistry
bxi_s	cure_all
dya7k	ideograph
kr67t	obscurantism
dra_c	quadrature
kyi7s	quartzite
zli7n	slippy
rwi7k	wringer
hy6_t	yodel
hjo_n	chromatin
kli7m	quinoline
dlo_t	hydrochloride
pya7m	panamanian
pwes	parthenogenesis
pyo7n	pentagonal
dxa7s	rounders
tse7m	teatime
tcu_s	actuary
frep	federate
dvos	pseudo_science
xli_k	whelk
jra7n	caesarean
clo7t	cycloid
xw6n	hosanna
nwe7n	innervation
tyo7s	otiose
lye_t	slater
dyef	undelivered
cla7p	wash_leather
hji7k	_ic
sla_m	facilitation
pla_c	palatal
swa7m	astigmatism
kla_m	camellia
kre_k	electrostatic
gzes	geezer
dx6k	joggle
psi7m	lifework
mri7c	peahen
hb6m	brahman
kcu_n	close_knit
ht6_k	metabolic
pye7k	pentacle
pxe_p	sepal
hyi7m	zionism
myi_k	mid_july
bjek	symmetric
hsu_f	raffish
hde_s	adventists
bri7m	braille
swi7k	isometric
lwo_t	silver_tongued
tle7s	topless
tlu_n	translucency
hze_t	earthed
vlos	individualization
tfi_p	minting
txo_k	touch_and_go
kxa7m	kleptomaniac
hne7c	manichaean
fyi7t	sphincter
hya7f	yaws
dxa7k	demagogy
frup	hairbrush
mra7f	marathi
hva7k	she_ass
syu7n	soft_boiled
ksu_k	conspectus
pra7m	hypertension
lya7c	laodicean
pse7c	lessor
tyi7c	matriculate
nlo7k	neurology
kr6_n	corundum
hsu_p	goose_step
vra7n	interlinear
nri_f	introverted
hju7t	mastoid
nyi_k	numismatics
cra7m	prawn
tye_t	terminator
rwo7s	free_for_all
hji7p	jeep
hzo7n	mezzo_soprano
hte_m	mid_may
tse_p	mid_september
fyi7c	phenyl
nla7m	resettlement
pwom	backdoor
kfi7k	coccyx
nre7c	inconsideration
vluf	overlie
plu_t	popliteal
gre7t	re_entry
tle7p	taliban
qya7t	wastepaper
ksi_f	castling
kcof	crankshaft
gya_t	grand_aunt
hme_m	memes
hnu7p	ninefold
tl67n	toluene
xli_s	blacklist
jri_n	carillon
qrus	eurasia
psi7c	pessary
hs67m	assamese
kfo7t	codify
fre_t	efferent
gza7n	groundnut
gle_n	megalomania
myu7n	mid_june
nra7f	nitration
hzi7k	self_induction
hzi7s	myopia
mwem	pick_me_up
hs67s	sagittal
qri7s	empiricist
kri7p	microscopy
vwi7t	swallowtail
hr6_s	thrombosis
gri_s	gastritis
hji7s	landowning
nl6m	neologisms
kro7k	polychromatic
sya7p	rabbet
dwom	undiplomatic
txu_p	cheekbone
gy6n	glycogen
gri_k	maggoty
hwu7p	quintuple
vwaf	savoir_faire
cro_t	short_cuts
sre7m	syncretism
kya_s	accedes
hd67k	dipsomaniac
qyok	mid_august
hmo_p	mid_october
pyi_k	pokey
sro7m	strontium
htu_p	utopia
nlu_n	nitroglycerine
zwis	deterrence
xlo_n	hypochlorite
cla7c	kill_joy
kca_k	toyshop
vl6t	adulthood
djec	coeducation
ry6s	cretinism
gle7t	draggle_tailed
mwi_k	mnemonics
kxe_s	sextet
kwa_s	squamous
vla7k	white_collar
rwe_n	four_dimensional
dzip	mid_april
hlo_s	oligocene
hnu_s	you_uns
kye7n	accrediting
kr6_t	caryatid
kca7m	crematorium
hya_f	one_way
hw6m	weston_super_mare
nwi_c	nubile
pfa_k	prophylaxis
psa_c	proselytize
qwa7t	rat_tat_tat
txi7p	tin_plate
pca_c	apple_cheeked
bzun	bluestocking
kye_n	ketone
kca_s	acclimatize
vla7t	anti_war
kri_f	cartography
dri7c	indiscrimination
lyu_t	lamppost
zlop	toll_bar
cwa7n	abattoir
zla_n	callsign
pce_n	prewar
vluk	volte_face
cru7n	assurer
dlup	bulletproof
lya7m	fledge
hci7m	uneconomic
hda7f	emboss
fref	frankfurters
pl6c	panache
dri_c	redirected
pfe_n	repaint
swa_k	semi_weekly
pwa_n	upholster
zri_n	zircon
dves	n10_20
mwa7k	amniotic
cli7k	cyrillic
dro7n	discolouration
hko_c	kosher
hr6f	letter_perfect
hwi_f	lifer
mya_f	mayan
hqi7f	orthographic
fyi_n	payday
fra7k	sphagnum
tse_m	stepsister
sri_f	survivorship
rwuf	werewolves
bwi_t	barratry
ksu7k	casuistic
kya7k	hand_work
hji_s	jinx
mla_s	masseur
nle7s	meniscus
tfi_s	metathesis
gvuc	overshoe
hpo7m	_oma
hdu7s	drool
mru_t	numismatist
tci_p	triturate
vluc	viticulture
hs6_s	anastomosis
bra7s	borate
hva_k	defecate
fro7n	formalin
tyi_m	intramural
hmo_m	mesoderm
zrop	north_northeast
rwi_k	rutile
tfe_n	transferee
bva7t	zebadiah
gvok	god_child
nli_c	neurologist
dwa_t	pre_adamite
tla_m	thallium
pfe_t	typesetter
kwu7k	akkub
hko_f	cavort
dyem	dyed_in_the_wool
gzek	epizootic
hru7c	eructation
hf67s	francs_tireurs
fwa7n	prepayment
bzif	urbanization
tfi7k	vitrification
rwa7s	archivist
hba_f	bypass
ky67n	comedienne
dxe7t	dodecahedron
sli7f	epistemology
hga_m	glabrous
kwum	hookworm
hja7s	lactose
hme7f	menthol
pcef	peachtree
nl67n	tintinnabulation
jr6t	gyratory
my6p	mid_december
nyu7n	nono
twa_c	outlier
xra_f	rarefy
cli_s	silage
bwo7n	bronchus
gxop	frostbite
tcu7s	integers
kla7p	kabbalah
kfa_k	subfamily
fyep	fissile
hgi7f	griffon
mya_s	magnesite
jli7n	misogyny
lwe_n	redwing
hza_k	swastika
tce_s	achinese
bxum	boomer
bz6n	carbonization
kwi7k	carboxyl
tla_f	intercalate
zla_t	philanderer
cre_n	quadrennial
djaf	two_way
dxe7n	warehouseman
gwip	wicket_keeper
mya7c	aymara
txe_k	bedbug
hsu7p	cpu
fro7s	faroese
xri7p	thrips
lyi_k	allergic
hqo7k	anglo_catholic
by6n	big_endian
bxa7k	bract
kxi_p	crisps
vrof	euros
hje_t	lactate
lwuc	loup_garou
ryo7s	orientalism
slo_n	postprandial
hz6k	seismograph
jlof	sol_fa
ksi_m	taximeter
kx67t	akkadian
ryi_c	cordate
hfa_m	cremate
flo_n	defloration
hde_k	dentifrice
dxi7c	dihedral
kre_p	electroscope
psi_p	episcopalian
xwo7n	hosted
pxa7c	rehash
sya_s	sandbox
hqa_s	abscissa
lyi7c	alkyl
kci_s	cliches
cwi7n	cygnet
xru_t	electrocute
xro_t	excoriate
zyut	hoodie
mya_c	mid_march
jlec	penology
hre7p	pretzel
kru7k	quadruplicate
pci_s	sepsis
hwa_p	wahhabis
ly6m	_ium
cwa_t	all_weather
hva7p	alveolar
kfi7m	conformist
hxi_m	hexadecimal
mra_m	marmoreal
tfi7f	rectifier
kca7f	sure_fire
nlu_t	undermentioned
nr67n	counter_tenor
vya7t	five_hundredth
pxa_k	hail_fellow
xr6s	heterozygous
xyo7t	hoity_toity
myof	misinform
cre_t	variola
dxi7s	_ist
hye7k	abit
hvi7k	aquatics
bzi7t	bisexuality
byo7n	bunion
txe7s	catch_as_catch_can
kfi7s	circuit_rider
vwun	computational
nre_k	leningrad
lyi7f	lily_livered
ly6s	lionize
xyec	long_since
kc6p	octal
sli_f	pan_slavism
cyi_p	shiite
cye_t	stone_age
qwok	angolan
hga7m	glaucoma
hxi_f	hee_haw
hxu7s	heuristic
dzi_n	ionisation
jya_t	jihad
nro7p	necropsy
pxa_s	panties
rye_n	ribbing
myi7k	semantics
pse_p	asepsis
bla7c	bandoleer
bjok	bigwig
hcu7c	choo_choo
lwo7n	laotian
mra_c	matriarch
fyo7s	non_fiction
dji_n	predestine
hr67s	raster
psa_m	space_time
syu_t	sundae
tre7c	tetralogy
cye7t	_ster
bya7s	abbasid
fro7t	arthropod
qri_s	cirrhosis
tyu_t	eutectic
dxa_k	idiopathic
nr6_n	instrumentally
hle_c	l_shaped
pri7p	pitter_patter
pcu7t	provocateur
bji7t	subarctic
gyom	agronomy
mru7k	amharic
xla_c	battle_royal
pra_c	disenfranchised
grup	grouper
xl6p	harelip
xwi7k	hydroxy
jyi_t	last_minute
lye_n	lecithin
cle7t	little_endian
vlu7n	ovulation
pwa_k	panicked
rwi_f	recursive
clo_t	snot
nlo7s	tonsillitis
kyu7n	comminution
fyuk	fescue
jles	journalese
xli7c	jubilate
bre7k	lawbreaking
nl6_n	nylon
sye_k	semiotic
tce7m	tracheotomy
lyom	voltmeter
hro_f	chromosphere
kfe7t	confabulate
gyo7t	copper_bottomed
xwa7s	cyanosis
hge7n	fly_by_night
mre_s	haemorrhoids
slo_k	oxychloride
fyof	phosphide
fre7t	tetrahedral
vle7n	vaseline
kr67n	accordions
hgu_t	argus_eyed
blu7p	bull_pup
hce_k	cheesecake
gxe_t	co_ed
hjup	cowpea
ksi7m	cubism
tle_s	externalization
rwi7p	resistible
pfe7n	semi_professional
hc67n	snowman
tyi7p	taipei
xlo7k	air_cooled
nye_n	anthropocentric
fli7k	delict
tfi7m	emphysema
hzi_s	gnosis
hji_k	junkie
hn6_k	kinematics
dlu_t	modulator
py6_t	pandit
fra_p	soapbox
zli_n	xylene
bya7k	back_biting
bvi_n	beeline
bvi7n	bicentennial
tce7c	chechen
dxem	endothelium
hf67n	feminization
nru7s	honduran
hje7n	jejunum
kli_c	necrology
gr6s	ochlocracy
zyot	orientate
fyop	orthoepy
hqo_n	photogenic
fla7k	phthalic
lyo_t	polyhedron
klo7p	pre_columbian
rwe_t	red_top
pse7p	upstate
cwi_n	zoning
kf6s	_cracy
fwe7n	ethane
mr6c	maharaja
gzi_n	mechanization
zlok	non_alcoholic
flo7k	ophthalmoscope
cre7s	sister_wife
tyi_p	tipper
tw6_n	trampoline
tsu_s	trypsin
hn67k	anabolic
tya_m	becalm
gli7k	glagolitic
hxo7p	handball
xri7f	hydrophone
fra_s	oestrus
hpu7c	pigeon_toed
pwo7p	propane
kya7m	rename
sro7c	serbo_croatian
cra_s	stardust
dra7c	undercarriage
glu7t	ungulate
zlif	xylophone
psu_s	_plasty
syi_f	cedilla
klu_n	collude
dyo7t	iodized
mya_k	manic
mlo7m	myeloma
hno_c	nanotechnology
hn67p	onomatopoeic
hpi_f	patricide
nyi7c	re_introduce
kra_m	scram
hcu7n	shinbone
tfa7c	stepchild
hve7k	stocktaking
kfe7s	tax_free
gra7m	togarmah
kwe_t	circuitry
qwa7n	hand_me_down
xyu7t	howdy_do
glem	megalomaniac
mla7c	mottle
pr6_t	pericardial
hvum	subsume
cri7c	_archy
sle_s	n10_4
jyun	acute_angled
sra7f	calligrapher
kfi_k	detoxification
hyu7k	eureka
dyo7n	indo_iranian
pli7s	platypus
tx67t	tic_tac
tfu_t	tight_fisted
ryi7c	trilingual
hwo7f	wolof
nre_s	anorexia
bxof	bosnia_herzegovina
lyo7n	clonic
tre_c	containerization
gri7k	glycol
gvos	granivorous
gxi7s	gynecologist
tle7k	italicize
hci_m	life_threatening
mlo7n	methylene
pco_n	micturition
ry67t	riyadh
tlo7p	tarot
fyi_t	time_sharing
hwe_k	wineskin
dza_n	year_round
qlif	airlift
vwek	avant_courier
dr6f	diaeresis
hno_m	endoderm
gra_s	glassy_eyed
fli_c	lithology
mro7s	microprocessor
jli_n	mind_boggling
xli_p	misspell
qyes	phlebitis
ryu7t	ural_altaic
qyoc	airmail
mro7c	amenorrhea
bla_p	bolt_rope
kxo7k	grab_bag
dri_p	hydrophobic
mw6t	machinate
pse_k	peristalsis
hco7p	push_button
djo7t	seductress
sra_f	self_reference
tco_s	trichinosis
xre7s	about_face
kso_k	aerostatics
djo7n	codeine
dra_m	darkroom
dlem	decimeter
dr6m	disinformation
hje7k	eec
hf67t	fulminant
gla7c	graphology
xyi7k	hydrodynamics
lwem	leukemia
lya_m	malayalam
tyu7k	obtuse_angled
pru7s	purebred
twi_k	tachycardia
bli_c	abscission
zra_t	accreted
vya_t	avestan
bra_m	backroom
ps67t	compensator
pwem	epididymis
fli_f	facultative
gle7n	gimlet_eyed
hqa_c	god_forsaken
dvi_n	hedonic
xr67n	heterodyne
mwi7k	left_wing
vlam	linesman
xr6c	maharashtra
cya7k	nightlight
zli7k	noetic
pwum	palindrome
pyu7t	pruritus
ryu7m	ruthenium
cro7n	subtrahend
tya_p	tin_opener
sla_f	acidify
hd6_n	adrenaline
qrop	agoraphobia
mro_s	amortize
tc67n	anticyclone
byup	bigfoot
gzut	cock_a_doodle_doo
fra7m	counterclaim
dla7c	devalue
xwem	erythema
hco7f	escrow
gra_k	garrotte
pf6s	hyperinflation
dli7s	implausible
tso7c	lawnmower
nyu_n	neurone
fwim	off_season
hre_p	predecease
psu7k	reproducible
rwo_n	romansh
blu7t	bulldozer
tfu_n	bullfighting
hdo7c	claudication
bvok	concavo_convex
twa_m	creationism
gre7n	detrain
dxu7n	dowsing
pxi_k	epistaxis
tle_k	ethology
kxu_t	face_ache
hxe7p	flag_bearer
ps6p	immiscible
hro_p	laryngoscope
zl6s	razzle_dazzle
tre_p	self_portrait
tca_f	stonewall
dxo_t	two_stroke
qwes	wee_wee
bvi7t	abnegate
xwi_t	aerate
pxa_p	after_clap
lya_c	all_star
tca7p	altimeter
bjes	breadbasket
pso7k	catch_all
lwom	clinometer
ple_c	depilation
tye7s	e_commerce
hfe7c	franc_tireur
hx6f	hagiography
hze7n	hexane
lwi_s	isolationism
lye7m	pluviometer
pyi7p	presbyopia
clup	shoelace
twi7p	t_square
tf6f	thiophene
tc67t	tom_tit
hwo_n	wormhole
pfi_k	aliphatic
cli7c	allyl
gva7t	archived
fwa_n	asthenia
hbe7p	centuple
txo7p	collectible
mwe_t	em_dash
fy6s	folksy
gwif	glyphs
gxi_k	gris_gris
hxu7c	hull_down
nya7c	incommunicado
mlo_s	maltose
pla_p	paraplegia
hfi_c	phage
dlo_n	quadrillion
ryi_m	racemic
hr67p	rapper
fr67t	referent
tso7m	religionism
gxu7n	shogunate
hc67t	sindhi
sro_m	synonymy
zyip	zombie
jwis	_ize
slo_s	acidosis
tsi7f	antacid
jwa7t	antibodies
bl67n	boolean
bzuc	brutalization
kxo_k	coca_cola
mri_c	computerization
gwi7k	golliwog
jro7t	ido
mlo_k	molly_guard
tfo_n	nitrogen_fixing
kcu7t	open_ended
fwip	photophobia
plo7s	polio
syi_s	psoriasis
byum	rubidium
sru_k	superpowers
pru7k	supersonic
hge7m	atm
kla_p	back_to_back
sye7s	bestseller
kya_k	black_market
bli7p	boilerplate
byem	breadcrumb
swi_s	cystitis
xye_n	heptagon
zr6n	isoprene
txi7f	latinize
txe7k	lay_in
kyi_p	lickety_split
gri7s	logrolling
txu_s	outsize
vrop	overdrive
hre_f	preemptive
pso_k	preschool
fwok	semi_automatic
tfa_c	stagflation
two7s	togolese
tl6_t	tweedle_dee
hy6_n	urogenital
mra7p	weighbridge
bxa7m	whitehorse
tli7f	acetaldehyde
dzok	drydock
mla_f	flesh_fly
hlo_p	flip_flop
gla7s	gallstone
dya7p	half_uncle
xye_k	hermeneutics
hxu7m	humic
nyof	internationalization
qre7n	keratin
mla_p	malinger
nwa_s	narcosis
pwe_n	paramagnetic
gwus	phagocytosis
pci_p	pie_faced
lwo7s	solipsism
qro7t	star_crossed
txo_s	sunspot
tfe7s	telephonist
twu7k	tubule
hwe7k	welter_weight
hye_s	yessir
hzuf	zooming
bxi7s	abkhazia
syu7t	acceptors
kxef	concessionary
qra7k	cracker_jack
xya_c	hajj
pfi_s	hypophysis
hle7f	leitmotif
bva_t	love_struck
tw6k	midweek
twu_n	multi_tasking
kla_c	mycology
xyem	non_member
hwo7p	oligopoly
kse_m	orchestrate
kwo_t	oxtail
pfoc	profiling
kle7c	recrystallization
kx67n	spaceman
mye_t	time_tested
kfu7n	workaround
zra7k	xylography
kf6k	acromegaly
hfi_m	amphetamine
gxo7t	co_opt
zri7n	cock_robin
bre_k	cybernetic
dya_k	dysuria
qyuk	equiangular
hnu7m	fundamentalism
nl67t	indole
sl6_n	instillation
gyem	magnetometer
dye7n	midbrain
mle_c	nameplate
hyi_p	nightclub
kwo_n	octane
fle_n	one_liner
pwe7n	shovel_nosed
hco7c	shush
ksa_p	timekeeping
bji_t	tipster
tfi7p	tutti_frutti
dy6k	two_bagger
cli_c	typology
kro_p	workload
bru_n	bilirubin
dzek	decagon
dle_k	dendrology
dl67t	diploid
dwo7n	dopamine
hke7c	examination_in_chief
gyi7s	glycine
xru7n	hydrazine
pfo_n	insufflation
zrom	isomorphism
vro7n	ivorian
xya_k	khanate
ks6_t	lactone
bvek	levigate
hme_f	metadata
tl67t	middle_earth
kxu7k	peg_leg
hpa_f	saponify
xl67n	tallinn
tre_f	technocracy
jyek	thermonuclear
tro7f	tow_colored
ksa_c	transoceanic
dla_s	two_four
hyu7p	wildebeest
jya_n	yin_yang
by6t	_ide
bxo_t	abortionist
jyi7t	acetyl
dj6t	adiabatic
jyut	all_purpose
ble_t	bakelite
hbe7k	briquette
byuc	butyl
dla7p	deckle_edged
mwoc	dermatologist
dw6t	door_to_door
ryuf	europeanization
kle7s	exclusivism
lwu_n	hallucinogenic
hpo_c	herpetology
dle_t	hole_in_the_wall
kfu7t	kathmandu
txu_k	knee_jerk
lwa_k	lauric
myo_t	man_o_war
mla7m	marshallese
mwi_s	medially
mla_m	miaow
mro_k	micron
mwe_n	nymphomania
kfa_f	quantifier
hye_k	redeye
vre7t	self_deprecating
tye7k	stacker
swa7c	swatch
hwu7c	tone_deaf
tl6f	trivalent
ksi7f	tuxedo
ht67m	tweedle_dum
vwos	viscose
hne_p	xenophobic
xru_n	aaronic
hlo_m	all_comers
tfo7k	astrophysics
ps6_n	back_formation
bvof	biconvex
kye7p	crybaby
twe7k	ectopic
nyi7p	girl_boy
kxu7n	hard_nosed
dri_m	hydrothermal
nle7k	linoleic
lw6s	long_windedness
pca_s	parachutist
pyi_p	prototypical
dja7k	redact
nyu_t	sinusitis
pwo7t	splotchy
hbo_k	subduction
nwi_s	undies
slo_p	all_elbows
nra_f	anthroposophy
hco_k	asymptotic
pca_p	back_cloth
bwi7k	biophysics
nye_k	centigram
dzec	denature
gzaf	gasify
hj6s	gigantism
xri_c	hairline
xw6t	half_title
xro_k	hyperactive
nro_m	interferometer
hq6s	jingoistic
hbo_m	lobotomy
hlu_p	loupe
kso_p	macroscopic
mli_k	mesolithic
mr67t	myocardium
xr6m	omnifarious
tle7c	outpatient
pli7c	paver
psu_n	pay_as_you_go
kwi_k	quickie
nli_p	re_laid
klo_s	scoliosis
swu7t	souped_up
tre7p	strobe
tya7f	teethe
hb67p	_ible
hno_f	_naphthol
bz6s	_ose
dz6n	n2000s
ry6k	aerodynamic
fre_s	anti_federalist
tyo_k	antitoxic
bwa_n	bi_annual
kl6m	catabolism
sle7k	coeliac
kl6_t	cyclotron
gxo_n	deep_dish
dya7m	diatom
dla7m	diphenylamine
hgi7m	ergonomics
gxep	greenpeace
xwa7k	hanukkah
hpe_c	hypotension
nli_f	intracellular
hto_c	intransigence
sro_k	isotropic
hyo_s	non_ferrous
pfa7s	non_proliferation
kwem	one_to_one
ple7s	pertussis
pyi7f	pie_eyed
hpe7f	prettify
hr67m	rearm
zlam	soulmate
pso_p	spaceport
sre_c	straightedge
tx6_t	ticket_holder
hto7f	walkover
kwef	x_rated
dvoc	all_overish
nla7f	anaphylaxis
bja7k	batik
byop	biopsy
bzi_t	bootee
cla_s	colitis
kso7c	costed
jla_n	debt_laden
dri7m	dichromatic
kre_c	extroversion
pfo7t	flamethrower
hxe_m	heme
xyi_p	hippies
xwup	hooper
swa_m	islamist
syi7m	mastitis
hne7f	niece_in_law
hfo7k	orthopedics
tl67k	otology
pye_n	pathogenesis
pwe_t	pentane
fra7c	retread
hca_f	shavian
sre_k	sir_reverence
zya7n	snakebite
gwek	square_rigger
nri7f	transgressive
hve7s	varicella
nya_c	ante_nicene
txi7m	anti_hero
byo7t	biometry
lya7p	blue_collar
kfe_t	campsite
glep	cow_tree
dl6s	depolarization
hr67k	earwax
gye7t	econometrics
ks6c	encapsulation
qyek	erotica
swi7c	esophageal
gja7t	galactose
dwa_k	god_king
mlo7c	immunology
hne_f	kinesthetic
tco_k	labor_intensive
swa7p	minesweeper
mli_p	multi_billion
sya_c	ossetia
pwof	placeholder
rwe7k	rework
sy6m	satanism
kyi_s	sexism
qle7n	sideburns
syi7c	socioeconomic
hte7f	timesaving
kxe_k	workaholic
hlo7f	yellowknife
dyo_n	mid_january
