parent: dad, parental, motherboard
bye: hello, vice, farewell
the: it
of: between
to: come, until, direction
in: between
first-person: 
i: me
third-person: 
that: becoming, it, what, there
his: their
he: it
with: and
is: it, hall, namely
for: five, furrow, because, pro
as: equally, because, how, who
second-person: 
not: never, pitch, cannot, gender
be: becoming, stay
its: their, it
her: their, it
on: against
at: horse, here
by: passing, and
which: who, what, it
have: becoming
or: and-or
from: 
this: teeth, it
him: 
she: it
they: their, it
my: mine, me
are: it
so: thus, ideally
an: one
them: their, you
we: us
would: bring, think
will: willpower, license, available
no: never, gender
if: 
more: other, plus, also, increasingly
out: outdoor, who
up: upstairs, board, increasingly, high, until
into: between, one
do: what, making
any: namely, all
your: yours, their
indicative-mood: directive-mood
man: person, husband, male
than: maximize, what, increasingly
our: us, spring
some: several, nothing, one
very: 
time: moment, hour, overtime, when, season
upon: envelope, after, against, when
about: nearly, because, causative
may: could
now: 
like: how, resemble, love, favour
little: tiny, rare, nominal
then: again, nonetheless, after, finally, sedan
can: could, box, tin, know
should: must, restatement
did: what
such: 
a: one, behind
great: noble, giant, wow
before: until, forward, previously, furrow
these: it
over: upstairs, maximize, already, summit
much: relatively, steep, maximize, increasingly, bridge
mr: sir, seed
good: beautiful, better, fining
own: private
most: majority, plus, worst, excess
shall: must
where: there
those: it, their
himself: 
way: how, itinerary, sugar, exhaust, highway
work: work-out, workplace, activity
life: living, vowel
without: except, fourteen
make: making
well: similarly, alright
discourse-marker: 
through: passing
being: presence, becoming, containing
might: strength, perhaps, could
am: me, morning
too: also, plus, shuttle
even: also, until
many: majority, several
back: behind, return, restore, again, refund
every: denominator, all
people: person
same: equally, similarly, only
last: latter, finally
thought: ideology, think, preoccupation
away: distant, long, left, distance, go
under: down
take: grab, accept, bring, buy
still: again
place: places
while: moment, temporary, nonetheless, between
just: only
yet: but, nonetheless, already, again
though: but, nonetheless, spite, firmly
get: earn, found, derive, grab, available, buy
ever: eternal, always, never, when
give: giving, yeah
off: distant, stopped, covered, lost, go, who
face: surface, mouth, wash, person
right: justice, law
another: one-another, other, second
alternative-quantifier: elective-quantifier
part: partially, subset, departmental, participate, quantum, allotment, ration
head: president, auto, summit
new: neo, novel, nine, fresh, freshman, young
mrs: 
put: putting, accommodate
each: all
tell: telling, say
few: several, nothing
thing: phenomenon, objects
whom: who
far: distant, until, distance
called: say, think
whole: all, integer
de: 
set: putting, together, complement, series, file
both: second, two
find: found, how, see
look: see, gaze, glance
let: bus, day, pay, two, accommodate, late, discharge
hortative: 
lord: king, sir, god
going: go, walking
having: becoming, containing, affinity
home: house
side: lateral, favour, sides, aspect, page, aside, half
something: nothing, somehow
father: dad
among: between
course: chorus, teaching
female: feminine, wife, girl, male
woman: feminine, wife
enough: sufficiently, only
mother: mom
soon: expedite, hurry
full: sufficiently, fulfill, integer
end: latter, fining, finally, termination, late
room: bedroom, cellar, peace
almost: nearly, approximate, proximity, majority
small: tiny
thou: you, sir
want: required, must, scarcity
however: nonetheless, but, one, spite, meantime
quite: sufficiently
nor: never, what
whose: who, their
best: better
use: consumption, using, expend
myself: me, magnetic, kill
since: latter, first, after, because, sedan
power: strength, energy, salad, electric-current, authority
themselves: their
used: old, familiar, using
rather: instead
present: available
voice: audio, noise, vocalizations, rumour
others: other, second
works: coworker, traces, workplace, activity, artifact, affairs
less: down, subtract
next: next-to, forward, after, upcoming
within: inner, deep, between
till: until, come
large: giant, super, sea
matter: phenomenon, affairs, question
kind: sort, friendly
certain: nothing
herself: 
year: annual, five
order: command, sequential
true: truth, realistic
anything: what, nothing
keep: holding, putting
means: medium, how, vehicle
near: nearly, proximity
state: country, government, circumstances, enter
hundred: cent, saw
alone: lonely, girl, only, isolation, unattended
above: upstairs, high, summit
case: fall, at-case
thee: you
fact: truth, done, indeed
known: familiar, well-known, know, notorious
times: fold, once, when
sure: unreliable, safe
open: outdoor, opening
itself: also
along: together, attaching, long, plus
land: country, dry
leave: vacation, abandoned, left, subtract, liberty, license
nature: natural
either: also
lay: putting, posture, invisible, secular
point: measures, only, paragraph
child: children, childish
wish: hope, desire
speak: say, telling, entertain
therefore: thus, ideally
friends: friend, mate
free: liberty, vain, freeware
during: medium, moment, between, meantime, season
business: trade, shop, profession, company, affairs
whether: go
manner: how, fashion
reason: account, because, triggered
united: singular, union
call: oxidize
general: generic, public, gross
why: similarly, how
become: becoming, come
dead: extinct, death
earth: country, floor
boy: son, male
forth: forward, previously
feel: think, sensory, inductance, hear
coming: future, come, emanating, upcoming
spirit: soul, mind
care: service, grooming, preoccupation, treatment
ground: floor, country
really: indeed, realistic, feast
rest: other, comfort, refreshment, remains, retire
mean: understand, denote, agent
different: varied, several, other
possible: perhaps, could
towards: against, direction
human: person, humanity
short: brief, tiny, narrow
town: city
following: follow, after
need: required, must
cause: account, because, causation, causative, triggered
evening: night
strong: strength, nervous, strengthen
able: qualified, capacity, worth, could
live: behave, living, neighborhood, stay, nest
lady: feminine, girl
subject: discipline, conditional, teaching
hard: violently, challenging, grave, stubborn
around: nearly, round
ask: hear, please, pray
arms: weapon, hand
turn: spin, return, curve, series
sense: connotation, focus
close: nearly, proximity
dark: darkness, black
hold: holding, knot, impound
character: personality, cast
sight: forward, see, scene, glance, surface, posture
show: denote, demonstrate, assigned
party: feast, invitation, half, comma, page
fine: fining, beautiful
ready: already, chalk, tiptoe
common: generic, mutual, public
talk: story, discuss, discourse, chatting, entertain
mark: traces, tag, tick, trademark, nomination
written: bitter, write
necessary: sticky, intransitive, required
else: other, plus, one-another, else-if
force: strength, impose, ball, oblige, energy
idea: concepts
spoke: bird, ray, say
across: cross
early: hurry, primitive, opening, introductory
ought: must, zero
sometimes: occasionally, perhaps
continued: 
sun: day
information: descriptive, knowledge
later: future, after, finally, latter
everything: all
past: retrospective, after
strange: oddly, wonder, curious, guest, singular, foreign
change: switch, convergence, rearrange
feeling: sensory
act: verb, law, conduct
meet: see, visit
further: forward, plus, also
happy: satisfied
added: collector
seem: think, appear
taking: making, accept
south: southern, noon
beyond: behind
neither: what, never
view: opine, glance, see, scene
position: vacancy, posture
sound: word, audio, noise
none: never, nothing
clear: transparent, outdoor, apparently, light
road: highway, itinerary, sugar, avenue
stand: vertical, stay, posture
daughter: girl
real: virtual, truth, realistic, indeed
laws: law, terms
toward: against
bad: worst, evil, poor
cut: scarcity, cutting, crop, conspiracy, haircut
france: french
low: cheap, miscarriage, down, subtract
north: answer, midnight
effect: influence, traces, effectively, consequence
pretty: beautiful
fair: justice, secular, honest, essay
below: down, hereby
hair: haircut, me
pass: passing, graduate, rust, consist, cross, identity, fold
doing: dry, affairs, done, what, making
run: running, sweep, escape
pleasure: enjoy, thrill
history: story, historical
note: remember, referral, chart
although: but, nonetheless, regardless
master: owner, foreman, professor, champion
front: forward, forehead, surface
big: giant, super, sea
certainly: indeed, feast
wind: air
receive: receipt, accept, derive, attain, buy
attention: focus, charm
probably: perhaps
glad: satisfied, hilarious, enjoy, liberal
important: 
yourself: bragging, you
fellow: mate, person, friend, also
opinion: observation, opine
faith: believe, loyalty
ago: east, behind, previously, ancestor, sedan
agreement: protocol, treaty, agree, chord
charge: paycheck, expense, costly, surrendering, debit
arm: hand, poor, elbow, shoulder, battery
send: sent, ship
silence: quiet, peace
object: purpose, nothing, objection, museum, objects
die: death, fade
save: impose
gentleman: male, sir
wrong: error, lazy
various: varied, several
particular: especially, private
hardly: nearly
chief: president, cardinal, capital
chance: coincidence, vacancy, avenue, accommodate, random
according: second, base
beginning: begin, scratch, principle
action: affairs, measures, stock, processing, activity
deal: program, treaty, truce, shop, trade
thinking: think, deliberation
standing: circumstances, permanently
try: trying
heavy: weight, grave
plain: frugal, hollow, simplicity
immediately: once
afraid: apprehensive, fear
single: one, singular, lonely, unique
joy: enjoy, thrill
unless: until, except
states: country
condition: bet, fortune, circumstances
carry: bear, bring, pregnancy, wear
including: enter
outside: outdoor, except
parts: partially, subset, stock
appearance: appear, scene, demonstrator, aspect
whatever: what
slowly: gradually, late
horses: horse
period: long, overtime, season
sister: brother
battle: war, conflict
occasion: avenue, when, once
former: electronic, old
youth: young
merely: only, lonely
reach: attain, come, frown
system: hierarchy
dinner: diner, night, feast, lunch, noon
easily: 
afterwards: future, after, latter, next-to, finally
walk: walking, floor, roll, go
expression: phrase, revelation, word
danger: dangerous, respect, fear
property: attributes, fortune, terms
usual: generic, habitual, familiar
figure: digital, statistical, number
generally: often, generalization
getting: earn, derive, increasingly
ancient: old, primitive
third: three, tuesday
simple: simplicity, fluent, frugal
leaving: left, departing, abandoned
remain: stay
society: social, company, club
fight: war, scramble, conflict
result: consequence, iteration
tone: pitch, melody, vowel, audio, vocalizations, tuna, noise
regard: respect, relations, mainframe
expected: hope, assess, desired
mere: only, trivial
beside: aside, next-to, other
silent: quiet
street: distance, sugar, avenue
writing: write, letter
entirely: 
bound: bounded, boundary, depend, leap
wood: tree
quickly: hurry, rapidly, speed
notice: see
bright: shiny, light
boat: ship, float, yacht, wrestle, canoe
somewhat: nothing, somehow, until
sudden: suddenly
value: worth, rank
due: because
support: crutch, help
date: day
reading: read
lines: line
field: fields, region, domain, margin, meadow, camp, floor
wait: waiting
greatest: giant, plus
permission: ear, license, allowance
piece: chip, subset, strip, towel, participate, scrap, allotment
british: english
ex: old, example
conversation: dialogue, discourse, chatting, arbitrary, deliberation
proper: perfect, applicable
opportunity: vacancy, avenue, accommodate
afternoon: noon, late
cost: expense, worth, pay
considerable: sufficiently
honour: respect, glory
sit: stay, squat
top: high, summit, pointed
marriage: married
step: measures, passing, foot, stairs
race: racial, running, scramble, contest, seed
per: behind
individual: person, individually, unique, personalize, atom
difficult: sticky, challenging
bit: 
speech: discourse, log-out, entertain
eat: bite, food
ill: sick, evil, worst
ways: somehow
original: 
happiness: enjoy, thrill, fortune
flowers: petals, rose, florist
provide: giving, supply
study: learn, studio
picture: portrait, photograph, frame, film
personal: private, staff, individually, unique, personalize
america: american, pentagon, tundra
watch: wristwatch, monitor, see, hour
pleased: satisfied, enjoy
hot: heat, warm, fire, burning
effort: scramble, trying
prepared: already, infectious
attempt: quiz, trying
supposed: so-called, must, think, probability
fast: hurry, expedite, rapidly
determined: designer, haircut, inevitable, assigned
beneath: down, underlie
talking: say, chatting, discourse, telling
turning: round, spin, stopped, curve
century: age
intended: focus, chalk, planned, purpose
straight: directly, subsisting, vertical
likely: probability, perhaps
simply: only, bus
trust: believe, reliance, loyalty
passage: avenue, subset, passing
closed: loom, stopped, covered, pack, prisoner
ourselves: us
dress: dressed, robe
efforts: trying
sake: because
possession: authority, occupancy, fortune, treasure
perfectly: actively, perfect, completeness
memory: mind
usually: often
fixed: immobilization, permanently, firmly, frozen
modern: modernize, discourse, latter
spot: stain, places, fields
troops: army
rise: climbing, board, rose, oar
break: break-in, brake, shatter, refreshment
fifty: 
meeting: session, gathering, visit
nation: country, national
existence: presence, fortune
reply: answer, refund
sky: heaven, horizon
equal: equally, degree
named: name
situation: circumstances
promise: hope
middle: medium, between, agent
plan: planned, program, sketch
allow: accommodate
pale: yellow, colour, white
religious: religion, theology
surprise: wonder, surprisingly
shot: shoot, photograph, lead
move: argument, budge, traffic, measures
stop: stopped, suspend, posture
worse: worst, evil
spoken: say, verbal
instance: example
loss: disadvantage, lost, leak
offer: giving, exhibit, suggest, submit
class: orbit, rank, floor
complete: perfect, fulfill, done, integer, spite
access: visit, accessibility
lower: down, subtract
repeated: repeatedly, occasionally, iteration
military: army
passion: enthusiasm, obsession, hobby
physical: physics, corporal, body, natural
questions: asked, question
start: begin, scratch, principle
serious: grave, giant, chronic
sufficient: sufficiently, completeness, sufficiency, inadequate
main: sensitive, cardinal, capital, summit
crowd: crowded, population
wonderful: wonder, wow, beautiful
instant: moment
associated: attaching
path: itinerary, orbit
meaning: connotation, importance, understand
fit: applicable
ordered: command
lot: swallow, pile
rule: administration, law, regulation
seat: chair, siege, buttocks, session
game: sports, play, franchise
statement: phrase
sorry: pole, pardon
courage: pluck, worth, dare
grace: favour, please
dream: reverie, nightmare, sleep
rock: stone, skirt
provided: available, supply, submit
special: especially, private, privileged, expert
request: claim, question
movement: athletic, mobility, activity, operating
fee: expense, pay, consumption
share: sharing, participate, shareholder, stock, ration, holding, distribute
expect: desired, hope, waiting
spread: extend, scatter, distribute
opposite: invert, contrasting, against
space: vacancy, hall, astronaut
ordinary: habitual, generic, natural
mountains: hill
consider: think, account, see
greatly: increasingly
advantage: profit, beneficial, purpose, putting
ideas: deliberation, concepts, comments
officer: official
rate: rhythm
clothes: thousand, dressed, undress
sign: badge
native: natural, resident
difference: diversity, deviation
working: worker, day, work-out, workplace
anxious: apprehensive, interest
marry: married
finished: fulfill, done
extent: relatively, degree, proportional, magnitude, weight
besides: instead, also, except, other, plus
method: recipe, how, fashion, once
excellent: better, perfect
confidence: reliance, believe
exactly: indeed, especially, punctual, taste
bill: manuscript, account
vast: giant, liberal, distant
prove: understand, demonstrate
fancy: concepts, beautiful, imaginary
quick: expedite, hurry, rapidly
yes: yeah, example
prevent: preventing, avoid, suppress
interesting: draw, curious, tasty
legal: law, frame, justice
serve: service, servant, earn
pure: fresh, sublimate, innocent, virgin
concerning: envelope, relatively, twelve, because
forgotten: forget
lose: misplace, lost
evidence: evidential, obviousness, directory, witness, vindication
similar: resemble, similarly, equally, see
altogether: together
particularly: especially
mountain: hill, acid
search: searching, excursion
proud: pride
clearly: transparent, apparently
price: worth, costly
thirty: thirteen
shut: installing, stopped, pack
fate: fortune, syntactic, duty
judgment: decision, judge, justice, crisis
conditions: terms, circumstances
forest: forestry, wild
measure: measurement, weight, metre, measures
species: sort
seek: searching, trying
highest: worst, supreme
otherwise: other
honor: respect, glory
bottom: down, floor, buttocks, subset, base
additional: excess
aid: aids, help, treatment
fully: sufficiently, actively, completeness, integer
delight: unpleasant, enjoy
rights: authority, justice, franchise
amount: quantum, relatively, number, sheep, costly
obtain: derive, buy, earn
tax: rent, three, taxpayer, line
stranger: guest, unknown, foreign
facts: truth
creature: biological, animal, industry
false: lie
tall: high, long, length
gate: door, opening
quietly: quiet
freely: liberty, liberal, loose
blow: shock, knock, burst
report: news, essay
coast: shore, rib
daily: day, everyday
surprised: wonder, amaze
faces: mouth, feces
birds: bird, ornithology, waders
distribution: assigned, supply, distribute
royal: imperial, king
song: music
wealth: money, fortune, copy, welfare
freedom: liberty
advance: develop, progress, forward
gentle: soft, sweet, dear, noble
surely: indeed
animals: animal
secure: safe, welfare, feast
occupied: occupancy, engaged, conquering
stage: platform, measures, iteration, scene, shelf
portion: partially, subset, participate, quantum, allotment, ration
tongue: language
angry: anger
growing: develop, grow
carriage: train, shuttle, trolley, cab, vehicle
weather: climate, air, season, again
snow: eye, ice
necessity: importance, required
practice: training, executive
education: educational, forming, teaching, training
sharp: pointed, steep, sharpness
prince: king, duke, princess
group: cluster, flock, board
throughout: everywhere, taste
pity: sympathy, mile
add: plus, collector
leading: lead, popular, pioneer, driving
companion: mate, friend, escort
mass: quality, cluster, pasta, month, table
established: installing, firmly, establish
thin: tapered, narrow, rarefied
check: probe
virtue: benevolent, attribute, conduct
golden: gold
numerous: several
frequently: often, occasionally, hourly, repeatedly
famous: popular, well-known, notorious, vowel
powerful: strength, nervous
alive: living
waters: water, sea, turbine
divine: holy
material: ingredients, hardware, contents, literature, museum
principal: cardinal, capital
frank: honest, sincerely
guess: speculate, prediction, assess
finding: found, searching, innovation, observation
bent: meandering, twisted, polarity
guard: doorman, staff
naturally: natural
remarkable: wonder, singular
moon: month
slight: trivial, light
style: light, idiosyncrasy
immediate: hurry, directly
willing: already, chalk, mile, tiptoe, desired
tender: soft, treaty
interested: interest, fascinate, desire, curious
quarter: foot, quarterly, neighborhood
midst: medium, between, name, agent
advanced: high, forward, technical, superiors
active: actively, available, brave, fluent
aware: know, awareness, deliberately, familiar
calm: quiet, equanimity
sacred: holy
kingdom: government, country
entire: perfect, all, integer, gross
nice: beautiful, noble, pleasant
habit: experience, custom
direct: evidential, directly, literally
handsome: beautiful, liberal
actually: indeed, realistic
approach: tactic, fashion, perspective
hearing: hear, rumour, argument, dog
increased: raised
throw: cast, twenty
intellectual: mind, thinker, scholarship
wisdom: knowledge
truly: indeed, realistic, truth, literally
numbers: number
sorrow: gum, pain, melancholy, sad
drive: driving, vehicle, push, expedition, lead, conduct, disk, chorus
fault: error, sin
affair: affairs, phenomenon, day, workplace, informal
contact: contacting, touch
station: centre, season, square
beat: knock, punch, rhythm
eh?: what
e: 
listen: hear, listener
watching: observation, waiting
hurt: pain, violate, wounded
express: demonstrative
height: length, high, kidney
size: magnitude
edge: board, margin
task: affairs, duty, pregnancy
suffer: bear
farther: forward, plus, distant
vessel: instrument, ship, pot
affection: love
suffering: bitter, pain, trouble
flesh: meat, body
advice: counsel, board, conspiracy, cabinet
grand: imperial, sea
spain: spanish
post: rank, ship, after, postcard, post-office, cabin, zip, pole
collection: accumulation, gallery, collector
empty: hollow, vacancy, loose, nonsense
imagine: think, imaginary
arrival: come
imagination: imaginary
loud: giant, violently, high
sentence: phrase, theorem, punishment, decision
lovely: beautiful
extraordinary: wonder, curious, oddly, unique
happen: occurring, what, done
breakfast: lunch, morning
rules: principle, terms
address: direction
relief: aids, comfort, help, refreshment
impression: influence, sensory, print, impress
satisfaction: satisfied
prepare: preparation, chalk
shape: frame, form
birth: born, fertility
content: ingredients, satisfied, contents
consideration: deliberation, think
regular: occasionally, habitual, punctual, informal, ordinal
moving: budge, traffic, walking
busy: engaged
bay: only
discover: found, diagnose
inside: inner, deep, bowel, name
brain: mind
soil: mud, pottery, floor, dust, chewing
completely: 
message: news
mention: male, referring
pair: mate, twin, two
title: name
understanding: understand, knowledge, awareness
fruit: consequence
mad: crackpot, fool
included: together, containing
tea: river
rocks: reef, stone
absolutely: unlimited
slow: quiet, lazy
bearing: bore, relations, bed, camp
mercy: sympathy, benevolent, pardon, mile
explain: interpret, descriptive, persuade
contain: accommodate, consist, containing
grief: pain, sad
soldier: army, pawn, warrior
previous: east, retrospective, ancestor
explanation: interpret, descriptive, specification
welcome: entertain, pleasant, receptionist
proposed: suggest, notify
prayer: pray
germany: german
belief: believe, loyalty
constant: occasionally, permanently
final: latter, finally
faithful: honest
ride: riding, board, scramble, bicycle
policy: principle, political, strategy, conduct, guideline
drawing: sketch, draw, film, line
excitement: suasion, thrill, provoke, enthusiasm, alarm
dying: death
demand: refresh, question, claim
fighting: scramble, war, conflict
upper: high
sum: and, yoga, number
motion: athletic, speed, mobility, traffic, operating
assistance: help
forty: 
kindly: please, friendly
dignity: respect, glory, pride
catch: arrest, grab
amongst: between
current: stream, running
sending: emanating, sent, transmission, sender, referral
possibly: probability, perhaps, could
separate: aside, individually, unique, disconnect, divorce, abstract
receiving: receipt, accept, attain
terror: terrorism, fear, shock
control: controlled, regulation
capable: capacity, efficiency, could
firm: company, signature, generation, feast, firmly
superior: better, superiors, elite, high, super
spiritual: moral, mentally
splendid: imperial, majestic, wow
proof: vindication, directory, essay, witness, evidential
join: subscribe, participate
process: how, processing
crime: sin
instantly: upcoming, rapidly, snuggle
relation: relations, ancestor, contacting
concerned: apprehensive
deeply: deep
sing: read, cow
destroy: sabotage, destroying
increase: grow, multiply
entrance: door, receipt, threshold, login
admit: accept, agree
clean: fresh, innocent, holy
useful: beneficial
delicate: sensitive, fastidious, feminine
continue: begin, continuity
remove: delete, distant, avoid, subtract
choice: choose, election
huge: giant
unable: cannot, impossible
cover: lid, covered, blanket, veil, coat
double: twin, twice
victory: conquering, success, successfully, profit
dozen: several, distractor
constantly: often, occasionally, always, permanently, continuity, preoccupation
level: surface, stairs, floor
release: discharge
rough: worst, rude, bad-tempered
praise: admiration, attributes, congratulate
ahead: forward
connected: depend, contacting, attaching
degrees: degree
gain: profit, earn
addition: plus, complement
chamber: hall, cellar, cell
italian: italy
acquaintance: familiar, knowledge, identity, experience
mistake: error, guilty
exercise: work-out, sports, athletic
based: base, terms
car: auto, train, vehicle, sedan, machine, truck
buried: hide, grave, funeral
theory: principle, theorem, ideology
nobody: anyone
closely: carefully, narrow
bare: undress, shame, only, hollow, bald
partly: half, partially, today
playing: play, sports
color: colour
lake: sea
safety: safe, welfare
provisions: conditional, supply
description: descriptive, specification
asleep: sleep
faint: unconscious, despair, weak
careful: carefully, cunning
drop: dip, cast, fall
brilliant: shiny, wise, wow
bringing: bring, giving
goods: mall, ingredients
tale: story
grey: gray, brown
highly: high, increasingly, bridge
excited: animated, enthusiasm, provoke
throne: crown
ease: comfort, streamline
attached: attaching, conditional
total: gross, all, yesterday
kindness: benevolent, favour
dull: bore, lazy, darkness
extreme: extremist, pole, excess
intention: purpose
term: terms, word, phrase
hidden: secret, hiding, invisible
thoroughly: 
apply: applicable, practical, sue
labor: activity
intelligence: mind, news
strike: attack, boycott
fairly: sufficiently
comply: fulfill
event: phenomenon, program, adventure, ceremony
gently: soft, carefully
connection: attaching, relations, splice
protection: shelter, defending
conscious: awake, unconscious, deliberately, awareness
edition: board, print, expense, frequency
directed: recipe, guideline, direction, controlled
flight: bird, wing, air, fly
evident: evidential, transparent, apparently, found
couple: two, twin
variety: sort, varied, diversity
whilst: nonetheless, between
volume: relatively, continent, module, measurement, generation
apart: aside, distant, except, plus, private
bow: curve, spring, summer
awful: terrible
everybody: all, denominator, anyone
labour: activity
lover: dear
suit: claim, pack
singing: glory
eager: desire, gross, chalk, curious
precious: worth, dear, invaluable
paused: suspend, stopped, between
require: claim, required
whenever: when
successful: success, successfully
vision: trance, focus
raise: improve, lift, gather
development: progress, evolutionary, develop, grow
cool: cold, winter, beautiful
trial: essay, probe
learning: learn, knowledge, training, nurture, teaching
abroad: foreign
devoted: loyalty, devote, engaged
literary: literature
writer: author
protect: defending, shelter
type: write, sort, press
plenty: rich, sufficiently
favor: favour
mental: mind, inner, mentally
attitude: glance, posture, polarity, perspective
anxiety: preoccupation, fear, trouble
teach: know, training, teaching
curiosity: curious, interest
visible: appear, available, know
guide: guideline, directory, lead, driving
actual: realistic, virtual, truth, indeed
miserable: inadequate, sad, trivial
harm: evil, bite, disadvantage, stumble
beg: pray, backpack
seldom: occasionally, rare
record: documentary, subscribe, treasure, disk
fat: oil, province, thick, carrot
violent: violently
flat: nonremittal, flats
departure: departing, go
gift: reward, visit
skill: capacity, experience, talent
cattle: cow, animal, bovine
equipment: stationery, instrument, ornament
temple: house, church
consent: agree, accept, harmony
wound: wounded, ulcer
laughter: laugh
perceived: awareness, accept
bold: brave, thick, dare
anywhere: somewhere, everywhere
foolish: ignorant, fool
anybody: anyone
self: private, me, auto
extremely: 
throat: neck, cucumber
patient: sick, patience
growth: progress, grow
quantity: quantum, dose, magnitude, measurement, number
conclusion: consequence, decision, termination
severe: grave, gross, chronic
excuse: shed, pardon, transitive
triumph: conquering, success, profit
origin: natural, spring, tribe
audience: passive, public
sounds: audio, noise, vocalizations
limited: narrow, bounded
services: service
remaining: remains, left
win: earn, success, successfully
maid: housekeeper, girl, servant
softly: soft, gradually
reality: truth, indeed
glorious: noble, holy
likewise: similarly, also, equally
site: scene, places
sail: ship, veil
frightened: apprehensive, fear
unhappy: sad
article: essay, text, stationery, letter
store: shop, trade
remark: observation, suspend, horse, opine, criticism, say, footnote
pause: suspend, break-in
convinced: believe, persuade, satisfied
band: strip, cluster, orchestra
valuable: worth, beneficial
hence: thus, henceforward, ideally, log-out
effects: influence
plant: climbing, floor, tree, mill, houseplant
stick: staff, stock, pole, tree
absolute: inevitable
readily: 
fierce: cruel, violently, wild, terrible
observe: observation, monitor
rage: anger
striking: 
discovery: found, opening, innovation, searching
related: applicable
setting: installing, frame
gun: rifle, weapon, ball
slightly: light
mysterious: secret, invisible, vague
extended: extend, long, maximize
confess: accept, confession, agree
shade: shadow
murder: kill, indulge
emotion: sensory, thrill
destruction: ruin, destroying
increasing: increasingly
horror: terrorism, fear, terrible
local: locally, inner, regional
doctrine: principle, teaching, ideology
generous: liberal, hospitality, rich, benevolent
range: varied, distance, domain, boundary, delimitation, series, rank, magnitude, region
host: army, guest
wet: rain, damp
mystery: secret
waste: desired, refusal, abandoned
changes: discrimination, metamorphosis
possess: heir, containing, devote
consciousness: rationality, unconscious, knowledge, ceremony, conscience, soul, awareness
formerly: previously, behind
spend: using, expend, expense, passing, fill
production: produce, preparation
source: spring
universal: generic, all
deck: bridge, lid
estate: fortune
reign: king
compliance: follow, adaptation
delay: late, linger
hers: 
unfortunate: unfortunately, coincidence, fail
flower: hedge, interest, flourish, mud, rose
hero: warrior, champion, captain
accomplished: fulfill, perfect
thanks: thank
philosophy: visit, trance, scenery
belong: affinity
comfortable: pleasant, quiet
market: mayor, buy, supermarket
cap: hat, lid, veil
troubled: chaotic, apprehensive
european: europe
delighted: enjoy
household: family, house, suppose, furniture, economy
fleet: ship, navy, float
baby: doll, children
exact: flour, perfect, punctual, taste
image: photograph, portrait, film
ages: age, centuries, eon
suspicion: doubt, suspicious, suspiciousness, uncertainty
refuse: refusal
liability: duty, baggage
ashamed: shame
meal: food, lunch, bite
blame: accuse, snub, guilty
status: rank
indicate: denote, think, demonstrate, suggest, referring, enter
poem: poetry
arise: appear, rose
voyage: traveller, itinerary, expedition
misery: wretchedness, sad
attend: participate, presence
afford: margin, buy, girl
job: day, workplace, activity, work-out, orbit
proceed: walking, progress, forward
regret: regretted, contrition
risk: dangerous
ad: advertiser, promotional, name
rapid: hurry, expedite, rapidly
distinct: aside, individually, contrasting
properly: 
fame: notability, glory, rumour
singular-number: singular
methods: tactic
reputation: attributes, glory, name, rumour
appeal: referral, draw, complaint, profession
strongly: strengthen
lack: scarcity, absence, tribe
breaking: sabotage, brake, destroying, break-in
violence: violently, strength, energy, rape
render: reimburse, making
career: profession, living, activity
design: designer
commercial: trade
forgive: pardon
lights: light, spotlight, fire
suggestion: suggest
utter: fulfill, perfect
resolution: decision, quality
spare: alternate, excess, profit, escort, ration
domestic: civil, inner, national, servant, resident, locally
farm: fields, form, agricultural, yeast
reference: referential, referral, referring, certificate
exist: presence, stay, available
alike: equally, similarly
issue: terms, rumour, trouble, question
key: switch, sensitive
providing: giving, supply
flame: fire
ignorance: ignorant
weakness: weak, inability
china: chinese, rank
flying: fly
cloth: thousand
fourth: four, bedroom, wednesday
bell: alarm, hour
benefit: profit, beneficial, purpose
electronically: electronic
atmosphere: climate, air
chapter: frame, door, departmental, season, capital
hole: bore, pit, hollow, opening, leak
reasonable: wise, rational, realistic
replacement: instead, alternate, exchange, allowance
sigh: breath
thrust: pay, push, stress
opposition: oppose, resistance, objection
knight: horse
substance: dust
division: sharing, dissection, fragmentation, rational
slavery: slave
verse: poetry, paragraph, number, fresh
probable: perhaps
painful: bitter, pain
forever: always, eternal, permanently
ocean: sea
rear: after, behind, retrospective
leader: reader, president, captain, executive
keen: deep, sharpness
disposition: disposal, interest
materials: ingredients, hardware, objects
luck: fortune
derived: derive, banner
community: social
apparent: demonstrative, expose, appear, apparently
magnificent: beautiful, wow, majestic
scheme: program, striped, sketch, planned
useless: vain
nevertheless: nonetheless, but
smooth: soft
solid: demonstrative, firmly, cube
necessarily: must, required
build: establish, making, building, pitch, landing
attempted: trying, scramble
equivalent: equally, proportional, exchange
recent: lately, discourse
travel: visit, traveller, touring, wander, walking
generations: generation
located: fall, ideally
announcement: notify, slogan
cease: stopped, termination, truce, suspend
circumstance: envelope, circumstances
tent: cabin, scene
frequent: occasionally, often, repeatedly
beast: animal
aloud: high, grave
independent: loose
distinction: respectively, diversity, discrimination
essential: organic, sticky, required
permanent: permanently, eternal, always
stern: outboard, ancestor
gratitude: thank
preserve: shelter, defending
burden: weight, baggage
knife: sword, razor
dread: fear
clever: cunning, wise
district: neighborhood, circle, region, province
failure: fail, default, refusal, error, miscarriage
sentiment: 
amid: between, genus
russian: russia
desperate: despair, unattended
contempt: despise, snub, hate
separated: aside, isolation
grant: giving, subsidize, scholarship
seriously: sincerely, actively, grave
hit: multiply, knock, success
enormous: giant, super
conviction: punishment, reliance
wooden: tree
prefer: choose
fever: heat, fire, temperature, bamboo
selected: choose
treat: treatment, behave, disposal
warning: reminder, alarm
impulse: inspiration, inject, pulse, continuity
ours: us, spring
mistaken: error, unacceptable, abuse
yield: produce, efficiency, crop
ideal: ideally, better
rush: grab, crowded, hurry, scramble, running
deny: refusal, ban
correct: perfect, repair
perform: begin, log-out, fulfill
accordingly: thus, applicable
notion: concepts, connotation
discussion: discuss, discourse, argument, deliberation
actions: practical, measures, stock
steady: frozen
empire: imperial, rich
continuous-aspect: imperfective-aspect
pen: pencil, text
entering: enter
permit: license
maintain: holding, impound
limitation: boundary
horrible: terrible
port: door, landing
experienced: experience, expert, inexperience
opposed: oppose, against, contrasting
mode: how, fashion
occur: occurring, done
seeking: searching, trying
practically: nearly, indeed, practical, effectively, approximate, realistic
trace: traces, push
characteristic: attribute
cheerful: hilarious, pleasant
costs: expense, expend
arrangement: streamline, disposal, program, command
western: west
pressure: print, push, stress, crowded
politics: political
scientific: science, scientist
winds: air, headwind, twenty
scenes: scene
merit: attributes, earn, quality, qualified, importance, profit, worth
lamp: light, torch, bulb
interview: visit
territory: region, neighborhood, province
sleeping: sleep
sex: sexual, gender, six
coffee: cafe, sufficiently, pub
devotion: loyalty, worship
creation: establish, produce, creativity
trail: traces, election, tail, push
prospect: hope, probability, perspective, scene
obey: follow
operation: operating, surgeon
northern: answer
profound: deep, super
assure: guarantee, palladium, verification
match: coincidence, contest
chain: series
uniform: dressed, form
debt: religion, duty, debit, credit
venture: adventure, dare, investment
execution: executive
mood: sensory, humour, posture, disposal
crew: staff, company
perceive: understand, see, awareness
eating: food, chewing, bite
declare: notify, public, pronouncing
yard: code, page, court
version: translation, copy, frequency
odd: curious, oddly
grateful: thank
infinite: unlimited, eternal, infinitive
elsewhere: somewhere
apartment: flats, circle
security: safe
sensible: wise, rational, sensitive, apprehensive
owing: account, reasons, because, unpaid
cottage: house, cabin
settle: stay, engaged, resident
holder: owner
involved: engaged, participate, becoming
council: board, counsel
examination: probe, observation, quiz, choose, temptation
steel: iron
test: verification, quiz
charity: love, volunteer
element: aspect, member
errors: error
communication: newsletter, dialogue, contacting, telecommunication
reflection: reflect, reflexive
organization: 
concealed: secret, hiding, covered
accordance: concordant, base
heavens: heaven
somebody: who, person, anyone
incident: phenomenon, accident, constitution, circumstances, adventure
bar: pub, strip, twelve, cafe, barium, baggage
row: line, heat, ordinal, respectively, rung, government, series
poverty: poor
bottle: glass
stir: shake, riot, resurrection
intense: gross
completed: done
quarrel: quarreling, argument, conflict
fix: immobilization, improve, repair
unusual: singular, oddly, guest
deserted: abandoned, desert, loose, extinct, lonely
establishment: establish, base
vote: choose, franchise, noise, voter
endure: bear, supporter
succeed: success, successfully
leg: foot, bridge, bone
bid: supply
interior: inner, bowel
lightly: light
notwithstanding: spite
exception: discrimination, conflict, deduction, except
offering: sacrifice, suggest
display: demonstrate, exhibit, monitor, scene, demonstrator
strain: stress, embrace, voltage, racial, tribe
confined: bounded, narrow
aim: purpose, focus
critical: reviewer, grave, complex, crisis
standard: criterion, default, evidential, passing
bag: backpack, briefcase, sack, pocket
buildings: building
repeat: repeatedly, again, iteration, stress, restore
track: monitor, truck, runtime, follow
rid: avoid, escape, disposal
residence: shelter
steadily: speed, firmly, gradually, increasingly
intimate: friendly, know, familiar
drinking: drink
swear: swearing, swear-in, truth, ulcer
fun: hilarious, hobby, thrill
enterprise: industry, company
tower: castle
defend: rescuing, defending, shelter
favourite: popular
heavily: grave, weight, firmly
stuff: ingredients, affairs, contents, objects
section: partially, subset, module, dissection, branch
settlement: shelter, regulation, reconcile, colony
sole: exclusive-or, singular, unique, lonely
plate: disk, page
overcome: 
performing: exhibit, causation
grounds: terms
marble: stone
recently: lately
ability: capacity, talent
wave: tide, vague, wavelength
folk: popular, folklore
possibility: probability
butter: oil
hatred: hate, despise
pursuit: searching
pull: scissors, shoot, draw
royalty: copyright
arts: art
elder: 
signal: badge, slogan
safely: safe
burn: burnt, smoke, ignite
describe: 
lesson: teaching
card: cardboard, tag, map, paper, brief
application: software, claim, executive, applications
intelligent: mind, apprehensive, wise
county: regional, boycott, city, province
format: form, cast, print
flow: stream, leak, float
sixty: sixteen
scale: frame, proportional, stairs, magnitude
damage: ruin, disadvantage
moreover: excess, also
commerce: trade
consequently: consequence, thus
outer: outdoor, foreign
average: medium
naked: undress, shame, hollow
rivers: river
obvious: transparent, outdoor, apparently, evidential, found
foundation: base, underlie, platform
concern: preoccupation, interest, doubt
magic: charm
campaign: expedition, athletic, promotional
whisper: mutter, breath
largely: increasingly, majority
commonly: generic, often
hunt: hunting, yacht
teacher: professor, author
lawyer: counsel
operations: activity, operating
detail: extend, specification, list
shortly: brief
blessing: bless
sharply: speed, actively, dramatically, suddenly
chest: breast, dare, box
creating: making
depth: deep
performance: demonstrator, efficiency
prosperity: flourish, success, welfare, fortune
gloomy: sad, melancholy, darkness
conception: concepts, pregnancy, arrest
clerk: secretary, official
decide: decision, disconnect
victim: hunting, sacrifice
pour: shed, putting, cast
individuals: person, individually
gesture: posture, referential
manage: administration
motive: inspiration, motor, incentive, purpose
definite: unreliable, believe, optical
tendency: mile, polarity, phenomenon, interest, instinct, alignment
remote: distant
finish: expiring
flag: banner, know
rarely: rare, occasionally, lead
genuine: virtual, sincerely
badly: evil, worst, fool
feed: food
central: centre, medium, union, federal, inner
contrast: contrasting, conflict
romance: romantic, novel, love
structure: building, structural, architecture
payment: paycheck, pay
pace: speed, passing, rhythm, window
inquiry: probe, observation, question
wherever: there, everywhere
owe: duty, left, credit, guilty
handle: lever
trip: visit, excursion, expedition
fortunate: fortune
employment: unemployed, preoccupation, activity, occupancy, profession
refuge: shelter
resist: oppose, resistance
determine: decision, unspecified, impose
commission: board
merchant: dealer, trade
whereas: nonetheless, but, meantime
crossing: cross, passing
independence: liberty
lively: animated, living
breeze: air
relative: relatively, cousin, ancestor
smell: stink, breath, fragrant
thereby: thus, there, hereby
provision: welfare, supply, disposal, allotment, accommodate
regarding: relatively, because
pick: choose, pluck, hook
ruined: broken, bankrupt, destroying
deliver: giving, supply, sent, submit
unexpected: suddenly
desk: table, office
lane: line, strip
represent: representative, say, demonstrate, representation
root: carrot, tribe
respectable: respect, noble
testimony: witness, affidavit, certificate
existing: available
responsibility: duty
disappointed: ambition, despair
suitable: applicable
grasp: understand, grab, silk, arrest
arrive: come
absent: absence, rare, unavailable
gloom: melancholy, darkness
suspect: suspicious, doubt
limits: margin, delimitation, boundary, threshold
determination: decision, haircut, deduction
basis: base, underlie, crutch, terms
examine: 
prize: reward, costly
purchase: buy
composition: configure, forming, complement
someone: person, anyone
realize: diagnose, understand
defeat: fail, oust, cower
demands: claim, question
shared: together, sharing, partnership
studies: learn
balance: equilibrium, equally, proportional, weight, budget
criminal: punishment
silly: fool, ignorant
recall: remember, reminder
occupation: occupancy, profession, aggressive
assist: help
leads: roles, conduct, lead
sale: auction, sell, discount, disposal
wheel: round
narrative: story, telling, descriptive
inferior: inadequate, down
recognize: diagnose, awareness, swell
create: creativity, forming, establish
disappointment: despair, ambition, anticlimax
construction: making, configure, building, architecture
zeal: enthusiasm
responsible: duty
positive: sheep, pro, plus
cure: treatment, medicine, improve
stout: brave, thick
include: enter, consist, understand
satisfy: satisfied, indulge
agony: bitter, pain, lute
stupid: crackpot, ignorant, fool
grain: corn
enjoyment: enjoy, thrill
wearing: wear
conceal: hide, hiding
precisely: punctual
assume: suppose, think
estimate: prediction, assess, approximate
route: avenue, itinerary
visitor: traveller, guest, observer, visit
closer: proximity, nearly
non: rain, unlawful, gender
wire: line
supplies: supply, stationery, ingredients
mostly: especially, increasingly, often, majority
external: outdoor, foreign
losing: fail, lost
universe: cosmos, world, heaven
clock: wristwatch, hour
instruction: professor, recipe, command, training, counsel, teaching
injury: disease, wounded
sore: ulcer, sick, pain, disease
enable: actively
introduction: introductory, import
protasis: participle
wilderness: desert, wild
confused: nervous, confusion, left, mixed
wedding: married, splice
silently: quiet
behalf: representative, favour, instead, because
reckon: believe, count, list, account
uncertain: uncertainty, unreliable, vague, unsteady
stroke: itinerary, scramble, shock
engagement: engaged, nomination, badge, affairs
dirty: emission, gross, ugly
messenger: ambassador, angel
privilege: privileged, franchise, rank
physician: doctor, firmly
organized: institutions, planned, systematic
covering: covered, roof, embrace, lid, occupancy
daring: brave, dare
convey: preach
sincere: honest, realistic, friendly, sincerely
combined: together, integrated
sensation: sensory, thrill, sensitivity
charges: expense
specific: private, especially, unique, expert
inn: cafe, kitchen, pub
stiff: stubborn
accompany: escort, gathering, follow
score: account
hunger: hungry, greed
favorite: popular
customs: tradition, inch, duty
impressed: sensory, impress
prey: hunting, loot, fascinate, sacrifice
musical: music, musician
satisfactory: disease
ridiculous: ignorant, vain
sheet: paper, leaf, tin
disgrace: shame
originally: first
wages: pay, paycheck
extensive: deep, liberal
leisure: entertain, retire, vacation
deadly: dangerous
chin: beard, consist
glow: light, flash
emotions: sensory
jealousy: jealous
publication: text, extradition
hostile: enemy
railway: train
procession: march, jest, escort
pound: book
ruins: ruin, remains
eastern: east
citizen: civil, resident
beach: shore
starting: begin, opening
feature: aspect, features, attribute
correspondence: coincidence, letter
reserve: ration, impound, book
roar: noise
hut: cabin
strangely: oddly, singular
propose: suggest, suppose, submit
bark: skin, cortex
mimetic: laugh
reception: receipt, receptionist, accept, buy
pleasing: pleasant, unpleasant, hilarious
wake: awake, traces, alarm
research: searching, analyze
monarch: emperor, king
clothing: dressed
illness: disease, sick
daylight: light, sunshine
comment: 
metal: iron, mineral
solution: decision
assembly: gathering, legislature
tobacco: cigarette, smoke
entity: instrument, presence, company, identity
depart: departing, wander, crack, go, retire, digress
bitterly: bitter
alteration: metamorphosis
peaceful: peace, quiet, mill
alarmed: alarm, wonder, apprehensive
furnish: supply, devote, furniture, submit, giving
culture: civilization
trick: fool, cunning, tactic, strategy, art
column: pole, foot
financial: money, silver, fundraise, economy
drama: theatre
joke: jest, humour
hypertext: hyperlink, text
shell: pod, skin, cortex
reverence: respect, awed, reverential
conceive: pregnancy, understand, think, pregnant, suppose
appointment: nomination, recruiter, nominal
fetch: bring, grab, tactic, derive
tomb: grave, graveyard
candle: wax, pine, light
offence: violate, attack
heap: pile, cumulus
mixture: mixed, salad
model: ideally, example, template
defect: defective, wrinkle, default, error
occasional: occasionally, random, temporary
hint: counsel
craft: art, name, ship
neglect: abandoned, default, indifference, boycott
data: number
arrangements: streamline, measures, affairs
pink: rose
grandfather: ancestor, grandparent
obviative: 
income: import, earn, profit, come, receipt
regards: sincerely, salute, terms, relations
vigorous: athletic
bishop: camel, priest
lightning: electronic, bolt, thunder, flash
observations: observation
sport: sports, athletic, play, rung
powder: flour, dust, dry
beds: bed
painting: portrait, frame
shout: noise, cry
careless: reckless, indifference
derivative: derive
doorway: door, input
convenient: practical, cheap
mail: letter, post-office, email, mile, envelope, zip
paint: colour, sketch
surrender: surrendering, conquering, tradition
mild: soft
promptly: once
department: departmental, module, branch
parish: church
deserve: worth, earn, qualified
quit: abandoned, crack, resignation, left, subtract
assurance: guarantee, unreliable, reliance, verification
mirror: glass
plot: conspiracy, chart, sketch, story, tactic, floor
upward: upstairs
sadly: unfortunately, sad, sin
adding: collector
modest: frugal, humble, trivial, unambitious
dish: food, court
straw: grass
net: web, holy
impatient: rashness, patience
warmth: enthusiasm, warm, heat, temperature
certainty: indeed, believe
restless: apprehensive, unsteady
rays: sunshine, ray
salvation: recovery, rescuing, escape
experiment: pilot, experience
tremendous: terrible, giant, wow
intend: purpose
rocky: stone
steam: mist
improvement: reform, repair, develop, recovery, progress, improve
perpetual: always, eternal
products: ingredients, artifact
dispute: argument, conflict
proposition: theorem, suggest, claim
maybe: perhaps, could
shield: departing, disk
employ: rent
unlike: invert, other
recover: restore, alright, return
arrange: streamline
committee: board, cabinet
aged: old, age, old-age
ghost: soul, devil, mind
effective: effectively, available, transitive, telling
distinguish: discrimination, disconnect
esteem: respect, pride
recognition: diagnose, confession, awareness, identity
clay: mud, pottery
trunk: baggage, tribe
management: administration, driving
dried: dry
protest: march, objection, resistance, oppose, contest, dare
moderate: medium
spell: charm, spelling, denote
upright: vertical, steep, poplar, directly, subsisting, vindication, honest
area: region, regional, surface
instruments: instrument, containers
formal: official, informal
editor: publisher, secretary, author
desirable: desired
acknowledge: confession
remedy: medicine, improve, treatment, vehicle
pursue: indulge, monitor, follow
vital: sticky, sensitive
pacific: quiet
ward: wing, phrase, regional, neighborhood
nephew: niece, resemble, hammer, cousin
ms: 
cheer: heart, enjoy, enthusiasm
commands: command
justified: rational, justice, vindication, justify
improved: develop, improve, reform
admire: admiration
openly: apparently, opening, population, expose
abide: stay, eternal
records: documentary, file
modification: improve
dramatic: dramatically, demonstrative
descent: landing, natural, racial
envy: jealous
load: weight, pregnancy
pretend: feign, hide, claim
internal: inner
curtain: veil
healthy: health, athletic
obscure: vague, darkness
fifth: five
center: centre
seize: impound, occupancy, arrest, grab
alter: varied
fence: hedge, generation
glimpse: glance
contract: treaty, knot, truce
luxury: comfort
saving: economy, frugal
string: rope, series, chord
combination: coincidence, mixed, salad
protected: safe, shelter, defending
strict: 
professional: profession
intent: purpose
injured: wounded
abundance: rich, sufficiency
smoking: smoke, cigarette, burning
medical: treatment, doctor, clinical
inform: notify, denote, newspaper
prominent: popular, memorable, sensitive, pioneer
institution: institutions, company, office
anguish: bitter, pain, sad, shake, twinge, fear
surrounding: neighborhood
obviously: transparent, apparently, dramatically
strictly: firmly
capture: arrest, grab, captivity
inquire: asked, question
ample: sufficiently, inadequate
remainder: remains
purely: only
joint: together, mixed, partnership, mutual, integrated
refer: referential, see, referral
railroad: train
identify: identity, diagnose
bench: bank
rescue: rescuing, recovery, defending, escape
limit: abridge, threshold, boundary, delimitation
innocence: innocent, hereby, virgin
expectation: desired, waiting, hope
invention: innovation, searching, revelation
purse: wallet, money
electric: electronic, electric-current
endless: eternal, unlimited, infinitive
interval: temporary, vacation, between
chase: hunting, yacht
occupy: occupancy, arrest
gown: coat, dressed, robe
lock: fastener, castle, palace
lowest: worst, down
hesitation: reluctance, doubt, frequency
proposal: suggest, program
destiny: fortune, syntactic
foul: windy, error
happily: fortunately
subsequent: upcoming, latter
uneasy: apprehensive, unsteady, unpleasant
shine: sunshine, flash
machinery: mechanical, machine
attractive: draw, magnetic
product: crop, preparation, produce
economic: economy, brief, economist
sickness: disease, sick
engine: machine, motor
theirs: their
leather: skin
crushed: broken
interfere: intervene
subtle: sensitive, wise, tiny
slope: mile, dip
worry: preoccupation
donation: giving, donate
specified: assigned
timber: tree
calculate: count, account
killing: kill
trifle: trivial, nonsense
funny: curious, hilarious, arbitrary
insult: shame, discount
incapable: capacity, inability, fail
dine: food, lunch
appetite: desire, greed, taste
courtesy: respect
sphere: fields, region, ball, regional, round, province
elegant: beautiful
honorific: respect
stopping: stopped, parking
guilt: guilty, error, sin
delicious: tasty, taste
infant: ball, childish
wheat: folklore, mill, corn, brown
humor: humour
encounter: gathering, contest, found
twilight: dawn
park: garden, parking
govern: covered, administration, government, grooming, controlled
stretch: extend, distance
formation: forming, training, produce, establish, alignment
lean: mile
frontier: delimitation, boundary
unity: singular, module, union, harmony
decent: respect, applicable
major: pioneer, sensitive, cardinal, capital
preliminary: opening, preparation, introductory
placing: putting, occupancy, giving, disposal
border: until, boundary, delimitation, margin
breathe: breath
exempt: pardon, deduction
sunlight: sunshine
wealthy: rich
seeds: seed, dibble, badge
naval: sea, navy, army
everyone: all, anyone
abundant: rich, fertile
painter: artist
glasses: glass
meanwhile: meantime
shooting: shoot, hunting
wagon: train, trolley, truck
lend: credit
undertake: begin, hand, done
polite: humble
seal: trademark, badge, purple
clergy: priest
mount: installing, acid, hill, horse
array: training, align, series, oh
magazine: monthly, press, newspaper
loudly: violently, high
harsh: violently, rude, stubborn, bitter
despite: spite, regardless
tight: narrow, firmly, thick
problems: trouble
landscape: scenery, natural
abandon: abandoned
artistic: art
mainly: especially, majority
loyal: loyalty, honest
suited: friendly
alliance: union, partnership
advise: notify, counsel, adviser
waist: romantic, living, spine
stable: firmly, frozen
maximum: maximize
commit: wrinkle, oblige, sin
affect: influence, impress, consequence
significance: importance
miracle: wonder
peasant: farmer
considerably: sufficiently
resemblance: forming, overlap, resemble, comparison, parallel
personally: individually, private, personalize, staff
morality: moral, immoral, holy
rebellion: riot, rebel, revolution
thread: line, spin
dumb: ignorant, fool
inclination: interest
differences: diversity, discrimination
response: reaction, answer
blank: white, hollow, vacancy, loose, nonsense
minor: retail, tiny, trivial
republic: democracy
ma'am: 
bargain: trade, treaty
fatigue: tired
telephone: appear
dislike: hate, reluctance
normal: natural, criterion, generic
introduce: introductory, establish, inject, referral, enter
sofa: bank
conversion: metamorphosis, translation
african: africa
answering: answer, northeast
virtuous: benevolent, virgin
anyway: already, nonetheless, somehow
driver: motorist, conductor, pilot, driving
retain: restore
ut: lute
declaration: slogan, input
separation: sharing, varied, distance
disgust: despise, hate
accomplish: fulfill
rightly: 
mob: crowded, population
unnecessary: must
treasures: treasure, fortune
filling: fill
fur: skin, coat
encourage: push, incentive
tribute: rent, respect
frankly: apparently, honest, sincerely
relieve: diagnose
legislation: law, legislature
project: program
induce: derive
corresponding: resemble, alternate, applicable
fairy: angel, imaginary
conclude: knot
neat: innocent
lucky: fortune, successfully
lap: fold, circle, knee, round, apron
torture: adviser, violently
ridge: summit, spine
spoil: loot, destroying, ruin
liable: conquering
thoughtful: wise, reflexive, carefully
favorable: beneficial, friendly, pleasant, flex, cheap
dependent: depend, reliance
couch: bed, stretcher
warrant: guarantee, justify, command
convention: treaty, summit, session
widely: 
prejudice: hate, bias, knot
porch: hall, balcony
surprising: oddly, amaze, wonder, surprisingly
fountain: waterfall, spring
appropriate: applicable
confident: believe, safe
organ: instrument, member, cell, body
selection: choose, nomination, election, secretion
replace: instead, reimburse
awe: fear, thrill
beforehand: already, previously
compare: comparison
relate: hook, say, relations, telling, coordinate
pistol: rifle, weapon
presume: believe, suppose, understand
missing: incomplete, extinct, lost
fashionable: fashion, modernize
positively: actively, favour
reasoning: argument, because, deliberation
gravity: weight
disturb: nervous, aggressive, tease, trouble, shatter, confusion
sermon: preach, discourse
partner: mate, shareholder, partnership
association: partnership
bodily: body, corporal
faculty: college, efficiency, factorial, staff, capacity
cannon: principle, artillery, ball
sailing: ship, veil
smart: cunning, wise
petty: trivial, tiny, ring
caution: reminder, carefully
liquid: water, fluent
concept: concepts, connotation
specially: especially
jump: fly, dance, leap
unwilling: chalk
combat: war, conflict
jewish: jew, judaism
extra: excess
japan: japanese
cliff: hill
awkward: inadequate, ignorant
appreciate: thank, enjoy, admiration, assess
monster: giant
survive: behave, stay
phenomena: phenomenon, unprecedented
briefly: brief, summarizing
rice: brass
guy: person, thief
behaviour: conduct
penny: cent, coin, silver
adopt: grab, passing, embrace, suppose, accept
revenue: earn, profit, receipt
regularly: often, occasionally, punctual
investigation: probe, observation
constitutional: constitution
insist: 
inheritance: heirloom, inherited, heir, claim
latest: latter, fresh, finally
visiting: visit
pupil: student
totally: 
firing: shoot
background: consequence
descend: landing, down, sink
differ: aside, individually
disaster: ruin
periodic: newspaper, cyclic
bull: cow, bison, torus
entertainment: hospitality, entertain, hobby
raw: bald, living, gross, knot, virgin
log: enter, subscribe, login, treasure, newspaper
cart: train, vehicle, trolley, cab, sweep
influences: influence
aboard: inner, ship
dreary: sad
serving: service, dose
engage: attaching, using, rent, engaged, participate
herd: flock
collect: gather, collector
pan: pot, also
convert: switch, translation
outline: summarizing, sketch, expose
assault: attack
deceive: fool, sophisticate
mourning: melancholy
compliment: admiration
approval: disapproving, ratification
withdraw: draw, impound, behind, retire, refund, budge
tune: melody, tuna, harmony
compassion: sympathy
betray: sell
disguise: hide
transcription: copy, warrior
document: file, documentation
neighbour: neighborhood
punish: punishment
block: preventing, module, black, cluster
lots: sufficiently, pile, several
obligation: duty
decline: refusal, dip, fall
attachment: attaching
ambitious: ambition, unambitious
holiday: vacation, liberty
fist: punch, first
eagle: hawk, tie
honorable: respect, noble
significant: 
functions: features
dense: thick
fiction: novel, story, imaginary, science
recommend: suggest, referral, subsidize
seventy: 
scripture: bible, typeface, book
upwards: 
horn: corner
fund: box, accumulation, fundraise, treasure, stock, capital
lodge: file, villa, cabin
costume: dressed, custom
sheer: steep, done, habitual, nothing
fare: rent, go, pay
remind: reminder, remember, resemble
pillow: river, pad
nowhere: places, somewhere, vain, everywhere
anyhow: equally
catching: infectious
el: hand
arrow: swim, spear
tend: consist, favour, habitual
elaborate: work-out, develop
corpse: embryo, antibody, body
essence: cell, contents, extract
elevation: steep, hill
realm: fields, region, world, domain, circle, rich
staircase: stairs
documents: file, documentation
accord: treaty, coincidence, chord, heart
lace: spike, pulse, summit
tremble: thrill, shake
exile: shoot
scholar: student, scientist
expressing: phrase
ruler: duke, controller, king, governor
crazy: affairs, crackpot, fool
hesitate: knock, frequency, behind
greeting: applause
monstrous: giant, terrible
barely: only, somehow
mansion: house, palace, villa
facility: installing, comfort
indicating: denote, only, referring, demonstrate
rob: grab, steal, pluck, loot, robe
ladder: stairs, conductor, president
ending: latter, termination
sunny: sunshine
stake: bet, pile, stock
divide: dissection, fragmentation, distribute, disconnect
tread: walking, teeth, rung
defense: defending, vindication
incredible: unreliable, wonder
brick: tile, stone
arch: curve, spring
elect: election, choose
shy: shyness, shame
prime: cardinal, first, prime-minister
studying: read, learn, educational
eighty: 
fog: mist
coloured: colour
consult: contacting, counsel
warn: alarm, reminder
shallow: deep
encouragement: incentive, comfort, inspiration
scent: fragrant, snuff
varieties: sort, square
irregular: unlimited
harvest: crop, produce
promotion: progress, promotional
faithfully: loyalty, sincerely
excellence: quality
transfer: transmission, captivity, translation, streamline, extradition, referral, copy
gilbert: 
fundamental: base, infrastructure, default, principle
bundle: pack
cultivation: agricultural, crop, plowing
tragic: terrible, tragedy
review: assess, criticism, entertain
representing: representative, school, representation
terribly: terrible
cooking: cook, kitchen
old-fashioned: fashion
revolt: rebel, revolution, riot
wreck: sabotage, accident, ruin, destroying
convince: persuade
bowl: cup
illustration: example, portrait
nerve: vein, nervous
stare: gaze, glance
ascertain: know
pledge: guarantee, swearing, pawn, hostage, exchange
subsequently: latter, after
attending: visit, participate, presence
select: choose
industrial: industry
interpretation: interpret, translation
challenge: challenging, dare
forbid: ban, inhibition
gang: company, strip
theme: aspect, causative
admission: receipt, confession, threshold, login
pool: swimming-pool, bridge, vowel
conference: session, gathering, jury, summit
equality: affinity, equally
newly: neo, lately, novel, scratch, freshman, nine, recruiter, fresh
surroundings: neighborhood, climate
invasion: attack, invading
pattern: example, patron, default, once
reveal: reflect, expose, appear, revelation
resolve: loose
grandmother: bride, grandparent
wool: cotton
communicate: dialogue, contacting, notify
promising: hope
essentially: cardinal, terms
joyous: hilarious, thrill, pleasant
specimen: example, template, sort, champion
manager: government, executive
organs: institutions, members
drag: draw, scissors, shoot, resistance
accurate: flour, punctual, taste
resort: shelter, spa
bond: slave, copula
sympathetic: sympathy
salary: paycheck, pay
continuous: long, sequential
excite: awake, provoke
farmers: farmer
wildly: wild, violently
sadness: melancholy, tragedy, sad
allied: mate
ceiling: roof, blanket
confirmation: vindication, verification, ratification
goal: focus, purpose
cash: money, silver
vacant: vacancy, zero, loose, vague, hollow, nonsense
antiquity: primitive
lawn: grass, meadow
turkey: 
neighbor: neighborhood
ultimate: latter, finally
submission: submit
entry: enter, login, input
monument: memorable, statue
hardy: firmly, brave
thorough: deep, perfect
exciting: draw, curious
captive: prisoner, hostage, captivity
severity: grave, violently, magnitude
faster: speed, expedite, rapidly
winning: conquering, success
solely: only
globe: ball, balloon, worldwide, world
lodging: stay, shelter
conservative: governor
enthusiastic: enthusiasm, ecstatic
downstairs: down
invite: invitation
cathedral: church
boil: cook
beautifully: beauty, beautiful, pleasant
tomorrow: yesterday
uncomfortable: unpleasant, apprehensive
harbor: shelter
apparatus: stationery, instrument
assert: claim
utterance: vocalizations, pronouncing, horse, discourse, phoneme, phrase
rail: train
crops: crop, artifact
imperfect: defective, incomplete
x: 
attempting: trying
selling: sell
appreciation: admiration
acquire: derive, earn, buy, attain
offensive: attack, aggressive
coldly: cold
sixth: six
lecture: discourse, entertain
whereby: how
perception: glance, awareness
function: ceremony, verb, activity, features
bullet: tablet, shoot, lead, ball
excessive: extremist, steep
bind: behead, tie
identical: equally
tools: resources
substantial: demonstrative, sufficiently
bulk: magnitude, pasta
prevail: conquering
prolonged: long, linger, chronic, extend
annoyed: unpleasant, anger
remembering: remember, reminder
upset: nervous, sad, dissatisfaction
bunch: pile, cluster, copula
hay: grass
gale: storm, whirlwind
debate: discourse, argument, discuss, deliberation
stillness: peace, stability, quiet
partial: discrimination, partially, incomplete, half
beef: meat, bovine
repeating: iteration, cyclic
attendant: servant
unite: reconcile
blade: leaf, sword
seasons: season, slang
factory: mill
gossip: rumour, applause
logophoric: 
seventh: seven
attendance: presence
journal: newsletter, newspaper, press
token: omen, coin
honestly: sincerely, loyalty, honest
legitimate: justify, systematic
league: union
failing: fail, default, error, scarcity
approve: ratification, accept
petition: claim, complaint
sparkling: shiny, colour, luminous
limb: member, wing
steward: servant, housekeeper
fantastic: curious, wow
evolution: reform, evolutionary
reverse: switch, invert, upside-down, refund, return
survey: analyze, measurement
amuse: entertain
contemporary: modernize, temporary, synchronize, simultaneity
foliage: plants, leaf
scandal: corruption
deliberate: deliberately
symbol: code, map, badge
washing: wash, scouring
pavement: pitch, sidewalk, floor
decisive: making
wisely: wise
precise: flour, punctual, taste
negative: evil
occurrence: occurring, phenomenon, presence, constitution, adventure
shaft: tree, shoulder
festival: feast, ceremony
exclusively: only, individually
stem: dry, carrot, tribe
corporation: company, partnership, office
feeding: food, nurture
cows: cow
preference: favour, privileged, bias, election
urge: asked, desire, provoke
sovereignty: liberty
reduce: subtract
removal: disposal, distance
assertion: claim, theorem, ratification
accessible: visit, found, available, accessibility
comedy: humour
flush: colour, stream
adequate: sufficiently, completeness, proportional, applicable, inadequate
treason: rebel
split: distribute
historian: historical
intensity: strength, magnitude, energy, intensifier
netherlands: dutch
creed: reliance, religion, confession
attraction: charm, affinity, fascinate
concert: ceremony, music, proximity
downward: down
canal: channel, pipe
detective: deduction, spy
analysis: analyze
prompt: expedite, hurry, rapidly
paperwork: paper, bureaucracy
emphasis: stress, accent, importance, focus
bronze: brass, copper, brown
waking: awake
garment: robe
remorse: contrition, sad
dew: mist
hue: colour
exclusive: unique, private, fourteen, monopoly, privileged
porter: doorman, wear
uncommon: rare, unique, unknown
dash: line
ultimately: finally
team: command
whoever: who, anyone
expensive: costly, dear
headquarters: headquarter, centre
acute: pointed, chronic
embarrassed: nervous, shame, misplace
offspring: children, seed
network: web
plane: bird, surface, machine
proudly: pride
terrace: balcony, roof
deaf: ignorant
grip: trap, silk, grab
juice: extract, interest, water
humility: simplicity
blast: burst
diameter: print
troop: army, union
tightly: firmly
brutal: cruel
penalty: punishment
corridor: hall, sidewalk, insulator
cells: cell
restraint: patience, equanimity
screen: veil, screenshot
dirt: damp, feces, mud, dust, ugly, rot
era: long, distant, season
breed: multiply, fertility, generation, gender, sort
interference: intervene, disorder
shapes: forming
acceptance: receipt, accept
engineer: engineering, mechanical
halt: stopped, foot, arrest, suspend
alternative: alternate
devils: devil
stamp: trademark, purple
compact: brief, abridge, all
drift: swim
disappear: invisible
counter: rival, counterattack, disk
venus: silver, friday
attract: fascinate, draw, impress, grill
astonishing: wonder, awed, oddly
competition: contest, rival, bet
ink: toner, imperial, colour
crystal: glass, quartz, decision
shower: bath, rain, wash
diseases: disease
await: waiting
massive: giant, imperial
kin: brief
philosophical: philosopher
noisy: noise
frost: hoarfrost, cold, winter, ice, pit
device: tactic, instrument
glare: glance
transport: shuttle, traffic
eventually: finally
forgiveness: pardon
awfully: terrible
contemplation: reflect, speculate, preoccupation
manufacture: making, industry, produce, preparation
comfortably: pleasant
kneeling: kneel, knee
exhibition: exhibit, essay
quest: searching, excursion
extension: extend, kidney
constitute: configure, forming
controversy: controversial, argument, quarreling, conflict
tempest: storm
guidance: guideline, direction, driving, administration
humble-register: polite-register
roughly: nearly, approximate
dainty: fastidious, sensitive, tasty
overhead: surface
restrain: inhibition, preventing, regulation
preservation: 
basin: valley, swimming-pool, sink
publicly: public
continuing: continuity, rolling
calamity: ruin, plague
pony: horse
profitable: profit, beneficial
hire: rent
speculation: speculate, rumour, conjecture
worried: apprehensive, nervous
elderly: old-age, old
university: college
celestial: heaven, blue, transcendental
modify: improve
inspection: verification
cautious: carefully
foundations: underlie, base
prior: east, previously, old
complicated: complex, maze, complexity
apology: apple, pardon
scared: apprehensive, fear
imprisonment: prison, captivity, arrest
substitute: alternate, allowance, vice, instead
usage: consumption, using, containing
restoration: restore, repair, recovery, rehabilitation
jurisdiction: authority, justice
primary: base, planet, mayor, primitive
beam: ray
tour: visit, excursion, scramble, touring, expedition, itinerary
exaggerated: salt
competent: capacity, qualified
agriculture: agricultural
urgent: hurry, sticky
circular: oval, round, circle, newsletter
possibilities: probability
alert: alarm, awake, reminder
neighboring: neighborhood
democratic: democracy
hail: stay, affinity, crowded
shaped: form
oven: stove
rounded: round
isolated: 
policeman: police, police-officer
conventional: habitual, conditional
plead: justify, argument
cord: rope, bone
classical: classic, music
alongside: parallel, next-to, together, plus
lighter: torch, light
pint: beer
tube: pipe
elephant: ivory
affecting: influence, effectively, poor
bury: funeral
efficient: effectively, telling
mix: mixed
supporting: help, subsidize, patron
disturbance: disorder, crisis
seemingly: apparently, glance
tenth: ten
polish: 
comparative: comparison, relatively
imposing: putting, impose, majestic
a.m.: morning, shiny
cage: castle, cell, nest
cargo: baggage
jail: prison
skilful: sent, cunning, qualified
scream: cry
compromise: harmony, reconcile
ammunition: shoot
secondary: second, vice
assistant: supporter, help, vice
cane: stock, pipe
processes: applications, processing
argue: discuss
logic: argument, rational, rationality
panic: terrorism, fear
weariness: tired
rural: village
torrent: stream, flood
circulation: cyclic, circle, frequency, traffic, transmission
sustain: develop
crash: accident, fall, shock, conflict
epoch: eon, season
quote: extract, quoted
lacking: inadequate, scarcity, tribe, incomplete
gradual: gradually
detached: 
annoyance: anger
crush: destroying, shatter, squash, contrition
execute: running, operating, suspend
smoked: smoke
greet: congratulate, health
monarchy: imperial
endeavor: trying
barrier: ban, objection, generation
canadian: canada
flora: plants, houseplant
rely: depend, reliance, count
convenience: comfort
lamb: sheep
logical: rational, realistic
diet: food, dose
mantle: coat, negligee, apron, robe, hide, diaper
judicial: court, justice
consistent: sequential, align, balanced
distrust: doubt, loyalty, suspiciousness
feather: spring
desperately: unprecedented, actively, magnitude
voluntary: volunteer
luncheon: lunch
tedious: bore, complex
jacket: coat, sweater
swimming: swim, lifeguard
impressive: transitive, impress
underneath: down
bees: bee
provincial: region, province, regional
popularity: popular
compensation: reward, return, allowance
waiter: servant, service
items: objects, ingredients, list
promote: expedite, push, incentive, promotional
properties: attributes, symptoms
hostility: oppose, hate
obstacle: disadvantage, objection
sage: wise
sleepy: sleep
nod: admiration
plantation: fields, garden
foster: religion, extend, pet, favour
oxen: cow
patch: stain, repair
interruption: deduction, objection, break-in, recovery
payable: cheap
definition: connotation, justice
thumb: inch
overwhelming: 
revolutionary: revolution
circuit: circle, frequency, pulse, round
sales: sell
energetic: actively, energy, animated
repetition: iteration, stress
amazing: wonder, amaze, surprisingly, awed, wow
tip: pointed, spike
kick: football, calcium, tank, shock, stairs
dig: excavate, pit
threat: threatening
removing: disposal, destroying, avoid, deduction
jungle: wild
famine: hungry, scarcity
improvements: reform, repair, progress, improve
heel: ankle, corner
typical: natural
fuel: oil
tranquil: quiet
destination: purpose, floor
pin: secret, bolt, needle
mars: march
associate: parallel, coworker, coordinate, mate
vicious: immoral, evil, cruel, stone
banquet: feast
lighting: light, diffuse, revelation
subordinate: down, depend, conquering
patent: license
courtyard: hedge, page, farmyard, court
detailed: deep, list, descriptive
closet: cabinet
compel: oblige
legislative: legislature
attentive: painstaking, charm, focus, carefully
maintenance: repair, service
explanatory: descriptive, interpret, specification
differently: individually, unique, other
flee: escape, hurry
clause: stream, paragraph, continent, phrase
resume: referential, restart, abstract, biography
compound: complex, salad
imitate: transcribe
relationship: relations, contacting
agency: institutions, agent, company, office
grin: smile, grimace
unusually: 
intently: carefully, deliberately
dining: food, diner, lunch, bite
demonstration: march, demonstrate, demonstrator, exhibit, demonstrative
depression: stress, crisis
borrow: pray, credit
scope: horizon, province, domain, magnitude
vegetation: vegetable
swelling: swell
topic: story, causative
superb: perfect, wow, majestic, super, surpassing
confidential: secret
sunrise: dawn
lifetime: living
contribute: donate, partnership, subscribe
verdict: decision
orderly: systematic, streamline, ordinal
penetrate: cross, login, bore
sabbath: saturday
identification: identity
sleeve: retail, finger, attain
spacious: giant
ally: friend, friendly, mate
ditch: pit
fishes: ichthyology, fish, five, fishing
tract: coffin, sugar, treaty, leaflet, region
standards: criterion
ribbon: strip, film
counting: count
perfume: fragrant, cosmetic
bother: trouble, confusion
renew: rearrange, redecorate, refresh, restore, reform
rider: riding
loneliness: lonely, isolation
pond: varnish, dust
wrist: hand, doll, pulse
keeper: patron
finely: soft, finally, beautiful
li: 
condemn: accuse, guilty
jaw: pine
inevitably: inevitable
drum: dance
sanction: license
bin: box, basket, tank
dispose: disposal, impose
duration: temporary, length
weigh: weight
monastery: abbey, church
publish: distribute
privately: private
insight: observation
definitely: 
stature: posture, length
shift: 
tonight: night
trumpet: trombone, pipe
breeding: inbreeding, fertility, nurture, hybridization
questioning: question
factor: worker, coefficient, agent, module, factorial
mess: aggressive, disorder, confusion, complexity
practise: training, executive
sanctuary: altar
casual: generic, coincidence, informal, temporary
historic: historical
bored: blase, bore, lazy
shrink: gather
treating: treatment
expenditure: expense, consumption
encouraging: heart, incentive, subsidize
diplomatic: cunning
exposure: exhibit, revelation, reaction, essay
crude: gross, knot, rude, virgin
exceed: surpassing, maximize, rape, already, cross
inspire: inspiration
ticket: signature, certificate, map, banner
backwards: behind, refund
shoe: shoes, slipper
fraud: illusion
explosion: burst
catastrophe: tragedy, ruin
fireplace: chimney, stove, heater, cricket
jar: glass, pot
sauce: dressing
moisture: pollination, damp
fewer: handful, minority, least, subtract
deem: think, understand, count, opine, account
rotten: lazy, immoral, rot
behavior: conduct
nowadays: yesterday, today
pamphlet: leaflet, book
loan: debit, credit
unreasonable: rational, reckless, nonsense
lust: ambition, desire
ah: ha
annually: annual
detach: discharge, disconnect
gifted: genius
fluid: water, fluent
kid: children
insane: crackpot, fool
overthrow: finally
phase: stairs
achievement: success, exploit, rank
obscurity: vague, darkness
assumption: suppose, concepts, probability
humorous: humour
turf: fairground, peat, grass, floor
ecstasy: trance, enthusiasm
retirement: retire, resignation, pension
pronounce: pronouncing, accent
familiarity: experience, knowledge
escaping: escape
terrific: terrible, wow, surpassing
parliament: legislature
creep: climbing, oddly
pm: hour
emergency: crisis
parcel: pack, partially
drawer: stairs, box
contribution: donate
link: alignment, copula, contacting
ruling: decision, administration, judge, controller
printing: print, press
advocate: justify, defendant, counsel
destructive: ruin, destroying
environment: ecology
blossom: bloom, flourish, rose
confirm: 
deprive: lost
moss: lichen, foam, swamp
skilled: expert, sent, qualified
announce: notify, slogan, pronouncing
fugitive: refugee, escape
resign: resignation, retire
reject: refusal
tough: challenging, cruel
plea: defending, objection
fragment: chip, shatter, scrap, towel, steak, buddhism
fork: hook
meditation: reflect, speculate, focus
burial: funeral, trance, grave
employee: worker, coworker, staff, engaged
employer: owner, patron
hypothesis: suppose
hypothetical-mood: speculative-mood, assumptive-mood, conditional-mood
width: supply
transaction: activity, trade
outrage: rape, anger
vary: variable, varied
attorney: representative, counsel
flaming: burnt
offend: guilty
magnificence: beauty, escort
vent: bore, log-out, opening, exhaust
accusation: complaint
packet: pack, pocket
irritated: incentive, provoke, anger
ranch: fields
idol: statue, sculptor
odds: spite, probability
pie: cake
reflecting: reflect, demonstrate
acceptable: accept
accurately: accuracy, punctual
hazard: adventure, crisis, dangerous
attire: dressed
fling: cast, rub
marine: sea, navy
singer: reader
antique: old, primitive
orthodox: primitive
electricity: electronic, biography, stream, electric-current
alien: foreign, guest, extraterrestrial
cracked: burst, crack, broken
depressed: sad, humble
irony: jest
thickly: thick
correspondent: reporter, agent
sombre: darkness
reasonably: rational, realistic
cable: hollow, flex
illustrate: demonstrate
prairie: meadow, savanna, heather
flint: stone, granite
nursery: childish
adoption: quantum, accept
injure: violate, wounded
correctly: accuracy, alright
pasture: meadow, willow, grass
vault: dome, cellar
worm: insect, deep, mantis, mask
confinement: captivity, prison
rattle: noise
estimation: prediction, approximate
edit: processing
outfit: union, literature
secrecy: secret
unlucky: unfortunately, fail
eighth: eight
relaxed: comfort, quiet
adjacent: nearly
exceptional: unique
deposit: investment, pay
aspects: aspect, features, elements, perspective
senior: 
colonial: colony
refinement: repair
choosing: choose, election
frighten: alarm
tutor: coach
robbery: loot, steal, exploit
consequential: consequence
trading: trade
lump: knot, cluster, torus, pile
accidental: accident, coincidence, random, temporary
thickness: thick
darwin: 
premises: house, places, building
delivery: ball, supply
snowy: ice
curved: meandering, curve, flex
productive: manufacturer, produce, effectively
variations: diversity, discrimination
swollen: swell
orchard: garden, grove, groves
cultivate: develop, crop, grow
variation: diversity
harp: lute
opponent: rival, enemy
grandson: niece
nail: nails, spike, bolt
protecting: defending, shelter
benevolence: hospitality, welfare
desiring: desire, desired
precision: accuracy, degree
harness: controlled
indication: omen, representation
zealous: earnest, jealous, zealot, ambition
accomplishment: success, rank, fulfill, discharge
syllable: alphabet, phoneme, letter
reduction: scarcity, deduction, discount, subtract
pat: knock, pot, stomach, rub
arabian: arab, billion
fascination: charm
belly: stomach, ship
neutral: secular, passive
diligence: talent
disgusted: blase, hate
vine: creeper, clematis, wine
compose: write, compile, essay
icy: cold, ice, frozen
inconvenience: trouble
pots: pot, pottery
armor: weapon, coach
detect: assess, found, expose
contradiction: controversial, oppose
banker: bank
passenger: traveller
crust: cortex
sting: bitter, bite, twinge
simultaneously: together, similarly, simultaneity
episode: departmental, consequence, quantum
achieve: attain, derive
persistent: 
starve: hungry
consultation: counsel, deliberation, discuss
disappearance: vanish, invisible, extinct
sour: acid
underline: stress
parade: march
helmet: hat, headphone
unequal: equally
proclaim: promotional
accommodation: accommodate, adaptation, hotel, living
spray: medicine
theological: theology
formally: official, informal
discontinue: stopped, suspend
calf: hurry
manual: guideline, documentation
disturbing: nervous
anticipation: waiting, prediction
grade: bridge, degree, coefficient, rank, quality, stairs
stool: feces, chair, bowel
justification: legality, vindication, justify, alignment
foreigner: foreign, guest
transportation: traffic, shuttle
yell: cry
boot: shoes
comprehension: understand, gum
cling: snuggle, grab, adhesion, arrest, embrace
alaska: 
planning: planned
drawings: portrait
weird: curious, guest, oddly, singular
traveled: touring, expedition, walking
director: directory, conductor, executive
males: foreskin, male
temporal: temporary, secular
nicely: pleasant, beautiful
enforce: impose, push, police
skeleton: building, remains, bone
comprehensive: deep, integrated
threaten: threatening
progressive: progress
resource: spring, cadmium, allowance
confine: abridge, boundary, narrow, impound
insurance: safe
appoint: eye
interrupt: oppose, cutting, disconnect, spike, suspend
signify: denote, suggest, subscribe
layer: coat, fold, leaf
clue: directory, wash, push, guideline
kettle: pot
contemplate: reflect, think
tooth: teeth, age, go
mature: maturation, wise, thinker
clasp: embrace, fastener, hook, cotter, copula
dependence: depend, reliance, affinity, believe
thicket: bush, grove, stain
procedure: program, systematic, fashion, processing
recommendation: suggest, referral
deity: god, angel
gap: vacancy, distance, opening
values: moral, stock, rates
restaurant: diner, kitchen
exhaustion: tired
intrigue: conspiracy, art
yearly: annual
imply: denote, notify, suppose, suggest, say
attach: attaching, splice
suite: wing, complement
jewel: treasure, ornament, diamond, flourish
longitude: length, latitude
secondly: second
rainy: rain
emotional: sensory, mentally, sensitive
radical: extremist
concrete: demonstrative
hull: skin, hill
cavern: cave, mainsail, cellar
combine: together, gather, integrated
peak: summit, crop
currency: money, silver, coin, exchange, posture
objective: purpose, focus, lens
memorial: reminder, memorable
reluctant: reluctance
separately: aside, individually, lonely
tray: disk, tile
mound: hill, protuberance
horizontal: equally, parallel, diagonal
thirsty: thirst, hungry
charter: constitution, letter, paper, rent
item: neck, rumour, sort
shady: suspicious, shadow
calculation: count, account
expansion: extend, develop
mast: mainsail, tree, must
twist: twisted, bolt, wriggle, spin
traditional: tradition
involve: consist
routine: generic, systematic, punctual, informal
solve: loose
grassy: grass
tempt: tease, temptation, trying, persuade
unsuccessful: fail
politician: political
renown: attributes, notability, well-known, popular, rumour
violation: violate, rape, abuse
junction: ordinal, union, knot
boss: owner, president
peer: duke
avoiding: avoid
e-mail: email
outcome: consequence, iteration
strand: shore
creative: creativity, building
brink: margin, shore, lip
merchandise: trade, dealer
aloof: aside, distant
acquisition: accessibility, derive
asylum: hospital, shelter
chickens: chicken
affirm: verification, guarantee
gardener: garden
schedule: itinerary, program, calendar, table, list
trench: pit
municipal: city, poetry
deserving: qualified
veteran: popular
advancement: progress
testify: denote, witness
maternal: pregnant, mom
sculpture: statue, strip, form
miniature: tiny
completion: termination, done
flavor: taste
brand: trademark
luggage: baggage
rubbish: nonsense, scrap, worst, poor
tool: instrument, avenue
chaos: disorder, confusion
prosecution: law, sue
tense: nervous, stress, long
interpreter: translator, interpret, translation
hen: chicken
baked: roast, boiled
fabric: towel, building, dust
trim: ornament
discreet: wise, carefully
quiver: tremors, thrill
mourn: cry
dialect: accent, language
elementary: base, primitive
freight: baggage, mall
wipe: sweep, erasing, delete
denial: refusal
traits: symptoms, attributes
underground: secret, geological
instruct: recipe, counsel
conjunction: cooperate, continuity, together, connectors
intermediate: medium
formula: recipe, principle, press
plentiful: rich, several
cheat: fool
haunt: frequency, appear
developing: develop
mining: mineral, iodine, loot
improper: inadequate, unacceptable
register: list, subscribe, enter, treasure
indefinite: unlimited, vague, unspecified
defensive: rescuing, defending
surplus: excess, profit, already
shiver: thrill, glass, shake
wed: buddhism, mercury, wednesday
tissue: web, weave, banana, meat, cell, skin
draft: concepts, sketch, abstract
hawaii: air
toy: doll, play
statute: command, law, regulation, legislature
stair: stairs, rung, escalator, ordinal
biting: cutting, bite
perseverance: patience, persistence, dare
transition: convergence, transmission, migration
button: bud
tenant: renter, resident
unkind: rude, cruel, evil
programme: program, ceremony
manufacturing: mill, making, produce, preparation
zone: region, regional, collar
ninth: nine, three
alcohol: wine
heal: treatment, improve
planting: climbing, october
spectator: observer
greedy: ambition, greed
ninety: 
imperative: oblige, imperative-mood
steer: lead, storm, ship, grooming, news
influential: influence, transitive
surround: collar, siege, orbit, isolation
drown: sink
slide: slip, fly
sow: climbing, pig, bread
imminent: upcoming, inevitable, nearly
dominant: giant
leadership: lead, hierarchy, map, inspiration, command, driving, administration
ducks.: duck, goose, duckling
diary: newspaper, calendar
regain: restore, again, reimburse, rehabilitation, attain
connecting: hook, connectors
celebrate: persuade, footnote
fuss: noise, confusion
deputy: representative, alternate, escort, vice
automobile: auto, motor, sedan, vehicle, machine, truck
discussions: discuss, deliberation
amendment: reform, repair, improve
insufficient: inadequate, sufficiently
hem: margin, ham
damn: curse, abuse
pastor: priest, pastoral
inherent: natural
inference: consequence, speculate, deduction
inferential-mood: inductive-mood
advertisement: advertiser, complaint
enclosure: wall, girdle, envelope
theft: steal, kidnapping
spontaneous: instinct, natural, arbitrary, random, suddenly
utility: instrument
ash: gray
expletive: swearing, vain, complement, curse
revive: resurrection, again
connect: hook, connectors, splice
downwards: down
intervention: intervene, attack
subsistence: subsisting, living
susceptible: sensitive, weak
revival: rejuvenation, resurrection, recovery
temporarily: temporary
internet: trade
mechanism: systematic, mechanical
raft: catamaran, canoe, shelf, float, oar, series
pork: pig, ham, bacon
physically: physics, body, corporal
dot: gross, stain
loaf: bread
expanse: 
shocking: shock
rudely: rude
index: exponential, list, encoding, index-finger
transmit: sent, distribute, transmission
dispatch: expedition, letter, kill
onto: envelope, increasingly, against
diminish: subtract
unit: module, singular
phillips: 
rim: lip, margin, rum
complaining: complaint, dissatisfaction
temperate: cold, winter, clement
chat: chatting, dialogue
gambling: bet, indulge
amber: yellow
ton: tin, tuna, choke
perpendicular: steep, vertical
wreath: circle, scallop, crown
smoothly: 
tension: stress, thrill
cork: lid
whale: election
deception: illusion
undergo: passing, earn
haze: mist, hoarfrost
poisonous: poison
omit: forget
concession: budge, franchise, discount
incline: dip, conjugate, pitch
toilet: restroom, cabinet
buddha: fire
offense: violate, attack
starvation: hungry, appetizer
grudge: hate, revenge, spite, complaint
fortitude: patience, birch, liver, pluck, valency
malignant: fatal
anticipate: hope, prediction
scrutiny: censor, observation, verification
rat: mouse, bee
knit: weave, knitted, knot
correspond: answer, bite, fulfill
detain: arrest, suspend
salon: shop, hall
operate: operating, workplace, work-out
blooming: bloom
disgraceful: shame
drain: channel
wage: pay, paycheck, payroll
nasty: hate, unpleasant, evil, worst, ugly
cemetery: funeral, graveyard, grave
plaster: chalk
tap: pipe, milk, crane
chairman: president, speaker
dismiss: sack
reside: stay
decoration: ornament, cosmetic, scenery
toe: foot, finger, tiptoe
farthest: distant
invent: searching
climax: summit, termination
define: unspecified
restricted: bounded, ban
cupboard: cabinet, shelf
stimulus: incentive, recipe, inspiration
vigilance: alarm
rack: shelf, adviser
barley: who
plateau: platform
superintendent: controller, conductor, trustee, foreman
presentation: introductory, exhibit, supply, demonstrator, promotional, submit
rubber: ball, elastic, gum, rub
exclude: delete, varied, disposal
screw: bolt, helix
caravan: expedition, trailer
explore: exploit, analyze
insure: guarantee
cylinder: disk, roll
summary: summarizing, abstract
unlikely: probability, suspicious, challenging
swarm: flock, son
virtually: indeed, nearly, effectively, practical, virtual
baking: cook, burning, kitchen, frying
client: custom, guest, systematic
catalogue: directory, list, chart, table
dock: doll, landing
analogy: affinity, comparison
chemistry: chemical
peninsula: alternate
infer: suppose, omen
maritime: sea
bake: bread, grill, cook
alley: avenue
pierce: perforate, bore, inject
snatch: grab, pluck, tear
launch: begin, cast, lunch
worms: insects, wolf, insect
regulate: regulation, align
farming: agricultural, yeast, crop
fasten: arrest, alright, attaching, impound
actress: actor
theater: theatre, hall
thanksgiving: thank
drug: medicine
adverse: worst, disadvantage
candy: sweet, sugar, chocolate
trout: tuna, fish
paste: putting, pasta, cake
convict: prisoner, guilty, trap
investigate: probe, excavate, analyze
package: pack, roll
crawl: cow, cower
role: roles, paper, stock, cast
snap: click, film, suddenly
magical: invisible
tire: embryo, gum, ring
geese: goose, duck
noticeable: glance
core: base, seed
observance: ceremony, ban, feast, respect
predecessor: ancestor, old, retrospective, pioneer
reap: bite, cutting, spoon, gather
dam: generation, dust
slippery: slip, skate
transformation: convergence, adaptation, translation
ornamental: ornament, cosmetic
fringe: margin, boundary, pointed
arabia: arab, saudi, billion
medal: badge, reward, coin
location: places, posture
ruby: diamond, pomegranate
quotation: extract, quoted
custody: captivity, arrest
plausible: rational
toss: cast
concentration: accumulation, focus, integrity, gathering
scrape: scratch
handy: practical, hand
bait: taste, temptation, bet
deposits: accumulation
bureau: office
diverse: varied, mosaic, contrasting
slice: chip, disk, towel, scrap
necklace: collar
courier: envelope
drill: perforate, excavate, bore
respond: reaction, answer, refund
usefulness: beneficial
mortality: death
profusion: rich, sufficiency, unlimited
twentieth: twenty
maturity: expiring, maturation, deadline, termination
weed: cigarette, grass, wild
latent: secret, hibernation
mathematical: mathematics, athletic
morally: moral
gasp: pant, breath, yawn
gliding: slip
racing: running, contest, runtime
exit: exporting, departing, log-out, door
sometime: occasionally
adult: age, expert
hardship: bitter, trouble, work-out
withstand: oppose, bear, resistance
snare: trap
ignore: indifference
junior: young
re: return, reimburse, restart, restore
psychological: psychology, mentally
limestone: lime, chalk
collision: collide, conflict, friction
knitting: weave, knitted, web
indirect: directly
precedent: example
aisle: hall, ray, wing
cedar: pine
contradict: invert, contrasting, oppose
soften: soft
stump: ball
redeem: rescuing, refund
poultry: chicken, duck, bird
pathway: avenue, exhaust
gear: teeth, rib, instrument, transmission
celebration: ceremony, feast, congratulate, arbitrary
snug: warm, pleasant
accompaniment: escort
publishing: distribute, publisher, editorial
customer: patron, guest, systematic, receptor
rug: carpet, floor, blanket
analogous: resemble, synonymous, similarly, analog
galley: kitchen
partition: count, distribute, hedge
outlook: glance, perspective, aspect
aesthetic: charm, beauty
consume: expend, consumption
resent: hate, resistance, contest
pose: posture, installing
contentment: satisfied, thank
bower: grove, groves
organism: organic
unintelligible: vague, understand
emphatic: 
factors: elements, reasons, factorial
midday: noon, lunch, southern
lily: read
noun: name, grammar
spit: mate
heritage: heirloom, inherited, heir, artifact
folding: fold, knock
helpful: help, beneficial
persist: linger
curves: curve
outlet: departing, shop, log-out, showroom
inherit: heir
butt: ass, buttocks, barrel
velocity: speed
arctic: pole
colleague: coworker, mate, brother
insulting: verbal, shame
deficiency: inadequate, scarcity, tribe, error
bleak: sad, cold, darkness
ensure: guarantee
unfair: justice
possessor: owner
descendant: familiar
sub: escort, vice
independently: loose
bucket: barrel, spoon, tank
vocation: vacation, profession
organisation: 
primarily: especially, cardinal, majority
ritual: ceremony, worship, custom
thigh: ham, foot
fiscal: money, silver, fundraise, economy
cor: heart, chorus
inspector: reviewer, observer
wardrobe: cabinet, robe
texture: weave, architecture
adjustment: reconcile, regulation, adaptation
turbulent: windy, flood
marsh: swamp
unaware: ignorant, unconscious, unknown
vase: pot
initial: opening, first, primitive, introductory
minimum: least
correction: reform, restatement, repair
morsel: bread
overlook: indifference, fail, forget
coil: roll, file, cyclic, helix, horoscope
stairway: stairs, escalator
willingness: willpower, desire
crisp: sharpness, frame, pointed
vocabulary: dictionary
stroll: wander, scramble, walking
poorly: sick, evil, weak, worst, poor
fitness: gymnastics, harmony
illumination: fluorescence, light, spotlight
nationality: national, seed
flavour: taste
dice: given, cube, thimble
administer: administration, trustee, executive
unimportant: trivial
genera: generation, childbirth, genus
deplorable: tragedy
benefactor: patron, benevolent
economical: economy, economist, frugal
stride: progress, passing, pitch
circumference: girth, frame
axis: print, shoulder
satisfying: disease, satisfied
reliable: honest
disgusting: hate
ethical: moral, protocol, conduct
collapse: fall
cushion: river, pad, suppress, vice
confound: falsify, amaze, fail
scrub: rub, squat, erasing, stain, sterilize, abrade
myth: story, legend
layers: lining, fold, rung, floor
ownership: fortune
cape: coat, nose
scare: terrible, fear
nut: bean, seed
enlarge: extend, maximize
solar: sunshine
mat: pad, treadmill, carpet, mate, doormat
raid: attack, siege
disclose: expose, public, appear, notify
juncture: hour, splice, moment, union
beak: lip, nose, knock
lease: leash, rent
charcoal: coal, carbon, peat, cinder
chilly: cold
participation: participate, partnership, presence
pier: pile
ratio: balanced, comparison, relations
comb: brush, shoulder
translate: translation, interpret
mortar: lime, motor, consumption
recreation: refreshment, entertain, hobby, recovery
rite: ceremony, worship, conduct
rivalry: contest
whim: colour, sink
peg: ankle, wine, flourish, hook, hanger, immobilization
sample: example, champion
distinctive: unique, badge, conspicuous
plural: plural-number
initiative: program, trying
streak: striped, line, strip, rank
jelly: jam
administrative: administration
anarchy: disorder, confusion
revision: reform, iteration
operated: operating
profile: file
finance: money, silver, fundraise
gin: saddle, gene, trap
conveyance: vehicle, shuttle
maker: preparation, manufacturer
periodical: occasionally, newspaper, patrol
tub: barrel, pelvis, bath, tank
basic: base, infrastructure, default, principle
premature: previously
extinction: destroying, extinct
boiler: pot, forehead
separating: disconnect
banish: distant, ban, impound, oust
electrical: electronic, electric-current
herb: grass, spice
prosper: flourish, success, rescuing
similarity: affinity, resemble, comparison
subscription: subscribe, sharing
voting: franchise, pronouncing
privacy: private
arena: domain, sand
traveler: traveller
unfamiliar: ignorant, unknown, foreign
conform: follow, answer, tailor
particle: atom, seed
paddle: oar, palette, instrument, born, pocket
innate: born, natural
statistics: statistical, number
inhabitant: resident
flute: whistle
lava: volcanic, volcano, excess
reproduction: fertility
consistency: stability
span: length, margin, opening, inch
attic: upstairs, bridge, roof
affirmative: agree
t: 
dye: colour
coloring: colour
infection: transmission, infectious, temporary
arithmetic: mathematics, account
considerate: deliberation, sympathy
ethics: moral, immoral
pitcher: pot
officially: official
annoy: tease, bore, narrow
glide: slip
abandonment: abandoned, surrendering
mane: horse, me
trait: attribute
composer: musician
continuation: continuity, begin
vest: sweater, jug, west, coat
bass: inhabit, base
quarry: hunting, mine, ear, stone
abnormal: crackpot, singular, unique
omission: default, fall, error
sequence: series, sequential, rank, continuity
squeeze: crowded, push
canopy: umbrella, veil, lid, dome, roof
drunkenness: sugar, drink, drunk
assign: assigned, unspecified, attaching, impose
tackle: wrestle, intervene
eddy: eddies, whirlwind, spin
percentage: cent
curb: inhibition, hedge, brake, margin
advertising: advertiser, promotional
cavity: vacancy, pit, follicle, leak
fried: frying, roast
spade: oar, introductory
withdrawal: return
mortgage: hostage, credit, pawn
forbearance: patience, bear
repress: suppress
spouse: wife, husband, mate
valid: effectively, available, alright, qualified
legacy: heirloom, inherited, heir
valve: van, lid
compelling: impose, draw, fascinating, inevitable
iris: rainbow
relic: remains, artifact
bug: insect, error
vocal: verbal, vowel, vocalizations, audio
construct: making, building, configure, recycle, establish
vapor: cough
bat: club
contradictory: rival, contrasting
automatic: directly, automatically, auto
explicit: outdoor, transparent, punctual
mates: coworker, mate
well-being: welfare, health, alright
fret: frown
buck: dollar, male, deer, tick
panama: 
intoxication: drunk
inspect: 
precipitate: sediment, skin
classification: sort
haul: draw, distance, loot, distant, hunting
embarrassing: shame
disabled: defective, passive
arrogant: pride, imaginary
hurts: mistreating, pain
curl: ring
brace: tongs, weeds, instrument, needle, parenthesis
gem: stone, diamond, flourish
tremor: earthquake, tremors, epicenter
anniversary: birthday, annual
wrap: pack, fold
curly: helix, bore
prestige: credit, glory
freezing: immobilization, frozen, cold
negligence: reckless, default
sulphur: sulfur, broken
cooling: cold, winter, refrigeration
flowering: bloom, petals, florist, deluxe
continental: continent
target: purpose
stall: shop
dictate: command, oblige
manure: composting, litter, mall
invest: investment, invert, buy
cruise: itinerary, ship
rally: gathering
rumor: rumour
cheque: probe
emerge: appear, gathering
flask: bottled, squash, bulb, balloon, jug, glass, piston
hurricane: storm
canyon: valley, stork, defile
apprentice: student, amateur
compartment: basket, branch
specifically: especially, private
emerging: appear
framework: frame, mainframe
annoying: trying, narrow, fastidious, unpleasant
grind: half, mill, rain
bang: burst
unreal: imaginary
aggregate: gross, gravel
fraction: partially, deduction
illegal: wild, unlawful
dissolve: delete, solvent, abandoned, melt
bases: base
closest: nearly
weaving: weave
earnings: profit
indoors: covered
picnic: excursion, walking
exploration: probe, searching, analyze
needy: poor, helpless
stationary: frozen, stationery
onion: bulb, fragrant
vested: establish
dishonest: honest
supplement: complement
clash: conflict, shock, attack
reserves: holding
armchair: chair
dough: flour, pasta, cake, yeast
clutch: pluck, coupling, switch
embark: begin
rejection: refusal
wintry: cold, winter
variance: quarreling, diversity, deviation
absorption: skin, exploit
terminate: termination
conveniently: beneficial
cleanliness: housekeeper, erasing
collective: together, partnership, mutual
timely: moment, behead
invade: invading, attack
buggy: defective
prolong: extend, latitude
weaken: weak, exhaust
dismissal: sack, resignation, termination
quay: shore, landing
significantly: dramatically
experimental: pilot, practical
cooperation: cooperate, partnership
distraction: disposal
publicity: promotional, preach, obviousness
suspension: stopped, prohibition, suspend, outboard, hang
relaxation: entertain
expand: extend, develop, decompress
tumble: fall, stumble, dip, fly
forge: forging, falsify, knock
underlying: base, seminal, underlie
darts: archery, spear
fossil: oil, organic, archaeological
constraint: ban, regulation
mechanics: mechanical, machine, engineering
epithet: adjective
aurora: dawn
zest: enthusiasm, experience, hobby, taste, spice
cycle: circle, frequency, bicycle
nap: sleep
crater: pit, follicle
hamlet: suburb, village
shrub: bush, grove, tiny, hedge
paw: foot, pad
boom: flourish, burst, tree
reproduce: copy
prominence: importance, notability
congress: gathering, session, seminar
overgrown: covered, raised, placenta
engraving: fragments, form
equity: equally, justice, sharing, stock, capital
eclipse: darkness
grape: wine
workshop: studio
decrease: scarcity, subtract, fall
broom: rain, sweep
incur: expend
naming: nomination
citizenship: resident
pronunciation: pronouncing, accent
judgement: decision, deliberation, judge, justice, crisis
concentrate: focus, gather
vineyard: hospitality, copula, garden
undo: expose, restore
ferry: yacht, phrase, ship
panel: board
mace: hammer, chinese
straightforward: directly, transparent, subsisting, linear, frugal, simplicity
rupture: burst, shatter, crack, farewell
hazardous: dangerous, threatening
deluge: flood
altitude: length, high
cumulative: overtime, accumulation, gross
malta: 
fibre: scratch
thrive: flourish, bloom, develop
export: exporting
offender: comet, guilty
disapproval: disapproving, dissatisfaction
par: assess, paragraph, equilibrium, cross, equally, ration, skin, criterion
abolish: expiring, delete
adjust: accommodate, tailor, justify, balanced
membership: member
gauge: measurement, magnitude, assess, abbey
tolerate: bear
hip: buttocks, romantic, ham
adhere: follow
stimulate: incentive, provoke
conflagration: fire, wildfire
gust: burst, volley, storm
abounding: rich
fragile: feminine
repel: oust, push
unrest: disorder, riot, crisis
partiality: privileged, bias
chastity: accuracy, purity
cope: resistance
dilemma: suspicious, crisis
slack: loose, quiet, soft
contraction: shyness
journalist: reporter
symptom: phenomenon, exhibit, attribute
homestead: shelter, grange, house
youngster: young
priceless: invaluable, worth
tar: pitch
spiral: helix, spin, meandering
commentary: vaccine, suspend, interpret
camera: cell
apologize: apple, pardon
basement: cellar
locomotive: train
celebrity: notability, popular, well-known, personality
ballot: ballet, franchise, election, voter
lick: me
venison: deer
potential: capacity
eligible: qualified, justice
kitten: girl
loop: cyclic, ring
laborer: worker
prosecute: sue, complaint
licence: license
unfold: expose
relinquish: discharge
ego: breath
jet: bird, stream, comma
addicted: slave, habitual, obsession, reliance
survival: vowel, recovery
carving: fragments
boarding: landing
freeze: frozen
vatican: liberty
incumbent: depend
tack: spike, baste, flourish, direction
apathy: indifference
daytime: day
organize: configure, institutions, planned, systematic, coordinate
presumably: perhaps
drought: dry
convoy: expedition, escort
bleed: blood, bloody
dissipation: consumption, dissolution, evaporation
napkin: handkerchief, towel
fry: toast
dessert: sweet, desert
keel: spine
arc: spring, curve
detection: found, searching, revelation
nocturnal: night
smash: destroying, shatter
facilitate: expedite, streamline, accommodate
correctness: accuracy, truth, perfect
arid: barren, dry, stubborn
hose: pipe, slang
stitch: sewing, sweat, abridge
stab: twinge, inject, shoot, grab
chop: bite, cutting, steak
password: code, slogan
hemisphere: pointed
heating: warm, heat, temperature, heater
depressing: provoke, despair
coup: revolution, knock, rebel, success
dedication: loyalty, volunteer
compassionate: sympathy
moth: insect, butterfly
civic: civil
earthen: mud, topsoil, subsoil, terrestrial, pottery
twig: branch, understand, rod
aiming: focus, purpose
portal: door
expiration: termination, expiring, deadline, pardon
insert: inject, enter
meditate: reflect, speculate, think, focus
reefs: reef
flexible: flex, elastic
slab: board, tablet, stove, float, tile
qualification: qualified, talent
wrestling: wrestle, scramble, ship
decade: ten, knot
multiple: varied, several
healthful: health, verification
primeval: primitive, adam
bandage: strip, dressing
tidy: systematic
testing: essay
hack: hawk
teaspoon: spoon
safeguard: fuse, safe
clap: applause, rhythm, knock
ax: axe
maple: palm
rake: sweep
emptiness: vacancy, ball
marrow: oil, gourd
halfway: half
sheath: pod, coat, envelope, glove, apron
memorandum: treaty, representation
absorb: exploit, consist, swallow, embrace
cone: tapered, steep, angle
educate: educational, training, awareness, train
enquiry: probe, observation, question
symmetry: equilibrium
domination: administration, domain
upside: upside-down, foot
cooler: cold, winter, refrigerator
elevator: lift
mosque: church
postpone: suspend, smoke
loathing: hate, despise
sprinkle: spark, scatter
nucleus: cell, embryo
disperse: scatter, distribute, invisible, transmission
toll: sacrifice, consumption
drunkard: drunk
metaphor: example
widespread: 
diminutive: tiny
tow: rope
percent: cent
beetle: beetles, insect, cockroach, insects
bomb: pump
mattress: bed
critically: deep, reviewer
reservation: terms
chuck: lining, chalk, cast
sew: sewing
chemist: chemical, pharmacist
lounge: hall, chair, showroom
schoolboy: student, school
occupant: resident, renter, profession
onset: scratch, begin, attack, invading, introductory
magnet: magnetic
suck: heart
dive: dip, sink
receptacle: containers, basket, pot
warming: warm, temperature
ranked: vacancy, square, stairs, rank
transit: traffic
fern: colour
unfriendly: cold
lagoon: shore
explosive: burst
denounce: accuse
flax: linen, flex
membrane: veil, art
slap: punch
relax: comfort
courtship: court
commodity: ingredients, baggage
lending: credit
sod: grass, stew
consistently: series, permanently, always, sequential
reciprocal: exchange, mutual
reel: curler, ring, roll, roles
shave: artillery, haircut
prescription: medicine, recipe, copy, regulation
bubble: foam, balloon
aptitude: talent, interest, capacity, genius
trespass: guilty, sin
shovel: tongs, oar
taint: stain, ruin
loft: bridge, flock
utilize: exploit, using, consumption, containing
vista: scenery, perspective
durable: long
lineage: familiar
evenly: equally
hog: pig, piglet, hedgehog
whichever: who
finite: bounded, finally
prospective: future, candidate
auxiliary: supporter, aids, plus, escort
academic: student, educational, technical
tyre: embryo, gum, ring
hoof: poison
consumer: consumption, receptor
validity: legality, worth, credit, reliability, accuracy
approximately: nearly, approximate
soar: fly
microscope: telescope, lens
civilian: civil
funding: money, silver, fundraise
strap: leash, rope, whip, list
magnetism: magnetic
symbolic: identity
adapt: adaptation, tailor, transcribe
admonition: reminder, counsel, alarm
likelihood: probability
subjective: mentally, imaginary
ancestry: ancestor, familiar, taproot, generation
pronoun: conscience
wrongly: abuse
broker: agent
discourage: ambition
staple: cardinal
newcomer: guest, freshman
zenith: summit, twenty
blend: mixed, shuffle, salad, synthesize
bail: guarantee
molten: melt, fade
pouch: follicle, sack, bladder, pocket
infinity: mathematics, infinitive
graphic: chart
gases: gas
reparation: repair
fig: violin
niche: sensitive, nest, province
disappoint: despair, fail
carrier: conductor, vector, air
rap: knock
needing: must, required
blouse: shirt
designate: assigned, forming, nominal, denote
projection: sketch
angular: corner
liberation: discharge, deliberation, liberty
vibration: shock
enclose: attaching, bounded
palate: heaven, palace, taste, floor
incongruous: nonsense
scorching: burning
tropics: tropical
southeast: southern, southwest
tenacity: persistence
plow: hill
wither: wilt, fade
rotation: circle, frequency, spin, revolution
rudder: oar
knob: bud
physiological: corporal
gutter: channel
restriction: ban, regulation
category: rank, series, branch, sort
substitution: instead, alternate
confront: contest
decorative: ornament, cosmetic
lobby: hall
swan: goose
hurl: cast, pitch
compensate: reimburse, reward, return
builder: developer, makers, manufacturer, founder
eruption: burst, rash
scroll: book, roll, helix
plastic: variable
mechanic: mechanical, artisan
blight: stain, rust, disease, destroying, plague
aggression: attack, invading, rape, aggressive
clemency: pardon
hey: hello, oh
fullness: completeness, maturation
inert: passive, resident, argon
compete: wrestle, contest, rival
warehouse: shed, camp, cellar, stock
protective: immune, defending
academy: college
prescribe: import, impose
novice: fresh
divorced: divorce
dairy: milk
beech: rash, peach, poplar, between
reservoir: tank
shopping: buy, shop
batter: thunder, battery, pasta
implicit: fulfill, secret
strategic: strategy
trigger: cunning
counterpart: mate
ne: northeast, what, us
mold: module, form, cast, template, print, vowel
rehearsal: training, essay
oppress: suppress
insistence: claim
faulty: defective, incomplete
inequality: diversity
precede: previously
mid: medium, medieval, between
jewelry: ornament
hug: embrace
surge: tide, seafloor
query: question
tourist: traveller, excursion, touring
housewife: housekeeper
prow: forehead, nose
rye: mustard
beverage: drink, refreshment
mindful: 
perennial: permanently, habitual, eternal
articulate: phrase, demonstrative
disobey: violate
saucepan: pot, pelvis
tolerant: bear, liberal
amend: splice, reform, align, improve
diagram: sketch, chart, map
thriving: flourish, rich, develop
deductive-mood: inductive-mood
sherry: 
cider: extract
overwhelm: suppress
mobile: auto, variable, mobility, mobile-phone
predicament: preach
elevate: lift, superiors
miner: worker
furthermore: also
paradox: tragedy
applaud: applause, bless
concourse: crowded, contest, convergence
pore: bore
exaggerate: salt, maximize
blonde: yellow
renunciation: sacrifice, refusal, resignation
exhortation: counsel, incentive
intercept: cutting
cue: slogan
runner: hall
dormant: passive, fallow, hibernation
negotiate: discuss, dialogue, sue
premium: reward
reporting: relations, documentary
regime: administration, government
tolerance: allowance, bear, patience
option: cucumber, alternate
crusade: expedition
epidemic: tragedy, translation, infectious
technique: technical, tactic, engineering, strategy
tumbler: glass
puppy: dog
terminal: teminal, finally
output: expense, produce
bankruptcy: bankrupt
anterior: page
navigable: traffic, navigation
lovable: sweet, dear
fighter: warrior, war, boxers
mint: coin
inactive: passive, activation, unemployed
designation: rank, duty, unspecified, assigned, nomination
html: 
locate: accommodate, searching, situate, see
context: scene, referral, referential
classified: sort, secret
recruit: recruiter, candidate, tide, choose, freshman
trash: worst
verdant: green, evergreen, innocent
cashier: treasurer, box
storage: gathering
coalition: union
ponder: reflect, think, deliberation, scraper, fortune, discuss
distract: distractor, scatter
heredity: inherited, tradition, genotypic
endangered: terrible
flaw: defective, disadvantage, error, default
lengthy: long, length, extend
concede: accept, discount
broadcast: emission, transmission
dial: choose, ring
hopefully: hope
prevalence: popular, influence
transform: switch, adaptation
ginger: come
kite: comet, dragon, hawk
ambiguous: vague, controversial
award: reward, scholarship
steamed: boiled, evaporation, plus
comparable: proportional, comparison
confronting: against
label: tag, studio, badge
triangular: triangle
approving: disapproving, flattering, ratification
kinship: affinity, socialist
gut: bowel, fox
reptile: snake
chips: chip, potato, money
politically: political
cite: referential
residue: remains
staunch: zealot, cutter, chauvinist
irrelevant: nonsense
urgently: hurry
forage: grass, lining, animal
tape: cassette, ice, strip, film
bland: soft, weak, sweet
westerly: west
verify: 
legislator: legislature
tribal: tribe
granddaughter: niece
dissent: objection, oppose
oral: verbal, lip, mouth, wash
bog: swamp
unruly: rebel, windy
disagreement: objection
backbone: spine, bones
notoriety: notability
combustion: burning, oxidation, combustible
respiration: breath, resuscitation
dupe: fool, hunting
enthusiast: fan
expel: expend, oust, subtract, discharge
hemp: dissolution, rope
tonic: toner, tank
recur: repeatedly, return
blemish: defective, stain, default, accuse, error
skip: left, dance, avoid, cross
celery: horseradish, fallow, parsley
crag: coral, stone
observable: observation
mug: cup, grimace, mouth
wedge: spike, corner
exemption: discount, pardon
portable: mobility, tiny
wrapping: pack
gauze: mist, grill
crank: lie
brilliance: talent, beauty
fin: wing, ballet, oar
berry: pluck, strawberry
immigration: migration
mimic: copy, transcribe
shorten: streamline, abridge, brief
journalism: press
hoe: hook
surgery: surgeon, operating, cutting
impoverished: poor
propaganda: promotional, preach
fireworks: firework, bet
sine: chord, fourteen, pocket
volatile: variable, unsteady
accumulate: accumulation, gather, dividend
poop: feces, pipe
abdomen: stomach
mantel: shelf
implication: connotation, consequence
formations: forming, making
pop: popular, appear, pop-up
pop.: popular, bob, appear, pop-up
reunion: union, gathering
wrench: screwdriver, instrument
harmful: dangerous, harmless
fencing: hedge, allotment
variegated: mosaic, varied
countryside: country, scenery, suburb, village
degrade: destroying
indigenous: natural, resident, locally
hoist: raised, crane, buttress, lift, wear
immunity: immune, resistance
stack: pile, stock
lecturer: speaker
contingency: probability, coincidence, conditional
disc: disk
qualify: qualified
wicket: door
trend: conduct, direction, polarity, phenomenon, instinct, alignment
density: crowded
induction: inductance, derive
chew: chewing
corporate: company
onslaught: attack, invading
acquit: done, innocent
rind: brother, cortex, skin, pod
mammals: mammal, animal
chisel: incisor, grater, axe
unstable: unsteady
compatible: parallel, harmony
sanitary: purity, health
phone: appear
benign: clement, introductory, harmless, benevolent
intermittent: blinker, discontinuous, occasionally
mandate: claim, authority, command
postal: post-office, zip
vacuum: vacancy
duplicate: copy, transcribe
lobster: cancer
ramble: digress, excursion, walking
convulsion: earthquake, burst
flare: flash, torch, burst
booth: cabin, headquarter, newsstand
boring: bore, lazy
portfolio: briefcase, wallet, investment
shove: push
crevice: crack
complication: complexity
overnight: once, night
polar: polarity, pole
porridge: pulp
delegate: representative, agent
consecutive: series, sequential
volition: willpower, desire
taxi: cab
predict: prediction, assess
racket: rigging, rocket, garage, club
turret: dome, vertex, shelter, steeple
contiguous: bounded
optimism: hope, believe
arable: agricultural
plumb: vertical, bob, poplar
tasting: tasty, taste
peel: skin, extract, pod, cortex
carve: bite, interpret, excavate, pluck
expire: expiring, enter
fleece: skin
debris: ruin, damp, litter, fragments, scrap
hover: float
sector: region, industry, strip, regional, departmental
surname: name, castle
institute: institutions, company
urgency: enthusiasm
abusing: abuse, mistreating
multiplication: multiply
enjoyable: pleasant
methodical: systematic, balanced
disappointing: provoke, despair
poke: sack, plunge
deter: preventing, inhibition
negation: refusal
winner: conquering, champion, success
composite: mixed, complex, consist
veto: inhibition, bet
lunar: month, monthly
drainage: burning
qua: 
pinnacle: summit, steeple, pointed, finial, vertex
impact: influence, traces, shock, consequence, conflict
squall: storm
bruise: whiplash, blue, sixteen
naive: frugal, linear, innocent, childish
overcast: clouds, cloudy, covered, darkness
diving: plunge, dip, diver
presidency: president
fiber: scratch
sip: mouth, swallow, interpret
inmate: captivity, prisoner, resident
buyer: recipient, copper
visual: optical, scene
monumental: memorable
falcon: hawk
carbonic: carbonate, carbon, organic
prevention: preventing, objection
claw: nails
pastry: cake, yeast
repulsion: propulsion, reluctance, resistance
plaintiff: manuscript, actor
deplore: hate, devote
mislead: fool, amaze, sophisticate
prohibit: ban, inhibition, preventing
performer: actor, player, artist, demonstrator
elusive: nightmare
ostrich: ostriches, bouquet
peacock: pheasant, bloom
tournament: contest
rarity: scarcity
requirement: refresh, claim, desire
minus: subtract, least, delete
advisor: adviser
translating: translation, interpret, translator, religion
grotto: cave, mainsail
pascal: 
shaving: scratch, foam, beard
untidy: reckless
postage: zip
emphasize: stress
revert: return, surrendering, invert
pants: trousers
indigo: purple, blue
confuse: puzzle, amaze, confusion
dedicate: devote, volunteer
gardening: horticulture, garden
surgical: surgeon
truthfulness: truth, accuracy
authorize: authority
tilt: flex, lute
digit: finger, integer, number
drawback: scarcity, disadvantage, return
hundredth: saw, cent
schooling: educational, school, teaching, training, nurture
spokesman: speaker, representative
sloped: steep, dip
nearby: nearly
constellation: planet, galaxy
normally: often
confusing: controversial, puzzle, confusion
consonant: recipe
disagree: agree
frigid: cold
bountiful: rich, hospitality, cream, fertile
font: typeface, alphabet
populations: population
seaside: sea, shore
irritate: anger, tease, provoke
saffron: yolk, yellow
outstanding: better, unpaid, oddly, left, popular
initiation: begin
artery: vein
precipitation: sediment, rain, sweat
terrify: alarm
devastation: ruin
insertion: import
grammatical: syntactic, grammar
numerical: digital, number, statistical, integer
hubbub: riot, confusion, noise
forecast: prediction
husbandry: agricultural, plowing, nurture, pastoral, domestication, yeast, controlled
tortoise: turtle, roll
disapprove: disapproving, refusal
environs: neighborhood, suburban
implement: practical
exotic: foreign, curious
jeweller: ornament
jaded: blase, tired, jade
enhance: improve, maximize, decompress
lettuce: salad
fusion: melt
poll: election, pole, voter
talented: talent
thaw: melt
hoop: girth, ring, circle, parenthesis
lemonade: lemon
lattice: grill
component: module, complement
pendant: trailer, hanger
kernel: pit, seed
straighten: directly, subsisting, rearrange
colonization: colony
decorate: ornament
lawsuit: claim, sue, causation
yeoman: farmer
explicitly: apparently
limiting: abridge
presidential: president
bump: conflict, multiply, push, ice, knot, knock, balloon
coincide: coincidence, sabotage
congratulation: congratulate
cartridge: patron, cassette
scan: sweep
awning: shed, blinker, umbrella
numb: follicle, frozen
breezy: fresh, windy, expense
funnel: suppress, chimney
metropolitan: capital
entitle: license, authority
betting: bet
technically: technical, engineering
elapse: passing, cross
economics: economy
cosmic: interplanetary, secular
waver: swing, weak
empirical: experience, practical
aquatic: water
dominate: judge
propagation: promotional, preach, transmission
advertise: advertiser, promotional, accuse
librarian: library
diffusion: distribute
graze: scratch, nominal
agile: talkative
kit: box
practitioner: doctor, coach, operator
posterior: after, behind, buttocks
soak: dip, pit
umbrellas: umbrella
quilt: river, eiderdown, blanket
competitor: rival, contest
conservation: 
hamper: impede, basket, barricade, collide
laundry: wash
easel: tripod, crutch, earnest, film, ass
slime: mud, pitch, dribble
reflex: reflect, reflexive
overture: opening, proximity, import
cuban: cuba
extermination: cruelty, vindication, indulge, consumption, disposal
digestive: digestion
characterize: attribute
urban: city
embarrass: trouble
notebook: copy
proficiency: sufficiency, talent, qualified
vas: 
seaweed: kelp, sponge, tongs
chemicals.: chemical
chemicals: chemical
batch: flock, pile, module, theorem
magnify: extend, glory
sniff: breath
mum: mom
buffet: refreshment
archaic: old, chronic
diagnosis: diagnose, disease
tiller: farmer
elation: enthusiasm, pride
extort: pluck, violently
registration: subscribe, enter, footnote
soluble: melt
zigzag: meandering, curve
frightening: terrible, threatening, dangerous
specialist: expert
yearn: desire
inundation: flood
bathroom: bath, restroom
gamble: play, adventure, bet
integral: perfect, integrated, must
brooch: ornament, cotter
alloy: salad, egypt, melt
buckle: hook
interrogation: interrogate, probe, question
tropic: tropical, burning
eliminate: kill, avoid, delete
pea: bean, lens
appendix: allowance
sylvan: rude
personnel: staff, servant
intonation: accent, rhythm, pitch, noise
circulate: distribute, improve, wander, orbit
glue: gum, tail
milky: milk
accessory: overtime, escort, reaction, complement
contributor: taxpayer, coworker
inclusive: singular, consist, enter, perfect
seller: dealer, salespeople, sell
cod: fish, code
thesis: essay
harass: nervous, obsession
discard: delete, avoid, cast
explode: burst, exploit
pry: lever, intervene
spill: leak, shed, float, shake
swimmer: swim, lifeguard, float
gratis: vain, freeware
ingredient: ingredients, contents, module
deficit: scarcity, tribe, outdoor, minority
businesses: jargon, company, affairs
upsetting: nervous, disorder, sad, unpleasant
housing: house
antithesis: conflict, paycheck
photographic: photograph
undiscovered: unknown
axiom: theorem, principle, truth
roller: disk, roll
edible: food
skim: foam
arbor: grove, newsstand, trees, tree
pest: insect
obligatory: duty, oblige
drip: leak, dribble, droplets
gable: summit
glacial: glacier, ice
pill: tablet, medicine
currently: moment
media: press, medium
wreckage: ruin
corpus: body
menu: list
fracture: crack, broken, bone
pi: silicon
inefficient: effectively, inadequate
tome: me, thousand, how, bible
forum: platform, court, bore
salesman: dealer, salespeople
momentum: speed, pulse
risky: dangerous, threatening
slant: dip, lute
drilling: bore
hacker: pirate
missile: rocket, weapon
bookcase: library
manipulation: operating
computation: account, count, computer
producer: manufacturer
monetary: money, silver, exchange
pith: cell, carpenter, pulp, bowel
outsider: foreign
depict: representation
inflation: swell
marginal: trivial, retail, least, rare
pip: seed, shatter
reinforce: strengthen
fantasy: imaginary
aroma: fragrant, taste
concierge: doorman, help, trustee
propeller: helix, pilot, butterfly, fan
chef: cook
javelin: spear
undermine: sabotage, weak
tuck: tick, fold
socket: plug
coherent: sequential, integrated
parasite: bacteria, parasitism, insect
holly: defending
sift: sieve, seven
tablespoon: spoon
crockery: pottery, palette
frustrate: pluck, fail, helpless
barring: except, prohibition, ban, inhibition
fundamentally: infrastructure, terms, default
retrieve: recovery, derive, return, restore, buy
intentional: deliberately, learn
survivor: family
flux: stream, river
trinidad: 
temperatures: temperature, warm, heat
competitive: contest, rival
dentist: doctor
jewellery: ornament, treasure
biology: biological
enact: making, ratification, accept, suppose
tuition: training, teaching
potency: strength, energy
alcoholic: drunk, wine
crib: domestication, coop, copy
installation: installing, putting
ace: slip
discriminate: discrimination, bias
militant: extremist, warrior
disarm: weapon
burner: burning, bromine
crucial: 
assignment: assigned, duty, allotment, activity, mission
quota: privileged, allotment, ration, quantum
solo: lonely, unattended
excavation: excavate, pit
gland: thyroid, follicle, spleen
commemorate: persuade, memorable, remember
historically: historical
fissure: crack, furrow, pit
hearsay: rumour
nuclear: molecular, atom
capability: capacity, efficiency
versus: against
hi: hello
elimination: 
taut: stress
relaxing: comfort
hysteria: crisis
surveillance: monitor, observation, controlled, spy
shears: scissors
accustom: habitual
fibrous: peach, filament
caller: guest, collar
rebuild: rearrange, again, restore, reform
jeopardy: dangerous, bite
juicy: swamp
eel: tuna
pivot: rod, cardinal, mile, swing
effectiveness: effectively, influence, capacity, efficiency
handbook: book
botanical: plants, botany
vulnerable: weak, sensitive
athlete: athletic, player
stripe: striped, strip, line, ray, film
namesake: name
anomaly: error
otter: dog, swordfish
transparency: transparent
facade: mask
greenhouse: emission
boxing: box
comprise: consist, covered, forming
seam: lining, sewing, expedite, transverse
clip: tongs, fastener
hypothetical: imaginary, conditional
enamel: mine
deft: worth, cunning, fluent
rehearse: telling, trying
strictness: violently, firmly
prototype: example
archipelago: island
filing: pitch, sunroof, giving
honeysuckle: achilles, yellow
priority: putting
offset: deviation, reimburse
ya: again, yeah, already, oh, you, who
nutrition: food
restrict: preventing, abridge
pedestrian: walking, pawn
landmark: historical, direction
axle: print, shoulder, undeveloped
vat: watt, barrel, tank
condensation: condensed, suppress
statuary: statue, sculptor
allege: accuse, argument
junk: scrap
luster: varnish, luminous, flash
woodlands: forestry, groves
constituency: voter, circle
uncontrolled: arbitrary
null: zero, hollow
cultural: civilization
upheaval: reform, rigging, revolution, tremors
technology: technical
marketing: sell
necktie: tie
pallet: palette, bed
propagate: promotional, diffuse, scatter, radiate
sprig: stalk, branch, heirloom
economically: economy, economist
drummer: battery
administrator: foreman, trustee, executive
appendage: allowance
cleaner: fresh
botanist: botany, explorer
intestine: bowel, colon, fox
portray: demonstrate, long
grandchild: niece
blues: 
tidal: tide
incandescent: luminous
openness: transparent, opening, obviousness, franchise
dual: two, twin, dual-number
periodically: occasionally
pickled: drunk
synthesis: summarizing, training
darn: curse
specialty: features, diversity, privileged, profession
interment: funeral
bizarre: wonder, curious, singular
culinary: kitchen
graft: corruption, grafting, vaccine, inoculate, bud
applicant: candidate, searching
linguistic: language
illogical: contrasting
collaboration: cooperate, together
mushroom: sponge
aide: supporter, tributary, adviser, coworker, mate
obliterate: bite, delete, destroying, snuff
repellent: mosquito
allure: impress, persuade
incite: persuade
cistern: sink, tank
sahara: 
gills: gum
devastating: terrible, destroying
gusto: enthusiasm, taste
pumpkin: gourd, squash
pate: skull, mind
storing: hide
uplift: lift, progress, enthusiasm
thunderstorm: storm, generator, cloud
phenomenal: phenomenon, super, wow
clod: ass, anus
spectacular: fascinating, wow
assessment: assess, diagnose, evaluative
rift: crack
dynamic: strength, animated
barrow: trolley, stretcher
revise: 
breakdown: brake, fall, accident
tiring: tired
campus: college, school
canine: dog, molar
serial: sequential, series
vortex: eddies, spin
ooze: loam, mud, veal
snail: helix, lazy
siren: noise
confluence: gathering
dissertation: essay
infinitesimal: nominal, tiny
facial: becoming
formulate: chalk, compile, form, preparation, impose
sandwich: bread
thyme: basil
buoy: float
clove: stove
porous: permeable, aquifer, opening
pluractional: 
stimulation: expedite, suasion, incentive, provoke, inspiration
censorship: censor, regulation
parity: affinity, equally, equilibrium
bleached: white
blink: flash
equip: accoutrements, complement, chalk
hybrid: mixed
nominate: nomination, referral, forward, suggest
equation: comparison
segment: partially, departmental, sugar, module
cancel: delete, scrap, abandoned
drastic: 
filter: sieve
meter: metre
dampness: damp, swamp
widen: extend, floor
damaging: destroying
floral: interest, pollination, florist
diaphragm: helix, shutter
depress: suppress, press
mister: sir
uncover: expose
reconstruct: rearrange, repair
umpire: judge
humans: humanity, humanoid
atomic: atom, molecular
sophisticated: complex, modernize, sophisticate
emit: discharge, shoot
alligator: crocodile
twitch: shrug, twinge
assimilation: accommodate, osmosis
uplifting: transcendental, high
inappropriate: inadequate
variant: other, variable
distillation: cleaning, refinery
specify: referential, denote, unspecified
dislodge: oust, subtract
planetary: planet, terrestrial
criticize: criticism
nomenclature: name
discrepancy: deviation
boredom: melancholy, bore
impurity: damp, pollution
forearm: hand, elbow
overseas: foreign
swirling: eddies
fauna: plants, animal, organisms
analyse: analyze, analyst
loin: pelvis, cola, kidney, spine
sewer: channel
rainfall: rain
sprout: grow, bud, bamboo
aircraft: bird
intersection: ordinal, cross
spicy: spice
certify: verification, guarantee
flexibility: elasticity
paraphrase: interpret
solidarity: affinity
reproductive: fertility, genitals
hinge: principle
adverb: envelope
inorganic: mineral, organic
longitudinal: vertical, parallel
locker: cabinet
instability: unsteady, uncertainty
honduras: 
serf: slave, servant
deprivation: disadvantage, bite
crouch: squat, cower
exponent: exponential, agent
generate: produce, chalk, emanating, establish
dorsal: spine
mop: sweep, doormat, rub, delete
wasp: hornet, bee
approximation: approximate, prediction, nearly
snout: kiss, nose
reconsider: rearrange, deliberation, again
disability: defective, inability
morale: awake, moral, mentally
optimistic: hope, believe
championship: champion
scaffolding: platform, frame
classify: sort
intrusive: bore, intervene
curriculum: program
outdoors: outdoor
splinter: fragmentation, chip
apathetic: passive
react: reaction, what, verb, justify
script: manuscript, line
blackmail: threatening
bonus: reward, excess, dividend
photographer: photograph
pointer: needle
asset: miscarriage, presence, capital, actively
evacuate: vacancy
variability: exchange
butte: 
curry: emulsion, stew, vegetables, vegetable
delta: participate
graduation: graduate, degree
refraction: deviation
colloquial: slang, intercom, familiar, locally
ambiguity: vague, controversial, uncertainty
trans: trance
neuter: animal, passive
handicap: disadvantage, yoga
photography: photograph
shortage: scarcity, tribe, absence
spurt: buoyancy, running, lunge
ailment: disease, bottled, pain
displacement: migration
hygiene: health
fungus: bacteria, umbrella, sponge
taboo: prohibition, inhibition, ban
wording: phrase
vibrant: animated, luminous
estuary: mouth
passover: valley, easter
dump: pile
gaseous: gas, pneumatic
advocacy: vindication, defending, enter, paralegal
cohesion: affinity, loyalty, adhesion, coincidence, harmony
cauldron: pot, evil
shipment: installing, expedition, baggage, exporting, transmission
refectory: diner, anchor
evolve: develop, flourish
refine: reform, sublimate, war, holy
demise: passing, dissolution, death
diplomat: ambassador
crochet: hook
definitive: 
salvador: 
initiate: establish, begin
merge: integrated
reversal: investment, break-in
divergent: varied
succulent: tasty
buttonhole: trap
mallet: hammer, pestle, lollipop
seeker: explorer, finder
iced: ice, frozen
downtown: city, centre
jog: running, awake
utilitarian: beneficial
inhale: pant, breath
rectify: improve, poplar, impede, distant, align, rearrange, repair
incorporate: indulge
pulley: crane
rump: buttocks
skinny: tapered, dry, bath, weak
federation: federal
monsoon: season
tighten: 
fisher: spider
gymnastic: gymnastics, work-out, gymnast
scoop: spoon, girth
unload: discharge
habitat: shelter, living
evoke: evoking, provoke
dilute: tapered, weak
goodbye: farewell
tornado: storm
agrarian: sharecropper, agricultural, terrestrial
demolish: destroying, shatter, break-in, scatter, ruin
inversion: invert, investment, upside-down
cyclone: whirlwind, blizzard, storm
tv: television, film
congestion: crowded, maturation, gather
syntax: syntactic, pension
downpour: rain, pouring
dimple: pit
productivity: fertility
hash: cutting
horseshoe: horse
distortion: wander, deviation
inexpensive: cheap
liner: ship, lining
slam: knock
relevant: applicable
senegal: 
parsimony: economy
functional: practical, operating
adjunct: tributary, allowance
gill: rill
agate: opal
millet: mile
teller: treasurer, box
dependency: depend, reliance
displace: oust, subtract, homeless
conglomerate: cluster
tram: trolley
autonomy: liberty
differentiation: discrimination, diversity
baton: rod
availability: accessibility, available
undergraduate: student, license, degree
graph: chart, map
skepticism: doubt, suspiciousness, uncertainty
fungi: cook
patchwork: mixed
cute: beautiful, wise
abdominal: stomach
diploma: certificate
waive: discharge
literacy: educational
waitress: servant
raspberry: strawberry, blackberry
primer: alphabet
synthetic: artificial
trainer: coach, training
conserve: 
fabrication: making, built, building, installing, lie
garbage: scrap, worst
humidity: damp
photo: photograph
mesa: table
rating: stairs, rank
eradicate: uproot, avoid
textbook: book
nostril: nose
subscriber: subscribe, member
consolidate: strengthen, coordinate, compile
equatorial: equator
wheelbarrow: trolley
constrain: suppress
athletics: athletic, work-out, sports
plait: ponytail, knitted
mow: cutting, crop
bulldog: dog
infect: cross
premise: base, theorem
firstly: first
chick: girl, chicken, bride
secrete: secretion, hide, expend
unix: 
enigmatic: secret
antigua: 
psychologist: psychology
spinach: parental
intensive: nervous
synonym: synonymous, alternate
visor: mask, diurnal, blinker
cogent: demonstrative
entities: containers, institutions
app: applications, programmer
debut: first, introductory, begin
marmalade: jam
amethyst: sapphire
pristine: primitive, intact, perfect
thousandth: thousand
indoor: inner, deep, covered
revoke: behind
acorn: chestnut
amplitude: capacity, magnitude, domain
dimension: direction, after, measurement
slush: mud, loam, sleet, corruption
encroach: surpassing, overlap, intervene
uterus: ovary, taproot, childhood, bee, intrauterine
convertible: translation
caper: somersault, kidnapping
poster: banner
accelerate: expedite, speed, hurry
churn: shake
intensify: intensifier, strengthen, chronic, streamline
abortion: miscarriage
notation: nomination
typically: often, especially
contamination: pollution
bounce: leap
asian: asia
commitment: bet
coastal: beachfront, shore
unbelievable: unreliable
queue: tail, heat, rung, trivial, snake
driveway: avenue, highway
salvage: rescuing, recovery, bracelet, defending
san: 
bracket: supporter, elbow, parenthesis, hook, needle
ladle: spoon
angler: fisherman
disruption: disorder, recovery
fertilizer: composting, mall
inverse: upside-down, engaged
evaporate: melt, yawn
aviation: wing, air
correlation: balanced, mutual, comparison, relations
cache: hiding
prank: jest
migratory: migration, nomad
brogue: accent
compute: gender, count
ethnic: racial, national
gastric: stomach
pare: subtract
floe: continent, glacier
compress: zip
amalgamation: attaching, melt, integrated
atop: upstairs, summit
slash: disconnect, cutting
tumor: knot
snowstorm: blizzard
specifications: specification, budget, attributes
repository: stock
erosion: tear
tandem: consist
trellis: grate
tricky: cunning, complex
navel: navy, pole
compost: composting, mixed
pests: insect, insects
pests.: insect, insects
wallow: fall, roll
polo: pole
dike: moat, breakwater, barricade
hunch: instinct, protuberance
characterization: features, cast
clarity: transparent, obviousness
affix: splice, parallel, depend
uh: 
molecule: molecular
configuration: configure, structural
dugout: canoe
fu: karate
cop: police
interaction: overlap, dialogue, contacting, mutual
influenza: influence
quantitative: relatively
introspection: retrospective
orient: east, dawn
sperm: seed, ration
tanker: battleship
clam: scallop, oyster, molluscs
pulmonary: lung, lunge
simplify: streamline, simplicity
endorse: referral, ratification, agree, accept
genre: stream, idiosyncrasy, sort
gypsum: chalk
petal: petals, leaf
credibility: loyalty, reliability, credit, probability
dent: pit, teeth
focused: focus
acclaim: admiration, applause, shelf
subversion: ruin, sabotage
isolate: varied
deflection: deviation, curve
captivate: fascinate
injection: needle, inject, vaccine, dose
cauliflower: cabbage
coerce: oblige, rape
shin: cinnamon
sandal: slipper, shoes
chunk: chip, paragraph
liqueur: rum
nascent: newborn, undeveloped, born
cereal: bean
container: instrument, recipient, containers, tank, pot
movie: film
migrate: migration, wander
pollute: pollution
terminology: terms, jargon
zoological: zoology, zoo
forefront: forehead
gregarious: player
components: features, elements, ingredients, complement
blackboard: slate, board
electorate: voter
penis: gender
erase: delete
mediate: reconcile, intervene
ie: namely
trowel: palette
angola: 
capitalism: capitalist
ski: skate
alfalfa: clover
clearance: obviousness
allegation: suspicious, claim, accuse
counselor: adviser
whisk: whip, garlic
prune: plum, crop
auditorium: hall
desecration: sacrilege
selective: choose, election
korean: korea
oscillation: swing, dance
static: frozen
converge: focus
adhesive: adhesion, infectious
tendon: leash, chord, also
alphabetical: alphabet
global: international, world, worldwide
eject: expend, oust, exhaust, subtract
economize: frugal
casualty: accident, sacrifice
schoolgirl: girl, student, school
ok: done, alright
pragmatic: practical, realistic, engaged
referee: punch, judge, adviser
inclusion: consist
goggles: eye
beneficiary: recipient, profit, applicable
differential: diversity
shale: slate
exhale: breath
mating: containing, inbreeding, hybridization
neutralize: passive
watershed: water
fixture: adaptation, immobilization, attaching, instrument
molding: cast, eaves, pouring
duct: pipe, channel, line, plumbing, conductor
install: installing, establish
resonance: echo
traditionally: tradition
ellipse: oval, scarcity
classroom: orbit
marketplace: buy
potentially: efficiency, effectively
tusk: ivory
tamper: intervene, sophisticate, rigging, falsify
indicator: posture, referential, index-finger
alimentary: digestion
calculus: account, terms
gram: grass, warm, kilogram, village
petrol: gasoline, patrol
cataclysm: flood
distort: scramble
browse: glance, eye, preview
mango: generic
adolescent: young
decimal: minority
knead: trouble
knuckle: knot, ankle, knee
lintel: architrave, translation
optics: optical, lens
complementary: complement
barb: spike, nettle
nebula: mist, cloud
airplane: bird
beaker: cup, baker, pot
sanitation: cleaning
crate: nest, box, basket
optic: optical
pedal: bicycle, foot
circa: nearly, approximate
sewage: feces
offal: pluck
sponsor: guarantee
flashlight: flash, battery, torch, lens
awesome: terrible, wow, supreme
mangrove: evergreen
climber: creeper
bowler: melon
mildew: rust, disease
suitcase: box, baggage
brawn: muscle, strength, objection
swap: exchange
disable: health, passive
optional: alternate, custom
quandary: confusion
matrix: stomach
portrayal: photograph, portrait, shoulder
pre: east, dictionary, meadow, previously
advert: advertiser, promotional, referential
nozzle: thimble, breast
stun: shock, amaze
feeder: vice
incidence: phenomenon, dip, frequency
topple: heart, oust
measurable: measurement
cog: teeth, scallop
consensus: coincidence, unanimous, agree
cocoon: pawn, pod, silk
pc: 
supervise: hang, monitor, police
aesthetics: beauty
crevasse: crack, chimney
cartoon: animated, comic-strip
uranus: pluto
transplant: alternate, exchange, bud
aluminium: aluminum
topaz: sapphire
ns: 
forensic: justice, court
nominee: candidate, nominal
shrimp: crab
organizer: whip
bakery: unemployment, bread
vane: aileron, compass, van, wing
programming: software, program
fluctuation: exchange, mobility
igneous: volcanic
simulate: transcribe, feign
onyx: opal
exemplar: example
overdue: late
complicate: complex
forceps: tongs, tweezer
mentor: patron, adviser, coach
slot: traces, opening
shank: cinnamon, stalk, tail, foot
solder: weld
honeycomb: honey
rook: crow, imposter, castle
manipulate: operating
authorization: authority, license
vegetarian: vegetable
norm: specification, ideally, criterion, regulation, respect
louse: tick, teeth, million, white
subway: metre, tunnel
respiratory: breath
simulation: badge
syringe: needle
mutation: switch
underwear: pant, slip, linen
vagina: cell, pod
tourism: touring, excursion
hallow: holy, bless
leakage: leak, pouring, emission
hub: epicenter, centre, cube, outpost, pole
modem: 
acceleration: expedite, speed
percussion: rhythm, shock
differentiate: discrimination, diversity
muffin: cake, pancake
seasonal: season
unveil: expose
reopen: again
pico: 
recapitulation: generalization, brief
puncture: twinge, bore, opening, perforate, punch
tendril: cirrus, cramp
kidnap: kidnapping
villager: village
lapel: badge, backhand
primate: monkey, mammal
sesame: mole
bunsen: 
coma: comma
broaden: extend
breeder: feathered, manufacturer, exponential, educator
huh: oh, noise, ha
nipple: breast
atrophy: nurture
galvanometer: 
vacate: vacancy, discharge, avoid
vendor: dealer, caterer, salespeople
arson: burning
supervisor: observer, foreman, controller, super
audit: 
deduct: deduction, bite, subtract, fall, derive
gander: glance, goose
olfactory: sweet
nationalism: national
warranty: guarantee, stability
hopper: grasshopper, fly, pocket
deciduous: autumn
hike: excursion, lift, wander, walking
plumber: artisan
vascular: vein, endocrine
rubble: fragments
topping: roof, overlap, page
locus: places
benin: 
flop: default, ruin, falls, fall
rebirth: born, reincarnation, renaissance
recession: economy
mileage: profit, kilometre, mile, distance
insulation: isolation, bracelet, insulator
groin: pelvis, fill
looting: loot
dietary: accommodate, food
motif: air
fetus: embryo
integration: partnership, coordinate, integrated
appliance: extinguisher, instrument
sedimentary: alluvial, sediment
magenta: purple
minimize: least
residential: shelter, resident, living
paprika: 
numeral: digital, number, integer
salty: salt
atrium: balcony
invoice: costly, landing
technological: biotechnology, technical
tobago: 
allspice: spice, pepper
swivel: spin
buffer: pad
chromatic: colour
cd: stairs
theorist: thinker, theoretical
frustration: despair, dissatisfaction
aquarium: fish, tunnel
cryptic: secret, vague
lotion: cream
traction: bet
whiting: chalk, white
parallelogram: rhombus, parallel
parachute: umbrella
importantly: especially
overall: all, gross, generic
deteriorate: rot
mirative: 
dynamics: dynamical, speed, mobility
pelican: stork
sexuality: gender, sexual
spool: spin
predominantly: cardinal
subtraction: subtract, deduction
increment: overtime
stockbroker: dealer
fiancee: engaged, candidate, bride
upstream: river
cuticle: epidermis, skin
keepsake: heirloom, reminder
commutation: exchange
cutlery: spoon
islamic: islam
flip: invert, transcribe
provider: caterer, donor
viscous: sticky, horoscope
fulcrum: base, solstice, buttress, centre, epicenter
redundancy: excess, iteration
geographic: geographical, geography, geological
skewer: grill
dental: teeth
archaeology: archaeological
freezer: refrigerator
fracas: quarreling, conflict
peanut: bean
cambodia: colombia
apposition: allowance
sexually: sexual
sprain: cramp
cooker: stove, pot, kitchen
trouser: trousers
timing: hour, summer, overtime
criteria: criterion, quality
slag: cinder, rust
decompose: decomposition, corroding, rot
firearm: weapon, rifle
oversee: controlled, monitor, police
adjustable: applicable
radar: 
aging: dry
geometric: geometry
lymphatic: lymph, weak
overview: observation, brief, expose, snapshot
rookery: crow, colony
salamander: sea
schist: slate, fold
qualitative: quality
cockatoo: parrot
eyeglasses: glass
fertilize: composting, fertile
yam: etc, potato
humus: topsoil, composting
rh: 
chimpanzee: monkey
hardwood: floor
enroll: write
crustacean: cancer
daffodil: canary
equine: horse
booklet: leaflet
genetic: morphological, genetics, gene
participant: participate, stock
coloration: colour
repertoire: talent, software
dispersal: scatter, transmission
duplication: copy, repeatedly
radiator: pipe
rectangle: square
generalize: generalization, generic
ligament: copula
digestible: pitch
revolutionize: revolution
fuels: energy, combustible
rotate: circle, frequency, spin, alternate
logging: documentary, subscribe
silt: sediment, alluvial, mud
teen: young, tin
anymore: henceforward, already
fertilization: composting, pollination, mall, hybridization
experimentation: pilot, essay, experience
layout: sketch, disposal, regulation, template
homosexual: gay
respondent: defendant, reaction, answer
voucher: evidential, plug, receipt, coupon
accountability: duty
lifeboat: yacht
loadstone: lodestone
long-term: long, chronic
scenario: circumstances, scenery, situate
formulation: forming, preparation
haddock: chad
radish: turnip, horseradish
consonance: harmony, synergy, friendly
clamp: tongs, suppress, handcuff, vice
intake: consumption, import
visibility: obviousness
backyard: fields, court
boost: strengthen, push
watermelon: melon
amenity: wash, comfort, beauty
mali: 
carpentry: carpenter
cognitive: mentally
catcher: fishing, receptor, collector
laos: 
affiliation: contacting, attaching, proximity
snip: disconnect, cutting, cuttings, bite, tailor, scrap
clarify: fining
detritus: gravel
ellipsis: oval
bookshop: library, book
vesicle: follicle, nest
amassing: gather, accumulation
juror: jury, judge, swear-in
prevarication: lie
toxic: poison
endemic: popular, locally
gopher: excavate, squirrel
handbag: wallet
stressed: stress, press, footnote
saturation: diffuse
stylus: needle, pencil
washer: virus, pad, tile
slump: crisis, dip
cater: fulfill, supply, caterer
server: servant
aviary: sparrow
efflorescence: weathering, bloom, pollination, develop
safari: 
pectoral: breast
algebraic: seed
banister: scarecrow
resistant: chronic, against, resistance, immune
motion-downriver: motion-downhill
putt: putter, knock, golf
discoloration: colour
snack: appetizer, toast, refreshment
unearth: excavate, expose
cinema: film, movie-theater
mower: trap
faucet: pipe, mill, crane, artillery
gestation: pregnancy
bib: apron, shirt
marker: traces, tick
sierra: hacksaw, syria
lethal: fatal
metamorphic: adaptation, metamorphosis
peripheral: regional
suitability: presence, alignment
assertive: aggressive, feast, predicative
einstein: 
garnet: pomegranate
node: knot
homeland: country
asteroid: planet
ruck: wrinkle, fold, furrow
headline: line
obese: thick
cockle: weeds, wrinkle, scallop
leek: leak, garlic
nouveau: rich, suddenly
sub-: escort, vice, subspecies
checkmate: oust, mate
lavatory: sink, restroom, farmyard, cabinet
discus: disk, entertain
armpit: rib
pillion: saddle, crack
geologic: geological, geologist, lipid, geography, geographical
loo: lining, sink, restroom, cabinet
terrain: topography, fields, floor
obsidian: 
summarize: abridge, summarizing
triassic: 
genital: fertility, sexual
cookie: biscuit, cake
prehensile: apprehensive
sophistication: completeness, complex
beta: son
vitreous: glass, transparent, eye
evaluation: assess, probe, diagnose, evaluative
tab: tag, ear
gears: teeth, transmission
inflate: swell
crayfish: rope, cancer, crab
electronics: electronic
sprawl: linger
fiance: engaged, candidate, bride
rewrite: transcribe
typhoon: storm, whirlwind
binoculars: telescope, lens
lab: laboratory
fixation: attaching, immobilization
ambient: medium, bounded
occupational: profession
addiction: idiosyncrasy, reliance, abuse
flyer: leaflet, fly, newsletter, pilot
gradient: mile, dip
mandatory: must, oblige, feast
raisin: currant
options: alternate
colorful: colour, shiny
coverage: covered, vaccine, hedge, roof, blanket, embrace
involvement: integrity
arboreal: tree, trees
sardine: salmon
turnover: surpassing
someday: day
hesitant: unsteady, reluctance
orientation: direction
parse: analyze
belize: 
quotient: capacity, rational, coefficient
meteorology: air
sinus: pocket, science, breast, follicle
analogue: analog
fabricate: making, produce, weave
thermal: heat, oil
amalgamate: integrated
somatic: body, corporal
stereotype: discrimination
girder: rafter
nova: 
environmental: neighborhood, ecology
plunger: diver, piston, postmark, pestle
tech: technical
sigma: 
mulch: leaf
residual: remains
jab: twinge, punch, vaccine
disjunction: isolation, fragmentation
lorry: truck
agenda: program
homemade: house
togo: go
additionally: 
stadium: domain, gymnasium
cancellation: delete, termination, erasing
coordination: coordinate
bacterial: bacteria
viola: violin, violate, subset
bookshelf: shelf
devastate: destroying
hairpin: needle
implementation: fulfill, practical
adaptive: adaptation, pro
biologist: scientist
sidereal: galaxy, star
appraisal: evaluative
meticulous: deep, fastidious, complex, sensitive, engaged, painstaking
interface: dialogue, surface, virtual
litmus: sunflower, heliotrope
savvy: expert, understand
turmeric: yellow
decorator: ornament
landslide: slip
citrus: orange
memorize: remember
consultant: adviser, counsel
hispanic: spanish
cheddar: 
pastel: cake
meander: wriggle, curve
quarterdeck: 
diagnostic: diagnose, observation, probe
opener: salute, opening
barbecue: grill
stockholder: shareholder
mussel: oyster, brush, scallop
clinic: hospital
homologous: homogeneous
polarization: discrimination, polarity
umbra: shadow
certification: certificate, verification, guarantee
businessman: dealer, business-person
torrential: pouring
lumen: 
porthole: mouth, window
collocation: editorial
corrosion: corroding, rust, stain
hardworking: worker
syllabus: program, abstract
venue: hall, places, locative, platform, parenthesis
unsure: uncertainty, unreliable, unsteady
urinary: urine, urethra
conduction: driving, line, transmission, kidnapping, holding
cricketer: cricket, actor
millionth: million, ten
floss: silk, wax, flock
oscillate: swing
sirocco: 
convolution: wrapped
bookstore: shop, book
therapy: treatment
loci: locally
retailer: dealer, retail
trachea: institutions, genitals
camomile: daisy
nationalist: national
touchdown: landing, touch, ship
mainstream: sensitive
meaningful: connotation, translation
problematic: trouble
footwear: shoes
im: 
backer: supporter, patron
endive: chicory, horseradish
rebate: discount, refund, deduction
antler: velvet, deer
israeli: israel
terrorist: extremist, terrorism, violently
vend: sell
cleaver: axe
conceptual: concepts, imaginary
greengrocer: vegetables
gym: gymnasium, gymnastics
algae: lichen
umbilical: placenta, epicenter, centre
brochure: leaflet
metabolism: ambassador
grid: web, grill
shaver: razor, grate, barber, scraper
taker: recipient
waterspout: drainpipe, whirlwind
earring: ear, crop
spatial: individually, regional
tuber: rhizome, torus, potato
specialize: expert
ventilate: ventilation, deliberation
cohesive: sticky, attaching, roll
anise: fennel
managerial: administration
oboe: clarinet
oesophagus: pipe
shit: feces, litter
weekend: saturday, sunday
exam: quiz, temptation, graduate
dill: heart, fenugreek, fennel, parsley
squid: octopus
costa: rib
inundate: flood, fill
undershirt: subset
makeup: grooming, cosmetic
assonance: alliteration
discrete: aside, isolation
distill: draw
headlight: lighthouse, spotlight, projector
inhibit: inhibition, preventing, suppress, suspend
qatar: train
cilia: eyelash, eye
cuttlefish: octopus
lingerie: inner, linen
motorcycle: bicycle
eggshell: eggs, egg, garden
locale: locally, scene, places, language, region, country
mantra: 
talus: ankle
kale: cabbage
multi: varied, several, newspaper, bridge
semester: session
lux: 
medial: medium
muggy: damp, warm, temperature
apogee: summit
morphology: morphological, form, science
floppy: soft, floppy-disk
poach: cook, grab, steal
fibula: femur
flu: influence, bamboo
scanner: browser
iguana: 
processed: treaty, processing, preparation
graphics: chart
coronary: disease, heart
buttock: buttocks, ham
reagent: causative, agent
archive: file
chore: homework, work-out
theta: 
confrontation: conflict, friction, comparison
freighter: baggage
optimum: classic, maximize
abutment: buttress, touch, shoulder, anchor
basically: terms, default
carapace: tank, crab
cycling: cyclic, bicycle
motivation: inspiration, incentive
sentencing: punishment
distal: late
testicle: egg
blueberry: cranberry, strawberry
operational: operating, running, restart
trajectory: ball, orbit
guava: pomegranate, peru
equivalence: equilibrium
fumigation: pneumatic
parsnip: beetroot, turnip
relevance: importance, relations, applicable
skid: skate, slip
bike: bicycle, online, round
modulate: modulation
buzzer: buzz, vowel, doorbell
directive: command, guideline, demonstrative, referential, recipe
jellyfish: tuna
airline: bird, air
amputate: disconnect
merger: union, melt, integrated
vanuatu: 
nib: thimble, spring, bee, prickly, nose, needlepoint
liter: litre
setback: shock, fail, disadvantage
basketball: baseball
transfix: bore, immobilization, perforate
contestant: candidate, rival
rodeo: playpen, livestock
unify: integrated, reconcile
mixer: blender, salad
stamen: banner, anther
stance: posture, polarity, integrity
minimal: least, rare
substrate: molecular, surface
testis: scrotum
bunker: pit, cellar
spew: vomit
commute: wear, shuttle, abridge, exchange
dashboard: board
nationwide: national, country
petrify: trance
bedrock: base, cell
scary: terrible
spatula: colour, sword
underwater: submarine
flawed: defective, unacceptable, incomplete, random
expertise: experience, knowledge
polygon: angle
placement: delimitation, occupancy, putting
logo: slogan
icon: map
ord: 
electron: electronic
interactive: overlap, mutual, together
teenage: young
initially: first
masher: pestle
potsherd: tile
funerary: funeral, grave
hydrant: plumbing, pipe
interact: dialogue, contacting, discourse, intervene, mutual
math: mathematics, account
pricing: worth
ream: perforate, oar
bathrobe: robe
fetal: embryo
iraqi: iraq
euro: 
foliation: 
toffee: caramel
ginseng: 
fission: fragmentation, decomposition
associative: vice
dolmen: 
drugstore: pharmacy
piss: urine
polyandry: polygamy
podium: platform
mollusc: molluscs, oyster
disrupt: sabotage, pluck, destroying
loge: 
nuance: colour
optician: optical
anytime: always, when
okay: alright, cheap
cleat: spike, handcuff
chili: pepper, chile
swipe: steal, grab
quanta: quantum
purposive: deliberately, purpose
disruptive: destroying, sabotage
transpiration: evaporation, sweat
semi: half, sell
acronym: brief
initialism: 
gerund: participle
scrabble: scratch, squash
assessing: evaluative, assess
ongoing: continuity, behave
frequencies: frequency
neural: nervous
sandbar: sandstone, ship
anti: rival, resistance, against, oppose
doldrums: melancholy, swamp
ohm: 
internationally: international
integrate: synchronize, integrated, coordinate, compile
hydraulics: hydraulic
ideological: ideology, theoretical
vocative: vocative-case
super-: super
attenuate: suppress
freckle: stain
seismic: earthquake, epicenter, seismology, tremors
lentil: lens
proximal: proximity
entrepreneur: contractor
mistral: 
nutrient: mineral, iodine, food
shaker: donor, blender
flipper: fillet, palette
unclear: unspecified, vague, transparent
adjectival: adjective, descriptive, aggressive
medication: treatment, medicine, pharmacy
trauma: shock, ulcer
pharmaceutical: medicine, pharmacy, pharmacist
resilience: elasticity, resistance
swop: exchange
coriander: parsley
weekday: week
evaluate: assess
mana: mind, mentally
percolate: leach, lime, leak
preterite: past-tense
ordinate: coordinates, coordinate, knot
skew: twisted
cumin: caraway
eyelet: bore, sunroof
toaster: baker
clone: copy, mud
silencer: quiet
proliferation: transmission
timer: wristwatch, temporary
insulate: isolation, ban
knowledgeable: expert, knowledge, cunning, awareness
viable: profit
lob: affairs, ball
barman: stalk
spiel: play, fluent, sports
backup: shore
forehand: frugal
informative: descriptive
bomber: aggressive
chutney: ketchup
factual: virtual, truth, realistic
graphical: chart
manually: hand
marshmallow: zephyr
replication: copy, answer, transcribe, flourish
splurge: bragging
intern: inner, prisoner
lambda: 
fuselage: bodywork, body, mainframe
marina: shore
reactive: reaction, reflexive
technician: artisan, expert, technical
hyaline: transparent
loess: alluvial
phylogeny: phylogenetic
girlfriend: bride, friend
timetable: itinerary, calendar
vulpine: cunning
filler: stuffed, pleonasm, complement
cookbook: recipe
ontogeny: 
schema: planned
stabilize: quiet, stability, frozen
dissident: rival, rebel
feedback: reaction, suggest
hamstring: femur
crossbar: reef
empathy: sympathy
outbuilding: reliance, shed
mousse: foam
shard: fragmentation, oblige
questionnaire: quiz
fucking: previously
toxin: poison
millimetre: millimeter
update: modernize, reform
memo: remember, list, reminder, footnote
numerator: molecular, metre, scrap
setup: establish, preparation, pitch, forming
lacrosse: hockey
psychiatric: mind, mentally
fluorescent: electronic, fluorescence, luminous
viewer: tracer, observer
eraser: gum
ingestion: swallow
prostate: patron
commuter: suburb, traveller
polygyny: polygamy
veterinarian: livestock, doctor
metatarsal: 
syndrome: disease
innovative: creativity
paradigm: concepts, example
quarterback: defender, founder
badminton: shuttlecock
sticker: tag
stinger: prickly
cafeteria: cafe
cantilever: swing
fries: potato, frying
legume: pod, bob
mini: 
smolder: simmer
toddler: strengthen
amplifier: intensifier
deplete: expend, exhaust
detergent: soap
gelid: cold
instal: installing, establish
upgrade: improve
windshield: glass
amino: 
brioche: 
glyph: badge
aorist: 
activate: actively, provoke
skeletal: bone
marijuana: crow
micro: tiny, microphone, sensitive
unwrap: expose, develop, decompress
randomly: random, coincidence, at-case
takeover: monitor
ostracize: isolation, boycott
cello: saxophone
handsaw: saw
multicellular: cell
predictable: prediction
statistic: statistical
catheter: probe, urethra, pipe
cervix: nape, neck, suppository
colloid: pulp
gasket: sealing
methodology: tactic, once
non-living: inanimate
artwork: sketch, artifact, art
pizza: 
deltoid: triangle, shoulder
hazelnut: chestnut
kayak: canoe
linguistics: science
spanner: switch, resources, clef
unsaturated: omnivorous
racism: racial
toggle: switch, lever, alternate, elbow
optimal: maximize
organizational: institutions
revitalize: activation, living
soviet: russia
hypotenuse: chord
industrialization: industry
kilometer: kilometre
multinational: international
planner: striped, designer
routinely: occasionally, punctual
menhir: megalith
allegedly: perhaps
bonding: union, grafting, fining, relations, weld
dialog: dialogue
hectare: ha
phosphorous: phosphorus
puck: chip, disk
shareware: 
solenoid: electromagnetic
carton: box, cardboard
congruent: friendly
duffel: 
pharmacology: pharmacy, medicine
underwrite: subscribe, guarantee
upload: download, cross
lawmaker: legislature
researcher: explorer, scientist
thermodynamics: thermodynamic, science
allocate: assigned, supply, allotment, distribute, devote
blueprint: guideline, striped, sketch
sketchbook: album, pleasant
-ish: 
modulus: coefficient, module
obligate: oblige, duty
scrum: attack, rugby, cluster
detonate: burst
dimensional: aspect
lightweight: light
mega: 
sledgehammer: hammer
twister: whirlwind, rotor
peeler: police
schematic: planned, generic
soccer: football, calcium, ball
ursine: 
boutique: shop
entitlement: justice, franchise, claim, law
leftovers: remains, gather, scrap
parameter: input
piggery: pig
wiper: rub, doormat, scraper
bottleneck: warm
macro: gross
quadratic: square
sustainable: balanced
commutative: exchange
dna: 
erode: corroding, abrade, runoff, destroying, weak
millennia: centuries, thousand
spaceship: shuttle, ship
sunglasses: sunshine
ureter: urethra
acclimation: domestication
experiential: experience, inexperience
paperback: novel
relocation: migration
penalize: punishment, fining
psi: 
semantic: connotation
grail: toast
url: 
freelance: liberal, unique
insider: inner, member
radiata: radiate
disco: disk
tonne: tin, choke
aquamarine: emerald
playa: 
prestigious: high
sharpener: grater, scraper
demographic: population
cryptography: encryption
osmium: gallium
synecdoche: metonymy
effluent: runoff, trade, emission
enzyme: yeast
epiphany: revelation, holy
sonic: noise
lifestyle: living
occlusion: occluded, gravel
inchoative: introductory, germ
opt: choose, deviation, aside
plagiarize: steal
triceps: weapon
deadhead: 
incineration: burning
moratorium: suspend
dorm: shelter, bedroom
columnist: author, reporter
teenager: young
airliner: bird, air
motivate: inspiration, incentive, provoke, persuade, grill
highlight: demonstrate
negate: ban
antonym: contrasting, four
catalyst: recipe, accelerator
boyfriend: friend, fan
reactor: reaction
sulfuric: sulfur
validate: verification, justify, ratification, tablet
aphid: tick
behavioral: conduct
hubris: pride
malfunction: defective, disorder, inadequate
www: 
thank-you: thank
incremental: gradually
taxonomy: sort, alignment, stratification
mastermind: mind, thinker, soul
topiary: 
barleycorn: 
ecological: ecology
academia: elite, science, teaching, educational, institutions
acrylic: synthesize
directional: direction
scree: stone
atto: 
envision: speculate, think, imaginary, lazy
immigrant: refugee, migration
laptop: distant, headphone
containment: holding, isolation, delimitation
memorization: reminder, remember
pigpen: 
zucchini: squash
bidet: 
postgraduate: graduate, postcard
wok: 
embed: indulge, dip
photocopy: copy, portrait
recursion: hierarchy, principle, iteration
romper: 
gazebo: balcony, finial
letterhead: forging, letter
right-wing: wing
holistic: integrated
phobia: fear
quadriceps: 
zoom: handful
jigsaw: puzzle, saw
socialize: social
stoma: mouth
activist: worker, volunteer
secant: cutting, tangent
tangerine: mandarin
unsupervised: unattended
validation: verification, vindication, ratification
encode: encoding, mask, code
nosebleed: lizard
phylum: door, genus, divisions, tribe, province
t-shirt: shirt
therapist: doctor, treatment
asymptote: touch
decode: sort
dermatology: skin, epidermis
emoticon: phrase
extrude: oust
magma: sediment
seafood: sea
termite: ant
backlash: reaction, vacancy, counterattack
karst: 
panda: 
sensor: transducer, censor, sensory
trainee: student, training
tycoon: king, flock, operator
arousal: thrill
sync: synchronize, sink
acidic: acid
environmentally: neighborhood, ecology
farad: 
geothermal: energy
chemotherapy: chemical
geode: 
lexical: dictionary, word, literally, verbal
polymorphism: polymorphic
modulo: module, denominator, magnitude
proton: 
taxonomic: sort, stratification
airborne: air
contraception: contraceptive
diskette: disk, floppy-disk
ecosystem: ecology
ingest: swallow
proliferate: multiply, flourish, nurture
sideline: margin
anacoluthon: 
chronogram: 
croissant: 
koala: cola
modular: season, modulation
reportedly: sidewalk, documentary
rutabaga: turnip, kohlrabi
tarmac: pitch, rink
layoff: disconnect
nubbin: 
perfective: perfect
robotic: robot
smog: mist, pollution, smoke
tequila: 
triggering: triggered, provoke
walkway: sidewalk, scramble, exhaust
xml: 
blowhole: bore, hollow
classifier: sort
groundwater: subterranean, aquifer, groundcover, subsoil
hamster: squirrel
luminescent: luminous
predator: hunter
publicize: preach, promotional, public, awareness
salami: salute
anorak: jackets
avant-garde: pioneer
chairperson: president, speaker
condominium: mutual, fold, villa
handout: leaflet, allotment
charismatic: charm
coulomb: 
protista: 
stripper: strip
breathtaking: liver
dermis: skin
determiner: decision
marzipan: almond
nano: 
parmesan: 
pesticide: insect
tampon: bumper, pad
bio: organisms, vowel, biography, biological, biotechnology
flan: cake
inductor: inductance
sorbet: syrup, kitchen
toolbox: vehicle, box, instrument, toolbar
underpants: pant, slip
brunet: 
hypothesize: suppose
mudguard: shuttlecock
soybean: bean
upwind: headwind
widget: module
clade: 
contrabass: saxophone
fridge: refrigerator
geodesic: topography
hallux: 
programmable: program
reboot: restart
weber: 
arachnid: spider
broadband: bandwidth
curie: 
electromagnetism: electromagnetic
fruitcake: cake
quantified: measurement
specificity: descriptive
woofer: antigen
tsunami: 
allergy: hate, sensitivity
blusher: lipstick
brainstorm: shake, inspiration
categorization: sort
customize: tailor, personalize, custom
denture: teeth
paronomasia: 
replicate: copy
slurry: pulp, mud, emulsion
webmaster: 
angst: fear, anger
antiphrasis: 
ceasefire: truce
dunking: 
endoskeleton: 
epa: 
juxtapose: comparison
candela: 
encrypt: encryption
esker: 
firmware: 
gaffe: default, error
guitarist: guitar
industrialize: industry
joystick: controller
olympic: olympics
sibling: brother
backstroke: backhand
biosphere: neighborhood, biological
brie: 
conditioner: controller
leone: 
lopper: 
loudspeaker: microphone, speaker
spokesperson: speaker, representative
stapler: fastener
tweeter: tweezer
windscreen: glass
workout: work-out, training
bobsleigh: sledding, bob
crt: 
dunk: dip
genome: gene, genetics
martini: 
rapeseed: mustard, mole
sauna: 
softwood: conifer
anastrophe: 
checkout: analyze, log-out
hijack: kidnapping, steal
litchi: 
mozzarella: 
nonmetal: metalloid
peta: 
plantae: plants
plug-in: plug, tie
reschedule: rearrange
runny: damp
joule: 
philately: gathering, exhibit
ytterbium: 
chiasmus: 
dendrite: 
finalize: database
freesia: 
gigabyte: 
hydrology: hydraulic
ladybug: insects
mascara: mask
polyphyletic: 
pyrimidine: 
radon: 
reeds: bamboo
allopatric: 
verbalizer: verbal
mistreat: mistreating, steal
qwerty: 
poales: 
prezygotic: 
archeology: archaeological
flatware: 
outgroup: 
quake: earthquake, epicenter, thrill
issues: affairs, trouble
managing: administration
wagering: bet
braid: weave, knitted
enormously: super, bridge
boned: steal, bones, osteopathy
techniques: technical, tactic, engineering
parkland: garden
pro-phrase: pro-sentence
topos: 
horotely: 
ignorative: ignorant
timespan: punctual
pineapples: pineapple
recycled: recycle, iteration
patterns: chart, form
homochromy: 
chores: duty, homework
amensalism: 
suntan: brown
litigation: claim, court
epideictic: 
readme: 
pathways: passageways, avenue
homology: synergy, confession
speciation: morphological
enrollment: login
hinderance: inhibition
whitespace: white
samarium: 
europium: gallium
roadways: highway
lutetium: 
waterway: channel, drainpipe, fairway
wetlands: swamp
disposable: available
codon: 
unplug: disconnect
homeobox: 
intestines: bowel
patientive: 
crocodiles: crocodile
relating: applicable, relatively, pipe
vagility: 
cepheids: 
grasslands: meadow, willow, grass, heather
squad: rot
quitting: termination
cynicism: despair
astatine: 
francium: 
undergoing: contacting
typicality: 
complain: complaint, accuse
overcharge: overcrowd
phenetic: phenotypic
trendiness: 
tolerating: bear, patience
refundable: extradition, surrendering, return
syntopic: 
aneuploidy: 
transposon: 
grower: manufacturer, farmer
artworks: art
thermistor: 
submitting: submit, sent
nobelium: 
sowing: climbing, plowing
stinginess: greed
passionate: tropical, sensory, fresh
sympatry: 
segments: paragraph
descriptor: descriptive
intragenic: 
descendent: familiar, generation, seed
frameshift: 
one-second: one-another
hillside: hill
bagel: carrot, persuade
operates: operating, propulsion, coworker, opera, collar
renovation: rehabilitation, rejuvenation, repair, refresh, alignment
pseudogene: so-called
scheduling: itinerary, calendar, programmer
allele: allelic, gene
aerobics: aerobic
cycles: circle, frequency
offenses: error, sin
mudita: 
incredibly: super, unreliable
microbes: microbe, insect
cybercrime: cyberspace
gloves: glove, immune
relational: relations, connectors
progenesis: 
locating: locative, putting
reassuring: reliance, believe
humidistat: 
healthcare: health
redwoods: 
labeling: tag
decay: rot
strategies: strategy
wasps: hornet
rsum: 
alternator: generator
salinity: salt
preserving: holding, defending, treatment
predicting: prediction
to-split: distribute
founders: founder
batesian: 
aperitif: appetizer
expansions: decompress
permitting: license
competence: capacity, sufficiency, qualified, authority
amphoteric: dual-number
performers: player, coworker, actor
patrolling: patrol
rental: rent, renter
courship: 
fluids: liquids
azeotropic: 
dependable: safe, unreliable
purser: accountant, treasurer
grinding: recycle, mill
gradable: 
specie: coin
forgoing: resignation
linker: fastener
yields: produce
ayurveda: 
feigning: feign, flattering
baguette: bread
fairness: justice, integrity
dealership: agent, dealer, salespeople
justifying: justify
outage: cutting, hang
exertive: 
combatants: warrior
roboticist: 
homeotic: homogeneous
traversing: gallery
cognizer: 
eventive: adventure
inspecting: verification
contrary: invert, contrasting, against, oppose
tuple: 
spelunking: 
missense: 
break-down: brake, break-in, scatter
improvised: temporary
grants: aids, scholarship, subsidize
euploidy: 
grisly: terrible
to-close: 
taiga: 
emptying: sediment, vacancy
slippage: slip
betulaceae: 
gooseberry: currant, blackberry
whitewater: white
innovate: innovation
avogadro's: 
cardiology: heart
emitting: emanating
stochastic: random
antiproton: protons
trough: passing, channel, hollow, tank
explaining: interpret, telling
bachelor's: graduate, degree
founds: resemble, found
chromatics: 
chamberpot: 
rotted: rot
exercising: gymnastics, work-out
remunerate: reimburse, pay, reward
buddy: mate, coworker, friend
estimating: prediction, approximate
employer's: owner
employee's: staff, coworker
riemannian: 
overload: excess
deciding: decision, disconnect
genes: gene
chlorphyta: 
outside-of: except
charophyta: 
unreactive: passive
gnetophyta: 
stakes: bet, rates, pile
aftershock: shock
allocation: assigned, allotment, dividend, allowance, sharing
that-which: who, it
caused: occurring, triggered, direction, because
compaction: compression
masculine-: male
ultrasonic: ultrasonography, noise
clementine: 
dyadic: binary
frond: leaf
conferring: chatting, surrendering
rounding: siege
concessive: budge, soft
cloudburst: rain
xylem: 
rising: climbing
rhodophyta: 
hydrologic: hydraulic
committing: done
losses: disadvantage, lost
easterlies: 
mindstream: 
cogitation: deliberation
logistic: baggage, supply
byebye: farewell, hello
flooding: flood
facet: aspect, direction, half
amphibians: amphibian
worthwhile: beneficial, worth, dear
candidness: honest, franchise
taxon: 
prokaryota: 
mechanisms: mechanical
lightening: electronic, cosmetic
male-: male
endstate: 
attributed: assigned, accuse
flurries: storm, pollen
brids: bird
bungling: corruption
subparts: 
snowflakes: sleet
cultivator: farmer
friendship: friendly
appointing: nomination, assigned
nomen: name
westerlies: 
ytrium: yttrium
climb: climbing, oar
polyptoton: 
permissive: liberal, loose
deixis: 
bulletin: leaflet, newsletter
goldbach: 
millibar: 
employed: engaged
cirque: circus
eolian: 
waterfalls: waterfall, falls
arriving: come
sightsee: touring, bore, excursion
butchery: cutting, genocide
phyta: 
entre: 
ambiparous: 
vocational: profession
phyte: 
stalactite: icicle
agentive: 
carcinogen: cancer
charitable: social, benevolent
adorning: ornament
adducing: 
warnings: reminder
whiteout: blizzard
dispensary: pharmacy
icecap: ice, aquifer
disquieted: apprehensive
supervised: controlled
dressmaker: tailor, sewing
dysphemism: 
camisole: nightdress, shirt
stunning: amaze, awed
sculpt: excavate, statue
euphoria: enthusiasm
hiring: recruiter, rent, tide, renter
petrograph: inscriptions
permafrost: permanently
cardamon: cress
hormones: hormone
carryall: 
carrycot: 
minerals: mineral, iodine, metals
centimeter: centimetre
posing: idiosyncrasy, appear
expressway: highway
germs: germ, insects, insect, bacteria, microbe
chopping: mince
neutrons: neutron
gusty: windy
instructor: adviser
cleanser: soap
bulbs: bulb
theorems: theorem
config: structural, forming
bodies: body, organisms
resonate: echo
colander: sieve, leach
supplier: caterer, supporter, contractor, manufacturer
rosid: 
wholes: 
watchstrap: bracelet
enforcement: executive
wildlife: wild
worrying: 
by-law: law
foehn: 
kinesthesia: 
conveyor: protractor
credit-card: credit
vespiary: 
struggle: conflict, scramble, war, wrestle
apomorphic: 
automotive: auto, railcar, vehicle, truck
precalculus: 
and/or: and-or
animalia: animal
pickup: shop, gather, tailgate
wastebasket: basket
workbook: book
gypsophila: 
cufflink: twin
wellness: health, welfare
symploce: 
photocopier: copier
quadrual: four
pursuant: concordant, base
emote: 
charales: 
proportion: balanced, magnitude, quantum, proportional
chordata: 
apart-from: except, expose
relativizer: comparison
racquetball: squash
counseling: counsel
tetrapod: 
cnidaria: 
underway: conduct, behave, running
deadbolt: bolt
radius: radio, radium, ray, orbit, print
platyzoa: 
dipstick: rod
aside-from: except, aside
brassica: 
toiletry: cosmetic, wash, restroom
rosaceae: rose
negotiation: dialogue, discourse, discuss
facilitator: simplicity
timeline: hour, itinerary
dunes: sandstone
dressage: horse
kung: king
mites: insects, inject, tick
internship: experience
stewardship: housekeeper, administration, treatment
armed: weapon
earthing: humanoid
wealthiness: 
affordable: cheap, available
latissimus: 
retrofit: 
creme: cream
web-site: world-wide-web, webpage
journalists: reporter
showjumping: steeplechase
amplifer: intensifier
brownout: blackout
recruitment: recruiter, tide
cell-phone: smartphone, mobile-phone, cell
exclamative: 
exhortative: 
breastfeed: milk, breast
anaphora: 
p.m.: night
springboard: yeast, prompter
chill: cold
loganberry: 
critique: criticism
reclamation: reform, recovery
resistor: resistance, rheostat
renovate: repair, redecorate, refresh, again
durating: 
relocate: migration
exterior: outboard, foreign, outdoor
eyeliner: 
redesign: again, reform
advances: progress
anadiplosis: 
pericentric: 
paracentric: 
reassure: guarantee
eyepiece: lens
sociability: hospitality
acrocentric: 
regression: return
metacentric: 
projectiles: elastic
mangosteen: 
constraints: barricade, inhibitor
figurine: doll
easy: fluent, light
fishhook: hook
drench: dip
holdings: plowing, stock, holding
genkan: 
sweatshirt: sweater, painstaking
migrants: migration
sweatpants: trousers
accompanier: 
sideways: aside, holding, lateral
sacrificing: sacrifice
monomorphic: 
corals: coral
punishments: punishment
drastically: speed, violently
antonomasia: 
orchards: groves, garden
ejaculatory: shed
broad: liberal
aeration: ventilation
foxglove: thimble, digital
cyder: 
stabilizing: streamline, immobilization, frozen, stabilizer
stepladder: stairs, rung, escalator
venitive: 
cayenne: red, pepper
brachylogia: 
efficiently: effectively
cooperative: cooperate, mutual
catachresis: 
winn: 
i.e.: namely
supportive: buttress, tributary, supporter, subsidize
electrician: electronic
dormancy: hibernation, inertia
promiscuity: dear, confusion
espalier: 
intrasexual: 
intersexual: 
auditor: reviewer, accountant, thank, controller
newsreader: advertiser
goodness: benevolent, favour, beneficial
prohibiting: ban
uncompleted: incomplete
ladybugs: beetles
kitchenware: cook, kitchen
australasia: australia
watering: water, irrigation
instead-of: instead
fourier: 
trimming: margin
incoming: come, earn
lurking: hiding
epanalepsis: 
relatedness: affinity, relativity
sousaphone: 
eusociality: 
stratus: 
balmy: crackpot, crack, soft, winter, fragrant
goatfish: 
flextime: 
sightseeing: excursion, touring
hotdog: sausage
interliving: 
rico: rich
snowmobile: ice
deferens: 
ants: ant
gadolinium: gallium
contacts: contacting, relations, connectors
bathtub: bath
alarming: terrible, dangerous
flared: burnt
findings: found
boast: pride, bragging
hayfield: meadow
etc.: guitar
categorical: predicative
godel's: 
specialties: features, privileged
aposematism: 
noxiousness: disadvantage
difficulty: trouble, disadvantage
downturn: crisis
downsize: narrow
pincushion: pad
rarified: rarefied, raised
supposedly: suppose, perhaps, apparently
ploughland: topsoil
newton: 
interviewer: reporter
enviro: 
prosciutto: ham
backward: behind, refund
jodhpurs: riding
cordless: wireless
lanka: 
parallelism: affinity, parallel, simultaneous
familiarize: familiar, read
rainforest: deforestation
anagenesis: 
intoxicants: drunk
cavities: hollow
dysprosium: gallium
each-other: one-another, mutual
recurse: 
timor: 
periphrasis: euphemism
andative: 
postzygotic: 
influencing: influence
per-cent: cent
inviability: 
edam: 
distributor: dealer
ought-to: must, needle
donut: disorder, bud
jardiniere: 
substances: objects, ingredients, elements
showers: bath, rain
regulatory: regulation, controller
opposing: oppose, defendant, resistance, objection, against
skier: player
burkina: 
prospecting: mineral
presumption: 
regulator: controller
beginner: introductory, begin
llamas.: camel
zymoscope: 
mendelevium: found
reflector: spotlight
einsteinium: 
attenuative: 
californium: 
allochronic: 
spending: consumption, expense, expend
nomina: nomination, nominal
freshly: fresh, lately, scratch
automate: unattended, auto, automatically
audition: choose, dog
attendee: engaged
assemble: gather, gathering, collector, installing
experiencer: 
infra-: down
protostomia: 
changing: protean
recycling: recycle, reusable, iteration
semispecies: 
synesthesia: 
unauthorize: 
longtime: long
terminative: 
usitative: 
experimient: 
indium: 
entertainer: artist
endangering: dangerous
advisory: adviser, deliberation, counsel
anew: rearrange, again, scratch
clippings: fragments, cuttings
homeodomain: 
belt: strip, leash
emphasizing: stress
intervening: intervene
zoomorphism: 
radicchio: chicory
scuba: larch, plunge, dip
racehorse: riding
sulfide: taproot
outcropping: 
swimsuit: swim
meringue: sugar
in-language: language
issac: 
heterokonta: 
teammate: coworker, mate
flowstone: 
rica: 
broiled: roast, boiled
forensics: foreign, justice
inexact: vague
excluding: except
for-example: example
patronym: 
quark: curd
matching: tailor
erbium: gallium
ginkgophyta: 
cycadophyta: 
deploy: scatter, distribute, indulge, develop, accommodate
sublimation: sublimate
curium: 
chlorophyta: 
colinearity: 
socially: social
clinal: 
severely: grave, violently, skein, firmly
neckline: collar
precambrian: 
aikido: 
kibbutz: camp, israel
counterfoil: coupon
ugli: ugly
praying: pray
standardize: specification
progression: progress, evolutionary
noseband: 
fluvial: river
glaucophyta: 
coughing: cough
infected: infectious
updraft: 
systematics: phylogenetic, systematic
honeycombed: 
scrambled: omelette, disorder, noise
planter: dibble
batholith: 
eudicot: 
pergola: 
rancher: farmer
tumour: knot
commonality: generic, affinity, popular, subscribe
disinfect: sterilize
applied: practical
salesperson: dealer, salespeople
crustaceans: enjoy
snowsuit: 
tautonym: 
annexe: coupling
neolatin: 
tides: tide, achilles
playhouse: theatre
secateurs: scissors
sponsorship: scholarship, sufficiency
keyword: word
veering: vertical, deviation
chorizo: sausage
podcast: 
overpass: bridge
deport: oust
firefighter: firefighting
airfare: air, rent
contrastive: contrasting
coreference: 
bend: meandering, curve, flex
yaor: 
consignment: expedition
xyst: 
landlord: owner
booster: overtime, thruster, intensifier, buttocks, accelerator
intergrade: 
guyot: 
critic: reviewer, censor
pepperoni: 
arraignment: criticism
auspicious-: beneficial
abiosis: 
enumerative: 
genetically: gene, genetics
landowner: angel
hydroponics: hydroponic
resultative: 
coordinator: copula
circulatory: cyclic, circle, frequency
trinomen: 
outwash: 
reflexology: massage, sensitivity, reflexive
eluvium: 
multilinear: 
ratios: balanced, relations, rates
nonliving: inanimate
legislate: law
have-to: must, duty
biplane: attack
oviparous: eggs
courtroom: court
seahorse: horse
conservanda: 
undissolved: insoluble, melt
basalt: black
plimsoll: 
ramekin: egg
cockpit: cabin, cab
importe: 
poaceae: vice
brag: bragging
faso: 
filtering: leach
stalagmites: 
checkup: probe, verification
paramedic: nurse, escort, clinical, mate
codons: 
translative: translation, interpret
skydiving: parachuting
ice-cream: cream, ice
intron: 
principe: 
onwards: latter, forward, first, after
add-: plus, collector, maximize
misidentify: 
uracil: 
monocot: 
monograph: essay
squares: square
educated: educational, scholarship
motorboat: yacht, motor
oilseed: seed, rape
allophagic: 
clique: click
butterflies: butterfly
soldering: weld
petri: 
announcer: advertiser, public, speaker
islands: island
southward: southern, southwest, noon
samsara: wife
veridical: 
circumfix: 
nosewheel: 
nightwear: nightdress, night, sleep
syneresis: 
banking: bank
miss: scarcity, never
battlefield: war
mesozoa: 
full-time: integer
nonmetallic: metalloid
from-case: at-case
newsagent: newsstand
exon: 
caf: cafe
briefs: brief, drawers
fermat: 
entertaining: entertain, hilarious
nectarine: peach
inventory: list
barn: shed, grange, children
uprooting: uproot, subtract
cladistic: 
doppler: 
mache: pulp
phenogram: 
strapless: 
conning: fool
cladogram: 
phylogram: 
dendogram: 
windstorm: storm, blizzard, whirlwind
deco: ornament
anglais: english
to-case: at-case
moderator: president, foreman
snowboarding: skiing
rb>c: 
arugula: rocket
sugarcane: fold
getaway: vacation, escape, log-out
homoplasy: 
canvas: web, linen
galileo: 
gastrin: 
moonstone: sword
armband: badge, bracelet
poisson: poison
nino: children
delimited: boundary, delimitation, bounded
achieving: attain, derive
origami: fold
emissions: emission, pollution
cornice: eaves, icicle
barbuda: 
angles: angle, pointed, corner
anodize: anode
tachytely: 
appellations: 
arctan: 
bradytely: 
situ: 
used-to: habitual
emergence: appear, born
incarcerated: prisoner, prison, captivity
taxa: rates
cowling: roof, headphone
haar: 
female-: feminine, wife, girl
deme: 
depending: depend, base, reliance
adjusting: tailor, systematic
surfboard: surfing
refreshed: refresh, energy, fresh, fascinate, modernize
peril: dangerous
notepad: pad
seedlings: cuttings
embryophytes: 
streptophyta: 
petrified: fear, pod, foam
entrant: login
affine: affinity
nesting: nest
outdate: oust
rockslide: 
pteridophyta: 
coding: encryption, encoding
tramotane: 
gallons: gallon
desirability: desire
hassium: 
motorbike: motor
bohrium: 
stomia: 
dubnium: 
fisheries: fishing, peach, fish
amounting: magnitude
hiker: traveller
according-to: second
polygonaceae: 
satsuma: 
plantings: groves
authorship: author
conserved: safe
arranging: measures, streamline, forming
antanaclasis: 
macadamia: 
nutrients: food
rainstorm: storm
remodel: reform
dominance: influence, domain
renewal: rejuvenation, rearrange, reform, refresh, innovation, rehabilitation
phonological: audio
enhancers: intensifier
antimetabole: 
continuative: always
categories: divisions, genus
identicality: 
fermium: 
raindrops: rain, droplets
ineffability: 
epanorthosis: 
egg-white: protein
leading-edge: pioneer, pointed
imperfective: incomplete
indefinitive: unlimited, vague, unspecified
monotypic: 
herbicide: poison
prognosis: prediction
intercepting: preventing
rainwater: rain
cheeseburger: cheese
wide: liberal
aven: 
speleologist: 
gizmo: 
hade: axe
parazoa: 
trajector: 
allotrope: 
polysyndeton: 
replenish: complement, fill, reimburse, again
noncombatant: 
neptunium: 
notification: notify, reminder
petrographer: 
cheek: play, surface
thwarting: fail, vain
leftfield: 
richter: magnitude
converb: 
americium: 
seating: landing, squat, buttocks
subregion: region
concepts:: concepts
berkelium: 
parapatry: 
optimization: adaptation, custom
contour: form, line
worksheet: paper, spreadsheet, workplace, leaf
detransitive: intransitive
shopper: guest, dealer
paucal: 
sympatric: 
allotopic: 
multal: 
distributive: distribute
subtend: underlie
packaging: roll
bureaucratic: bureaucracy, official
ditransitive: intransitive
surviving: living
renewable: alternate
breaststroke: breast
repairperson: 
breathing: immune, breath
hafnium: 
ions: ion
panmictic: 
tectonics: tectonic, architecture
sterility: sterilize
obligated: duty, thank, oblige, bounded, guilty
scrutinizing: deliberation, verification, probe, carefully
interrelated: mutual
holmium: 
besieging: preventing, siege
undetermined: vague, unspecified, assigned
subordinates: conquering
thermocouple: thermosphere
closure: loom, fastener
journey: visit, itinerary, expedition, excursion
unattributed: anonymous
substantiate: justify, underlie
transposable: 
maximization: maximize, supreme
recreational: entertain, hobby
shortages: scarcity, absence
wisecrack: jest
mooring: anchor
sirloin: cow, muscle
randomize: random
kebab: 
authentic: official
transversion: 
constructive: manufacturer, developer, structural, founder
borrowing: credit
retroelement: 
interplay: synergy, descriptive, mutual, interplanetary
electrifying: unique, generator, galvanize
trapezius: trapezium
defence: defending, vindication
toil: work-out
mumification: 
alternatives: alternate
smuggling: kidnapping
grading: making
calendric: 
luffa: 
inclement: windy, defective, fatal
regeneration: renaissance, rejuvenation
diversifying: diversity
ventifact: 
ossification: modifier, fossilization
partitioning: sharing, stock, sealing
snooker: fool
wellies: 
eucrypsis: 
aromatherapy: perfumery
trex: 
silencing: refusal
coadaptation: 
presenter: advertiser, submit
commensalism: symbiosis
identifiable: identity
biota: organisms
investigator: scientist
jumbled: mixed
undependable: unreliable
photomimicry: 
measurements: measurement, specification
predation: hunting, hunter
wiki: 
state-marker: 
space-marker: 
epidemiology: disease
dancing: play, dance
damping: rates
tasks: duty, coworker
authenticity: reliability
authenticate: ratification, verification
protactinium: 
housekeep: 
communicable: infectious, contacting
homeowner: owner
choices: choose, election, sieve
horsebean: 
permaculture: 
heterochrony: 
deficiencies: scarcity
conservandum: 
antennapedia: 
vermiculture: 
crosswalk: line
microfossils: microchip
thymine: adenine
namenclature: 
pumping: pump
rimrock: 
subject-case: topic-case
pathogen: germ
paraphyletic: 
holophyletic: 
archaea: 
monophyletic: federal
olap: 
cladogenesis: 
selectionist: 
dorsi: 
loosely: loose, vague
metrics: measures, measurement
souffle: breath, eggs
statistically: statistical
advisable: desired
qualities: attributes, quality, features
embryological: embryo, zygote
purchaser: recipient
autapomorphic: 
zygophyte: 
afterward: future, after, climate, latter, next-to
institutional: structural
synapomorphic: 
eukaryota: eukaryotes
herpetologist: 
plesiomorphic: 
headboard: forehead
embarrassment: shame, trouble, shyness, confusion
supplementary: complement, overtime, escort
parapatric: 
robb: 
compounds: elements, ingredients
hatchback: tailgate
dropper: pipette, droplets
skateboarding: sledding, skateboard
exabyte: 
retaining: treatment
handstamp: 
amazed: wonder, amaze
handlebar: command, dumbbell
reshaping: rehabilitation
make-up: grooming, cosmetic
underpass: tunnel
heterotic: 
schadenfreude: 
endosymbiotic: 
stromatolites: 
reserving: putting, book
bandaging: dressing, palette
contend: wrestle, argument, quarreling
workforce: staff
regressor: 
xeriscape: 
amused: hilarious, ecstatic
all-right: alright, better
screening: observation, bran
replacing: instead, rearrange
digging: excavate, moat
mutations: mutant
instructional: teaching, training, educational
hypermophosis: 
thunderstorms: thunder, storm
belongingness: 
supercomputer: super
sprayer: sprinkler, inhaler
artificiality: artificial
meteorologist: astronomy
masking: glass, mask
corned: drunk
haplotype: 
repayment: return, refund, pay
dehydrated: liquids
goalkeeper: doorman
recording: documentary, subscribe, footnote
subspeciation: 
rollerblading: skate
oblitum: 
sequences: series, scenery, ordinal
anticodon: 
dichopatry: 
introgressive: 
no-one: nothing
grassland: meadow, grass
stirrer: guilty, blender
neighbourhood: neighborhood
rutherfordium: 
soya: bean
stirrup: hook
feminine-: feminine
subsidy: subsidize
interestingly: draw, pleasant, curious
replica: copy, transcribe, portrait
circumscribed: bounded
commemorative: reminder, memorable
social-marker: 
compatibility: alignment
alleged: claim, accuse
amount-marker: 
meiotic: meiosis
contershading: 
viridiplantae: 
goosefish: 
hallway: hall
sultana: currant
pteridophytes: 
haplodiploidy: 
spermatophyte: seed
cyan: blue
releasing: discharge
variables: variable
trinary: 
magnoliophyta: 
architectural: architecture, architect
exemplariness: 
lawrencium: 
alternatively: alternate
binomen: 
deuterostomia: 
expensiveness: accuracy
neuter-gender: masculine-gender
disorders: harassment, disease
mailbox: postbox
computing: computer, calculator
mailbag: 
reforming: reform
deterministic: crystals, given
biodegradable: biological
gearshift: transmission, switch
amaranthaceae: 
seeding: seed, grafting, speed
cellphone: smartphone, mobile-phone, cell
substantially: dramatically
relationships: relations
defoliate: exfoliate
mixing: shuffle, mixed
galapagos: 
detaching: disconnect
developmental: evolutionary, progress, develop
website: world-wide-web, webpage
linkage: coupling, grafting, attaching, affinity, contacting, weave, connectors
crypsis: 
instep: ankle
intentionally: deliberately
catalog: directory, list, chart, table
communicative: talkative, contacting
detaining: holding, arrest
reimbursement: refund, reimburse, allowance
retrogression: degenerate
arachnids: spider
tempera: temperature
hubcap: 
teeing: 
distributions: distribute
anticausative: 
professionals: expert, industry
approximative: approximate
triticale: 
teapot: teacup
nonfunctional: passive
fractionation: fragmentation
forecourt: farmyard, court
irradiate: radiate
reciprocality: 
masterful: arbitrary, cunning
commercialism: commercialization
paleoclimates: 
soprano: childish
o'clock: hour, poetry
factorisation: 
uninomen: 
potting: pot, pouring
sensors: transducer, censor, sensory
orientational: 
complimentary: complement, flattering
flowerbed: parterre, discount
nougat: zero
kaon: 
euthenics: 
proliferating: multiply, freshman, owner
seepage: leak
employing: using, worker
flatbread: 
phd: doctorate
fibonacci: 
bryophyte: 
butternut: pecan
combinatorial: combinatorics, copula
quarantine: isolation
contrabassoon: 
cheaply: cheap
preliminaries: preparation, introductory
confectionery: caramel, sweet
bissau: 
perlite: 
will-be: 
precariousness: unsteady, dangerous, uncertainty
dvd: 
bloodshed: bloody
camcorder: cell
pinophyta: conifer
camembert: 
quantification: measurement
timpani: tambourine
subpart: 
auxiliary-verb: verb
businessperson: business-person, operator
bryophyta: 
enforcing: applicable, push
grated: rape, scraper
overpopulation: population
golfer: golf, player
entourage: escort
burying: funeral
rented: rent
posessive-case: genitive-case
miscalculation: error
resubstitution: 
fluidic: 
papier: paper, absence
discontentment: dissatisfaction
neoteny: 
objective-case: destination-case
specialization: privileged, modifier
evolved: phylogenetic, develop
farmhouse: house, grange
ceasing: stopped
nominalization: nominal
tagging: tag, encoding
amusing: hilarious
paedomorphosis: 
sao: 
kumquat: 
autopolyploidy: 
allopolyploidy: 
professionally: profession, industry, expert
evolutionarily: phylogenetic, evolutionary, coevolution, develop
jutting: 
estimated: approximate
eumetazoa: 
lophotrochozoa: 
bilateria: 
sri: 
tam: integer, taste
mephrozoa: 
correlate: hook, mutual
tensile: elastic
camping: camp
sponges: sponge, foam
seaborgium: 
retreat: digress, retire, budge
retiree: retire, expiring
lycopodiophyta: 
gearbox: transmission
retired: retire, expiring, pension
intergradation: 
cotheme: 
dodging: avoid
exosphere: 
inelative-case: elative-case
gerbera: 
interdependent: mutual
excelsior: chip
downing: 
unquote: quoted
complementizer: 
ecdysozoa: molt
extractor: tongs
synaposematism: 
radiation: radioactivity, emission
blogger: blog
electrophoresis: photoelectric
excreting: secretion
parasympathetic: involuntary
authorise: authority, official
bap: 
vs.: against
evading: avoid, steal
gro: 
inducer: judo
prhobitive-mood: prohibitive-mood
artifacts: remains, artifact, objects
distinctiveness: unique, obviousness
conferral: allotment, transmission
postessive-case: genitive-case
marchantiophyta: 
indirect-object: direct-object
trimmer: cutter
condenser: capacitor
entrepreneurial: jargon
asyndeton: 
ley: law
interconnection: mutual
interdependence: mutualism
splint: strip, chip
eclair: 
eco: ecology, echo
fleeing: escape, leak
pseudocephalism: 
freeing: 
fcs: 
anesthesiologist: trance
pseudaposematism: 
praiseworthiness: 
broadly: 
fluctuate: varied
perceiver: 
chipboard: board
enthusiastically: enthusiasm, tiptoe, ecstatic
symplesiomorphic: 
slalom: 
connector: connectors, copula, plug, contacting
pollutant: damp
meitnerium: 
subjunctive-mood: conditional-mood, optative-mood
n't: 
problem: trouble, question
anthocerotophyta: 
whitecaps: 
financing: money, silver, fundraise
volcanoes: volcanic, volcano
puerto: 
inceptive: introductory
frugality: frugal, simplicity
seesaw: swing, bottled
scars: traces, ulcer
pseudocopulation: 
iterative: disease, iteration, repeatedly
rulings: making, decision
spectra: spectrum, spectral
pushup: jack, lift, push
exp: termination, experience
via: passing, using
dartboard: 
hurdles: hedge
obj: 
mimicry: transcribe
ied: 
misdeed: evil
feijoa: 
misrepresentation: entrap, placenta
heralding: pronouncing, notify
hindering: preventing
needles: needle, needlepoint
sander: sandpaper
domain-name-system: domain-name
col: saddle
radiation-sickness: disorder
locales: locally, places
sunscreen: sunshine
prepositional-case: nominative-case
reamer: strawberry
captcha: 
imitating: echo, copy, resemble
cubbyhole: restroom
renting: rent, renter
vs: against
marino: 
kv: volt
surprises: wonder
rewards: reward, atonement
oolites: 
handset: smartphone, headphone, receiver
rotting: rot
institutionalization: institutions
salted: salt
computer-programming: computer-program
importing: enter, import, submit
storeroom: shed, stock
soaking: exploit
alleles: allelic
squatters: squatter, invading
courgette: 
